Attempt	Real
re-cy-cling	recycling
hal-ibut	hal-i-but
read-mis-sion	re-ad-mis-sion
any-ways	an-y-ways
chalet	cha-let
springy	spring-y
hotspot	hot-spot
eter-nal-ly	e-ter-nal-ly
us-able	us-a-ble
un-abat-ed	un-a-bat-ed
satir-i-cal	sa-tir-i-cal
im-munoas-say	im-mu-no-as-say
doubter	doubt-er
em-piri-cist	em-pir-i-cist
swarm-ing	swarming
health-ily	health-i-ly
hy-dros-phere	hy-dro-sphere
stargaz-er	star-gaz-er
coro-nal	cor-o-nal
cor-re-spon-dent	cor-re-spond-ent
neo-phyte	ne-o-phyte
en-gi-neered	engineered
per-centile	per-cen-tile
axis	ax-is
rewire	re-wire
garage	ga-rage
dis-abuse	dis-a-buse
egal-i-tar-i-an	e-gal-i-tar-i-an
puffy	puf-fy
uni-son	u-ni-son
greedy	greed-y
fetid	fet-id
salient	sa-li-ent
chro-matog-ra-phy	chro-ma-tog-ra-phy
re-uni-fi-ca-tion	re-u-ni-fi-ca-tion
po-litesse	pol-i-tesse
in-sur-gency	in-sur-gen-cy
record-ed	re-cor-ded
scapu-la	scap-u-la
winnable	win-na-ble
hye-na	hy-e-na
sniff-ing	sniffing
gofer	go-fer
gro-cery	gro-cer-y
rewrite	re-write
hunter	hunt-er
re-design	re-de-sign
frailty	frail-ty
psy-cho-me-t-ric	psy-cho-met-ric
video	vid-e-o
ura-ni-um	u-ra-ni-um
kook-abur-ra	kook-a-bur-ra
turntable	turn-ta-ble
easy	eas-y
basin	ba-sin
apoth-e-o-sis	a-poth-e-o-sis
record-ing	re-cord-ing
resur-face	re-sur-face
into	in-to
unin-spired	un-in-spired
ten-able	ten-a-ble
fusty	fus-ty
pester	pes-ter
over-ween-ing	o-ver-ween-ing
apiece	a-piece
par-venu	par-ve-nu
cre-ativ-i-ty	cre-a-tiv-i-ty
teapot	tea-pot
pro-mul-gate	prom-ul-gate
poly-mor-phous	pol-y-mor-phous
syn-onymy	syn-on-y-my
crevice	crev-ice
epis-co-pate	e-pis-co-pate
gra-nary	gra-na-ry
seclu-sion	se-clu-sion
parochial-ism	pa-ro-chi-al-ism
telecom-mu-ni-ca-tion	tel-e-com-mu-ni-ca-tion
iron-works	i-ron-works
hawser	haw-ser
volt-meter	volt-me-ter
tra-verse	trav-erse
signet	sig-net
pol-lard-ed	pollarded
tiler	til-er
cheater	cheat-er
modal-i-ty	mo-dal-i-ty
tachy-on	tach-y-on
pre-s-e-lect	pre-se-lect
fid-get	fidg-et
iambus	i-am-bus
over-val-ue	o-ver-val-ue
gaze-bo	ga-ze-bo
de-mog-ra-ph-er	de-mog-ra-pher
lyri-cism	lyr-i-cism
bereft	be-reft
re-peater	re-peat-er
kilo-ton	kil-o-ton
re-spectabil-i-ty	re-spect-a-bil-i-ty
drom-e-dary	drom-e-dar-y
taster	tast-er
bathos	ba-thos
in-dis-putably	in-dis-put-a-bly
de-crepit	de-crep-it
sharply	sharp-ly
mic-turi-tion	mic-tu-ri-tion
dis-avow-al	dis-a-vow-al
brazen	bra-zen
briskly	brisk-ly
dactyl	dac-tyl
in-dige-nous	in-dig-e-nous
chas-ten-ing	chastening
im-moral-i-ty	im-mo-ral-i-ty
pold-er	pol-der
gallery	gal-ler-y
un-nec-es-sary	un-nec-es-sar-y
ocean	o-cean
cam-corder	cam-cord-er
oval	o-val
unas-signed	un-as-signed
uni-cam-er-al	u-ni-cam-er-al
fin-ery	fin-er-y
pushy	push-y
icon-o-clas-tic	i-con-o-clas-tic
me-te-oric	me-te-or-ic
tru-cu-lent	truc-u-lent
sari	sa-ri
undis-mayed	un-dis-mayed
mem-o-rable	mem-o-ra-ble
en-tropy	en-tro-py
habit	hab-it
spo-radic	spo-rad-ic
pyra-mid	pyr-a-mid
steamy	steam-y
in-abil-i-ty	in-a-bil-i-ty
cataract	cat-a-ract
ge-neti-cist	ge-net-i-cist
crazi-ly	cra-zi-ly
over-run	o-ver-run
desul-to-ry	des-ul-to-ry
hy-pox-ia	hy-pox-i-a
pre-de-ter-mined	predetermined
stiffly	stiff-ly
spongy	spon-gy
key-boardist	key-board-ist
amused	a-mused
grandiose	gran-di-ose
billing	bil-ling
erot-i-ca	e-rot-i-ca
apos-tate	a-pos-tate
id-iomat-ic	id-i-o-mat-ic
tai-lorable	tai-lor-a-ble
re-spectably	re-spect-a-bly
coulomb	cou-lomb
stapes	sta-pes
cretin	cre-tin
rounders	round-ers
sago	sa-go
fri-able	fri-a-ble
toga	to-ga
un-set-tling	unsettling
mono-pole	mon-o-pole
over-anx-ious	o-ver-anx-ious
spokes-woman	spokes-wom-an
enu-mer-a-tor	e-nu-mer-a-tor
body-guard	bod-y-guard
tweedy	tweed-y
slater	slat-er
serene	se-rene
grinder	grind-er
espres-so	es-pres-so
eco-log-i-cal-ly	ec-o-log-i-cal-ly
fairy	fair-y
costar	co-star
deficit	def-i-cit
aver	a-ver
trencher	trench-er
in-dis-putable	in-dis-put-a-ble
mil-ligram	mil-li-gram
sto-ry-telling	sto-ry-tell-ing
rip-pling	rippling
stipend	sti-pend
dither	dith-er
overuse	o-ver-use
coral	cor-al
tiling	til-ing
ne-go-tiable	ne-go-ti-a-ble
equidis-tant	e-qui-dis-tant
unswerv-ing	un-swerv-ing
palmy	palm-y
basal	ba-sal
sacral	sa-cral
break-able	break-a-ble
ves-ti-gial	ves-tig-i-al
cut-lery	cut-ler-y
an-swer-able	an-swer-a-ble
unlov-ing	un-lov-ing
un-in-for-ma-tive	un-in-form-a-tive
avi-ate	a-vi-ate
busy-body	bus-y-bod-y
de-mo-li-tion	dem-o-li-tion
episod-ic	ep-i-sod-ic
im-pri-matur	im-pri-ma-tur
satchel	satch-el
tele-vi-sion	tel-e-vi-sion
an-te-dilu-vian	an-te-di-lu-vi-an
boast-ing	boas-ting
un-de-cid-able	un-de-cid-a-ble
lu-mi-nary	lu-mi-nar-y
also	al-so
avert	a-vert
brandy	bran-dy
emi-rate	e-mir-ate
enor-mous-ly	e-nor-mous-ly
over-board	o-ver-board
bo-som	bos-om
bolero	bo-le-ro
flab-ber-gast-ed	flabbergasted
even-tu-al	e-ven-tu-al
re-deemer	re-deem-er
penol-o-gy	pe-nol-o-gy
elec-tric-i-ty	e-lec-tric-i-ty
brutish	brut-ish
em-anate	em-a-nate
reval-u-a-tion	re-val-u-a-tion
leav-ened	leavened
orig-i-na-tor	o-rig-i-na-tor
re-silience	re-sil-ience
mort-gagor	mort-ga-gor
oculist	oc-u-list
monomol-e-c-u-lar	mon-o-mo-lec-u-lar
iso-la-tion	i-so-la-tion
ringlet	ring-let
mud-dling	muddling
smoth-ered	smothered
pec-toral	pec-to-ral
sophist	soph-ist
lemon-ade	lem-on-ade
id-io-cy	id-i-o-cy
grid-iron	grid-i-ron
table-land	ta-ble-land
tute-lage	tu-te-lage
con-certi-na	con-cer-ti-na
squashy	squash-y
ital-ic	i-tal-ic
devo-tee	dev-o-tee
metro	met-ro
loafer	loaf-er
geri-atric	ger-i-at-ric
mandible	man-di-ble
over-act	o-ver-act
antler	ant-ler
au-dio	au-di-o
spon-sored	sponsored
sunspot	sun-spot
in-ter-vie-wee	in-ter-view-ee
over-sen-si-tive	o-ver-sen-si-tive
pass-able	pass-a-ble
posse	pos-se
sanc-tu-ary	sanc-tu-ar-y
planter	plant-er
be-fud-dling	befuddling
pre-fab-ri-cat-ed	prefabricated
couloir	cou-loir
tele-work-ing	teleworking
car-roty	car-rot-y
rein-vent	re-in-vent
rhodi-um	rho-di-um
chromi-um	chro-mi-um
cretinous	cre-tin-ous
nifty	nif-ty
straight-away	straight-a-way
colo-nial-ist	co-lo-ni-al-ist
fluffy	fluff-y
in-ter-change-able	in-ter-change-a-ble
opin-ion-at-ed	o-pin-ion-at-ed
gan-g-ly	gan-gly
monog-a-mous	mo-nog-a-mous
poseur	po-seur
ca-cao	ca-ca-o
loutish	lout-ish
frilli-er	fril-li-er
vi-su-al	vis-u-al
re-as-sur-ing	reassuring
trade-marked	trademarked
en-chant-i-ng	en-chant-ing
kudu	ku-du
arch-i-pel-ago	ar-chi-pel-a-go
im-mutable	im-mu-ta-ble
ri-boflavin	ri-bo-fla-vin
in-com-bustible	in-com-bus-ti-ble
bailout	bail-out
freaky	freak-y
pa-pyrus	pa-py-rus
palmist	palm-ist
blowup	blow-up
pre-dictably	pre-dict-a-bly
handy-man	hand-y-man
steplad-der	step-lad-der
elec-tri-fi-ca-tion	e-lec-tri-fi-ca-tion
meta-phys-i-cal	met-a-phys-i-cal
shoplifter	shop-lift-er
laugh-ably	laugh-a-bly
ques-tion-able	ques-tion-a-ble
bre-viary	bre-vi-ar-y
at-tack-ing	attacking
eclipse	e-clipse
arabesque	ar-a-besque
un-ac-cept-ably	un-ac-cept-a-bly
bar-bar-ian	bar-bar-i-an
pi-anis-si-mo	pi-a-nis-si-mo
symp-to-matic	symp-to-mat-ic
in-tu-ition	in-tu-i-tion
craven	cra-ven
wolfish	wolf-ish
dessert	des-sert
sinew	sin-ew
bitchy	bitch-y
elec-tive	e-lec-tive
re-pro-ducibly	re-pro-duc-i-bly
emery	em-er-y
bean-ery	bean-er-y
shiv-er-ing	shivering
ranch-ing	ranching
break-away	break-a-way
apex	a-pex
usurp	u-surp
em-body	em-bod-y
re-new-able	re-new-a-ble
az-imuth	az-i-muth
misog-y-nist	mi-sog-y-nist
ra-di-ograph-ic	ra-di-o-graph-ic
sub-stan-dard	sub-stand-ard
rec-i-p-ro-cal	re-cip-ro-cal
ar-bi-trary	ar-bi-trar-y
nightin-gale	night-in-gale
syco-phan-tic	syc-o-phan-tic
union-i-sa-tion	un-ion-i-sa-tion
an-tibi-ot-ic	an-ti-bi-ot-ic
spiny	spin-y
un-demon-stra-tive	un-de-mon-stra-tive
propo-si-tion	prop-o-si-tion
inca	in-ca
mi-mosa	mi-mo-sa
elab-o-rate	e-lab-o-rate
mer-ce-nary	mer-ce-nar-y
in-quiry	in-quir-y
de-mount-able	de-mount-a-ble
forte	for-te
tawdry	taw-dry
fly-away	fly-a-way
preda-to-ry	pred-a-to-ry
archer	arch-er
despo-tism	des-pot-ism
idol-a-trous	i-dol-a-trous
scat-tered	scattered
re-newed	renewed
potable	po-ta-ble
un-der-stand-ably	un-der-stand-a-bly
pre-dictabil-i-ty	pre-dict-a-bil-i-ty
grater	grat-er
inan-i-mate	in-an-i-mate
stretchy	stretch-y
seis-mome-ter	seis-mom-e-ter
litur-gi-cal	li-tur-gi-cal
re-doubtable	re-doubt-a-ble
mushy	mush-y
as-para-gus	as-par-a-gus
sub-ter-ranean	sub-ter-ra-ne-an
dis-senter	dis-sent-er
non-con-for-mi-ty	non-con-form-i-ty
as-segai	as-se-gai
diplo-mat-ic	dip-lo-mat-ic
screwy	screw-y
med-i-c-i-nal	me-dic-i-nal
cal-care-ous	cal-car-e-ous
pre-dictable	pre-dict-a-ble
defuse	de-fuse
as-cen-dant	as-cend-ant
epi-gram-mat-ic	ep-i-gram-mat-ic
toluene	tol-u-ene
de-f-i-n-i-tion-al	def-i-ni-tion-al
avoid	a-void
in-alien-able	in-al-ien-a-ble
mela-tonin	mel-a-to-nin
burn-ings	bur-nings
steeple-jack	stee-ple-jack
par-si-mo-nious	par-si-mo-ni-ous
metaphor	met-a-phor
mas-tery	mas-ter-y
doc-tor-ing	doctoring
can-dlelit	can-dle-lit
opera	o-pe-ra
in-frared	in-fra-red
orig-i-na-tion	o-rig-i-na-tion
stat-uette	stat-u-ette
gable	ga-ble
kilo-hertz	kil-o-hertz
pro-ject-ing	projecting
pig-gery	pig-ger-y
grandios-i-ty	gran-di-os-i-ty
post-mod-ernist	post-mod-ern-ist
metronome	met-ro-nome
epig-ra-phy	e-pig-ra-phy
uni-fy	u-ni-fy
frontal	fron-tal
docile	doc-ile
rein-vig-o-rate	re-in-vig-or-ate
de-crepi-tude	de-crep-i-tude
sisal	si-sal
psy-chother-a-py	psy-cho-ther-a-py
sacra-men-tal	sac-ra-men-tal
para-phrase	par-a-phrase
manda-to-ry	man-da-to-ry
samu-rai	sam-u-rai
polem-i-cal	po-lem-i-cal
dolomite	do-lo-mite
gelati-nous	ge-lat-i-nous
con-cil-iar	con-cil-i-ar
foot-balling	foot-ball-ing
punky	punk-y
sedi-tious	se-di-tious
satyr	sa-tyr
over-rate	o-ver-rate
literati	lit-e-ra-ti
timid	tim-id
cheru-bic	che-ru-bic
en-graver	en-grav-er
cine	cin-e
en-tre-pre-neur-ial	en-tre-pre-neur-i-al
iso-la-tion-ism	i-so-la-tion-ism
par-tici-ple	par-ti-ci-ple
tsuna-mi	tsu-na-mi
seg-ment-ed	seg-men-ted
gan-glion	gan-gli-on
meta-mor-phism	met-a-mor-phism
over-haul	o-ver-haul
un-con-ge-nial	un-con-gen-ial
plat-i-tudi-nous	plat-i-tu-di-nous
meta-physics	met-a-phys-ics
grenadier	gren-a-dier
bawdy	bawd-y
do-lor-ous	dol-or-ous
com-ple-men-tary	com-ple-men-ta-ry
sier-ra	si-er-ra
paci-fy	pac-i-fy
randy	rand-y
lion	li-on
chimera	chi-me-ra
tra-chea	tra-che-a
sun-flower	sun-flow-er
showjumpers	show-jum-pers
su-prema-cy	su-prem-a-cy
joyrid-ing	joy-rid-ing
usurer	u-su-rer
at-tribute	at-trib-ute
tempter	tempt-er
fragili-ty	fra-gil-i-ty
rata-touille	ra-ta-touille
white-washed	whitewashed
unlov-able	un-lov-a-ble
fel-la-tio	fel-la-ti-o
high-lighter	high-ligh-ter
cheva-lier	chev-a-lier
kilo	ki-lo
hobo	ho-bo
seraph-ic	se-raph-ic
dogged	dog-ged
ivy	i-vy
where-abouts	where-a-bouts
trans-plant-ed	transplanted
dis-con-ti-nu-ity	dis-con-ti-nu-i-ty
va-grancy	va-gran-cy
cor-nu-copia	cor-nu-co-pi-a
archival	ar-chi-val
raider	raid-er
tem-pera-men-tal	tem-per-a-men-tal
cen-tipede	cen-ti-pede
seaborne	sea-borne
teenaged	teen-aged
bio-met-ric	bi-o-met-ric
unabridged	un-a-bridged
heretic	her-e-tic
sabra	sa-bra
re-assem-ble	re-as-sem-ble
hefty	heft-y
util-i-tar-i-an	u-til-i-tar-i-an
mega-lo-ma-nia	meg-a-lo-ma-ni-a
ex-citable	ex-cit-a-ble
shifty	shift-y
beanstalk	bean-stalk
manslaugh-ter	man-slaugh-ter
ozone	o-zone
mil-lenar-i-an	mil-le-nar-i-an
poly-tech-nic	pol-y-tech-nic
hear-ken	heark-en
undis-cov-ered	un-dis-cov-ered
ir-res-olute	ir-res-o-lute
rhubarb	rhu-barb
roguery	ro-guer-y
elon-ga-tion	e-lon-ga-tion
over-fly	o-ver-fly
glassy	glass-y
tena-cious-ly	te-na-cious-ly
debu-tante	deb-u-tante
pan-das	pan-das
gen-uine	gen-u-ine
galling	gall-ing
fa-nati-cism	fa-nat-i-cism
razzmatazz	razz-ma-tazz
fa-ther-ing	fathering
with-ered	withered
res-cuer	res-cu-er
re-vival-ism	re-viv-al-ism
un-healthy	un-health-y
flaky	flak-y
ar-chaeopteryx	ar-chae-op-ter-yx
glam-orous	glam-or-ous
tro-pos-phere	trop-o-sphere
over-draw	o-ver-draw
castoff	cast-off
hermeneu-tics	her-me-neu-tics
pass-ably	pass-a-bly
poly-mor-phism	pol-y-mor-phism
me-nial	me-ni-al
pe-tit	pet-it
poly-thene	pol-y-thene
bear-able	bear-a-ble
fiat	fi-at
padding	pad-ding
un-bear-ably	un-bear-a-bly
nadir	na-dir
kayak	kay-ak
nonethe-less	none-the-less
ori-ent	o-ri-ent
ir-re-versible	ir-re-vers-i-ble
onyx	on-yx
tragedy	trag-e-dy
jalopy	ja-lop-y
un-pre-dictably	un-pre-dict-a-bly
cur-tained	curtained
ab-solute-ly	ab-so-lute-ly
parox-ysm	par-ox-ysm
cur-ricu-lum	cur-ric-u-lum
artiste	ar-tiste
flutist	flut-ist
tiny	ti-ny
wail-ing	wailing
glut-tony	glut-ton-y
uvu-la	u-vu-la
par-ent-ing	parenting
vizier	vi-zier
morale	mo-rale
hy-acinth	hy-a-cinth
deli	del-i
repos-i-to-ry	re-pos-i-to-ry
buoy	bu-oy
de-lin-eate	de-lin-e-ate
there-after	there-af-ter
mesca-line	mes-ca-line
hy-drochlo-ride	hy-dro-chlo-ride
utopi-an	u-to-pi-an
abroad	a-broad
macaw	ma-caw
dauber	daub-er
ho-mo-gene-ity	ho-mo-ge-ne-i-ty
undis-ci-plined	un-dis-ci-plined
vel-veteen	vel-vet-een
covenant	cov-e-nant
in-for-mant	in-form-ant
emul-sion	e-mul-sion
stetho-scope	steth-o-scope
melan-cholic	mel-an-chol-ic
sup-ple-men-tary	sup-ple-men-ta-ry
bather	bath-er
un-event-ful	un-e-vent-ful
phil-an-thropist	phi-lan-thro-pist
para-mount-cy	par-a-mount-cy
petro-chem-i-cal	pet-ro-chem-i-cal
swindler	swin-dler
bulky	bulk-y
sunken	sunk-en
mantrap	man-trap
dugout	dug-out
pun-ish-able	pun-ish-a-ble
hexa-gram	hex-a-gram
dero-gate	der-o-gate
lithi-um	lith-i-um
cursed	curs-ed
herbal-ism	her-bal-ism
lisp-ing	lis-ping
dishar-mo-ny	dis-har-mo-ny
liken	lik-en
naive-ly	na-ive-ly
sali-vary	sal-i-var-y
valise	va-lise
retic-u-lat-ed	re-tic-u-lat-ed
di-ure-sis	di-u-re-sis
mer-cu-r-ial	mer-cu-ri-al
con-vivial	con-viv-i-al
project	proj-ect
sto-ry-teller	sto-ry-tell-er
gospel	gos-pel
cli-ma-tol-ogy	cli-ma-tol-o-gy
gen-uine-ness	gen-u-ine-ness
sleepi-ness	sleep-i-ness
parabo-la	pa-rab-o-la
trea-son-able	trea-son-a-ble
pizze-ria	piz-ze-ri-a
squally	squal-ly
tyran-ni-cal	ty-ran-ni-cal
dis-penser	dis-pens-er
geo-chem-istry	ge-o-chem-is-try
mi-crowave	mi-cro-wave
mol-e-c-u-lar	mo-lec-u-lar
codling	cod-ling
ru-inous	ru-in-ous
fly-over	fly-o-ver
defe-cate	def-e-cate
cylin-der	cyl-in-der
bar-barism	bar-ba-rism
mis-align-ment	mis-a-lign-ment
pho-to-copy	pho-to-cop-y
over-pro-duc-tion	o-ver-pro-duc-tion
pre-dict-ed	predicted
os-tracism	os-tra-cism
gavotte	ga-votte
in-hala-tion	in-ha-la-tion
shad-owy	shad-ow-y
over-sup-ply	o-ver-sup-ply
fussy	fuss-y
unim-por-tance	un-im-por-tance
abaft	a-baft
friendlily	friend-li-ly
my-opia	my-o-pi-a
melo-di-ous	me-lo-di-ous
imam	i-mam
aor-tic	a-or-tic
recog-ni-tion	rec-og-ni-tion
ran-corous	ran-cor-ous
nymp-holep-sy	nym-pho-lep-sy
ap-pendage	ap-pend-age
poly-glot	pol-y-glot
wom-ankind	wom-an-kind
equal-i-ty	e-qual-i-ty
ex-porter	ex-port-er
rafter	raft-er
ex-piry	ex-pi-ry
in-cor-rupt-ible	in-cor-rupt-i-ble
steam-roller	steam-roll-er
chivvy	chiv-vy
ex-plic-a-ble	ex-pli-ca-ble
an-thro-pocen-tric	an-thro-po-cen-tric
cider	ci-der
irid-i-um	i-rid-i-um
me-thio-n-ine	me-thi-o-nine
okapi	o-ka-pi
beamy	beam-y
telegram	tel-e-gram
in-ter-mol-e-c-u-lar	in-ter-mo-lec-u-lar
hosepipe	hose-pipe
onus	o-nus
eval-u-a-tor	e-val-u-a-tor
chemist	chem-ist
award	a-ward
man-i-festo	man-i-fes-to
mealie	meal-ie
bac-te-r-i-al	bac-te-ri-al
co-pra	cop-ra
ra-di-og-ra-ph-er	ra-di-og-ra-pher
eosin	e-o-sin
cesspit	cess-pit
rial	ri-al
jeal-ousy	jeal-ous-y
pe-ri-as-tron	per-i-as-tron
derelict	der-e-lict
dis-obe-di-ent	dis-o-be-di-ent
hia-tus	hi-a-tus
even	e-ven
in-flat-able	in-flat-a-ble
naval	na-val
mayflower	may-flow-er
beeswax	bees-wax
makeshift	make-shift
heavy-weight	heav-y-weight
edit-ed	edited
op-por-tunism	op-por-tun-ism
con-sul-tan-cy	con-sult-an-cy
vestal	ves-tal
ho-n-our	ho-nour
mo-not-o-n-ic	mon-o-ton-ic
ego-tism	e-go-tism
para-mour	par-a-mour
hazel	ha-zel
await	a-wait
baby	ba-by
aro-ma	a-ro-ma
plumy	plum-y
trea-sure	treas-ure
tenon	ten-on
navy	na-vy
guinea	guin-ea
evade	e-vade
vanil-la	va-nil-la
siphon	si-phon
cousin	cous-in
reread	re-read
apos-tle	a-pos-tle
precipice	prec-i-pice
chi-canery	chi-can-er-y
loca-tive	loc-a-tive
par-adise	par-a-dise
humbly	hum-bly
musty	mus-ty
apos-ta-sy	a-pos-ta-sy
an-throp-ic	an-thro-pic
creaky	creak-y
car-cino-gen-e-sis	car-cin-o-gen-e-sis
ecol-o-gy	e-col-o-gy
sa-tanism	sa-tan-ism
ex-e-cutable	ex-e-cut-a-ble
gui-tarist	gui-tar-ist
im-munol-o-gy	im-mu-nol-o-gy
pre-cau-tion-ary	pre-cau-tion-ar-y
zigzag	zig-zag
in-com-men-su-rable	in-com-men-su-ra-ble
renter	rent-er
bistro	bis-tro
skele-ton	skel-e-ton
prefer-ably	pref-er-a-bly
semi-con-scious	sem-i-con-scious
prairie	prai-rie
cation	cat-i-on
by-stander	by-stand-er
chateau	cha-teau
facile	fac-ile
triplet	tri-plet
whisker	whisk-er
sabo-teur	sab-o-teur
un-in-ter-pretable	un-in-ter-pret-a-ble
maser	ma-ser
in-tegri-ty	in-teg-ri-ty
busi-ly	bus-i-ly
in-de-ter-minable	in-de-ter-mi-na-ble
peri-patet-ic	per-i-pa-tet-ic
prepara-to-ry	pre-par-a-to-ry
sepul-chral	se-pul-chral
tele-con-fer-ence	tel-e-con-fer-ence
bal-moral	bal-mor-al
climber	climb-er
un-no-tice-able	un-no-tice-a-ble
church-war-den	church-ward-en
precinct	pre-cinct
stu-dious-ly	stu-di-ous-ly
panache	pa-nache
poignant	poign-ant
busty	bust-y
re-fin-ery	re-fin-er-y
un-avoid-able	un-a-void-a-ble
quizzi-cal	quiz-zi-cal
un-am-bigu-ous-ly	un-am-big-u-ous-ly
heather	heath-er
orang	o-rang
look-ing	looking
over-spill	o-ver-spill
verisimil-i-tude	ver-i-si-mil-i-tude
jam-boree	jam-bo-ree
rapi-er	ra-pi-er
styl-is-tic	sty-lis-tic
arthro-pod	ar-thro-pod
odome-ter	o-dom-e-ter
mover	mov-er
metal-lic	me-tal-lic
un-war-rantable	un-war-rant-a-ble
dandy	dan-dy
bubon-ic	bu-bon-ic
com-pact-ed	compacted
mam-malian	mam-ma-li-an
myx-o-mato-sis	myx-o-ma-to-sis
pre-or-dained	preordained
tremu-lous	trem-u-lous
phys-iog-no-my	phys-i-og-no-my
arum	ar-um
rat-tlesnake	rat-tle-snake
myelin	my-e-lin
cameo	cam-e-o
trashy	trash-y
comet	com-et
comi-ty	com-i-ty
leucine	leu-cine
smelly	smell-y
an-tipodes	an-tip-o-des
emit	e-mit
apos-tolic	ap-os-tol-ic
mar-itime	mar-i-time
blus-ter-ing	blustering
barefaced	bare-faced
con-denser	con-dens-er
wispy	wisp-y
dwin-dling	dwindling
metonymy	me-ton-y-my
falset-to	fal-set-to
pathol-o-gy	pa-thol-o-gy
di-aphanous	di-aph-a-nous
apoc-ryphal	a-poc-ry-phal
lido	li-do
pan-icky	pan-ick-y
over-load	o-ver-load
oblige	o-blige
sulky	sulk-y
sumo	su-mo
repa-tri-a-tion	re-pa-tri-a-tion
liveli-hood	live-li-hood
igua-na	i-gua-na
sero-tonin	ser-o-to-nin
equa-to-r-i-al	e-qua-to-ri-al
ir-re-proach-able	ir-re-proach-a-ble
cur-tilage	cur-ti-lage
rewritable	re-writ-a-ble
per-ilous-ly	per-il-ous-ly
speechi-fy-ing	speechifying
whiskey	whis-key
xenon	xe-non
rosin	ros-in
dis-abil-i-ty	dis-a-bil-i-ty
silage	si-lage
bal-alai-ka	bal-a-lai-ka
dis-in-fec-tant	dis-in-fect-ant
rustler	rus-tler
milliner	mil-li-ner
over-ripe	o-ver-ripe
peafowl	pea-fowl
dusky	dusk-y
adult	a-dult
unchris-t-ian	un-chris-tian
overop-ti-mistic	o-ver-op-ti-mis-tic
cor-po-ratism	cor-po-rat-ism
be-wil-der-ing	bewildering
capri-cious	ca-pri-cious
re-assess-ment	re-as-sess-ment
union-ist	un-ion-ist
alive	a-live
ge-ot-her-mal	ge-o-ther-mal
in-con-ceiv-able	in-con-ceiv-a-ble
shilling	shil-ling
rack-e-teer-ing	rack-et-eer-ing
elas-tic-i-ty	e-las-tic-i-ty
bony	bon-y
va-porous	va-por-ous
fever-ish	fe-ver-ish
raven-ing	rav-en-ing
orig-i-nal-i-ty	o-rig-i-nal-i-ty
bivouac	biv-ou-ac
hu-manoid	hu-man-oid
read-able	read-a-ble
scrupu-lous-ly	scru-pu-lous-ly
ex-is-tent	ex-ist-ent
ebul-lience	e-bul-lience
out-lier	out-li-er
mistype	mis-type
mar-que	marque
spir-i-tu-al-ist	spir-it-u-al-ist
colan-der	col-an-der
ashamed	a-shamed
lyri-cal	lyr-i-cal
province	prov-ince
sen-hor	se-nhor
ir-ri-tabil-i-ty	ir-ri-ta-bil-i-ty
freck-led	freckled
fig-u-ra-tive	fig-ur-a-tive
zany	za-ny
melanin	mel-a-nin
ever-more	ev-er-more
soli-taire	sol-i-taire
bal-loon-ist	balloonist
cherub	cher-ub
mar-gin-a-lia	mar-gi-na-li-a
shopfront	shop-front
con-vert-ible	con-vert-i-ble
over-look	o-ver-look
un-de-tectable	un-de-tect-a-ble
gra-tu-itous-ly	gra-tu-i-tous-ly
atom-ic-i-ty	at-o-mic-i-ty
harpist	har-pist
weapon	weap-on
toothy	tooth-y
bullfinch	bull-finch
makeover	make-o-ver
in-cisor	in-ci-sor
omi-nous	om-i-nous
deluxe	de-luxe
soli-tary	sol-i-tar-y
uterus	u-ter-us
hy-draulics	hy-drau-lics
ure-thane	u-re-thane
calo-rie	cal-o-rie
breath-able	breath-a-ble
dis-pens-able	dis-pen-sa-ble
ir-re-versibly	ir-re-vers-i-bly
elec-tro-dy-nam-ics	e-lec-tro-dy-nam-ics
tenac-i-ty	te-nac-i-ty
slimy	slim-y
babysit-ting	babysitting
eu-pho-nious	eu-pho-ni-ous
aqua-naut	aq-ua-naut
spaghet-ti	spa-ghet-ti
techno-pho-bic	tech-no-pho-bic
strate-gi-cal-ly	stra-te-gi-cal-ly
judo	ju-do
in-com-press-ible	in-com-press-i-ble
coax-i-al	co-ax-i-al
equip-ment	e-quip-ment
mono-rail	mon-o-rail
frigid	frig-id
hauler	haul-er
vari-ate	var-i-ate
turnkey	turn-key
tri-adic	tri-ad-ic
un-break-able	un-break-a-ble
slip-ping	slipping
de-ity	de-i-ty
un-reach-able	un-reach-a-ble
re-mark-ably	re-mark-a-bly
leg-isla-tive	leg-is-la-tive
reaper	reap-er
con-formist	con-form-ist
si-nu-soid	si-nus-oid
un-mis-tak-ably	un-mis-tak-a-bly
sub-sis-tence	sub-sist-ence
ac-cept-able	ac-cept-a-ble
turnip	tur-nip
epi-der-mis	ep-i-der-mis
con-t-a-m-i-na-tion	con-tam-i-na-tion
mono-lin-gual	mon-o-lin-gual
con-struc-tivism	con-struc-tiv-ism
oakum	oa-kum
cen-tripetal	cen-trip-e-tal
pres-bytery	pres-by-ter-y
geisha	gei-sha
sinis-tral	sin-is-tral
de-plorable	de-plor-a-ble
shim-mer-ing	shimmering
cannabis	can-na-bis
ibis	i-bis
ivory	i-vo-ry
over-in-flat-ed	o-ver-in-flat-ed
mono-phon-ic	mon-o-phon-ic
fifty	fif-ty
icon-o-clast	i-con-o-clast
body-build-ing	bod-y-build-ing
bour-geoisie	bour-geoi-sie
fu-ner-ary	fu-ner-ar-y
soya	soy-a
in-ter-lock-ing	in-ter-loc-king
bur-glary	bur-gla-ry
eat-able	eat-a-ble
mores	mo-res
plat-inum	plat-i-num
tau-tol-ogy	tau-tol-o-gy
spinach	spin-ach
test-ing	testing
cop-pery	cop-per-y
ge-nial	ge-ni-al
techno-pho-bia	tech-no-pho-bia
uni-ver-sal	u-ni-ver-sal
over-seer	o-ver-se-er
poly-math	pol-y-math
cel-ery	cel-er-y
evo-ca-tion	ev-o-ca-tion
cocky	cock-y
su-per-natant	su-per-na-tant
amaz-ing	a-maz-ing
in-con-solable	in-con-sol-a-ble
bi-modal	bi-mod-al
boathouse	boat-house
pres-tidig-i-ta-tion	pres-ti-dig-i-ta-tion
dullard	dull-ard
elec-tro-sta-t-ics	e-lec-tro-stat-ics
he-li-copter	hel-i-cop-ter
regress	re-gress
navvy	nav-vy
ool-o-gy	o-ol-o-gy
elec-tro-mo-tive	e-lec-tro-mo-tive
dosage	dos-age
lin-gerie	lin-ge-rie
om-nipo-tent	om-nip-o-tent
dial	di-al
grad-ual	grad-u-al
hoard-ed	hoarded
pectin	pec-tin
ex-tend-able	ex-tend-a-ble
tav-er-na	ta-ver-na
resur-gent	re-sur-gent
vivi-sec-tion	viv-i-sec-tion
sadis-tic	sa-dis-tic
promi-nent	prom-i-nent
ptarmi-gan	ptar-mi-gan
over-pay	o-ver-pay
ex-i-gency	ex-i-gen-cy
in-ter-locu-to-ry	in-ter-loc-u-to-ry
eval-u-ate	e-val-u-ate
ima-go	i-ma-go
op-ti-misti-cal-ly	op-ti-mis-ti-cal-ly
forego	fore-go
chrono-log-i-cal	chron-o-log-i-cal
in-de-pen-dence	in-de-pend-ence
mis-sy	miss-y
miser	mi-ser
perime-ter	pe-rim-e-ter
dis-rep-utable	dis-rep-u-ta-ble
inkwell	ink-well
con-vect-ed	convected
telecom-mut-ing	te-le-com-mu-ting
be-wil-dered	bewildered
di-ana	di-an-a
steady-ing	steadying
over-joyed	o-ver-joyed
in-ex-haustible	in-ex-haust-i-ble
glaciol-o-gy	gla-ci-ol-o-gy
repack	re-pack
io-dide	i-o-dide
fatu-ous	fat-u-ous
dado	da-do
prefer-ment	pre-fer-ment
ranker	rank-er
steeply	steep-ly
squalor	squal-or
de-sir-abil-ia	de-si-ra-bi-li-a
are-na	a-re-na
choral	cho-ral
chamomile	cham-o-mile
woody	wood-y
so-porif-ic	sop-o-rif-ic
mer-cury	mer-cu-ry
stereo	ster-e-o
may-oral	may-or-al
em-bed-d-a-ble	em-bed-da-ble
soapy	soap-y
over-loaded	overloaded
jan-u-ary	jan-u-ar-y
stenog-ra-phy	ste-nog-ra-phy
in-cur-able	in-cur-a-ble
mul-ti-me-dia	mul-ti-me-di-a
duress	du-ress
katy-did	ka-ty-did
mi-cro-farad	mi-cro-far-ad
bac-teri-um	bac-te-ri-um
sibyl	sib-yl
mi-cro-bial	mi-cro-bi-al
nether-most	neth-er-most
orig-i-nate	o-rig-i-nate
tanker	tank-er
re-minder	re-mind-er
pom-padour	pom-pa-dour
uvu-lar	u-vu-lar
shady	shad-y
saline	sa-line
clat-ter-ing	cla-tter-ing
ure-thra	u-re-thra
tri-umvi-rate	tri-um-vi-rate
fruition	fru-i-tion
oral-ly	o-ral-ly
tangy	tang-y
urol-o-gist	u-rol-o-gist
against	a-gainst
banker	bank-er
catchy	catch-y
re-strain-ing	restraining
plumba-go	plum-ba-go
im-per-turbable	im-per-turb-a-ble
emer-gence	e-mer-gence
epi-demi-o-log-i-cal	ep-i-de-mi-o-log-i-cal
coro-na-tion	cor-o-na-tion
halo	ha-lo
pe-rusal	pe-rus-al
promise	prom-ise
painful	pain-ful
layper-son	lay-per-son
over-draft	o-ver-draft
durable	du-ra-ble
pewter	pew-ter
peren-ni-al	per-en-ni-al
tele-graph-ic	tel-e-graph-ic
elastin	e-las-tin
elec-tron	e-lec-tron
hon-esty	hon-es-ty
pogo	po-go
de-flower	de-flow-er
despot	des-pot
de-signed-ly	de-sign-ed-ly
diplo-mat	dip-lo-mat
weasel	wea-sel
clien-tele	cli-en-tele
ex-pand-able	ex-pand-a-ble
ig-neous	ig-ne-ous
aper-ture	ap-er-ture
soror-i-ty	so-ror-i-ty
mag-ne-tos-phere	mag-ne-to-sphere
bacil-lus	ba-cil-lus
bar-tender	bar-tend-er
res-onator	res-o-na-tor
in-ge-nious-ly	in-gen-ious-ly
ganger	gang-er
catholic	cath-o-lic
stratig-ra-phy	stra-tig-ra-phy
face-tious	fa-ce-tious
evening	eve-ning
lifeblood	life-blood
joyride	joy-ride
warhorse	war-horse
dud-geon	dudg-eon
un-easi-ness	un-eas-i-ness
cityscape	cit-y-scape
japan	ja-pan
slaver	slav-er
fi-brob-last	fi-bro-blast
poignan-cy	poign-an-cy
il-lim-itable	il-lim-it-a-ble
egress	e-gress
stature	stat-ure
slav-ery	slav-er-y
ar-rester	ar-rest-er
linkup	link-up
sum-mery	sum-mer-y
shindig	shin-dig
per-me-able	per-me-a-ble
easel	ea-sel
tum-bled	tumbled
bion-ic	bi-on-ic
hoary	hoar-y
porta-bil-i-ty	port-a-bil-i-ty
sonorous	so-no-rous
decagon	dec-a-gon
crony	cro-ny
aro-mather-a-py	a-ro-ma-ther-a-py
onion	on-ion
ionos-phere	i-on-o-sphere
de-sir-able	de-sir-a-ble
uni-sex	u-ni-sex
boudoir	bou-doir
podi-um	po-di-um
su-perla-tive	su-per-la-tive
tri-umphant	tri-um-phant
dancer	danc-er
au-r-al	au-ral
equine	e-quine
re-sul-tant	re-sult-ant
loosen	loos-en
gazette	ga-zette
tena-cious	te-na-cious
lam-plit	lamp-lit
reser-voir	res-er-voir
eques-tri-an	e-ques-tri-an
gos-samer	gos-sa-mer
rhetor-i-cal	rhe-tor-i-cal
ve-loci-pede	ve-loc-i-pede
iron-ic	i-ron-ic
por-phyry	por-phy-ry
over-bear-ing	o-ver-bear-ing
flashy	flash-y
dis-putable	dis-put-a-ble
re-arrange-ment	re-ar-range-ment
doubtless-ly	doubt-less-ly
carmine	car-mine
vari-cose	var-i-cose
cleaver	cleav-er
imag-ine	im-ag-ine
dis-may-ing	dismaying
ex-ult-ing	exulting
zenith	ze-nith
tonedeaf	tone-deaf
poly-merase	pol-y-mer-ase
retell	re-tell
cir-cum-lo-cu-to-ry	cir-cum-loc-u-to-ry
wag-gery	wag-ger-y
calorif-ic	cal-o-rif-ic
cus-tom-ary	cus-tom-ar-y
di-uret-ic	di-u-ret-ic
coinage	coin-age
bi-car-bon-ate	bi-car-bo-nate
roast-ed	roasted
con-gealed	congealed
rocky	rock-y
switchgear	switch-gear
edgy	edg-y
lega-tee	leg-a-tee
evan-ge-lism	e-van-ge-lism
iden-ti-fi-er	i-den-ti-fi-er
apolo-get-i-cal-ly	a-pol-o-get-i-cal-ly
coun-terof-fen-sive	coun-ter-of-fen-sive
ranter	rant-er
eu-phemisti-cal-ly	eu-phe-mis-ti-cal-ly
poignant-ly	poign-ant-ly
over-state-ment	o-ver-state-ment
poly-sac-cha-ride	pol-y-sac-cha-ride
read-just-ment	re-ad-just-ment
un-stop-pable	un-stop-pa-ble
eigen-func-tion	ei-gen-func-tion
meta-mor-phose	met-a-mor-phose
join-ery	join-er-y
car-dioid	car-di-oid
el-e-men-tary	el-e-men-ta-ry
stormer	storm-er
tonal-i-ty	to-nal-i-ty
skul-dug-gery	skul-dug-ger-y
platy-pus	plat-y-pus
whole-wheat	wholewheat
penance	pen-ance
kamikaze	ka-mi-ka-ze
unashamed-ly	un-a-sham-ed-ly
unas-so-ci-at-ed	un-as-so-ci-at-ed
plea-sure	pleas-ure
repack-age	re-pack-age
over-time	o-ver-time
con-nect-ing	con-nec-ting
charis-ma	cha-ris-ma
colosto-my	co-los-to-my
vic-arage	vic-ar-age
de-press-ing	de-pres-sing
wafer	wa-fer
qui-etus	qui-e-tus
ori-en-tal-ism	o-ri-en-tal-ism
re-cov-ery	re-cov-er-y
leviathan	le-vi-a-than
elate	e-late
missal	mis-sal
weav-ing	weaving
pathogen	path-o-gen
para-troops	par-a-troops
joey	jo-ey
mal-leable	mal-le-a-ble
preda-tor	pred-a-tor
nephew	neph-ew
un-ap-pre-cia-tive	un-ap-pre-ci-a-tive
equi-lib-ri-um	e-qui-lib-ri-um
re-spon-dent	re-spond-ent
sala-man-der	sal-a-man-der
io-dine	i-o-dine
unipo-lar	u-ni-po-lar
liti-gious	li-ti-gious
tiger	ti-ger
meta-bol-ic	met-a-bol-ic
epic	ep-ic
rein-sur-ance	re-in-sur-ance
man-darin	man-da-rin
ago	a-go
laden	lad-en
prosce-ni-um	pro-sce-ni-um
iso-tope	i-so-tope
posthu-mous	post-hu-mous
floozy	floo-zy
bound-ary	bound-a-ry
forest-ed	forested
leo-tard	le-o-tard
na-iad	nai-ad
in-spec-torate	in-spec-tor-ate
anoint	a-noint
pa-pery	pa-per-y
pho-to-genic	pho-to-gen-ic
im-mun-od-e-fi-cien-cy	im-mu-no-de-fi-cien-cy
polyg-y-ny	po-lyg-y-ny
elec-trophore-sis	e-lec-tro-pho-re-sis
un-equal	un-e-qual
iso-mor-phic	i-so-mor-phic
pro-pri-etor-ship	pro-pri-e-tor-ship
pala-tine	pal-a-tine
beau-teous	beau-te-ous
fisticuffs	fist-i-cuffs
des-orp-tion	de-sorp-tion
con-for-mance	con-form-ance
rar-efied	rar-e-fied
dis-uni-ty	dis-u-ni-ty
min-is-te-r-i-al	min-is-te-ri-al
polyp	pol-yp
fruity	fruit-y
dis-gust-ed	disgusted
con-stituen-cy	con-stit-u-en-cy
detox	de-tox
epis-tle	e-pis-tle
whether	wheth-er
forcibly	for-ci-bly
lanky	lank-y
beg-gary	beg-gar-y
in-dex-ing	indexing
sub-jec-tivism	sub-jec-tiv-ism
piton	pi-ton
per-man-ganate	per-man-ga-nate
holism	ho-lism
ap-plic-a-bil-i-ty	ap-pli-ca-bil-i-ty
any-body	an-y-bod-y
com-bi-na-to-r-i-al	com-bi-na-to-ri-al
parochial	pa-ro-chi-al
po-lice-woman	po-lice-wom-an
elo-quent	el-o-quent
prof-i-teer-ing	profiteering
tri-umphant-ly	tri-um-phant-ly
uni-tary	u-ni-tar-y
ruler	rul-er
para-chute	par-a-chute
fundrais-er	fund-rais-er
echid-na	e-chid-na
duchess	duch-ess
ori-en-tal	o-ri-en-tal
pinafore	pin-a-fore
refuge	ref-uge
iden-ti-ty	i-den-ti-ty
cuboid	cu-boid
reat-tempt	re-at-tempt
in-elas-tic	in-e-las-tic
punch-able	punch-a-ble
vig-i-lante	vig-i-lan-te
ra-tio-nal	ra-tion-al
ju-di-cia-ry	ju-di-ci-ar-y
as-siduity	as-si-du-i-ty
fetishist	fet-ish-ist
polygamy	po-lyg-a-my
over-worked	overworked
click-ing	clicking
un-even-ly	un-e-ven-ly
em-bryo	em-bry-o
dodo	do-do
yogi	yo-gi
cre-ation-ism	cre-a-tion-ism
par-alin-guis-tic	par-a-lin-guis-tic
bio-rhythm	bi-o-rhythm
bug-gered	buggered
lessor	les-sor
rudi-men-ta-ry	ru-di-men-ta-ry
pid-gin	pidg-in
raga-muf-fin	rag-a-muf-fin
arrange-ment	ar-range-ment
un-linked	unlinked
hair-spray	hairspray
prov-ably	prov-a-bly
con-vict-ed	convicted
di-lata-tion	dil-a-ta-tion
bio-ta	bi-o-ta
chesty	chest-y
bal-cony	bal-co-ny
mono-lith-ic	mon-o-lith-ic
in-tu-itive	in-tu-i-tive
amus-ing	a-mus-ing
en-abled	e-na-bled
chico-ry	chic-o-ry
carotene	car-o-tene
celandine	cel-an-dine
fla-gel-la-tion	flag-el-la-tion
com-pan-ion-able	com-pan-ion-a-ble
col-lec-tivism	col-lec-tiv-ism
courtship	court-ship
oafish	oaf-ish
uniden-ti-fied	un-i-den-ti-fied
smelt-ing	smelting
is-lander	is-land-er
cli-toris	clit-o-ris
wil-lowy	wil-low-y
coau-thor	co-au-thor
teething	teeth-ing
en-chant-ed	enchanted
ide-ol-o-gy	i-de-ol-o-gy
dowry	dow-ry
zealotry	zeal-ot-ry
poly-chrome	pol-y-chrome
wavelet	wave-let
best-seller	best-sell-er
lithos-phere	lith-o-sphere
dotage	dot-age
seashore	sea-shore
bul-letin	bul-le-tin
sep-a-ratist	sep-a-ra-tist
dyestuff	dye-stuff
overview	o-ver-view
marathon	mar-a-thon
tele-vi-su-al	tel-e-vis-u-al
iron-ing	i-ron-ing
ax-olotl	ax-o-lotl
mar-ketable	mar-ket-a-ble
misog-y-ny	mi-sog-y-ny
is-suance	is-su-ance
colour	co-lour
prophe-cy	proph-e-cy
servile	ser-vile
col-lec-tivist	col-lec-tiv-ist
weari-ness	wea-ri-ness
builder	build-er
above	a-bove
genome	ge-nome
tidal	tid-al
crawler	crawl-er
vestibu-lar	ves-tib-u-lar
avid-i-ty	a-vid-i-ty
sur-vivor	sur-vi-vor
whaler	whal-er
around	a-round
steno-sis	ste-no-sis
basil-i-ca	ba-sil-i-ca
de-riso-ry	de-ri-so-ry
dais	da-is
un-mis-tak-able	un-mis-tak-a-ble
ex-ploita-tion	ex-ploi-ta-tion
holo-caust	hol-o-caust
hauli-er	haul-ier
wilder-ness	wil-der-ness
tele-scop-ic	tel-e-scop-ic
leaflet	leaf-let
lot-tery	lot-ter-y
avens	av-ens
bire-frin-gent	bi-re-frin-gent
lessee	les-see
elixir	e-lix-ir
bio-di-ver-si-ty	bi-o-di-ver-si-ty
giro	gi-ro
exe-unt	ex-e-unt
bish-opric	bish-op-ric
dili-gent-ly	dil-i-gent-ly
duel	du-el
ego-cen-tric	e-go-cen-tric
voca-tive	voc-a-tive
de-gauss-ing	degaussing
cred-it-wor-thy	cred-it-worth-y
catheter	cath-e-ter
mo-lesta-tion	mo-les-ta-tion
poly-mor-phic	pol-y-mor-phic
quotable	quot-a-ble
kelvin	kel-vin
onto	on-to
residu-um	re-sid-u-um
ero-sion	e-ro-sion
rein-tro-duc-tion	re-in-tro-duc-tion
un-bear-able	un-bear-a-ble
un-fet-tered	unfettered
imag-i-na-tion	im-ag-i-na-tion
un-de-ni-able	un-de-ni-a-ble
lachry-mose	lach-ry-mose
arith-metic	a-rith-me-tic
dis-cor-dant	dis-cord-ant
mi-croor-gan-ism	mi-cro-or-gan-ism
sober-ly	so-ber-ly
sewage	sew-age
over-hang	o-ver-hang
smoky	smok-y
cedil-la	ce-dil-la
pinkie	pink-ie
in-signif-i-cant	in-sig-nif-i-cant
sub-servient	sub-ser-vi-ent
vic-ar-i-ous-ly	vi-car-i-ous-ly
swasti-ka	swas-ti-ka
doughty	dough-ty
promis-so-ry	prom-is-so-ry
tricky	trick-y
melee	me-lee
re-order	re-or-der
prodi-gal	prod-i-gal
portable	port-a-ble
id-i-olect	id-i-o-lect
sub-si-dence	sub-sid-ence
epi-cure	ep-i-cure
mirac-u-lous	mi-rac-u-lous
frat-ri-ci-dal	frat-ri-cid-al
firmware	firm-ware
gen-eros-i-ty	gen-er-os-i-ty
opi-ate	o-pi-ate
re-union	re-un-ion
renowned	re-nowned
even-tu-al-i-ty	e-ven-tu-al-i-ty
over-write	o-ver-write
recipe	rec-i-pe
for-giv-able	for-giv-a-ble
isother-mal	i-so-ther-mal
racon-teur	rac-on-teur
un-com-fort-ably	un-com-fort-a-bly
in-evitabil-i-ty	in-ev-i-ta-bil-i-ty
artist	art-ist
scintig-ra-phy	scin-tig-ra-phy
epochal	ep-och-al
copy-right	cop-y-right
emer-ald	em-er-ald
fes-ter-ing	festering
hazel-nut	ha-zel-nut
clemen-cy	clem-en-cy
fibu-la	fib-u-la
gravy	gra-vy
con-strict-ed	constricted
un-trans-lat-able	un-trans-lat-a-ble
over-lord	o-ver-lord
minute	mi-nute
degra-da-tion	deg-ra-da-tion
anvil	an-vil
hypocrisy	hy-poc-ri-sy
bristling	bris-tling
over-done	o-ver-done
beta	be-ta
avi-a-tion	a-vi-a-tion
ex-ploita-tive	ex-ploit-a-tive
vol-canic	vol-can-ic
school-teacher	school-teach-er
math-e-mati-cian	math-e-ma-ti-cian
kaiser	kai-ser
mon-e-tary	mon-e-tar-y
col-lec-tivi-sa-tion	col-lec-ti-vi-sa-tion
lifestyle	life-style
har-mo-nious	har-mo-ni-ous
cin-e-matog-ra-ph-er	cin-e-ma-tog-ra-pher
overt-ly	o-vert-ly
moral-i-ty	mo-ral-i-ty
mis-ery	mis-er-y
chaffinch	chaf-finch
marked-ly	mark-ed-ly
cryo-gen-ics	cry-o-gen-ics
condi-ment	con-di-ment
jokey	jok-ey
monog-a-mous-ly	mo-nog-a-mous-ly
re-trieval	re-triev-al
re-pen-tance	re-pent-ance
tint-ed	tinted
en-fee-bled	enfeebled
hon-orif-ic	hon-or-if-ic
buck-min-ster-fullerene	buck-min-ster-ful-ler-ene
in-ves-tiga-tive	in-ves-ti-ga-tive
augite	au-gite
con-queror	con-quer-or
swarthy	swarth-y
in-valu-able	in-val-u-a-ble
but-tery	but-ter-y
rani	ra-ni
con-fec-tionery	con-fec-tion-er-y
turpi-tude	tur-pi-tude
pe-riph-ery	pe-riph-er-y
de-scend-ing	descending
de-ify	de-i-fy
calorime-ter	cal-o-rim-e-ter
par-enter-al	par-en-ter-al
madam	mad-am
flagon	flag-on
jour-nalese	jour-nal-ese
laud-ed	lauded
method-ol-o-gy	meth-od-ol-o-gy
res-olute-ly	res-o-lute-ly
ge-o-g-ra-ph-er	ge-og-ra-pher
saki	sa-ki
bel-liger-ent	bel-lig-er-ent
phys-io-ther-a-py	phys-i-o-ther-a-py
ileum	il-e-um
pro-pa-gan-da	prop-a-gan-da
ex-tra-galac-tic	ex-tra-ga-lac-tic
avian	a-vi-an
area	ar-e-a
trumpery	trump-er-y
hide-away	hide-a-way
floater	float-er
copy	cop-y
at-tempt-ed	at-temp-ted
lov-able	lov-a-ble
creamy	cream-y
cafe-te-ria	caf-e-te-ri-a
nurs-ery-men	nurs-er-y-men
treaty	trea-ty
ban-ter-ing	bantering
in-ter-change-ably	in-ter-change-a-bly
con-t-a-m-i-nate	con-tam-i-nate
lancet	lan-cet
ashore	a-shore
sec-ondary	sec-ond-ar-y
her-i-ta-ble	her-it-a-ble
drink-able	drink-a-ble
postal	post-al
over-shad-ow	o-ver-shad-ow
faucet	fau-cet
litur-gy	lit-ur-gy
unas-sum-ing	un-as-sum-ing
deuteron	deu-ter-on
benefice	ben-e-fice
fevered	fe-vered
decor	de-cor
es-tu-ary	es-tu-ar-y
over-whelm-ing-ly	o-ver-whelm-ing-ly
hero-ine	her-o-ine
mo-lasses	mo-las-ses
ap-plic-a-ble	ap-pli-ca-ble
con-sor-tium	con-sor-ti-um
windswept	wind-swept
gu-ber-na-to-r-i-al	gu-ber-na-to-ri-al
re-moval	re-mov-al
un-avoid-ably	un-a-void-a-bly
wormy	worm-y
doyen	doy-en
mono-chro-mat-ic	mon-o-chro-mat-ic
un-der-study	un-der-stud-y
pa-tri-o-tism	pa-tri-ot-ism
elu-ci-da-tion	e-lu-ci-da-tion
canal	ca-nal
biosyn-the-sis	bi-o-syn-the-sis
plea-sur-able	pleas-ur-a-ble
notepa-per	note-pa-per
phrasal	phras-al
cre-ation	cre-a-tion
pi-rat-ed	pirated
cra-nial	cra-ni-al
topo-graph-ic	top-o-graph-ic
slant-i-ng	slant-ing
er-ro-neous	er-ro-ne-ous
hyp-nother-a-py	hyp-no-ther-a-py
ine-bri-ate	in-e-bri-ate
iota	i-o-ta
nineti-eth	nine-ti-eth
stron-groom	strong-room
ar-ti-fi-cial-i-ty	ar-ti-fi-ci-al-i-ty
cig-ar	ci-gar
neon	ne-on
fury	fu-ry
colos-sal	co-los-sal
back-bencher	back-bench-er
scanty	scant-y
uni-for-mi-ty	u-ni-form-i-ty
propul-sion	pro-pul-sion
prospec-tus	pro-spec-tus
over-pay-ment	o-ver-pay-ment
sub-lu-nary	sub-lu-nar-y
su-per-fi-cial-i-ty	su-per-fi-ci-al-i-ty
repli-cate	rep-li-cate
tourni-quet	tour-ni-quet
garbage	gar-bage
propin-quity	pro-pin-qui-ty
as-tro-physi-cist	as-tro-phys-i-cist
nonessen-tial	non-es-sen-tial
discog-ra-phy	dis-cog-ra-phy
bio-engi-neer-ing	bi-o-en-gi-neer-ing
phono-log-i-cal	pho-no-log-i-cal
pari-etal	pa-ri-e-tal
basilisk	bas-i-lisk
bedrock	bed-rock
pesti-lent	pes-ti-lent
fever-ish-ly	fe-ver-ish-ly
user	us-er
cast-away	cast-a-way
leath-ery	leath-er-y
com-paction	com-pac-tion
spelling	spell-ing
rigid-i-fy	ri-gid-i-fy
sycamore	syc-a-more
edit	ed-it
stinger	sting-er
un-rea-son-ably	un-rea-son-a-bly
strug-gling	struggling
dip-so-ma-nia	dip-so-ma-ni-a
agree-ment	a-gree-ment
macro-cosm	mac-ro-cosm
reap-pear-ance	re-ap-pear-ance
epi-graph	ep-i-graph
mis-spellings	mis-spel-lings
recre-ation	rec-re-a-tion
philoso-pher	phi-los-o-pher
med-ica-tion	med-i-ca-tion
talon	tal-on
propane	pro-pane
trendy	trend-y
stripy	strip-y
medi-um	me-di-um
mini-bar	min-i-bar
steamship	steam-ship
atri-um	a-tri-um
piety	pi-e-ty
con-fir-ma-to-ry	con-firm-a-to-ry
con-sumerist	con-sum-er-ist
enor-mous	e-nor-mous
caliper	cal-i-per
lun-cheon	lunch-eon
palatal	pal-a-tal
souther-ly	south-er-ly
over-do	o-ver-do
eigen-val-ue	ei-gen-val-ue
trace-abil-i-ty	trace-a-bil-i-ty
di-aphragm	di-a-phragm
con-duc-tance	con-duct-ance
chemise	che-mise
ra-tio-nal-ist	ra-tion-al-ist
ori-gin	or-i-gin
phoenix	phoe-nix
takeover	take-o-ver
syrup	syr-up
hayloft	hay-loft
detri-ment	det-ri-ment
woodsmoke	wood-smoke
inani-ty	in-an-i-ty
telethon	tel-e-thon
serendip-i-ty	ser-en-dip-i-ty
dweller	dwell-er
ria	ri-a
porous	po-rous
floury	flour-y
calami-ty	ca-lam-i-ty
poly-ester	pol-y-es-ter
pigsty	pig-sty
mono-plane	mon-o-plane
el-dest	eld-est
in-sur-mount-able	in-sur-mount-a-ble
ex-is-tence	ex-ist-ence
ex-tra-mur-al	ex-tra-mu-ral
buffer	buff-er
birdie	bird-ie
corky	cork-y
staphy-lo-coc-cus	staph-y-lo-coc-cus
over-head	o-ver-head
kestrel	kes-trel
un-in-hab-it-able	un-in-hab-it-a-ble
gener-ic	ge-ner-ic
nightlife	night-life
reuse	re-use
bes-tial-i-ty	bes-ti-al-i-ty
theos-o-phy	the-os-o-phy
cru-cible	cru-ci-ble
trans-for-ma-tive	trans-form-a-tive
celeb	ce-leb
chid-ing	chiding
re-porter	re-port-er
arranger	ar-rang-er
mil-i-tary	mil-i-tar-y
con-cor-dance	con-cord-ance
unan-swered	un-an-swered
in-fect-ed	in-fec-ted
stripling	strip-ling
vari-a-tion	var-i-a-tion
re-al-ness	real-ness
ketchup	ketch-up
ker-atin	ker-a-tin
sticky	stick-y
or-ga-ni-za-tion	or-gan-i-za-tion
tepid	tep-id
frown-ing	frowning
restart	re-start
hang-over	hang-o-ver
an-ti-body	an-ti-bod-y
poly-the-is-tic	pol-y-the-is-tic
virtue	vir-tue
drowsy	drow-sy
mo-men-tary	mo-men-tar-y
propo-si-tion-al	prop-o-si-tion-al
forepaw	fore-paw
hit-table	hit-ta-ble
un-read-able	un-read-a-ble
teacher	teach-er
de-con-struc-tive	deconstructive
method	meth-od
florin	flor-in
hy-drangea	hy-dran-gea
respire	re-spire
deben-ture	de-ben-ture
leafy	leaf-y
fizzy	fizz-y
ra-dia-tive	ra-di-a-tive
kneecap	knee-cap
miniskirt	min-i-skirt
mono-syl-la-ble	mon-o-syl-la-ble
riv-iera	riv-i-er-a
unglazed	un-glazed
pro-peller	pro-pel-ler
crumbly	crum-bly
punchy	punch-y
aware	a-ware
avoid-able	a-void-a-ble
solo	so-lo
dero-ga-tion	der-o-ga-tion
misty	mist-y
coali-tion	co-a-li-tion
groundswell	ground-swell
mori-bund	mor-i-bund
cordillera	cor-dil-le-ra
creak-ing	creaking
viva	vi-va
in-sulin	in-su-lin
erec-tion	e-rec-tion
kitch-enette	kitch-en-ette
bene-fac-tress	ben-e-fac-tress
retroac-tive	ret-ro-ac-tive
pesky	pes-ky
lethal-i-ty	le-thal-i-ty
hu-morist	hu-mor-ist
gam-bling	gam-bling
chalky	chalk-y
placid	plac-id
iron-stone	i-ron-stone
per-me-abil-i-ty	per-me-a-bil-i-ty
mod-esty	mod-es-ty
uni-di-rec-tion-al	u-ni-di-rec-tion-al
cud-gel	cudg-el
re-gency	re-gen-cy
donor	do-nor
hack-able	hack-a-ble
coralline	cor-al-line
tightrope	tight-rope
spiky	spik-y
mag-netron	mag-ne-tron
ex-ecu-tor	ex-ec-u-tor
dry-s-tone	dry-stone
weightlift-ing	weight-lift-ing
reach-able	reach-a-ble
ra-di-ogram	ra-di-o-gram
rein-car-na-tion	re-in-car-na-tion
enu-mer-a-tion	e-nu-mer-a-tion
Words with errors: 1798
Words with incorrect number of syllables: 1697
Total evluated: 6500
Perfect accuracy: 0.72
Number of syllables accuracy: 0.74
Average Levenshtein Distance(across incorrect words): 1.20
