Attempt	Real
gaiter	gait-er
glossy	gloss-y
lapel	la-pel
smelly	smell-y
penin-su-la	pen-in-su-la
chaos	cha-os
arch-dio-cese	arch-di-o-cese
im-prison	im-pris-on
raga-muf-fin	rag-a-muf-fin
sitar	si-tar
deci-bel	dec-i-bel
ath-leti-cism	ath-let-i-cism
hu-morist	hu-mor-ist
pes-simist	pes-si-mist
crazi-ness	cra-zi-ness
hauli-er	haul-ier
re-new-able	re-new-a-ble
eat-able	eat-a-ble
tem-porar-i-ly	tem-po-rar-i-ly
fi-brob-last	fi-bro-blast
schoolmistress	school-mis-tress
leg-isla-tive	leg-is-la-tive
iden-ti-fi-able	i-den-ti-fi-a-ble
dis-abled	dis-a-bled
dis-senter	dis-sent-er
in-ter-po-lat-able	in-ter-po-la-ta-ble
over-lie	o-ver-lie
crater	cra-ter
chrysalis	chrys-a-lis
span-gled	spangled
her-bi-cide	herb-i-cide
crosstalk	cross-talk
tasty	tast-y
coolant	cool-ant
posse	pos-se
touris-tic	tour-is-tic
ide-al-ism	i-de-al-ism
damper	damp-er
manes	ma-nes
glut-to-nous	glut-ton-ous
peachy	peach-y
wreck-ing	wrecking
gra-tu-itous-ly	gra-tu-i-tous-ly
chrono-graph	chron-o-graph
dis-heart-ened	dis-hear-tened
im-per-me-able	im-per-me-a-ble
wily	wil-y
deserts	de-serts
pen-tathlon	pen-tath-lon
gazelle	ga-zelle
chi-ropody	chi-rop-o-dy
par-lia-men-tary	par-lia-men-ta-ry
wolfish	wolf-ish
markup	mark-up
grumpy	grump-y
ar-rival	ar-ri-val
tick-et-ed	ticketed
un-adapt-ed	un-a-dapt-ed
poly-cyclic	pol-y-cy-clic
over-ride	o-ver-ride
any-more	an-y-more
ex-cep-tion-able	ex-cep-tion-a-ble
transpon-der	tran-spon-der
chival-ry	chiv-al-ry
rover	rov-er
dark-ened	dar-kened
hyp-ocrite	hyp-o-crite
re-design	re-de-sign
em-body	em-bod-y
potable	po-ta-ble
cin-e-matog-ra-ph-er	cin-e-ma-tog-ra-pher
sedan	se-dan
notepad	note-pad
nico-tine	nic-o-tine
de-served-ly	de-serv-ed-ly
emer-gent	e-mer-gent
ready	read-y
in-con-ve-nience	in-con-ven-ience
limpet	lim-pet
geopo-lit-i-cal	ge-o-po-lit-i-cal
body-work	bod-y-work
coleslaw	cole-slaw
posy	po-sy
litotes	li-to-tes
me-dieval	me-di-e-val
an-tithe-sis	an-tith-e-sis
unin-spir-ing	un-in-spir-ing
un-chal-lenge-able	un-chal-lenge-a-ble
oblo-quy	ob-lo-quy
iambus	i-am-bus
durable	du-ra-ble
emer-gence	e-mer-gence
flan-nelette	flan-nel-ette
in-cisor	in-ci-sor
cen-trifu-ga-tion	cen-trif-u-ga-tion
cu-ra-to-r-i-al	cu-ra-to-ri-al
quizzi-cal	quiz-zi-cal
apol-o-gize	a-pol-o-gize
enu-mer-a-tor	e-nu-mer-a-tor
cupo-la	cu-po-la
itchy	itch-y
menar-che	men-ar-che
hearthrug	hearth-rug
groom-ing	grooming
icon	i-con
crumbly	crum-bly
anorex-ic	an-o-rex-ic
dean-ery	dean-er-y
im-mov-able	im-mov-a-ble
be-wil-dered	bewildered
athe-ist	a-the-ist
hashish	hash-ish
suf-frag-ist	suf-fra-gist
hermeneu-tic	her-me-neu-tic
mistle-toe	mis-tle-toe
itin-er-ant	i-tin-er-ant
re-versible	re-vers-i-ble
par-tial-i-ty	par-ti-al-i-ty
cho-ris-ter	chor-is-ter
messy	mess-y
ar-cana	ar-ca-na
fungi-cide	fun-gi-cide
pedi-gree	ped-i-gree
golfer	golf-er
valiant-ly	val-iant-ly
graphite	graph-ite
awake	a-wake
uni-lat-er-al-ism	u-ni-lat-er-al-ism
eu-kary-ote	eu-kar-y-ote
mini-cab	min-i-cab
naked-ness	na-ked-ness
swishy	swish-y
body	bod-y
nir-vana	nir-va-na
ori-en-ta-tion	o-ri-en-ta-tion
mar-ketabil-i-ty	mar-ket-a-bil-i-ty
cataract	cat-a-ract
bire-frin-gent	bi-re-frin-gent
up-silon	up-si-lon
fermi-on	fer-mi-on
par-enter-al	par-en-ter-al
beg-gary	beg-gar-y
tilde	til-de
vary	var-y
elect	e-lect
funky	funk-y
karate	ka-ra-te
democ-ra-cy	de-moc-ra-cy
trans-mo-gri-fy	trans-mog-ri-fy
lul-la-by	lull-a-by
in-tu-itive	in-tu-i-tive
minia-ture	min-i-a-ture
camisole	cam-i-sole
es-capade	es-ca-pade
undo	un-do
pati-na-tion	pat-i-na-tion
ex-oge-nous	ex-og-e-nous
diathermy	di-a-ther-my
manslaugh-ter	man-slaugh-ter
syn-ony-mous	syn-on-y-mous
pastis	pas-tis
necro-man-tic	nec-ro-man-tic
quiver	quiv-er
tuna	tu-na
sun-burned	sunburned
eeri-ly	ee-ri-ly
genii	ge-ni-i
hy-acinth	hy-a-cinth
stock-bro-ker	stock-brok-er
di-vider	di-vid-er
over-due	o-ver-due
in-tegri-ty	in-teg-ri-ty
er-ro-neous-ly	er-ro-ne-ous-ly
marcher	march-er
killer	kil-ler
over-state-ment	o-ver-state-ment
diplo-mat-ic	dip-lo-mat-ic
disin-gen-u-ous	dis-in-gen-u-ous
tem-pera-men-tal	tem-per-a-men-tal
lar-ynx-es	la-rynx-es
ap-praisal	ap-prais-al
unas-signed	un-as-signed
in-tifa-da	in-ti-fa-da
video-phone	vid-e-o-phone
anom-alous	a-nom-a-lous
haiku	hai-ku
detox-i-fi-ca-tion	de-tox-i-fi-ca-tion
ir-ra-tional-ly	ir-ra-tion-al-ly
diva	di-va
prefa-to-ry	pref-a-to-ry
spaghet-ti	spa-ghet-ti
quotable	quot-a-ble
tremor	trem-or
tute-lage	tu-te-lage
polyandry	pol-y-an-dry
grouchy	grouch-y
atri-um	a-tri-um
tan-nery	tan-ner-y
mar-malade	mar-ma-lade
rosin	ros-in
usu-al	u-su-al
merid-i-an	me-rid-i-an
flab-ber-gast-ed	flabbergasted
sana-to-ri-um	san-a-to-ri-um
amuse	a-muse
daisy	dai-sy
japan	ja-pan
po-litesse	pol-i-tesse
coun-ter-rev-o-lu-tion-ary	coun-ter-rev-o-lu-tion-ar-y
nugget	nug-get
whaler	whal-er
voca-tive	voc-a-tive
stu-dentship	stu-dent-ship
mo-lasses	mo-las-ses
aquifer	aq-ui-fer
emo-tion-less	e-mo-tion-less
claret	clar-et
jury	ju-ry
torus	to-rus
veto	ve-to
baronet	bar-on-et
grater	grat-er
un-re-cov-er-able	un-re-cov-er-a-ble
positron	pos-i-tron
kina	ki-na
bel-liger-ent	bel-lig-er-ent
emo-tion-al	e-mo-tion-al
toma-to	to-ma-to
millinery	mil-li-ner-y
re-stroom	rest-room
bud-getary	budg-et-ar-y
haver-sack	hav-er-sack
grandee	gran-dee
bac-te-r-i-al	bac-te-ri-al
un-cre-ative	un-cre-a-tive
ob-lig-ate	ob-li-gate
re-ceiver-ship	re-ceiv-er-ship
em-piri-cist	em-pir-i-cist
geome-ter	ge-om-e-ter
en-docrine	en-do-crine
rapid	rap-id
abuse	a-buse
per-me-able	per-me-a-ble
testy	tes-ty
postal	post-al
raven-ing	rav-en-ing
en-force-able	en-force-a-ble
ante	an-te
di-ary	di-a-ry
touristy	tour-ist-y
avens	av-ens
monastery	mon-as-ter-y
over-throw	o-ver-throw
rani	ra-ni
respite	res-pite
parochial-ism	pa-ro-chi-al-ism
va-porous	va-por-ous
song-writer	song-writ-er
nodal	nod-al
mi-croscopy	mi-cros-co-py
snob-bery	snob-ber-y
sesame	ses-a-me
breast-feed-ing	breastfeeding
loaded	load-ed
igloo	ig-loo
in-staller	in-stall-er
un-der-e-d-u-cat-ed	un-der-ed-u-cat-ed
over-writ-ing	overwriting
cur-tilage	cur-ti-lage
washy	wash-y
elon-gate	e-lon-gate
perquisite	per-qui-site
eru-di-tion	er-u-di-tion
the-atri-cals	the-at-ri-cals
piti-ful	pit-i-ful
over	o-ver
here-inafter	here-in-af-ter
delir-i-um	de-lir-i-um
cathe-dral	ca-the-dral
cu-rio	cu-ri-o
fer-al	fe-ral
lighter	light-er
mas-tery	mas-ter-y
cliffhang-er	cliff-hang-er
cel-ery	cel-er-y
dis-cotheque	dis-co-theque
port-fo-lio	port-fo-li-o
tran-scen-dence	tran-scend-ence
penul-ti-mate	pe-nul-ti-mate
galling	gall-ing
fara-day	far-a-day
beaver	bea-ver
satire	sat-ire
bes-tial-i-ty	bes-ti-al-i-ty
mis-nomer	mis-no-mer
col-liery	col-lier-y
raf-fia	raf-fi-a
bolero	bo-le-ro
sim-per-ing	simpering
ide-al-is-tic	i-de-al-is-tic
mul-ti-me-ter	mul-tim-e-ter
lu-natic	lu-na-tic
saga-cious	sa-ga-cious
in-con-gruity	in-con-gru-i-ty
panz-er	pan-zer
quater-nion	qua-ter-ni-on
elide	e-lide
kilo-hertz	kil-o-hertz
elec-table	e-lect-a-ble
pyra-mid	pyr-a-mid
valet	val-et
pep-pered	peppered
bitmap	bit-map
cousin	cous-in
scruti-ny	scru-ti-ny
gui-tarist	gui-tar-ist
un-ut-ter-able	un-ut-ter-a-ble
in-vesti-ture	in-ves-ti-ture
baobab	ba-o-bab
gib-ber-ing	gibbering
over-flow	o-ver-flow
racial-ism	ra-cial-ism
patel-la	pa-tel-la
dis-abling	disabling
pa-pery	pa-per-y
iden-ti-fi-ca-tion	i-den-ti-fi-ca-tion
tele-work-ing	teleworking
auger	au-ger
fontanel	fon-ta-nel
look-ing	looking
hor-mon-al	hor-mo-nal
un-frozen	un-fro-zen
benefice	ben-e-fice
mono-cul-ture	mon-o-cul-ture
want-i-ng	want-ing
inessen-tial	in-es-sen-tial
syl-labub	syl-la-bub
mo-not-o-ne	mon-o-tone
misog-y-ny	mi-sog-y-ny
ethics	eth-ics
place-bo	pla-ce-bo
ever-last-ing	ev-er-last-ing
virtue	vir-tue
unar-guable	un-ar-gu-a-ble
fran-chisee	fran-chi-see
in-fect-ed	in-fec-ted
rar-efac-tion	rar-e-fac-tion
over-rate	o-ver-rate
jan-u-ary	jan-u-ar-y
quadruped	quad-ru-ped
fevered	fe-vered
for-get-table	for-get-ta-ble
round-about	round-a-bout
redo-lent	red-o-lent
changeover	change-o-ver
bevy	bev-y
re-process	re-proc-ess
grid-ded	gridded
meringue	me-ringue
missal	mis-sal
ar-senic	ar-se-nic
manome-ter	ma-nom-e-ter
pere-grine	per-e-grine
inane	in-ane
recharge-able	re-charge-a-ble
julep	ju-lep
wag-gery	wag-ger-y
every-body	eve-ry-bod-y
tiling	til-ing
ro-mancer	ro-manc-er
delu-sion	de-lu-sion
con-troller	con-trol-ler
rigid-i-fy	ri-gid-i-fy
novice	nov-ice
obe-di-ent	o-be-di-ent
gale-na	ga-le-na
urine	u-rine
para-mil-i-tary	par-a-mil-i-tar-y
en-durance	en-dur-ance
palate	pal-ate
hus-bandry	hus-band-ry
teenage	teen-age
craven	cra-ven
orac-u-lar	o-rac-u-lar
evis-cer-ate	e-vis-cer-ate
sewage	sew-age
wadi	wa-di
holler	hol-ler
he-do-nist	he-don-ist
op-por-tunis-tic	op-por-tun-is-tic
pantry	pan-try
mis-shapen	mis-shap-en
ego	e-go
in-hos-pitable	in-hos-pi-ta-ble
fluffy	fluff-y
sophistry	soph-ist-ry
ocean-ic	o-ce-an-ic
in-ter-de-pen-dent	in-ter-de-pend-ent
dairy-man	dair-y-man
ni-hilism	ni-hil-ism
puerile	pu-er-ile
tripoli	trip-o-li
trans-portable	trans-port-a-ble
demon-stra-bly	de-mon-stra-bly
en-abled	e-na-bled
reawak-en	re-a-wak-en
curly	curl-y
spillage	spill-age
elec-tive	e-lec-tive
imag-i-na-tion	im-ag-i-na-tion
mi-cro-com-put-er	mi-cro-com-pu-ter
mil-lisec-ond	mil-li-sec-ond
gov-ern-ing	governing
in-ter-locu-tor	in-ter-loc-u-tor
psy-cholin-guis-tics	psy-cho-lin-guis-tics
in-es-timable	in-es-ti-ma-ble
un-speak-able	un-speak-a-ble
dumper	dump-er
ar-guable	ar-gu-a-ble
lega-cy	leg-a-cy
beget	be-get
vial	vi-al
melt-ed	melted
grinder	grind-er
com-fort-able	com-fort-a-ble
can-dlelit	can-dle-lit
loutish	lout-ish
mock-ery	mock-er-y
iso-late	i-so-late
un-ap-proach-able	un-ap-proach-a-ble
gaseous	gas-e-ous
debonair	deb-o-nair
petu-lance	pet-u-lance
cog-nizance	cog-ni-zance
newsagent	news-a-gent
cater	ca-ter
neuter	neu-ter
stripy	strip-y
ban-ter-ing	bantering
com-forter	com-fort-er
binoc-u-lar	bin-oc-u-lar
fre-quent-ed	frequented
mushy	mush-y
ra-dia-tive	ra-di-a-tive
seabed	sea-bed
twitchy	twitch-y
able	a-ble
ab-solute	ab-so-lute
de-scend-ing	descending
fac-to-r-i-al	fac-to-ri-al
scratchy	scratch-y
easy-go-ing	eas-y-go-ing
cardi-gan	car-di-gan
for-warder	for-ward-er
hideous-ly	hid-e-ous-ly
les-bian	les-bi-an
winder	wind-er
papule	pap-ule
reach-able	reach-a-ble
ar-chaeopteryx	ar-chae-op-ter-yx
ini-tial	in-i-tial
ori-en-tal-ism	o-ri-en-tal-ism
tempter	tempt-er
elo-cu-tion	el-o-cu-tion
di-atom-ic	di-a-tom-ic
inkling	ink-ling
avail-abil-i-ty	a-vail-a-bil-i-ty
pho-to-genic	pho-to-gen-ic
in-ter-vie-wee	in-ter-view-ee
vestal	ves-tal
apos-tolic	ap-os-tol-ic
el-e-men-tary	el-e-men-ta-ry
river-side	riv-er-side
steamship	steam-ship
episode	ep-i-sode
ir-re-deemable	ir-re-deem-a-ble
brawny	brawn-y
eu-pho-nious	eu-pho-ni-ous
telepa-thy	te-lep-a-thy
mea-sure	meas-ure
me-dia	me-di-a
gluten	glu-ten
rolling	roll-ing
dif-fuser	dif-fus-er
rel-a-tivis-tic	rel-a-tiv-is-tic
catholic	cath-o-lic
en-thralling	en-thral-ling
fleecy	fleec-y
in-de-struc-tible	in-de-struct-i-ble
aplen-ty	a-plen-ty
poly-atom-ic	pol-y-a-tom-ic
vil-lager	vil-lag-er
un-der-writer	un-der-writ-er
matins	mat-ins
uterus	u-ter-us
poundage	pound-age
gasi-fy	gas-i-fy
equal-ly	e-qual-ly
pam-phle-teer	pam-phlet-eer
aver	a-ver
sideshow	side-show
floozy	floo-zy
astern	a-stern
bal-alai-ka	bal-a-lai-ka
slant-i-ng	slant-ing
ed-uca-tive	ed-u-ca-tive
un-con-tain-able	un-con-tain-a-ble
unglazed	un-glazed
het-ero-ge-neous	het-er-o-ge-ne-ous
polo	po-lo
reprisal	re-pris-al
tomboy	tom-boy
un-par-don-able	un-par-don-a-ble
get-away	get-a-way
fla-gel-late	flag-el-late
ravi-o-li	ra-vi-o-li
eques-tri-an	e-ques-tri-an
quixot-ic	quix-ot-ic
an-te-dilu-vian	an-te-di-lu-vi-an
frozen	fro-zen
cy-tochrome	cy-to-chrome
un-healthy	un-health-y
can-taloupe	can-ta-loupe
medusa	me-du-sa
poly-thene	pol-y-thene
con-demned	condemned
in-hibito-ry	in-hib-i-to-ry
abaft	a-baft
open-ing	o-pen-ing
re-al-ness	real-ness
dul-cimer	dul-ci-mer
zither	zith-er
emit-ter	e-mit-ter
un-learned	un-learn-ed
casse-role	cas-se-role
us-abil-i-ty	us-a-bil-i-ty
around	a-round
im-agery	im-age-ry
cherub	cher-ub
ur-ticaria	ur-ti-car-i-a
idly	i-dly
palat-able	pal-at-a-ble
test-ing	testing
un-e-lec-table	un-e-lect-a-ble
an-tivi-ral	an-ti-vi-ral
biosyn-the-sis	bi-o-syn-the-sis
arith-metic	a-rith-me-tic
leucine	leu-cine
hair-spray	hairspray
jerky	jerk-y
freestyle	free-style
baguette	ba-guette
per-jury	per-ju-ry
dig-ni-tary	dig-ni-tar-y
epi-graph	ep-i-graph
cun-nilin-gus	cun-ni-lin-gus
eru-dite	er-u-dite
per-i-he-lion	per-i-he-li-on
wran-gling	wrangling
in-deli-ble	in-del-i-ble
mi-croc-ode	mi-cro-code
transcon-ti-nen-tal	trans-con-ti-nen-tal
denizen	den-i-zen
borstal	bor-stal
co-pro-lite	cop-ro-lite
tirade	ti-rade
smithy	smith-y
min-der	mind-er
ephemera	e-phem-er-a
sub-terfuge	sub-ter-fuge
mogul	mo-gul
swimwear	swim-wear
testis	tes-tis
arranger	ar-rang-er
wun-derkind	wun-der-kind
costar	co-star
bulky	bulk-y
rarebit	rare-bit
apos-tro-phe	a-pos-tro-phe
mo-torist	mo-tor-ist
condi-ment	con-di-ment
classy	class-y
re-porter	re-port-er
cli-toris	clit-o-ris
ap-plic-a-bil-i-ty	ap-pli-ca-bil-i-ty
sporty	sport-y
gut-sy	guts-y
cre-ation-ist	cre-a-tion-ist
vig-i-lante	vig-i-lan-te
bur-gundy	bur-gun-dy
restau-ra-teur	res-tau-ra-teur
baby-ish	ba-by-ish
record-ing	re-cord-ing
pro-cre-ation	pro-cre-a-tion
masseuse	mas-seuse
loony	loon-y
over-stretch	o-ver-stretch
troglodyte	trog-lo-dyte
asleep	a-sleep
shipload	ship-load
white-washed	whitewashed
pur-suant	pur-su-ant
smoother	smooth-er
rasper	rasp-er
stoma	sto-ma
pro-pri-etor	pro-pri-e-tor
mono	mon-o
seclu-sion	se-clu-sion
uni-ver-sal-i-ty	u-ni-ver-sal-i-ty
un-ortho-dox	un-or-tho-dox
coulomb	cou-lomb
enu-mer-a-tion	e-nu-mer-a-tion
flota-tion	flo-ta-tion
physics	phys-ics
di-choto-mous	di-chot-o-mous
un-sur-pass-able	un-sur-pass-a-ble
gud-geon	gudg-eon
over-es-ti-ma-tion	o-ver-es-ti-ma-tion
edgy	edg-y
en-riched	enriched
som-brero	som-bre-ro
baroness	bar-on-ess
chameleon	cha-me-le-on
mealy	meal-y
het-erol-o-gous	het-er-ol-o-gous
pageantry	pag-eant-ry
feath-erlight	feath-er-light
movie	mov-ie
briny	brin-y
hooli-gan	hoo-li-gan
con-sid-er-ably	con-sid-er-a-bly
detri-ment	det-ri-ment
inat-ten-tion	in-at-ten-tion
joyride	joy-ride
ex-che-quer	ex-cheq-uer
equa-tion	e-qua-tion
an-tifreeze	an-ti-freeze
repa-tri-ate	re-pa-tri-ate
ogre	o-gre
bivouac	biv-ou-ac
in-sa-tiable	in-sa-tia-ble
testable	test-a-ble
dilem-ma	di-lem-ma
fid-get	fidg-et
dis-obey	dis-o-bey
unso-cial	un-so-cial
present-ly	pres-ent-ly
iso-la-tion-ist	i-so-la-tion-ist
crick-eter	crick-et-er
mem-o-ra-bil-ia	mem-o-ra-bil-i-a
know-able	know-a-ble
in-ter-change-able	in-ter-change-a-ble
brava-do	bra-va-do
coro-na	co-ro-na
pre-de-ter-mined	predetermined
palace	pal-ace
his-tol-ogy	his-tol-o-gy
cloven	clo-ven
re-ori-en-ta-tion	re-o-ri-en-ta-tion
gullible	gul-li-ble
para-psy-chol-o-gy	par-a-psy-chol-o-gy
ge-neal-o-gy	ge-ne-al-o-gy
reclu-sive	re-clu-sive
ragged	rag-ged
un-prof-itable	un-prof-it-a-ble
conifer	co-ni-fer
ap-proval	ap-prov-al
pan-theon	pan-the-on
hosepipe	hose-pipe
dis-com-fort-ing	discomforting
parabo-la	pa-rab-o-la
bel-liger-ence	bel-lig-er-ence
undis-guised	un-dis-guised
re-tal-ia-to-ry	re-tal-i-a-to-ry
de-sir-able	de-sir-a-ble
charis-ma	cha-ris-ma
pizze-ria	piz-ze-ri-a
cud-gel	cudg-el
pre-dict-ed	predicted
bio-m-e-try	bi-om-e-try
cho-les-terol	cho-les-ter-ol
sa-fari	sa-fa-ri
count-able	count-a-ble
garbage	gar-bage
lachry-mose	lach-ry-mose
teach-able	teach-a-ble
theta	the-ta
un-de-ni-ably	un-de-ni-a-bly
mio-sis	mi-o-sis
metaphor-i-cal-ly	met-a-phor-i-cal-ly
turmer-ic	tur-mer-ic
over-sim-pli-fy	o-ver-sim-pli-fy
su-per-nu-mer-ary	su-per-nu-mer-ar-y
servi-ette	ser-vi-ette
eco-log-i-cal	ec-o-log-i-cal
hooli-gan-ism	hoo-li-gan-ism
cor-po-ratism	cor-po-rat-ism
equinox	e-qui-nox
lyric	lyr-ic
taboo	ta-boo
mis-cel-lanea	mis-cel-la-ne-a
slant-ed	slanted
im-munoas-say	im-mu-no-as-say
as-pirin	as-pi-rin
bio-met-ric	bi-o-met-ric
poly-styrene	pol-y-sty-rene
archdea-con-ry	arch-dea-con-ry
out-lier	out-li-er
roguery	ro-guer-y
stodgy	stodg-y
mod-icum	mod-i-cum
painter	paint-er
reat-tempt	re-at-tempt
pro-tec-torate	pro-tec-tor-ate
reis-sue	re-is-sue
tele-text	tel-e-text
im-ma-te-r-i-al	im-ma-te-ri-al
mid-dleweight	mid-dle-weight
enu-mer-ate	e-nu-mer-ate
in-sur-gency	in-sur-gen-cy
caviar	cav-i-ar
pro-pri-etary	pro-pri-e-tar-y
ra-di-ogram	ra-di-o-gram
sub-species	sub-spe-cies
refu-ta-tion	ref-u-ta-tion
macro-scop-ic	mac-ro-scop-ic
dosage	dos-age
ir-rec-on-cil-able	ir-rec-on-cil-a-ble
incog-ni-to	in-cog-ni-to
dial	di-al
grandil-o-quent	gran-dil-o-quent
egal-i-tar-i-an-ism	e-gal-i-tar-i-an-ism
ivy	i-vy
re-deemer	re-deem-er
icosa-he-dron	i-co-sa-he-dron
as-pi-ra-tional	as-pi-ra-tion-al
be-lit-tling	belittling
tri-tium	trit-i-um
gas-troin-testi-nal	gas-tro-in-tes-ti-nal
prepara-to-ry	pre-par-a-to-ry
cagoule	ca-goule
screen-writer	screen-writ-er
hy-dro-sta-t-ics	hy-dro-stat-ics
sorghum	sor-ghum
re-as-sur-ing	reassuring
atom-ic	a-tom-ic
aban-don-ment	a-ban-don-ment
avenge	a-venge
ob-scu-ran-tist	ob-scu-rant-ist
curlew	cur-lew
tequi-la	te-qui-la
ex-pec-tant-ly	ex-pect-ant-ly
armistice	ar-mi-stice
sober-ly	so-ber-ly
bug-gery	bug-ger-y
turnover	turn-o-ver
pleat-ed	pleated
proph-esy	proph-e-sy
bizarre	bi-zarre
sooty	soot-y
eerie	ee-rie
smirk-ing	smirking
diplo-mat-i-cal-ly	dip-lo-mat-i-cal-ly
miser	mi-ser
re-mov-able	re-mov-a-ble
fidu-cia-ry	fi-du-ci-ar-y
antacid	ant-ac-id
sagac-i-ty	sa-gac-i-ty
boater	boat-er
duchess	duch-ess
un-nec-es-sary	un-nec-es-sar-y
agree	a-gree
guinea	guin-ea
haystack	hay-stack
item	i-tem
un-demon-stra-tive	un-de-mon-stra-tive
con-ve-nient-ly	con-ven-ient-ly
obey	o-bey
ex-tra-mur-al	ex-tra-mu-ral
penance	pen-ance
aro-ma	a-ro-ma
vagabond	vag-a-bond
brethren	breth-ren
maya	ma-ya
ru-ina-tion	ru-in-a-tion
un-jus-ti-fi-able	un-jus-ti-fi-a-ble
cere-bel-lum	cer-e-bel-lum
minute-ly	mi-nute-ly
reser-va-tion	res-er-va-tion
mildewy	mil-dew-y
stratig-ra-phy	stra-tig-ra-phy
tuba	tu-ba
un-shak-able	un-shak-a-ble
steve-dore	ste-ve-dore
trel-lised	trellised
unis-sued	un-is-sued
biki-ni	bi-ki-ni
rivulet	riv-u-let
depre-da-tion	dep-re-da-tion
tidal	tid-al
strate-gi-cal-ly	stra-te-gi-cal-ly
read-mit	re-ad-mit
translit-er-ate	trans-lit-er-ate
com-peti-tor	com-pet-i-tor
biodegrad-able	bi-o-de-grad-a-ble
solid-ly	sol-id-ly
un-ortho-doxy	un-or-tho-dox-y
re-pro-ducibly	re-pro-duc-i-bly
swampy	swamp-y
res-onate	res-o-nate
exe-unt	ex-e-unt
brew-ery	brew-er-y
email	e-mail
dip-so-ma-nia	dip-so-ma-ni-a
en-doge-nous	en-dog-e-nous
spokesman	spokes-man
rheumat-ics	rheu-mat-ics
bour-geoisie	bour-geoi-sie
un-wary	un-war-y
gen-tri-fied	gentrified
nurs-ery	nurs-er-y
cam-panol-o-gy	cam-pa-nol-o-gy
blun-der-ing	blundering
dis-union	dis-un-ion
lemur	le-mur
athe-ism	a-the-ism
pur-po-sive	pur-pos-ive
shipown-er	ship-own-er
okapi	o-ka-pi
penol-o-gy	pe-nol-o-gy
frumpy	frump-y
foundling	found-ling
ori-gin	or-i-gin
tabloid	tab-loid
facet	fac-et
vivid-ly	viv-id-ly
deco-rous	dec-o-rous
ner-vous	nerv-ous
re-silience	re-sil-ience
cloudy	cloud-y
karaoke	kar-a-o-ke
util-i-ty	u-til-i-ty
warthog	wart-hog
rhubarb	rhu-barb
java	ja-va
cog-nizant	cog-ni-zant
clemen-cy	clem-en-cy
pumice	pum-ice
forcible	for-ci-ble
calum-ny	cal-um-ny
servi-tude	ser-vi-tude
legalese	le-gal-ese
supreme-ly	su-preme-ly
testos-terone	tes-tos-ter-one
bur-sary	bur-sa-ry
musty	mus-ty
toupee	tou-pee
quadri-lat-er-al	quad-ri-lat-er-al
meanie	mean-ie
man-i-cured	ma-ni-cured
hypochon-dria	hy-po-chon-dri-a
turnip	tur-nip
codex	co-dex
overop-ti-mistic	o-ver-op-ti-mis-tic
bar-barism	bar-ba-rism
in-ex-plic-a-ble	in-ex-pli-ca-ble
prof-itabil-i-ty	prof-it-a-bil-i-ty
demon-stra-tive	de-mon-stra-tive
tib-ia	tib-i-a
re-minder	re-mind-er
crys-talline	crys-tal-line
triple	tri-ple
spongy	spon-gy
hooray	hoo-ray
leisure	lei-sure
em-piri-cism	em-pir-i-cism
di-elec-tric	di-e-lec-tric
wrin-kled	wrinkled
anon	a-non
ban-knote	bank-note
palm-istry	palm-is-try
le-nient	le-ni-ent
bromine	bro-mine
elec-trol-y-sis	e-lec-trol-y-sis
garage	ga-rage
con-cil-ia-tor	con-cil-i-a-tor
im-muno-com-pro-mised	im-mu-no-com-pro-mised
com-modi-ous	com-mo-di-ous
hy-gien-ic	hy-gi-en-ic
glis-ten-ing	gli-ste-ning
id-iom	id-i-om
ine-bri-a-tion	in-e-bri-a-tion
ir-re-place-able	ir-re-place-a-ble
triglyc-eride	tri-glyc-er-ide
de-brief-ing	debriefing
slushy	slush-y
pathfind-er	path-find-er
promon-to-ry	prom-on-to-ry
rosette	ro-sette
moc-casin	moc-ca-sin
miser-ly	mi-ser-ly
iso-tope	i-so-tope
turnkey	turn-key
eleventh	e-lev-enth
felo-nious	fe-lo-ni-ous
prostate	pros-tate
in-tra-venous	in-tra-ve-nous
fifti-eth	fif-ti-eth
poster	post-er
scullery	scul-ler-y
pedant	ped-ant
ra-dius	ra-di-us
lamp-lighter	lamp-light-er
erec-tile	e-rec-tile
fault-ing	faulting
kilo-ton	kil-o-ton
un-com-fort-ably	un-com-fort-a-bly
pre-sum-ably	pre-sum-a-bly
promis-so-ry	prom-is-so-ry
avalanche	av-a-lanche
stereo-typ-i-cal	ster-e-o-typ-i-cal
tiller	till-er
psy-chother-a-py	psy-cho-ther-a-py
gillie	gil-lie
reagent	re-a-gent
tri-umphal-ism	tri-um-phal-ism
whisker	whisk-er
sander	sand-er
rhetor-i-cal-ly	rhe-tor-i-cal-ly
delu-sive	de-lu-sive
welling-ton	wel-ling-ton
orig-i-nal-ly	o-rig-i-nal-ly
ge-nial	ge-ni-al
catal-y-sis	ca-tal-y-sis
par-tici-ple	par-ti-ci-ple
genre	gen-re
mistype	mis-type
un-prov-able	un-prov-a-ble
der-ma-tol-ogy	der-ma-tol-o-gy
shad-owy	shad-ow-y
over-pow-er-ing	o-ver-pow-er-ing
cast-away	cast-a-way
apex	a-pex
data-base	da-ta-base
leghorn	leg-horn
opaque	o-paque
ha-track	hat-rack
roast-ed	roasted
forcibly	for-ci-bly
repa-tri-a-tion	re-pa-tri-a-tion
sparkle	spar-kle
jagged	jag-ged
ego-tist	e-go-tist
he-li-pad	hel-i-pad
rigid-ly	rig-id-ly
citadel	cit-a-del
de-mo-c-ra-t-i-cal-ly	dem-o-crat-i-cal-ly
qua-dru-pli-cate	quad-ru-pli-cate
im-placa-ble	im-plac-a-ble
minute	mi-nute
satrap	sa-trap
avul-sion	a-vul-sion
con-certi-na	con-cer-ti-na
dearie	dear-ie
ju-ridi-cal	ju-rid-i-cal
pre-lim-i-nary	pre-lim-i-nar-y
ex-trater-res-tri-al	ex-tra-ter-res-tri-al
jus-ti-fi-able	jus-ti-fi-a-ble
repa-ra-tion	rep-a-ra-tion
prefer-ably	pref-er-a-bly
elec-tro-sta-t-ic	e-lec-tro-stat-ic
ebul-lient	e-bul-lient
coura-geous-ly	cou-ra-geous-ly
retic-u-lar	re-tic-u-lar
ejec-tor	e-jec-tor
aver-sive	a-ver-sive
un-change-able	un-change-a-ble
sta-t-ics	stat-ics
rocky	rock-y
lawyer	law-yer
chas-ten-ing	chastening
ap-pa-ra-tus	ap-pa-rat-us
un-con-t-a-m-i-nat-ed	un-con-tam-i-nat-ed
charmer	charm-er
sausage	sau-sage
bindery	bind-er-y
willpow-er	will-pow-er
mono-pole	mon-o-pole
in-au-gur-al	in-au-gu-ral
metic-u-lous-ly	me-tic-u-lous-ly
re-former	re-form-er
bac-teri-um	bac-te-ri-um
prove-nance	prov-e-nance
com-bi-na-to-r-i-al	com-bi-na-to-ri-al
ate-lier	at-el-ier
lassie	las-sie
egret	e-gret
mag-netite	mag-net-ite
ranker	rank-er
erad-i-cat-ed	e-rad-i-cat-ed
unin-sured	un-in-sured
re-volt-ed	revolted
jovial	jo-vi-al
uter-ine	u-ter-ine
mar-i-onette	mar-i-on-ette
hazel	ha-zel
perigee	per-i-gee
over-con-fi-dent	o-ver-con-fi-dent
pro-pri-eto-r-i-al	pro-pri-e-to-ri-al
counter	coun-ter
up-hol-stery	up-hol-ster-y
swarthy	swarth-y
neo-prene	ne-o-prene
at-tain-able	at-tain-a-ble
su-per-fluity	su-per-flu-i-ty
delin-quent	de-lin-quent
castoff	cast-off
rigid	rig-id
re-tiree	re-tir-ee
imag-in-ings	im-ag-in-ings
hori-zon	ho-ri-zon
adapt	a-dapt
in-alien-able	in-al-ien-a-ble
pre-sen-ta-tion	pres-en-ta-tion
gra-tu-ity	gra-tu-i-ty
fash-ion-able	fash-ion-a-ble
po-lice-woman	po-lice-wom-an
cuneiform	cu-ne-i-form
fuzzy	fuzz-y
mega-phone	meg-a-phone
im-politic	im-pol-i-tic
trouper	troup-er
im-pro-vi-sa-tion-al	im-prov-i-sa-tion-al
teleg-ra-phy	te-leg-ra-phy
con-sor-tium	con-sor-ti-um
stovepipe	stove-pipe
prophe-cy	proph-e-cy
clin-i-cian	cli-ni-cian
writer	writ-er
mar-quetry	mar-que-try
flood-ing	flooding
over-sub-scribed	o-ver-sub-scribed
un-adorned	un-a-dorned
syco-phant	syc-o-phant
can-tilevered	cantilevered
techno-pho-bic	tech-no-pho-bic
un-sup-port-able	un-sup-port-a-ble
no-ti-fi-able	no-ti-fi-a-ble
con-nivance	con-niv-ance
unchecked	un-checked
covert-ly	cov-ert-ly
pageant	pag-eant
bio-mass	bi-o-mass
nadir	na-dir
in-vig-o-rat-ing	in-vig-or-at-ing
evanes-cent	ev-a-nes-cent
un-sink-able	un-sink-a-ble
provin-cial	pro-vin-cial
bio-ta	bi-o-ta
union	un-ion
cordillera	cor-dil-le-ra
so-cialite	so-cial-ite
gofer	go-fer
frica-tive	fric-a-tive
un-lac-ing	un-lacing
emet-ic	e-met-ic
philo-soph-i-cal-ly	phil-o-soph-i-cal-ly
stringy	string-y
atroc-i-ty	a-troc-i-ty
serif	ser-if
sago	sa-go
radar	ra-dar
un-de-mo-c-ra-t-ic	un-dem-o-crat-ic
tax-able	tax-a-ble
over-much	o-ver-much
winnable	win-na-ble
seraph-ic	se-raph-ic
posthu-mous-ly	post-hu-mous-ly
de-plorable	de-plor-a-ble
monomol-e-c-u-lar	mon-o-mo-lec-u-lar
ge-o-mag-net-i-cal-ly	ge-o-mag-ne-ti-cal-ly
isotrop-ic	i-so-trop-ic
tri-umphal	tri-um-phal
pho-tore-cep-tor	pho-to-re-cep-tor
re-moval	re-mov-al
in-ad-ver-tent	in-ad-vert-ent
bot-tled	bottled
kilo-byte	kil-o-byte
eclipse	e-clipse
cor-morant	cor-mo-rant
poem	po-em
puffy	puf-fy
naive	na-ive
hys-terec-to-my	hys-ter-ec-to-my
para-ble	par-a-ble
satirist	sat-i-rist
in-tractable	in-trac-ta-ble
opine	o-pine
rewrap	re-wrap
fig-u-ra-tive-ly	fig-ur-a-tive-ly
di-nosaur	di-no-saur
busy-body	bus-y-bod-y
lack-adaisi-cal	lack-a-dai-si-cal
briefer	brief-er
lacrosse	la-crosse
beta	be-ta
syl-labus	syl-la-bus
showy	show-y
lazi-ness	la-zi-ness
read-able	read-a-ble
uten-sil	u-ten-sil
dra-con-ian	dra-co-ni-an
emer-ald	em-er-ald
atop	a-top
trea-son-able	trea-son-a-ble
project	proj-ect
for-giv-able	for-giv-a-ble
mor-phia	mor-phi-a
manikin	man-i-kin
liftoff	lift-off
illiq-uid	il-liq-uid
assig-na-tion	as-sig-na-tion
semi-cir-cu-lar	sem-i-cir-cu-lar
rhap-sody	rhap-so-dy
wether	weth-er
plushy	plush-y
romper	romp-er
nobly	no-bly
fetish	fet-ish
propul-sive	pro-pul-sive
moun-taineer-ing	moun-tain-eer-ing
ex-cel-sior	ex-cel-si-or
undiplo-mat-ic	un-dip-lo-mat-ic
creak-ing	creaking
diplo-ma	di-plo-ma
ra-dio-met-ric	ra-di-o-met-ric
pu-gna-cious	pug-na-cious
stealth-ily	stealth-i-ly
diode	di-ode
evo-ca-tion	ev-o-ca-tion
septet	sep-tet
tourism	tour-ism
lever-age	lev-er-age
mufti	muf-ti
re-trieval	re-triev-al
man-dolin	man-do-lin
video-tape	vid-e-o-tape
mer-chantable	mer-chant-a-ble
oviduct	o-vi-duct
apish	ap-ish
mau-soleum	mau-so-le-um
degra-da-tion	deg-ra-da-tion
un-nerv-ing	unnerving
how-itzer	how-itz-er
au-tonomous-ly	au-ton-o-mous-ly
steadi-ness	stead-i-ness
spon-tane-ity	spon-ta-ne-i-ty
in-ex-orable	in-ex-o-ra-ble
un-touch-able	un-touch-a-ble
topo-graph-ic	top-o-graph-ic
leak-ing	leaking
po-ten-tial-i-ty	po-ten-ti-al-i-ty
mari-nade	mar-i-nade
sax-ony	sax-o-ny
bungee	bun-gee
dis-agree	dis-a-gree
per-ish-able	per-ish-a-ble
turtle-neck	tur-tle-neck
mal-leable	mal-le-a-ble
in-ter-me-di-ary	in-ter-me-di-ar-y
best-seller	best-sell-er
leafy	leaf-y
high-lander	high-lan-der
tox-i-c-i-ty	tox-ic-i-ty
spec-tropho-tome-ter	spec-tro-pho-tom-e-ter
unipo-lar	u-ni-po-lar
based	based
op-er-cu-lum	o-per-cu-lum
pota-to	po-ta-to
longish	long-ish
molyb-de-num	mo-lyb-de-num
gu-ber-na-to-r-i-al	gu-ber-na-to-ri-al
epis-temic	ep-i-ste-mic
slip-pery	slip-per-y
hasti-ly	hast-i-ly
woman	wom-an
gleam-ing	gleaming
pa-paya	pa-pa-ya
shogun	sho-gun
spelling	spell-ing
in-dictable	in-dict-a-ble
coda	co-da
weighty	weight-y
glac-i-er	gla-cier
randy	rand-y
tu-to-r-i-al	tu-to-ri-al
plexus	plex-us
para-noia	par-a-noi-a
im-moral-i-ty	im-mo-ral-i-ty
ether	e-ther
pri-apic	pri-ap-ic
retroac-tive	ret-ro-ac-tive
scorcher	scorch-er
bloody	blood-y
misog-y-nis-tic	mi-sog-y-nis-tic
li-bido	li-bi-do
leviathan	le-vi-a-than
skele-ton	skel-e-ton
butch-ery	butch-er-y
satir-ic	sa-tir-ic
de-po-si-tion	dep-o-si-tion
squeegee	squee-gee
vinyl	vi-nyl
macro	mac-ro
atone-ment	a-tone-ment
tablet	tab-let
up-heaval	up-heav-al
mac-a-roni	mac-a-ro-ni
physi-cist	phys-i-cist
triv-ia	triv-i-a
equate	e-quate
miser-li-ness	mi-ser-li-ness
trans-paren-cy	trans-par-en-cy
un-mis-tak-able	un-mis-tak-a-ble
un-rep-re-sen-ta-tive	un-rep-re-sent-a-tive
pyri-dine	pyr-i-dine
ex-i-gency	ex-i-gen-cy
overeat	o-ver-eat
ele-phant	el-e-phant
stetho-scope	steth-o-scope
jugu-lar	jug-u-lar
vi-sion-ary	vi-sion-ar-y
prog-es-terone	pro-ges-ter-one
duik-er	dui-ker
avian	a-vi-an
mar-chioness	mar-chion-ess
dandy	dan-dy
every-thing	eve-ry-thing
hexa-dec-i-mal	hex-a-dec-i-mal
regress	re-gress
in-de-pen-dent	in-de-pend-ent
bridal	brid-al
nightlife	night-life
anger	an-ger
maudlin	maud-lin
beamy	beam-y
un-de-cid-able	un-de-cid-a-ble
san-i-tary	san-i-tar-y
quadru-ply	quad-ru-ply
coali-tion	co-a-li-tion
post-mistress	post-mis-tress
feal-ty	fe-al-ty
union-ism	un-ion-ism
pho-to-s-phere	pho-to-sphere
sali-vary	sal-i-var-y
trendy	trend-y
tribesman	tribes-man
chid-ing	chiding
steam-roller	steam-roll-er
opac-i-ty	o-pac-i-ty
malev-o-lent	ma-lev-o-lent
in-dis-tin-guish-able	in-dis-tin-guish-a-ble
unim-pres-sive	un-im-pres-sive
mul-tira-cial	mul-ti-ra-cial
un-reach-able	un-reach-a-ble
ser-vant	serv-ant
hy-drochlo-ride	hy-dro-chlo-ride
fuel	fu-el
navel	na-vel
au-topi-lot	au-to-pi-lot
elec-tro-mag-net	e-lec-tro-mag-net
retsi-na	ret-si-na
uni-corn	u-ni-corn
macron	ma-cron
mis-cel-la-neous	mis-cel-la-ne-ous
table-land	ta-ble-land
as-siduity	as-si-du-i-ty
en-forcer	en-forc-er
capri-cious	ca-pri-cious
rein-sur-ance	re-in-sur-ance
ex-oti-cism	ex-ot-i-cism
cor-ti-cos-teroid	cor-ti-co-ster-oid
maser	ma-ser
gherkin	gher-kin
ir-re-solv-able	ir-re-solv-a-ble
prosody	pros-o-dy
het-ero-sex-u-al-i-ty	het-er-o-sex-u-al-i-ty
undig-ni-fied	un-dig-ni-fied
un-ser-vice-able	un-ser-vice-a-ble
leav-ened	leavened
leo-tard	le-o-tard
ranch-ing	ranching
utopi-an	u-to-pi-an
erase	e-rase
de-lim-it-ed	delimited
hege-mo-ny	he-gem-o-ny
spindly	spin-dly
tailplane	tail-plane
curvy	curv-y
be-fud-dled	befuddled
pager	pag-er
labi-al	la-bi-al
bubon-ic	bu-bon-ic
neo-plasm	ne-o-plasm
in-de-pen-dent-ly	in-de-pend-ent-ly
ax-olotl	ax-o-lotl
sul-tana	sul-tan-a
orig-i-nate	o-rig-i-nate
trackbed	track-bed
mytho-log-i-cal	myth-o-log-i-cal
reshow	re-show
en-durable	en-dur-a-ble
moun-taineer	moun-tain-eer
bond-ing	bonding
pup-peteer	pup-pet-eer
colum-nar	co-lum-nar
rip-pling	rippling
raster	ras-ter
plea-sur-able	pleas-ur-a-ble
chateau	cha-teau
evade	e-vade
un-man-age-able	un-man-age-a-ble
fiendish	fiend-ish
in-ter-roga-tor	in-ter-ro-ga-tor
ta-pes-try	tap-es-try
un-solv-able	un-solv-a-ble
envy	en-vy
cus-tody	cus-to-dy
astrad-dle	a-strad-dle
redac-tion	re-dac-tion
newsprint	news-print
erect	e-rect
botany	bot-a-ny
uni-ty	u-ni-ty
cider	ci-der
for-mu-la-ry	for-mu-lar-y
poly-ester	pol-y-es-ter
redi-rect	re-di-rect
epi-logue	ep-i-logue
urea	u-re-a
solem-ni-ty	so-lem-ni-ty
hal-lelu-jah	hal-le-lu-jah
sumo	su-mo
cochlea	coch-le-a
in-con-tro-vert-ible	in-con-tro-vert-i-ble
evoca-tive	e-voc-a-tive
par-ent-ing	parenting
gratic-ule	grat-i-cule
tidi-ness	ti-di-ness
motile	mo-tile
gory	gor-y
crafty	craft-y
any-one	an-y-one
melo-dra-ma	mel-o-dra-ma
ema-ci-a-tion	e-ma-ci-a-tion
swarm-ing	swarming
soupy	soup-y
re-seller	re-sell-er
un-ten-able	un-ten-a-ble
ex-per-i-menter	ex-per-i-ment-er
en-joy-able	en-joy-a-ble
pro-peller	pro-pel-ler
poly-merase	pol-y-mer-ase
ca-cao	ca-ca-o
filthy	filth-y
gallery	gal-ler-y
glacia-tion	gla-ci-a-tion
knowl-edge-able	knowl-edge-a-ble
climber	climb-er
parental	pa-ren-tal
foundry	found-ry
aper-i-tif	a-pe-ri-tif
un-con-trol-lable	un-con-trol-la-ble
exother-mic	ex-o-ther-mic
in-di-vid-ual	in-di-vid-u-al
di-atom	di-a-tom
coy-ote	coy-o-te
bal-cony	bal-co-ny
di-alec-tic	di-a-lec-tic
wicked	wick-ed
unan-swered	un-an-swered
data	da-ta
needy	need-y
limo	lim-o
iron-stone	i-ron-stone
deism	de-ism
es-planade	es-pla-nade
par-al-lelism	par-al-lel-ism
framer	fram-er
goatskin	goat-skin
dero-gate	der-o-gate
huffy	huff-y
vene-re-al	ve-ne-re-al
showjumpers	show-jum-pers
cre-osote	cre-o-sote
over-write	o-ver-write
fran-coph-o-ne	fran-co-phone
chemise	che-mise
idem	i-dem
derelict	der-e-lict
elec-tri-cal-ly	e-lec-tri-cal-ly
re-li-ably	re-li-a-bly
io-dide	i-o-dide
vari-able	var-i-a-ble
un-ob-ser-vant	un-ob-serv-ant
detox	de-tox
aca-d-e-m-ic	ac-a-dem-ic
mantling	man-tling
fly-over	fly-o-ver
unsweet-ened	un-sweet-ened
vac-uole	vac-u-ole
con-tes-tant	con-test-ant
seda-tive	sed-a-tive
gigo-lo	gig-o-lo
deduct	de-duct
earthy	earth-y
phys-iog-no-my	phys-i-og-no-my
nyala	nya-la
hys-teric	hys-ter-ic
caliph	ca-liph
ap-pari-tion	ap-pa-ri-tion
ure-thra	u-re-thra
clam-orous	clam-or-ous
elas-tic-i-ty	e-las-tic-i-ty
tightrope	tight-rope
undis-tort-ed	un-dis-tort-ed
prof-itably	prof-it-a-bly
seascape	sea-scape
weary-ing	wea-ry-ing
monar-chist	mon-ar-chist
de-sirous	de-sir-ous
weepy	weep-y
va-ri-etal	va-ri-e-tal
il-lim-itable	il-lim-it-a-ble
seag-ull	sea-gull
pro-gressed	progressed
tele-pho-ny	te-leph-o-ny
aver-sion	a-ver-sion
de-riva-tion	der-i-va-tion
mo-les-ter	mo-lest-er
treat-able	treat-a-ble
equable	eq-ua-ble
ranter	rant-er
dis-abuse	dis-a-buse
prodi-gious	pro-di-gious
reusable	re-us-a-ble
elec-tric-i-ty	e-lec-tric-i-ty
leather	leath-er
pu-ri-tanism	pu-ri-tan-ism
rheuma-tol-ogy	rheu-ma-tol-o-gy
steadi-ly	stead-i-ly
may-oral	may-or-al
origa-mi	o-ri-ga-mi
hoard-ed	hoarded
un-san-i-tary	un-san-i-tar-y
un-in-hab-it-able	un-in-hab-it-a-ble
provoca-tive	pro-voc-a-tive
satin	sat-in
unre-deemed	un-re-deemed
di-a-bolism	di-ab-o-lism
visa	vi-sa
sanc-tu-ary	sanc-tu-ar-y
an-nu-ity	an-nu-i-ty
navy	na-vy
galac-tic	ga-lac-tic
poly-mor-phous	pol-y-mor-phous
lyrist	lyr-ist
ther-mome-ter	ther-mom-e-ter
vo-cab-u-lary	vo-cab-u-lar-y
be-reaved	bereaved
loft-ed	lofted
restora-tion	res-to-ra-tion
stopover	stop-o-ver
un-re-pairable	un-re-pair-a-ble
codling	cod-ling
beefeater	beef-eat-er
de-sir-abil-i-ty	de-sir-a-bil-i-ty
pro-le-tari-at	pro-le-tar-i-at
iron-work	i-ron-work
frilli-er	fril-li-er
draftee	draft-ee
ergo	er-go
loco	lo-co
placid	plac-id
ebony	eb-on-y
hero	he-ro
promis-ing	prom-is-ing
tillage	till-age
wadding	wad-ding
sali-vate	sal-i-vate
un-ready	un-read-y
laity	la-i-ty
dis-sent-ing	dissenting
de-lin-eate	de-lin-e-ate
un-treat-able	un-treat-a-ble
awhile	a-while
slaver	slav-er
se-quoia	se-quoi-a
quadri-par-tite	quad-ri-par-tite
noisy	nois-y
drom-e-dary	drom-e-dar-y
carat	car-at
ugly	ug-ly
spir-i-tu-al-ism	spir-it-u-al-ism
cetacean	ce-ta-cean
con-tem-po-rary	con-tem-po-rar-y
cari-bou	car-i-bou
ap-pre-cia-ble	ap-pre-ci-a-ble
mata-dor	mat-a-dor
iota	i-o-ta
quasar	qua-sar
re-dis-tri-b-u-tion	re-dis-tri-bu-tion
paving	pav-ing
bios-phere	bi-o-sphere
he-li-copter	hel-i-cop-ter
en-chanter	en-chant-er
avarice	av-a-rice
tele-o-log-i-cal	tel-e-o-log-i-cal
oner-ous	on-er-ous
over-anx-ious	o-ver-anx-ious
mis-er-able	mis-er-a-ble
zigzag	zig-zag
sil-very	sil-ver-y
piti-ful-ly	pit-i-ful-ly
or-nithol-o-gist	or-ni-thol-o-gist
racist	rac-ist
elec-tro-mo-tive	e-lec-tro-mo-tive
odor-if-er-ous	o-dor-if-er-ous
wiz-ardry	wiz-ard-ry
dis-ori-en-ta-tion	dis-o-ri-en-ta-tion
wilder-ness	wil-der-ness
de-sir-abil-ia	de-si-ra-bi-li-a
apery	ap-er-y
hobo	ho-bo
apol-o-gy	a-pol-o-gy
in-tu-itive-ly	in-tu-i-tive-ly
milk-shake	milkshake
copy-cat	cop-y-cat
syn-onym	syn-o-nym
caldera	cal-de-ra
yokel	yo-kel
rel-a-tivism	rel-a-tiv-ism
in-fante	in-fan-te
mousy	mous-y
re-port-ed	reported
mil-lenar-i-an	mil-le-nar-i-an
amus-ing	a-mus-ing
up-end-ed	upended
colobus	col-o-bus
foot-balling	foot-ball-ing
en-chantress	en-chant-ress
rephrase	re-phrase
zany	za-ny
nonen-ti-ty	non-en-ti-ty
laven-der	lav-en-der
giro	gi-ro
monarch	mon-arch
sarong	sa-rong
spaniel	span-iel
in-ter-atom-ic	in-ter-a-tom-ic
refugee	ref-u-gee
in-de-fin-able	in-de-fin-a-ble
ra-tio-nal-ist	ra-tion-al-ist
haven	ha-ven
saunter	saun-ter
shunter	shunt-er
domi-no	dom-i-no
wiry	wir-y
freely	free-ly
strate-gist	strat-e-gist
sahib	sa-hib
undis-tin-guished	un-dis-tin-guished
pity	pit-y
in-jury	in-ju-ry
amused	a-mused
halite	hal-ite
de-scen-dant	de-scend-ant
di-rec-torate	di-rec-to-rate
yel-lowed	yellowed
the-atri-cal	the-at-ri-cal
gatepost	gate-post
vari-ate	var-i-ate
lith-o-g-ra-phy	li-thog-ra-phy
bacil-lus	ba-cil-lus
platy-pus	plat-y-pus
read-abil-i-ty	read-a-bil-i-ty
dahlia	dahl-ia
mil-i-taris-tic	mil-i-ta-ris-tic
over-fill	o-ver-fill
weedy	weed-y
husky	hus-ky
ter-rapin	ter-ra-pin
ni-troge-nous	ni-trog-e-nous
so-cioe-co-nom-ic	so-ci-o-ec-o-nom-ic
sibyl	sib-yl
cin-e-matog-ra-phy	cin-e-ma-tog-ra-phy
darter	dart-er
tricky	trick-y
gateau	ga-teau
orig-i-na-tor	o-rig-i-na-tor
snaky	snak-y
ran-corous	ran-cor-ous
stinker	stink-er
hip-popota-mus	hip-po-pot-a-mus
gro-cery	gro-cer-y
stapes	sta-pes
dis-tin-guish-able	dis-tin-guish-a-ble
seedy	seed-y
sophist	soph-ist
in-signia	in-sig-ni-a
obelisk	ob-e-lisk
yoga	yo-ga
es-capee	es-cap-ee
basil	bas-il
lit-toral	lit-to-ral
finicky	fin-ick-y
spanker	spank-er
frigate	frig-ate
ar-chaism	ar-cha-ism
sporran	spor-ran
calami-ty	ca-lam-i-ty
com-ple-men-tary	com-ple-men-ta-ry
in-ad-ver-tent-ly	in-ad-vert-ent-ly
bol-stered	bolstered
ju-di-cia-ry	ju-di-ci-ar-y
awry	a-wry
cougar	cou-gar
in-valid	in-va-lid
emen-da-tion	e-men-da-tion
ruin	ru-in
lichen	li-chen
im-peri-um	im-pe-ri-um
cre-ativ-i-ty	cre-a-tiv-i-ty
un-de-sir-able	un-de-sir-a-ble
un-proven	un-prov-en
adopt	a-dopt
hangar	hang-ar
ele-phan-tine	el-e-phan-tine
un-sea-son-ably	un-sea-son-a-bly
notepa-per	note-pa-per
omis-sion	o-mis-sion
balus-ter	bal-us-ter
gamy	gam-y
eter-ni-ty	e-ter-ni-ty
in-cor-rupt-ible	in-cor-rupt-i-ble
im-pass-able	im-pass-a-ble
spinet	spin-et
cheer-ing	cheering
lion	li-on
un-ob-jec-tion-able	un-ob-jec-tion-a-ble
hexa-ne	hex-ane
im-pro-pri-ety	im-pro-pri-e-ty
the-atri-cal-i-ty	the-at-ri-cal-i-ty
ally	al-ly
skul-dug-gery	skul-dug-ger-y
clink-ing	clin-king
endgame	end-game
neg-ligee	neg-li-gee
tyran-ni-cal	ty-ran-ni-cal
ex-porta-bil-i-ty	ex-por-ta-bi-li-ty
orang-utan	o-rang-u-tan
toady	toad-y
curie	cu-rie
taran-tu-la	ta-ran-tu-la
apos-tle	a-pos-tle
celiba-cy	cel-i-ba-cy
notwith-stand-ing	not-with-stand-ing
jalopy	ja-lop-y
transat-lantic	trans-at-lan-tic
harpists	har-pists
boun-teous	boun-te-ous
cata-ton-ic	cat-a-ton-ic
rhetoric	rhet-o-ric
iron-works	i-ron-works
payable	pay-a-ble
aloud	a-loud
bul-letin	bul-le-tin
flashy	flash-y
tsetse	tset-se
abalone	ab-a-lo-ne
de-nial	de-ni-al
con-tender	con-tend-er
he-do-nism	he-don-ism
colosto-my	co-los-to-my
un-equiv-o-cal	un-e-quiv-o-cal
medi-oc-rity	me-di-oc-ri-ty
banker	bank-er
con-juror	con-ju-ror
un-lucky	un-luck-y
dessert	des-sert
palette	pal-ette
dis-cor-dant	dis-cord-ant
re-formist	re-form-ist
hy-dro-elec-tric	hy-dro-e-lec-tric
both-ered	bothered
au-tonomous	au-ton-o-mous
uni-formed	u-ni-formed
in-no-v-a-tive	in-no-va-tive
over-rule	o-ver-rule
sawyer	saw-yer
nitwit	nit-wit
ruler	rul-er
us-able	us-a-ble
flu-vial	flu-vi-al
rheo-stat	rhe-o-stat
dili-gent-ly	dil-i-gent-ly
sandy	sand-y
ma-te-r-i-al	ma-te-ri-al
idle	i-dle
babysit-ting	babysitting
en-comi-um	en-co-mi-um
builder	build-er
dwelling	dwell-ing
multi-na-tion-al	mul-ti-na-tion-al
sen-tinel	sen-ti-nel
pigsty	pig-sty
melanin	mel-a-nin
over-sized	o-ver-sized
knitwear	knit-wear
prosce-ni-um	pro-sce-ni-um
padre	pa-dre
gos-sipy	gos-sip-y
metronome	met-ro-nome
eman-ci-pat-ed	e-man-ci-pat-ed
repro-bate	rep-ro-bate
prefer-ment	pre-fer-ment
oxy-moron	ox-y-mo-ron
uni-ver-sal-ist	u-ni-ver-sal-ist
un-der-body	un-der-bod-y
tri-bunal	tri-bu-nal
overview	o-ver-view
aqualung	aq-ua-lung
dis-cor-dance	dis-cord-ance
dero-ga-tion	der-o-ga-tion
galaxy	gal-ax-y
elas-ti-cat-ed	e-las-ti-cat-ed
prodi-gy	prod-i-gy
un-de-tectable	un-de-tect-a-ble
silent-ly	si-lent-ly
gra-tu-itous	gra-tu-i-tous
earnest	ear-nest
aback	a-back
rea-son-able	rea-son-a-ble
opi-um	o-pi-um
tuner	tun-er
tiler	til-er
hadron	had-ron
unchris-t-ian	un-chris-tian
over-joyed	o-ver-joyed
renum-ber	re-num-ber
roundel	roun-del
bereft	be-reft
untest-ed	un-test-ed
heifer	heif-er
un-aligned	un-a-ligned
artist	art-ist
freighter	freight-er
mala-chite	mal-a-chite
leaky	leak-y
serendip-i-tous	ser-en-dip-i-tous
moral-ism	mor-al-ism
sce-nario	sce-nar-i-o
query	que-ry
boa	bo-a
rainy	rain-y
mi-crochip	mi-cro-chip
un-watch-able	un-watch-a-ble
elu-ci-da-tion	e-lu-ci-da-tion
over-long	o-ver-long
in-vestor	in-ves-tor
py-rotech-nics	py-ro-tech-nics
re-searcher	re-search-er
be-liev-able	be-liev-a-ble
epicy-cloid	ep-i-cy-cloid
pala-tine	pal-a-tine
bidi-rec-tion-al	bi-di-rec-tion-al
peri-toneum	per-i-to-ne-um
pala-tial	pa-la-tial
plaza	pla-za
dodo	do-do
im-per-ish-able	im-per-ish-a-ble
are-na	a-re-na
grad-ual	grad-u-al
im-mun-od-e-fi-cien-cy	im-mu-no-de-fi-cien-cy
paral-y-sis	pa-ral-y-sis
causal-i-ty	cau-sal-i-ty
across	a-cross
balder-dash	bal-der-dash
im-mea-sur-ably	im-meas-ur-a-bly
epit-o-me	e-pit-o-me
morale	mo-rale
neon	ne-on
un-buried	un-bur-ied
tubu-lar	tu-bu-lar
eosin	e-o-sin
nether	neth-er
sadis-tic	sa-dis-tic
springer	spring-er
pro-mul-gate	prom-ul-gate
bio-chem-i-cal	bi-o-chem-i-cal
roughshod	rough-shod
overem-pha-sis	o-ver-em-pha-sis
decor	de-cor
greasy	greas-y
bil-iary	bil-i-ar-y
overkill	o-ver-kill
dumb-found-ed	dumbfounded
mag-ne-sium	mag-ne-si-um
philoso-pher	phi-los-o-pher
daf-fodil	daf-fo-dil
er-gonom-ic	er-go-nom-ic
eigen-state	ei-gen-state
dais	da-is
el-dest	eld-est
teenaged	teen-aged
fet-tered	fettered
mar-itime	mar-i-time
cobalt	co-balt
promi-nent	prom-i-nent
ethno-graph-ic	eth-no-graph-ic
in-haler	in-hal-er
triv-ial	triv-i-al
ep-silon	ep-si-lon
lazi-ly	la-zi-ly
preser-v-a-tive	pre-serv-a-tive
rur-al	ru-ral
epochal	ep-och-al
eco-log-i-cal-ly	ec-o-log-i-cal-ly
hy-dros-phere	hy-dro-sphere
dimwit	dim-wit
te-dious	te-di-ous
tele-vi-sion	tel-e-vi-sion
dele-te-ri-ous	del-e-te-ri-ous
miniskirt	min-i-skirt
apho-rism	aph-o-rism
uniden-ti-fi-able	un-i-den-ti-fi-a-ble
madras	mad-ras
transept	tran-sept
menswear	mens-wear
creduli-ty	cre-du-li-ty
zero	ze-ro
propane	pro-pane
minke	min-ke
bud-get	budg-et
again	a-gain
wingspan	wing-span
car-dio-vas-cu-lar	car-di-o-vas-cu-lar
net-work-ing	networking
serum	se-rum
navvy	nav-vy
also	al-so
logo	lo-go
an-tibi-ot-ic	an-ti-bi-ot-ic
unin-su-lat-ed	un-in-su-lat-ed
dotage	dot-age
cor-duroy	cor-du-roy
fool-ery	fool-er-y
asym-me-try	a-sym-me-try
li-oness	li-on-ess
res-cuer	res-cu-er
im-muno-sup-pres-sion	im-mu-no-sup-pres-sion
in-con-testable	in-con-test-a-ble
om-ni-science	om-nis-cience
dishy	dish-y
trage-di-an	tra-ge-di-an
piv-otal	piv-ot-al
legume	leg-ume
coitus	co-i-tus
Words with errors: 1868
Words with incorrect number of syllables: 1772
Total evluated: 6500
Perfect accuracy: 0.71
Number of syllables accuracy: 0.73
Average Levenshtein Distance(across incorrect words): 1.19
