Attempt	Real
foam-ing	foaming
opos-sum	o-pos-sum
chapel	chap-el
any-how	an-y-how
idio-syn-crat-ic	id-i-o-syn-crat-ic
con-tretemps	con-tre-temps
her-i-ta-ble	her-it-a-ble
porcine	por-cine
quixot-ic	quix-ot-ic
any-body	an-y-bod-y
ashen	ash-en
avoid	a-void
lager	la-ger
legate	leg-ate
fum-bling	fumbling
fu-ner-ary	fu-ner-ar-y
cheery	cheer-y
in-ex-haustible	in-ex-haust-i-ble
mod-icum	mod-i-cum
his-togram	his-to-gram
piglet	pig-let
epi-demi-o-log-i-cal	ep-i-de-mi-o-log-i-cal
telecom-mu-ni-ca-tion	tel-e-com-mu-ni-ca-tion
cere-bel-lum	cer-e-bel-lum
de-for-mi-ty	de-form-i-ty
gospel	gos-pel
binoc-u-lars	bin-oc-u-lars
thau-maturge	thau-ma-turge
homage	hom-age
sus-pend-ed	sus-pen-ded
coy-ote	coy-o-te
walkover	walk-o-ver
ini-tia-tive	in-i-ti-a-tive
aver-sion	a-ver-sion
even-song	e-ven-song
soli-tude	sol-i-tude
viper	vi-per
ax-il-lary	ax-il-lar-y
crier	cri-er
cur-able	cur-a-ble
para-mount-cy	par-a-mount-cy
morass	mo-rass
ex-porta-bil-i-ty	ex-por-ta-bi-li-ty
furtive	fur-tive
tanker	tank-er
rose-mary	rose-mar-y
bribery	brib-er-y
table-ware	ta-ble-ware
markup	mark-up
evac-uee	e-vac-u-ee
un-usu-al-ly	un-u-su-al-ly
pun-ish-able	pun-ish-a-ble
fore-see-able	fore-see-a-ble
fo-liage	fo-li-age
thievish	thiev-ish
trusty	trust-y
emer-ald	em-er-ald
alarm-ing	a-larm-ing
steadi-ness	stead-i-ness
broadsword	broad-sword
nightin-gale	night-in-gale
shady	shad-y
prodi-gious	pro-di-gious
naked-ness	na-ked-ness
pesti-lence	pes-ti-lence
perime-ter	pe-rim-e-ter
stereo-typ-i-cal	ster-e-o-typ-i-cal
mnemon-ics	mne-mon-ics
pro-pri-etress	pro-pri-e-tress
colour	co-lour
sacro-sanct	sac-ro-sanct
twofold	two-fold
dogged	dog-ged
tele-pho-to	tel-e-pho-to
har-mo-nious	har-mo-ni-ous
sim-per-ing	simpering
horsey	hors-ey
promi-nence	prom-i-nence
slalom	sla-lom
gener-ic	ge-ner-ic
loader	load-er
pol-lard-ed	pollarded
veni-son	ven-i-son
tru-cu-lent	truc-u-lent
co-rian-der	co-ri-an-der
pe-trel	pet-rel
frothy	froth-y
psy-chopathol-o-gy	psy-cho-pa-thol-o-gy
stan-dard	stand-ard
awash	a-wash
con-tigu-ous	con-tig-u-ous
willpow-er	will-pow-er
apothe-cary	a-poth-e-car-y
glut-to-nous	glut-ton-ous
deco-rous	dec-o-rous
boomer	boom-er
delu-sive	de-lu-sive
vine-gar	vin-e-gar
unau-dit-ed	un-au-dit-ed
jit-tery	jit-ter-y
over-coat	o-ver-coat
evan-ge-lis-tic	e-van-ge-lis-tic
muslin	mus-lin
divers	di-vers
alone	a-lone
agency	a-gen-cy
prospec-tus	pro-spec-tus
but-tery	but-ter-y
briskly	brisk-ly
tou-sled	tousled
worsted	wor-sted
un-avoid-ably	un-a-void-a-bly
brassiere	bras-siere
pho-to-volta-ic	pho-to-vol-ta-ic
benef-i-cent	be-nef-i-cent
fiat	fi-at
sto-icism	sto-i-cism
barefaced	bare-faced
in-testi-nal	in-tes-ti-nal
arum	ar-um
ax-iom	ax-i-om
emer-gent	e-mer-gent
over-sup-ply	o-ver-sup-ply
aqua	aq-ua
usurp-er	u-surp-er
uned-i-fy-ing	un-ed-i-fy-ing
sym-biont	sym-bi-ont
copy-ist	cop-y-ist
un-bear-ably	un-bear-a-bly
ap-pre-cia-ble	ap-pre-ci-a-ble
biop-sy	bi-op-sy
de-pen-dence	de-pend-ence
slant-i-ng	slant-ing
ragout	ra-gout
car-dioid	car-di-oid
haughty	haugh-ty
re-bury	re-bur-y
busy	bus-y
moorhen	moor-hen
harpist	har-pist
dispir-it-ed	dis-pir-it-ed
hec-tor-ing	hectoring
pathos	pa-thos
mas-culin-i-ty	mas-cu-lin-i-ty
sleepy	sleep-y
gra-nary	gra-na-ry
over-ex-po-sure	o-ver-ex-po-sure
rein-sur-ance	re-in-sur-ance
propen-si-ty	pro-pen-si-ty
basil	bas-il
aso-cial	a-so-cial
colos-sal	co-los-sal
blush-ing	blushing
di-a-bolism	di-ab-o-lism
mush-room-ing	mushrooming
es-capist	es-cap-ist
leer-ing	leering
par-enter-al	par-en-ter-al
river-side	riv-er-side
ma-tri-lin-eal	mat-ri-lin-e-al
platy-pus	plat-y-pus
dis-heart-en-ing	dis-hear-te-ning
fin-ery	fin-er-y
om-nipo-tence	om-nip-o-tence
id-io-cy	id-i-o-cy
katy-did	ka-ty-did
com-ple-men-tary	com-ple-men-ta-ry
be-wil-dered	bewildered
wily	wil-y
over-reach	o-ver-reach
pharaoh	phar-aoh
un-re-li-able	un-re-li-a-ble
talkie	talk-ie
over-act-ing	overacting
un-quan-tifi-able	un-quan-ti-fi-a-ble
gazelle	ga-zelle
physics	phys-ics
im-pro-visato-ry	im-pro-vi-sa-to-ry
serum	se-rum
sali-vary	sal-i-var-y
rock-etry	rock-et-ry
colosto-my	co-los-to-my
liquor-ish	liq-uor-ish
in-nu-mer-able	in-nu-mer-a-ble
recita-tion	rec-i-ta-tion
poly-glot	pol-y-glot
prebend	preb-end
reify	re-i-fy
naughty	naugh-ty
share-able	share-a-ble
labia	la-bi-a
fold-ing	folding
avert	a-vert
squea-mish	squeam-ish
positron	pos-i-tron
body	bod-y
ca-cao	ca-ca-o
coro-nal	cor-o-nal
piti-ful	pit-i-ful
sibyl	sib-yl
prowler	prowl-er
usu-al-ly	u-su-al-ly
coolant	cool-ant
transat-lantic	trans-at-lan-tic
eigen-state	ei-gen-state
chill-ing	chilling
physique	phy-sique
holism	ho-lism
prece-dence	prec-e-dence
com-bi-na-to-r-i-al	com-bi-na-to-ri-al
unar-tic-u-lat-ed	un-ar-tic-u-lat-ed
ser-vant	serv-ant
vic-arage	vic-ar-age
com-mis-sari-at	com-mis-sar-i-at
dairy-ing	dair-y-ing
salu-ta-tion	sal-u-ta-tion
hy-pother-mia	hy-po-ther-mi-a
ova-tion	o-va-tion
propy-lene	pro-pyl-ene
mil-ligram	mil-li-gram
hero-ine	her-o-ine
sug-ary	sug-ar-y
rec-on-cil-able	rec-on-cil-a-ble
backpedal	back-ped-al
basil-i-ca	ba-sil-i-ca
equa-to-r-i-al	e-qua-to-ri-al
puny	pu-ny
pri-mar-i-ly	pri-ma-ri-ly
em-anate	em-a-nate
literati	lit-e-ra-ti
im-mov-able	im-mov-a-ble
de-tainee	de-tain-ee
statu-to-ry	stat-u-to-ry
tidal	tid-al
lodestar	lode-star
clemen-cy	clem-en-cy
based	based
kayak	kay-ak
in-choate	in-cho-ate
solid-ly	sol-id-ly
im-pro-pri-ety	im-pro-pri-e-ty
tyran-ni-cide	ty-ran-ni-cide
soapy	soap-y
con-tour-ing	con-touring
rant-i-ng	ranting
bubon-ic	bu-bon-ic
in-ter-de-pen-dent	in-ter-de-pend-ent
liv-able	liv-a-ble
comi-ty	com-i-ty
speedome-ter	speed-om-e-ter
glassy	glass-y
un-event-ful	un-e-vent-ful
sinew	sin-ew
makeshift	make-shift
nico-tine	nic-o-tine
creamy	cream-y
jour-nalese	jour-nal-ese
chival-ry	chiv-al-ry
mega-hertz	meg-a-hertz
car-rion	car-ri-on
qua-train	quat-rain
ela-tion	e-la-tion
dweller	dwell-er
habi-ta-tion	hab-i-ta-tion
navvy	nav-vy
eatery	eat-er-y
ravi-o-li	ra-vi-o-li
invit-ing	in-vit-ing
py-rotech-nic	py-ro-tech-nic
rel-a-tivism	rel-a-tiv-ism
grenade	gre-nade
trust-ed	trusted
triv-ial	triv-i-al
hab-er-dash-ery	hab-er-dash-er-y
har-mo-nious-ly	har-mo-ni-ous-ly
brasserie	bras-se-rie
rainy	rain-y
ra-dionu-clide	ra-di-o-nu-clide
able	a-ble
slav-ery	slav-er-y
ed-uca-tive	ed-u-ca-tive
recital	re-cit-al
makeweight	make-weight
herbal-ist	herb-al-ist
distaff	dis-taff
petard	pe-tard
rearm	re-arm
ally	al-ly
nodal	nod-al
screwy	screw-y
tam-bourine	tam-bou-rine
tum-bled	tumbled
power-boat	pow-er-boat
kriegspiel	krieg-spiel
para-mil-i-tary	par-a-mil-i-tar-y
ori-en-tal-ism	o-ri-en-tal-ism
unan-swer-able	un-an-swer-a-ble
kalei-do-scope	ka-lei-do-scope
dis-cred-it-ed	discredited
sundry	sun-dry
rene-go-ti-a-tion	re-ne-go-ti-a-tion
hege-mon-ic	heg-e-mon-ic
pho-to-genic	pho-to-gen-ic
en-cy-clo-pe-dia	en-cy-clo-pe-di-a
cabri-o-let	cab-ri-o-let
ot-toman	ot-to-man
brushy	brush-y
bovine	bo-vine
coro-nary	cor-o-nar-y
detox	de-tox
premise	prem-ise
febrile	fe-brile
sparkle	spar-kle
serif	ser-if
struc-tural-ly	struc-tur-al-ly
treaty	trea-ty
whomev-er	whom-ev-er
con-juror	con-ju-ror
re-newed	renewed
tena-cious	te-na-cious
un-men-tion-able	un-men-tion-a-ble
at-trib-ut-able	at-trib-ut-a-ble
lazi-ness	la-zi-ness
simil-i-tude	si-mil-i-tude
avul-sion	a-vul-sion
vari-ate	var-i-ate
sun-burned	sunburned
hypocrisy	hy-poc-ri-sy
meta-mor-phism	met-a-mor-phism
avens	av-ens
couloir	cou-loir
cli-ma-tol-ogy	cli-ma-tol-o-gy
triplex	tri-plex
prefer-ably	pref-er-a-bly
opal	o-pal
retro	ret-ro
tit-ter-ing	tittering
lex-i-cog-ra-ph-er	lex-i-cog-ra-pher
over-strung	o-ver-strung
mine-strone	min-e-stro-ne
de-tectably	de-tect-a-bly
mi-cro-bial	mi-cro-bi-al
whaler	whal-er
uni-form-ly	u-ni-form-ly
hermeneu-tic	her-me-neu-tic
wretched	wretch-ed
bur-gundy	bur-gun-dy
ozone	o-zone
chevron	chev-ron
blaster	blast-er
legu-mi-nous	le-gu-mi-nous
ar-ti-fi-cial-i-ty	ar-ti-fi-ci-al-i-ty
hemi-sphere	hem-i-sphere
marigold	mar-i-gold
un-re-peat-able	un-re-peat-a-ble
amuse	a-muse
fi-nis	fin-is
giblets	gib-lets
tele-graph-ic	tel-e-graph-ic
dri-ven	driv-en
con-traindi-ca-tion	con-tra-in-di-ca-tion
skew-ered	skewered
bat-tery	bat-ter-y
medal-lion	me-dal-lion
ori-en-tal	o-ri-en-tal
ro-tary	ro-ta-ry
yogi	yo-gi
unim-peach-able	un-im-peach-a-ble
cognoscen-ti	co-gno-scen-ti
ebony	eb-on-y
boa	bo-a
in-vi-o-lable	in-vi-o-la-ble
gaudy	gaud-y
timetable	time-ta-ble
un-fa-mil-iar-i-ty	un-fa-mil-i-ar-i-ty
chronome-ter	chro-nom-e-ter
mor-phia	mor-phi-a
binoc-u-lar	bin-oc-u-lar
dis-solute	dis-so-lute
regress	re-gress
diehard	die-hard
wadi	wa-di
panacea	pan-a-ce-a
nar-ra-tol-ogy	nar-ra-tol-o-gy
hunter	hunt-er
spon-sored	sponsored
nat-ur-al	nat-u-ral
avid-i-ty	a-vid-i-ty
askew	a-skew
evan-gel-i-cal	e-van-gel-i-cal
dumb-found-ed	dumbfounded
preda-to-ry	pred-a-to-ry
teapot	tea-pot
postal	post-al
pro-ject-ed	projected
grapevine	grape-vine
tutu	tu-tu
chas-ten-ing	chastening
un-beat-able	un-beat-a-ble
chi-canery	chi-can-er-y
un-equal	un-e-qual
halfway	half-way
kilo	ki-lo
zoo-plank-ton	zo-o-plank-ton
know-able	know-a-ble
equian-gu-lar	e-qui-an-gu-lar
pecan	pe-can
ar-chaeopteryx	ar-chae-op-ter-yx
ex-pi-ra-to-ry	ex-pir-a-to-ry
crick-eter	crick-et-er
data	da-ta
espy	es-py
py-rotech-nics	py-ro-tech-nics
col-le-gial	col-le-gi-al
emen-da-tion	e-men-da-tion
spir-i-tu-al-i-ty	spir-it-u-al-i-ty
lazy-bones	la-zy-bones
steam-roller	steam-roll-er
plumba-go	plum-ba-go
cousin	cous-in
opin-ion-at-ed	o-pin-ion-at-ed
fi-deli-ty	fi-del-i-ty
oblit-er-a-tion	ob-lit-er-a-tion
lofty	loft-y
qui-eten	qui-et-en
mic-turi-tion	mic-tu-ri-tion
yeti	yet-i
chemise	che-mise
mega-phone	meg-a-phone
as-tro-physics	as-tro-phys-ics
kina	ki-na
sub-si-dence	sub-sid-ence
over-man-tel	o-ver-man-tel
moody	mood-y
om-nipo-tent	om-nip-o-tent
perigee	per-i-gee
steady	stead-y
husky	hus-ky
lassie	las-sie
in-hibitor	in-hib-i-tor
con-formist	con-form-ist
ex-pen-di-ture	ex-pend-i-ture
mer-cu-r-ial	mer-cu-ri-al
feath-erlight	feath-er-light
beaver	bea-ver
en-comi-um	en-co-mi-um
bacil-lus	ba-cil-lus
scam-per	scamp-er
duet	du-et
ab-solute-ly	ab-so-lute-ly
peachy	peach-y
re-assess	re-as-sess
in-sou-ciance	in-sou-ci-ance
stu-dious	stu-di-ous
poignan-cy	poign-an-cy
moder-ni-ty	mo-der-ni-ty
re-cov-ery	re-cov-er-y
ap-pari-tion	ap-pa-ri-tion
cata-ma-ran	cat-a-ma-ran
away	a-way
me-nial	me-ni-al
phono-log-i-cal	pho-no-log-i-cal
valance	val-ance
ren-dezvous	ren-dez-vous
wattage	watt-age
plumage	plum-age
sun-tanned	suntanned
for-syth-ia	for-syth-i-a
emer-gence	e-mer-gence
trawler	trawl-er
milliner	mil-li-ner
de-fend-ing	defending
costar	co-star
re-strain-ing	restraining
parox-ysm	par-ox-ysm
pantry	pan-try
em-bell-ish	em-bel-lish
corny	corn-y
habit	hab-it
com-press-ibil-i-ty	com-pres-si-bil-i-ty
block-buster	block-bust-er
testis	tes-tis
deism	de-ism
spin-naker	spin-na-ker
dis-parag-ing	dis-par-ag-ing
uni-tary	u-ni-tar-y
ar-bi-trary	ar-bi-trar-y
or-di-nary	or-di-nar-y
pep-pered	peppered
preach-ing	preaching
untest-ed	un-test-ed
demon-stra-tive	de-mon-stra-tive
sitar	si-tar
cam-era-man	cam-er-a-man
elect	e-lect
avail-able	a-vail-a-ble
con-cil-ia-tor	con-cil-i-a-tor
itin-er-ant	i-tin-er-ant
di-atom-ic	di-a-tom-ic
un-govern-able	un-gov-ern-a-ble
any-way	an-y-way
erot-i-ca	e-rot-i-ca
aslant	a-slant
ouster	oust-er
stovepipe	stove-pipe
lu-natic	lu-na-tic
mar-riage-able	mar-riage-a-ble
motile	mo-tile
baroque	ba-roque
cata-ton-ic	cat-a-ton-ic
elec-toral	e-lec-tor-al
java	ja-va
prairie	prai-rie
sun-flower	sun-flow-er
so-cio-bi-ol-o-gy	so-ci-o-bi-ol-o-gy
doyen	doy-en
di-alect	di-a-lect
puree	pu-ree
bac-carat	bac-ca-rat
fidu-cia-ry	fi-du-ci-ar-y
voyeuris-tic	voy-eur-is-tic
spark-ly	spar-kly
singsong	sing-song
moraine	mo-raine
com-paction	com-pac-tion
sinewy	sin-ew-y
spooky	spook-y
elec-tro-mo-tive	e-lec-tro-mo-tive
wardrobe	ward-robe
beach-comber	beach-comb-er
be-liev-able	be-liev-a-ble
liq-uida-tor	liq-ui-da-tor
va-pid	vap-id
ecol-o-gy	e-col-o-gy
laugh-ably	laugh-a-bly
med-i-c-i-nal	me-dic-i-nal
colo-nial-ism	co-lo-ni-al-ism
con-sid-er-ably	con-sid-er-a-bly
chamois	cham-ois
lira	li-ra
serai	se-ra-i
hooli-gan	hoo-li-gan
elu-ci-date	e-lu-ci-date
wolfish	wolf-ish
penu-ri-ous	pe-nu-ri-ous
paci-fist	pac-i-fist
wringer	wring-er
the-atri-cals	the-at-ri-cals
ho-n-our	ho-nour
aban-don-ment	a-ban-don-ment
sander	sand-er
brava-do	bra-va-do
show-ery	show-er-y
so-ci-ety	so-ci-e-ty
triathlon	tri-ath-lon
navel	na-vel
patchy	patch-y
heavy-weight	heav-y-weight
flus-tered	flustered
cus-tody	cus-to-dy
un-ap-pre-cia-tive	un-ap-pre-ci-a-tive
boron	bo-ron
yeasty	yeast-y
procla-ma-tion	proc-la-ma-tion
sub-mersible	sub-mers-i-ble
on-ag-er	on-a-ger
im-mea-sur-ably	im-meas-ur-a-bly
arabesque	ar-a-besque
jeop-ardy	jeop-ard-y
in-ex-plic-a-ble	in-ex-pli-ca-ble
pro-pri-etary	pro-pri-e-tar-y
the-o-reti-cian	the-o-re-ti-cian
loutish	lout-ish
scathing	scath-ing
reaper	reap-er
penal-ty	pen-al-ty
pen-i-ten-tiary	pen-i-ten-tia-ry
over-due	o-ver-due
lino	li-no
filmic	film-ic
there-upon	there-up-on
in-sis-tence	in-sist-ence
tithing	tith-ing
citadel	cit-a-del
turn-about	turn-a-bout
drap-ery	dra-per-y
kilo-hertz	kil-o-hertz
chloro-phyll	chlo-ro-phyll
ve-loci-pede	ve-loc-i-pede
gal-vanome-ter	gal-va-nom-e-ter
pread-o-les-cent	pre-ad-o-les-cent
plen-teous	plen-te-ous
felo-nious	fe-lo-ni-ous
guardian-ship	guard-i-an-ship
te-dious	te-di-ous
bulky	bulk-y
ten-able	ten-a-ble
litur-gi-cal	li-tur-gi-cal
protest	pro-test
chirpy	chirp-y
hereto-fore	here-to-fore
over-lay	o-ver-lay
refu-ta-tion	ref-u-ta-tion
ghana	ghana
crys-talline	crys-tal-line
re-li-ably	re-li-a-bly
inat-ten-tive	in-at-ten-tive
pome-lo	pom-e-lo
arise	a-rise
trashy	trash-y
vari-ant	var-i-ant
con-nivance	con-niv-ance
eigen-val-ue	ei-gen-val-ue
man-i-cured	ma-ni-cured
clement	clem-ent
necrop-o-lis	ne-crop-o-lis
tuna	tu-na
sickbed	sick-bed
su-per-posed	superposed
forepaw	fore-paw
equip	e-quip
peanut	pea-nut
umpteenth	ump-teenth
thiev-ery	thiev-er-y
lounger	loung-er
in-frared	in-fra-red
steadi-ly	stead-i-ly
mo-men-tary	mo-men-tar-y
legged	leg-ged
pi-caresque	pic-a-resque
dactyl	dac-tyl
as-cetic	as-cet-ic
heater	heat-er
plucky	pluck-y
torus	to-rus
ran-corous	ran-cor-ous
hero	he-ro
her-bi-cide	herb-i-cide
puma	pu-ma
con-demned	condemned
de-f-i-n-i-tion	def-i-ni-tion
dero-gate	der-o-gate
di-etit-ian	di-e-ti-tian
over-staffed	overstaffed
de-r-ate	de-rate
painful	pain-ful
remap	re-map
reti-nal	ret-i-nal
par-alin-guis-tic	par-a-lin-guis-tic
com-pelling	com-pel-ling
genus	ge-nus
tsetse	tset-se
vivi-sec-tion	viv-i-sec-tion
equa-tion	e-qua-tion
ge-nial	ge-ni-al
bal-cony	bal-co-ny
ap-palling-ly	ap-pall-ing-ly
sec-ondary	sec-ond-ar-y
episode	ep-i-sode
pal-lia-tive	pal-li-a-tive
velo-drome	ve-lo-drome
tur-bocharged	turbocharged
pic-turesque	pic-tur-esque
malaise	ma-laise
gig-gling	giggling
crin-kled	crinkled
em-bryo	em-bry-o
want-i-ng	want-ing
teacup	tea-cup
gazette	ga-zette
gravy	gra-vy
cyclic	cy-clic
lin-gerie	lin-ge-rie
elec-tive	e-lec-tive
cam-era	cam-er-a
trigonom-e-try	trig-o-nom-e-try
di-lata-tion	dil-a-ta-tion
periscope	per-i-scope
showjumpers	show-jum-pers
geyser	gey-ser
macaque	ma-caque
apos-to-late	a-pos-to-late
cryo-stat	cry-o-stat
lemur	le-mur
es-tu-ary	es-tu-ar-y
undy-ing	un-dy-ing
foolscap	fools-cap
lop-sided	lop-sid-ed
fever	fe-ver
celi-bate	cel-i-bate
lifeboat	life-boat
cetacean	ce-ta-cean
car-dio-vas-cu-lar	car-di-o-vas-cu-lar
copy	cop-y
poky	pok-y
bar-barism	bar-ba-rism
haver-ing	ha-ve-ring
deduct	de-duct
trade-marked	trademarked
tri-maran	tri-ma-ran
reval-ue	re-val-ue
dishy	dish-y
poly-mor-phous	pol-y-mor-phous
zeta	ze-ta
crispy	crisp-y
de-posi-tary	de-pos-i-tar-y
revenant	rev-e-nant
adopt	a-dopt
scoundrel	scoun-drel
glyc-erol	glyc-er-ol
bub-blegum	bub-ble-gum
de-tectable	de-tect-a-ble
heraldic	he-ral-dic
in-ter-atom-ic	in-ter-a-tom-ic
dandy	dan-dy
streaky	streak-y
un-cre-ative	un-cre-a-tive
stu-dio	stu-di-o
mantrap	man-trap
hexa-ne	hex-ane
dodgy	dodg-y
va-sec-to-my	vas-ec-to-my
boathouse	boat-house
inane	in-ane
di-alec-ti-cal	di-a-lec-ti-cal
re-new-able	re-new-a-ble
preda-tor	pred-a-tor
evo-ca-tion	ev-o-ca-tion
amazed	a-mazed
footage	foot-age
up-lift-ed	uplifted
over-land	o-ver-land
eject	e-ject
record-ed	re-cor-ded
cedil-la	ce-dil-la
mus-ke-teer	mus-ket-eer
en-er-getic	en-er-get-ic
overuse	o-ver-use
high-lander	high-lan-der
over-state-ment	o-ver-state-ment
treach-ery	treach-er-y
ob-tain-able	ob-tain-a-ble
col-lec-tivism	col-lec-tiv-ism
blud-geon	bludg-eon
onus	o-nus
evanes-cent	ev-a-nes-cent
fre-quent-ed	frequented
mit-i-gat-ing	mitigating
hy-per-boloid	hy-per-bo-loid
in-vari-ant	in-var-i-ant
tri-adic	tri-ad-ic
un-re-cov-er-able	un-re-cov-er-a-ble
pesky	pes-ky
over-whelm	o-ver-whelm
hosepipe	hose-pipe
frontal	fron-tal
eval-u-a-tion	e-val-u-a-tion
elite	e-lite
fibu-la	fib-u-la
meaty	meat-y
fatu-ous	fat-u-ous
sim-u-lacrum	sim-u-la-crum
con-formable	con-form-a-ble
cochlea	coch-le-a
mythol-o-gy	my-thol-o-gy
wari-ness	war-i-ness
de-bauch-ery	de-bauch-er-y
over-all	o-ver-all
cheva-lier	chev-a-lier
choco-late	choc-o-late
risky	risk-y
crisply	crisp-ly
catchy	catch-y
tele-o-log-i-cal	tel-e-o-log-i-cal
mar-itime	mar-i-time
ex-oskele-ton	ex-o-skel-e-ton
in-hala-tion	in-ha-la-tion
forest-ed	forested
dis-obey	dis-o-bey
reap-pear	re-ap-pear
epi-der-mis	ep-i-der-mis
cloa-ca	clo-a-ca
naked	na-ked
laud-ed	lauded
satirist	sat-i-rist
un-com-fort-able	un-com-fort-a-ble
forty	for-ty
loathing	loath-ing
pic-to-r-i-al	pic-to-ri-al
in-jury	in-ju-ry
both-ered	bothered
newslet-ter	news-let-ter
im-politic	im-pol-i-tic
valise	va-lise
baguette	ba-guette
gan-g-ly	gan-gly
squally	squal-ly
over-am-bi-tious	o-ver-am-bi-tious
paving	pav-ing
hy-dro-sta-t-ics	hy-dro-stat-ics
equidis-tant	e-qui-dis-tant
pipette	pi-pette
un-quench-able	un-quench-a-ble
com-pen-sato-ry	com-pen-sa-to-ry
in-com-bustible	in-com-bus-ti-ble
monog-a-mous	mo-nog-a-mous
aplen-ty	a-plen-ty
raven-ing	rav-en-ing
iso-sta-t-ic	i-so-stat-ic
stipen-di-ary	sti-pen-di-ar-y
hos-pitable	hos-pi-ta-ble
ra-tio-nal	ra-tion-al
spi-dery	spi-der-y
pronom-i-nal	pro-nom-i-nal
takeover	take-o-ver
pro-tec-torate	pro-tec-tor-ate
lever-age	lev-er-age
un-ob-jec-tion-able	un-ob-jec-tion-a-ble
limekiln	lime-kiln
silent	si-lent
crafty	craft-y
necrophil-ia	nec-ro-phil-i-a
aro-mat-ic	ar-o-mat-ic
zenith	ze-nith
com-muter	com-mut-er
col-lapsi-ble	col-laps-i-ble
scraper	scrap-er
scratchy	scratch-y
nifty	nif-ty
nineti-eth	nine-ti-eth
ar-rester	ar-rest-er
au-dio-vi-su-al	au-di-o-vis-u-al
dis-in-fec-tant	dis-in-fect-ant
impi-ety	im-pi-e-ty
tremo-lo	trem-o-lo
de-brief-ing	debriefing
scholas-ti-cism	scho-las-ti-cism
postlude	post-lude
rein-car-na-tion	re-in-car-na-tion
gad-getry	gadg-et-ry
meta-phys-i-cal	met-a-phys-i-cal
hearsay	hear-say
dumpy	dump-y
rosy	ros-y
troglodyte	trog-lo-dyte
scullery	scul-ler-y
pauci-ty	pau-ci-ty
vari-a-tion	var-i-a-tion
para-nor-mal	par-a-nor-mal
etui	e-tui
pig-ment-ed	pig-men-ted
event-ful	e-vent-ful
prowess	prow-ess
serendip-i-tous	ser-en-dip-i-tous
co-conut	co-co-nut
retic-u-lar	re-tic-u-lar
stony	ston-y
zealotry	zeal-ot-ry
para-med-ical	par-a-med-i-cal
psalmody	psal-mo-dy
penknife	pen-knife
monau-r-al	mon-au-ral
mealie	meal-ie
bil-iary	bil-i-ar-y
labyrinth	lab-y-rinth
li-brary	li-brar-y
im-pe-cu-nious	im-pe-cu-ni-ous
in-ter-vie-wee	in-ter-view-ee
uni-lat-er-al	u-ni-lat-er-al
un-re-pen-tant	un-re-pent-ant
turquoise	tur-quoise
ex-tend-able	ex-tend-a-ble
turfy	turf-y
over-tone	o-ver-tone
er-gonom-ic	er-go-nom-ic
rock-ing	rocking
ini-ti-a-tion	in-i-ti-a-tion
man-telshelf	man-tel-shelf
valid	val-id
marcher	march-er
dauphin	dau-phin
mod-ernist	mod-ern-ist
util-i-ty	u-til-i-ty
dy-namo	dy-na-mo
kinder-garten	kin-der-gar-ten
pekan	pek-an
pow-dery	pow-der-y
si-nu-soidal	si-nus-oi-dal
eleven	e-lev-en
mono-chro-mat-ic	mon-o-chro-mat-ic
handy	hand-y
iso-mer	i-so-mer
emu	e-mu
lousy	lous-y
lamb-swool	lambs-wool
con-ser-v-a-tive	con-serv-a-tive
grouper	group-er
syl-labub	syl-la-bub
con-sid-er-able	con-sid-er-a-ble
warpath	war-path
roulette	rou-lette
do-lor-ous	dol-or-ous
preser-v-a-tive	pre-serv-a-tive
elu-sive	e-lu-sive
sweaty	sweat-y
in-audi-ble	in-au-di-ble
rein-sert	re-in-sert
reshow	re-show
min-uet	min-u-et
habi-tat	hab-i-tat
backer	back-er
perquisite	per-qui-site
cesspit	cess-pit
un-der-stand-able	un-der-stand-a-ble
wa-tery	wa-ter-y
caviar	cav-i-ar
ini-tial	in-i-tial
lethar-gy	leth-ar-gy
ob-jec-tion-able	ob-jec-tion-a-ble
ni-hilis-tic	ni-hil-is-tic
key-boardist	key-board-ist
enun-ci-ate	e-nun-ci-ate
over-hand	o-ver-hand
mayflower	may-flow-er
plushy	plush-y
cen-tripetal	cen-trip-e-tal
kinswoman	kins-wom-an
friendlily	friend-li-ly
im-pressed	impressed
in-clement	in-clem-ent
salin-i-ty	sa-lin-i-ty
islet	is-let
stapes	sta-pes
foot-balling	foot-ball-ing
in-deli-ble	in-del-i-ble
over-work	o-ver-work
mer-chantable	mer-chant-a-ble
para-medic	par-a-med-ic
styling	styl-ing
ex-plorato-ry	ex-plor-a-to-ry
orig-i-nal	o-rig-i-nal
tri-umvi-rate	tri-um-vi-rate
pro-tean	pro-te-an
leisure-ly	lei-sure-ly
reci-procity	rec-i-proc-i-ty
over-draw	o-ver-draw
tepid	tep-id
fly-away	fly-a-way
rapid	rap-id
apos-tolic	ap-os-tol-ic
purist	pur-ist
stetho-scope	steth-o-scope
squalor	squal-or
unit-ed	u-nit-ed
mo-nop-oly	mo-nop-o-ly
ovoid	o-void
en-joy-ably	en-joy-a-bly
backgam-mon	back-gam-mon
hideous	hid-e-ous
innkeep-er	inn-keep-er
mar-quetry	mar-que-try
nympho-ma-ni-ac	nym-pho-ma-ni-ac
re-tiree	re-tir-ee
defy	de-fy
glos-sary	glos-sa-ry
ap-proach-able	ap-proach-a-ble
monastery	mon-as-ter-y
syn-ovial	syn-o-vi-al
samovar	sam-o-var
gelatin	gel-a-tin
patho-gen-e-sis	path-o-gen-e-sis
pep-pery	pep-per-y
lava-to-r-i-al	lav-a-to-ri-al
ex-che-quer	ex-cheq-uer
mufti	muf-ti
repet-i-tive	re-pet-i-tive
prepo-si-tion-al	prep-o-si-tion-al
idly	i-dly
reis-sue	re-is-sue
en-thalpy	en-thal-py
no-madic	no-mad-ic
opales-cent	o-pal-es-cent
ranter	rant-er
wavelet	wave-let
sari	sa-ri
impi	im-pi
sniff-ing	sniffing
welly	wel-ly
im-ple-menter	im-ple-ment-er
dowdy	dow-dy
cog-nizance	cog-ni-zance
unin-sur-able	un-in-sur-a-ble
irate	i-rate
un-aware	un-a-ware
un-handy	un-hand-y
groundswell	ground-swell
ra-tio-nal-ly	ra-tion-al-ly
curly	curl-y
nonethe-less	none-the-less
prophet-ic	pro-phet-ic
ter-ri-to-r-i-al	ter-ri-to-ri-al
asym-me-try	a-sym-me-try
fid-get	fidg-et
min-der	mind-er
lentil	len-til
there-after	there-af-ter
reper-cus-sion	re-per-cus-sion
awak-en	a-wak-en
frat-ri-ci-dal	frat-ri-cid-al
elec-table	e-lect-a-ble
dri-ver-less	driv-er-less
rosette	ro-sette
ver-bosi-ty	ver-bos-i-ty
neu-ro-surgery	neu-ro-sur-ger-y
par-si-mo-nious	par-si-mo-ni-ous
de-sir-abil-ia	de-si-ra-bi-li-a
anonymi-ty	an-o-nym-i-ty
funky	funk-y
billing	bil-ling
dullard	dull-ard
poem	po-em
in-famy	in-fa-my
de-ter-minable	de-ter-mi-na-ble
igloo	ig-loo
hy-dropho-bic	hy-dro-pho-bic
eclec-tic	ec-lec-tic
em-ploy-able	em-ploy-a-ble
sup-ple-men-tary	sup-ple-men-ta-ry
pur-suer	pur-su-er
sana-to-ri-um	san-a-to-ri-um
om-nipres-ence	om-ni-pres-ence
illiq-uid	il-liq-uid
choral	cho-ral
anom-aly	a-nom-a-ly
ex-tralin-guis-tic	ex-tra-lin-guis-tic
welling-ton	wel-ling-ton
cheer-leader	cheer-lead-er
restora-tion	res-to-ra-tion
take-away	take-a-way
non-con-formist	non-con-form-ist
panties	pant-ies
despot	des-pot
over-growth	o-ver-growth
woodsmoke	wood-smoke
litotes	li-to-tes
builder	build-er
hexa-dec-i-mal	hex-a-dec-i-mal
coma	co-ma
alive	a-live
toi-letries	toi-let-ries
bar-barous	bar-ba-rous
wildlife	wild-life
man-age-able	man-age-a-ble
tubu-lar	tu-bu-lar
loaded	load-ed
mildewy	mil-dew-y
click-ing	clicking
epis-co-pal	e-pis-co-pal
lap-idary	lap-i-dar-y
casi-no	ca-si-no
twitchy	twitch-y
pullover	pull-o-ver
idyl-lic	i-dyl-lic
sushi	su-shi
cru-cible	cru-ci-ble
crooked	crook-ed
pre-dictabil-i-ty	pre-dict-a-bil-i-ty
dogs-body	dogs-bod-y
iso-topic	i-so-top-ic
dinky	dink-y
util-i-tar-i-an	u-til-i-tar-i-an
un-re-served-ly	un-re-serv-ed-ly
palat-able	pal-at-a-ble
tiger-ish	ti-ger-ish
in-eluctable	in-e-luc-ta-ble
be-wil-der-ing	bewildering
man-dolin	man-do-lin
taskmas-ter	task-mas-ter
evince	e-vince
unloved	un-loved
tuba	tu-ba
cryo-genic	cry-o-gen-ic
phrenol-o-gy	phre-nol-o-gy
mono-pole	mon-o-pole
head-mistress	head-mis-tress
ver-biage	ver-bi-age
aor-ta	a-or-ta
in-hos-pitable	in-hos-pi-ta-ble
lion	li-on
rub-bishy	rub-bish-y
lusty	lust-y
tran-scen-dent	tran-scend-ent
es-capee	es-cap-ee
garbage	gar-bage
deca-dence	dec-a-dence
lamp-lighter	lamp-light-er
in-valu-able	in-val-u-a-ble
dri-ve-way	drive-way
trea-son-able	trea-son-a-ble
de-ity	de-i-ty
rhodi-um	rho-di-um
sprayer	spray-er
ringer	ring-er
boohoo	boo-hoo
ur-ticaria	ur-ti-car-i-a
taster	tast-er
elim-i-na-tion	e-lim-i-na-tion
de-odor-ant	de-o-dor-ant
flood-ing	flooding
de-nial	de-ni-al
hayloft	hay-loft
at-tribu-tive	at-trib-u-tive
avail-abil-i-ty	a-vail-a-bil-i-ty
bios-phere	bi-o-sphere
re-sis-tance	re-sist-ance
shogun	sho-gun
iso-bar	i-so-bar
re-assess-ment	re-as-sess-ment
stew-ardess	stew-ard-ess
over-charge	o-ver-charge
testy	tes-ty
tacho-graph	tach-o-graph
flautist	flau-tist
ca-ma-raderie	ca-ma-ra-de-rie
un-nerv-ing	unnerving
lisp-ing	lis-ping
joey	jo-ey
ship-builder	ship-build-er
solemn	sol-emn
reshuf-fle	re-shuf-fle
cele-ri-ac	ce-ler-i-ac
mul-ti-proces-sor	mul-ti-proc-es-sor
lessee	les-see
grenadier	gren-a-dier
squeaky	squeak-y
evic-tion	e-vic-tion
canon-i-cal	ca-non-i-cal
brigade	bri-gade
buffer	buff-er
over-sight	o-ver-sight
over-heat	o-ver-heat
ibis	i-bis
qua-drat-ic	quad-rat-ic
arach-nid	a-rach-nid
melo-dra-mat-ic	mel-o-dra-mat-ic
puerile	pu-er-ile
mata-dor	mat-a-dor
conker	conk-er
drifter	drift-er
over-loaded	overloaded
bio-met-rics	bi-o-met-rics
macaw	ma-caw
bal-alai-ka	bal-a-lai-ka
fet-tered	fettered
ide-al-ism	i-de-al-ism
em-ployed	employed
emo-tion	e-mo-tion
apolo-getic	a-pol-o-get-ic
dri-vable	driv-a-ble
resid-ual	re-sid-u-al
retroac-tive-ly	ret-ro-ac-tive-ly
egal-i-tar-i-an-ism	e-gal-i-tar-i-an-ism
mi-croor-gan-ism	mi-cro-or-gan-ism
lament-ed	la-ment-ed
odi-um	o-di-um
auburn	au-burn
busi-ness-woman	busi-ness-wom-an
in-ter-roga-tor	in-ter-ro-ga-tor
quest-ing	questing
geome-ter	ge-om-e-ter
an-thracite	an-thra-cite
eclec-ti-cism	ec-lec-ti-cism
wall-flower	wall-flow-er
macro-scop-ic	mac-ro-scop-ic
mis-sion-ary	mis-sion-ar-y
poly-ester	pol-y-es-ter
saline	sa-line
uten-sil	u-ten-sil
in-dis-putable	in-dis-put-a-ble
ple-nary	ple-na-ry
sonorous	so-no-rous
merid-i-an	me-rid-i-an
diode	di-ode
clin-i-cian	cli-ni-cian
wash-er-woman	wash-er-wom-an
ru-inous	ru-in-ous
unchris-t-ian	un-chris-tian
pesti-lent	pes-ti-lent
nitwit	nit-wit
tonal-i-ty	to-nal-i-ty
un-al-ter-able	un-al-ter-a-ble
lessen	less-en
om-ni-science	om-nis-cience
in-spec-torate	in-spec-tor-ate
serene-ly	se-rene-ly
biosyn-the-sis	bi-o-syn-the-sis
method-olog-i-cal	meth-od-o-log-i-cal
geno-ci-dal	gen-o-cid-al
chrono-log-i-cal-ly	chron-o-log-i-cal-ly
ex-plo-ration	ex-plo-ra-tion
polyp	pol-yp
hooray	hoo-ray
bailout	bail-out
sycamore	syc-a-more
whoso-ev-er	who-so-ev-er
cola	co-la
melod-ic	me-lod-ic
iso-mor-phic	i-so-mor-phic
spec-troscopy	spec-tros-co-py
puer-per-al	pu-er-per-al
plat-inum	plat-i-num
in-com-men-su-rable	in-com-men-su-ra-ble
tri-bune	trib-une
sinker	sink-er
in-evitabil-i-ty	in-ev-i-ta-bil-i-ty
signet	sig-net
saucepan	sauce-pan
skua	sku-a
ex-tra-or-di-nary	ex-traor-di-nar-y
per-ineum	per-i-ne-um
gulli-bil-i-ty	gul-li-bil-i-ty
auger	au-ger
methanol	meth-a-nol
trilin-gual	tri-lin-gual
gyro	gy-ro
paci-fism	pac-i-fism
maser	ma-ser
myelin	my-e-lin
tro-pos-phere	trop-o-sphere
bul-gy	bulg-y
erot-ic	e-rot-ic
or-ga-ni-za-tion	or-gan-i-za-tion
ax-olotl	ax-o-lotl
uni-ver-sal-ist	u-ni-ver-sal-ist
en-cycli-cal	en-cyc-li-cal
il-menite	il-men-ite
necro-man-cy	nec-ro-man-cy
un-drink-able	un-drink-a-ble
over-time	o-ver-time
as-tronomer	as-tron-o-mer
awning	awn-ing
colan-der	col-an-der
over-writ-ing	overwriting
un-pro-nounce-able	un-pro-nounce-a-ble
for-giv-able	for-giv-a-ble
con-sul-tan-cy	con-sult-an-cy
eosin	e-o-sin
baby	ba-by
cos-set-ed	cosseted
potable	po-ta-ble
apoplexy	ap-o-plex-y
ri-fled	rifled
rec-ti-lin-ear	rec-ti-lin-e-ar
thinker	think-er
pri-apic	pri-ap-ic
novice	nov-ice
sawyer	saw-yer
bel-liger-ence	bel-lig-er-ence
radish	rad-ish
mil-i-taris-tic	mil-i-ta-ris-tic
re-al-ness	real-ness
brioche	bri-oche
leapfrog	leap-frog
petrol-o-gy	pe-trol-o-gy
su-perbly	su-perb-ly
un-trans-lat-able	un-trans-lat-a-ble
om-nipresent	om-ni-pres-ent
sloven-ly	slov-en-ly
echo	ech-o
pes-simistic	pes-si-mis-tic
ra-dia-tive	ra-di-a-tive
equiv-o-ca-tion	e-quiv-o-ca-tion
su-per-fluity	su-per-flu-i-ty
bur-geon-ing	burgeoning
un-change-able	un-change-a-ble
con-for-mance	con-form-ance
apolo-gia	ap-o-lo-gi-a
en-fee-bled	enfeebled
fri-able	fri-a-ble
re-open	re-o-pen
over-state	o-ver-state
tequi-la	te-qui-la
retest	re-test
pan-das	pan-das
malev-o-lent	ma-lev-o-lent
grouchy	grouch-y
stat-uette	stat-u-ette
he-lios-phere	he-li-o-sphere
itchy	itch-y
mendele-vi-um	men-de-le-vi-um
dry-s-tone	dry-stone
judo	ju-do
over-ripe	o-ver-ripe
euro	eu-ro
calorime-ter	cal-o-rim-e-ter
hy-drother-mal	hy-dro-ther-mal
idol-a-trous	i-dol-a-trous
he-li-copter	hel-i-cop-ter
medal	med-al
psy-cho-analy-sis	psy-cho-a-nal-y-sis
seabird	sea-bird
mis-nomer	mis-no-mer
mul-ti-me-dia	mul-ti-me-di-a
thread-ed	threaded
whistler	whis-tler
dentin	den-tin
ho-mo-ge-neous	ho-mo-ge-ne-ous
pleas-antry	pleas-ant-ry
op-ti-mistic	op-ti-mis-tic
desert	de-sert
menar-che	men-ar-che
ir-re-solv-able	ir-re-solv-a-ble
phooey	phoo-ey
im-per-ish-able	im-per-ish-a-ble
surfer	surf-er
tri-umphant-ly	tri-um-phant-ly
na-iad	nai-ad
galleon	gal-le-on
mil-i-tary	mil-i-tar-y
waxy	wax-y
steeple-jack	stee-ple-jack
polyun-sat-u-rat-ed	pol-y-un-sat-u-rat-ed
salu-tary	sal-u-tar-y
steamship	steam-ship
ide-o-logue	i-de-o-logue
de-vour-ing	devouring
halo	ha-lo
em-piri-cist	em-pir-i-cist
haystack	hay-stack
in-ex-cus-able	in-ex-cus-a-ble
pen-tathlon	pen-tath-lon
sporty	sport-y
hireling	hire-ling
in-con-gruity	in-con-gru-i-ty
squadron	squad-ron
lemon-ade	lem-on-ade
kneecap	knee-cap
mucky	muck-y
as-segai	as-se-gai
eon	e-on
cre-ative-ly	cre-a-tive-ly
upon	up-on
mazur-ka	ma-zur-ka
hys-terec-to-my	hys-ter-ec-to-my
manslaugh-ter	man-slaugh-ter
avun-cu-lar	a-vun-cu-lar
cashew	cash-ew
gumshoe	gum-shoe
pa-ra-me-ter	pa-ram-e-ter
endgame	end-game
rhetoric	rhet-o-ric
avid-ly	av-id-ly
ho-mo-pho-bia	ho-mo-pho-bi-a
twister	twist-er
fuse-lage	fu-se-lage
ep-ithe-li-um	ep-i-the-li-um
ha-track	hat-rack
limo	lim-o
barter	bar-ter
holdall	hold-all
break-able	break-a-ble
fever-ish	fe-ver-ish
ref-er-ee-ing	re-fe-ree-ing
busi-ly	bus-i-ly
per-mit-ting	permitting
gatepost	gate-post
eter-nal	e-ter-nal
re-minder	re-mind-er
reclu-sive	re-clu-sive
re-uni-fi-ca-tion	re-u-ni-fi-ca-tion
posse	pos-se
in-vesti-ture	in-ves-ti-ture
sol-diery	sol-dier-y
teleprint-er	tel-e-print-er
naval	na-val
tri-umphal	tri-um-phal
donor	do-nor
hoary	hoar-y
un-easi-ly	un-eas-i-ly
hul-la-baloo	hul-la-ba-loo
winger	wing-er
ma-hogany	ma-hog-a-ny
every	eve-ry
breathy	breath-y
erec-tile	e-rec-tile
poet	po-et
re-place-able	re-place-a-ble
cin-e-matog-ra-ph-er	cin-e-ma-tog-ra-pher
cyanide	cy-a-nide
sphyg-mo-manome-ter	sphyg-mo-ma-nom-e-ter
dis-heart-ened	dis-hear-tened
codex	co-dex
colonic	co-lon-ic
char-woman	char-wom-an
ty-pog-ra-phers	ty-po-gra-phers
squirearchy	squire-ar-chy
chromite	chro-mite
hypochon-dri-a-cal	hy-po-chon-dri-a-cal
sagac-i-ty	sa-gac-i-ty
mono-plane	mon-o-plane
kilo-byte	kil-o-byte
op-por-tunism	op-por-tun-ism
mono-logue	mon-o-logue
damnable	dam-na-ble
ra-di-og-ra-ph-er	ra-di-og-ra-pher
net-work-ing	networking
spaghet-ti	spa-ghet-ti
pedi-gree	ped-i-gree
seascape	sea-scape
of-fend-ing	of-fen-ding
pro-ba-tion-ary	pro-ba-tion-ar-y
event-ing	e-vent-ing
monar-chy	mon-ar-chy
aor-tic	a-or-tic
icon	i-con
framer	fram-er
in-quisi-tor	in-quis-i-tor
dim-pled	dimpled
marshy	marsh-y
con-fec-tionery	con-fec-tion-er-y
dark-ened	dar-kened
ptarmi-gan	ptar-mi-gan
semi-cir-cle	sem-i-cir-cle
evade	e-vade
chronol-o-gy	chro-nol-o-gy
sanc-tu-ary	sanc-tu-ar-y
blis-tered	blistered
bougainvil-lea	bou-gain-vil-le-a
arrange-ment	ar-range-ment
arouse	a-rouse
mono-lay-er	mon-o-lay-er
bologna	bo-lo-gna
anom-alous	a-nom-a-lous
handrail	hand-rail
speller	spell-er
poly-no-mi-al	pol-y-no-mi-al
clover	clo-ver
brochure	bro-chure
retroac-tive	ret-ro-ac-tive
vestibu-lar	ves-tib-u-lar
cack-ling	cackling
silage	si-lage
aria	a-ri-a
swarm-ing	swarming
slip-pery	slip-per-y
steeple-chase	stee-ple-chase
styrene	sty-rene
her-itage	her-it-age
gluti-nous	glu-ti-nous
ju-rispru-dence	ju-ris-pru-dence
obe-di-ence	o-be-di-ence
whiskey	whis-key
mer-cury	mer-cu-ry
car-bonyl	car-bon-yl
un-awak-ened	un-a-wak-ened
trumpery	trump-er-y
in-fect-ed	in-fec-ted
para-graph	par-a-graph
swishy	swish-y
over-flow	o-ver-flow
anteater	ant-eat-er
olive	ol-ive
steno-sis	ste-no-sis
think-able	think-a-ble
platelet	plate-let
uni-son	u-ni-son
un-prece-dent-ed	un-prec-e-dent-ed
quadri-lat-er-al	quad-ri-lat-er-al
presto	pres-to
brinkman-ship	brink-man-ship
place-bo	pla-ce-bo
anx-i-ety	anx-i-e-ty
elec-trol-y-sis	e-lec-trol-y-sis
usurer	u-su-rer
ripen	rip-en
bivouac	biv-ou-ac
erode	e-rode
provoca-tive-ly	pro-voc-a-tive-ly
golfer	golf-er
reac-qui-si-tion	re-ac-qui-si-tion
coast-ing	coasting
un-ortho-doxy	un-or-tho-dox-y
jus-ti-fi-ably	jus-ti-fi-a-bly
un-think-able	un-think-a-ble
posthu-mous	post-hu-mous
para-keet	par-a-keet
un-com-mu-nica-tive	un-com-mu-ni-ca-tive
mys-tery	mys-ter-y
hardy	har-dy
racial-ly	ra-cial-ly
kudu	ku-du
hookah	hook-ah
re-cruiter	re-cruit-er
pre-sum-ably	pre-sum-a-bly
over-in-flat-ed	o-ver-in-flat-ed
ethno-graph-ic	eth-no-graph-ic
mer-ce-nary	mer-ce-nar-y
spir-i-tu-al-ist	spir-it-u-al-ist
de-con-struc-tive	deconstructive
di-elec-tric	di-e-lec-tric
en-hancer	en-hanc-er
flinty	flint-y
re-spectabil-i-ty	re-spect-a-bil-i-ty
ego-tist	e-go-tist
baobab	ba-o-bab
bases	ba-ses
tusker	tusk-er
hawthorn	haw-thorn
flutist	flut-ist
re-freshed	refreshed
aside	a-side
spir-i-tu-al-ism	spir-it-u-al-ism
syl-labary	syl-la-bar-y
straight-away	straight-a-way
on-tol-ogy	on-tol-o-gy
heady	head-y
mistype	mis-type
in-abil-i-ty	in-a-bil-i-ty
spir-i-tu-al	spir-it-u-al
eval-u-a-tor	e-val-u-a-tor
iris	i-ris
ma-nia	ma-ni-a
shoplift	shop-lift
cretinous	cre-tin-ous
dis-avow	dis-a-vow
in-fini-tive	in-fin-i-tive
con-for-mi-ty	con-form-i-ty
par-lia-men-tary	par-lia-men-ta-ry
el-e-men-tary	el-e-men-ta-ry
cat-a-stro-phe	ca-tas-tro-phe
claret	clar-et
lectern	lec-tern
lin-ear-ly	lin-e-ar-ly
denizen	den-i-zen
iron-stone	i-ron-stone
gallery	gal-ler-y
gim-micky	gim-mick-y
furtive-ly	fur-tive-ly
ne-go-tiable	ne-go-ti-a-ble
as-sailant	as-sail-ant
mist-ime	mis-time
round-about	round-a-bout
diplo-ma	di-plo-ma
be-fud-dled	befuddled
layper-son	lay-per-son
gory	gor-y
moral-is-tic	mor-al-is-tic
gen-eros-i-ty	gen-er-os-i-ty
stoa	sto-a
tonight	to-night
physi-cian	phy-si-cian
stingray	sting-ray
saber	sa-ber
tele-phone	tel-e-phone
evolve	e-volve
gamut	gam-ut
eques-tri-an-ism	e-ques-tri-an-ism
in-con-sis-tent	in-con-sist-ent
cre-ation-ism	cre-a-tion-ism
ab-solute	ab-so-lute
over-run	o-ver-run
playable	play-a-ble
philol-o-gy	phi-lol-o-gy
di-choto-my	di-chot-o-my
so-lic-it-ing	soliciting
un-avoid-able	un-a-void-a-ble
in-ter-galac-tic	in-ter-ga-lac-tic
imag-in-ings	im-ag-in-ings
glasshouse	glass-house
aton-al	a-ton-al
roofer	roof-er
union	un-ion
man-i-festo	man-i-fes-to
over-drive	o-ver-drive
orate	o-rate
phil-an-thropy	phi-lan-thro-py
pom-padour	pom-pa-dour
tele-pho-ny	te-leph-o-ny
in-ter-locu-tor	in-ter-loc-u-tor
an-titrust	an-ti-trust
good-night	goodnight
celandine	cel-an-dine
unan-tic-i-pat-ed	un-an-tic-i-pat-ed
showy	show-y
humbly	hum-bly
reroute	re-route
dizzi-ness	diz-zi-ness
porter-age	por-ter-age
rocky	rock-y
litur-gy	lit-ur-gy
urine	u-rine
sta-tis-ti-cian	stat-is-ti-cian
ex-em-plary	ex-em-pla-ry
aquar-i-um	a-quar-i-um
gateau	ga-teau
de-liv-ery	de-liv-er-y
archivist	ar-chi-vist
mut-ter-ing	muttering
as-cen-der	as-cend-er
pam-phle-teer	pam-phlet-eer
holis-ti-cal-ly	ho-lis-ti-cal-ly
collinear	col-lin-e-ar
wrinkly	wrin-kly
damna-tion	dam-na-tion
stretchy	stretch-y
hang-over	hang-o-ver
en-thralling	en-thral-ling
ine-bri-ate	in-e-bri-ate
dis-tin-guish-able	dis-tin-guish-a-ble
shekel	shek-el
stymie	sty-mie
goody	good-y
fruition	fru-i-tion
reper-to-ry	rep-er-to-ry
cop-pery	cop-per-y
astride	a-stride
overnight	o-ver-night
puffer	puff-er
but-tered	buttered
de-f-i-n-i-tion-al	def-i-ni-tion-al
eigh-teenth	eight-eenth
lulu	lu-lu
pro-pri-etor-ship	pro-pri-e-tor-ship
res-olute-ly	res-o-lute-ly
hobo	ho-bo
crevice	crev-ice
elec-tron-ics	e-lec-tron-ics
de-mo-c-ra-t-ic	dem-o-crat-ic
over-pass	o-ver-pass
uni-fy	u-ni-fy
ar-madil-lo	ar-ma-dil-lo
mores	mo-res
en-chant-i-ng	en-chant-ing
im-per-me-able	im-per-me-a-ble
drama-tist	dram-a-tist
rev-e-la-to-ry	re-vel-a-to-ry
mis-align-ment	mis-a-lign-ment
tint-ed	tinted
tem-pera	tem-per-a
pirou-ette	pir-ou-ette
rogu-ish	ro-guish
lyrist	lyr-ist
bot-tled	bottled
crozi-er	cro-zier
eu-pho-ria	eu-pho-ri-a
lefty	left-y
con-fir-ma-to-ry	con-firm-a-to-ry
aphro-disi-ac	aph-ro-dis-i-ac
mono-cul-ture	mon-o-cul-ture
orig-i-nal-i-ty	o-rig-i-nal-i-ty
plumy	plum-y
un-promis-ing	un-prom-is-ing
deluxe	de-luxe
glaciat-ed	gla-ci-at-ed
colo-nial	co-lo-ni-al
any-thing	an-y-thing
radon	ra-don
phrasal	phras-al
dis-gust-ed	disgusted
evil-do-er	e-vil-do-er
epiphe-nom-e-non	ep-i-phe-nom-e-non
blus-ter-ing	blustering
in-trauter-ine	in-tra-u-ter-ine
busker	busk-er
cre-ative	cre-a-tive
canon-ic	ca-non-ic
tragedy	trag-e-dy
verdi-gris	ver-di-gris
un-abat-ed	un-a-bat-ed
con-tes-tant	con-test-ant
rigid	rig-id
uniden-ti-fied	un-i-den-ti-fied
in-ge-nu-ity	in-ge-nu-i-ty
pe-riphrastic	per-i-phras-tic
ni-troge-nous	ni-trog-e-nous
hindquar-ters	hind-quar-ters
study	stud-y
bur-sary	bur-sa-ry
stocky	stock-y
gloomy	gloom-y
chantry	chan-try
chi-nois-erie	chi-noi-se-rie
athe-ist	a-the-ist
per-me-able	per-me-a-ble
turnover	turn-o-ver
supreme-ly	su-preme-ly
aper-ture	ap-er-ture
cas-sowary	cas-so-war-y
weav-ing	weaving
en-doge-nous	en-dog-e-nous
repar-tee	rep-ar-tee
ex-cel-sior	ex-cel-si-or
thrifty	thrift-y
so-bri-ety	so-bri-e-ty
iron-works	i-ron-works
mod-ernism	mod-ern-ism
equate	e-quate
saga	sa-ga
metaphor	met-a-phor
shiv-er-ing	shivering
provin-cial	pro-vin-cial
sonor-i-ty	so-nor-i-ty
flossy	floss-y
kerosene	ker-o-sene
epis-co-pate	e-pis-co-pate
steril-i-ty	ste-ril-i-ty
iden-ti-fi-ca-tion	i-den-ti-fi-ca-tion
post-mod-ernist	post-mod-ern-ist
herbal-ism	her-bal-ism
du-op-oly	du-op-o-ly
briefer	brief-er
ir-re-press-ible	ir-re-press-i-ble
flashy	flash-y
puni-tive	pu-ni-tive
mighty	might-y
charge-able	charge-a-ble
stripy	strip-y
per-pe-tu-ity	per-pe-tu-i-ty
cen-trifu-gal	cen-trif-u-gal
dodo	do-do
the-atri-cal	the-at-ri-cal
lucky	luck-y
trum-peter	trum-pet-er
newsagent	news-a-gent
pass-ably	pass-a-bly
erad-i-cate	e-rad-i-cate
se-lectee	se-lect-ee
raf-fia	raf-fi-a
punch-line	punchline
rota	ro-ta
lot-tery	lot-ter-y
over-con-fi-dent	o-ver-con-fi-dent
un-sup-port-able	un-sup-port-a-ble
chaffinch	chaf-finch
as-para-gus	as-par-a-gus
si-lencer	si-lenc-er
genre	gen-re
greasy	greas-y
axle	ax-le
dis-obe-di-ence	dis-o-be-di-ence
cerise	ce-rise
equa-nim-i-ty	e-qua-nim-i-ty
glo-be-trot-ting	globe-trot-ting
lusti-ly	lust-i-ly
libero	li-be-ro
epis-tle	e-pis-tle
pyrite	py-rite
deeply	deep-ly
leather	leath-er
shrub-bery	shrub-ber-y
iron-work	i-ron-work
seago-ing	sea-go-ing
phys-io-ther-a-pist	phys-i-o-ther-a-pist
eerie	ee-rie
sibi-lant	sib-i-lant
pro-tease	pro-te-ase
rent-ed	rented
per-mafrost	per-ma-frost
imag-in-able	im-ag-i-na-ble
inca	in-ca
lo-goff	log-off
re-seller	re-sell-er
out-lier	out-li-er
erup-tive	e-rup-tive
rein-car-nate	re-in-car-nate
hostel-ry	hos-tel-ry
cam-panol-o-gy	cam-pa-nol-o-gy
poly-car-bon-ate	pol-y-car-bon-ate
mam-malian	mam-ma-li-an
lyric	lyr-ic
avow	a-vow
en-treaty	en-treat-y
suet	su-et
vizier	vi-zier
flower	flow-er
any-more	an-y-more
sophistry	soph-ist-ry
poros-i-ty	po-ros-i-ty
mono-ma-nia	mon-o-ma-ni-a
ex-pect-ed	expected
blessed-ness	bless-ed-ness
kalei-do-scop-ic	ka-lei-do-scop-ic
mar-chioness	mar-chion-ess
crock-ery	crock-er-y
trans-porta-tion	trans-por-ta-tion
par-tici-ple	par-ti-ci-ple
mini-bar	min-i-bar
geo-syn-chro-nous	ge-o-syn-chro-nous
ba-ro-nial	ba-ro-ni-al
gravedig-ger	grave-dig-ger
lido	li-do
pi-anola	pi-a-no-la
cat-tery	cat-te-ry
preser-va-tion	pres-er-va-tion
sym-po-sium	sym-po-si-um
lifebelt	life-belt
jazzy	jazz-y
iri-des-cent	ir-i-des-cent
ex-trater-res-tri-al	ex-tra-ter-res-tri-al
in-con-testable	in-con-test-a-ble
mag-ne-sium	mag-ne-si-um
macron	ma-cron
hy-draulics	hy-drau-lics
satire	sat-ire
loca-tive	loc-a-tive
un-wary	un-war-y
beanstalk	bean-stalk
rheumat-ic	rheu-mat-ic
uni-ver-sal-ism	u-ni-ver-sal-ism
veg-etable	veg-e-ta-ble
un-proven	un-prov-en
leg-endary	leg-end-ar-y
chan-cellery	chan-cel-ler-y
ap-pendage	ap-pend-age
re-sis-tant	re-sist-ant
res-cuer	res-cu-er
opi-oid	o-pi-oid
elan	e-lan
elec-tron-i-cal-ly	e-lec-tron-i-cal-ly
paci-fi-er	pac-i-fi-er
inar-tic-u-late	in-ar-tic-u-late
cool-ing	cooling
tractable	trac-ta-ble
utopia	u-to-pi-a
in-deco-rous	in-dec-o-rous
os-teopa-thy	os-te-op-a-thy
as-ceti-cism	as-cet-i-cism
unan-swered	un-an-swered
ther-mo-elec-tric	ther-mo-e-lec-tric
mo-tocross	mo-to-cross
moray	mo-ray
ivy	i-vy
item	i-tem
unan-i-mous-ly	u-nan-i-mous-ly
over-tax	o-ver-tax
sil-very	sil-ver-y
ocean	o-cean
residue	res-i-due
fontanel	fon-ta-nel
redi-rect	re-di-rect
les-bian	les-bi-an
scholas-tic	scho-las-tic
pho-tog-ra-ph-er	pho-tog-ra-pher
re-lax-ation	re-lax-a-tion
us-abil-i-ty	us-a-bil-i-ty
archive	ar-chive
venue	ven-ue
dolomite	do-lo-mite
di-achron-ic	di-a-chron-ic
haven	ha-ven
brawler	brawl-er
sole-cism	sol-e-cism
eman-ci-pate	e-man-ci-pate
scruti-ny	scru-ti-ny
whether	wheth-er
pulpy	pulp-y
salty	salt-y
over-grown	o-ver-grown
in-ex-orable	in-ex-o-ra-ble
Words with errors: 1859
Words with incorrect number of syllables: 1761
Total evluated: 6500
Perfect accuracy: 0.71
Number of syllables accuracy: 0.73
Average Levenshtein Distance(across incorrect words): 1.19
