Attempt	Real
gad-getry	gadg-et-ry
neon	ne-on
eter-ni-ty	e-ter-ni-ty
dimin-u-en-do	di-min-u-en-do
re-process	re-proc-ess
fetishist	fet-ish-ist
bodice	bod-ice
quadri-par-tite	quad-ri-par-tite
porter-age	por-ter-age
mem-o-ra-bil-ia	mem-o-ra-bil-i-a
chronome-ter	chro-nom-e-ter
desert	de-sert
im-mov-able	im-mov-a-ble
elec-tron-ic	e-lec-tron-ic
tremu-lous	trem-u-lous
over-due	o-ver-due
deco-rum	de-co-rum
oner	on-er
car-avel	car-a-vel
bedrid-den	bed-rid-den
wolfhound	wolf-hound
lemur	le-mur
lama	la-ma
ar-madil-lo	ar-ma-dil-lo
em-broi-dery	em-broi-der-y
deco-rous	dec-o-rous
idio-syn-crasy	id-i-o-syn-cra-sy
quadru-ply	quad-ru-ply
prostaglandin	pros-ta-glan-din
un-sup-port-able	un-sup-port-a-ble
coun-ter-in-tu-itive	coun-ter-in-tu-i-tive
sub-sidy	sub-si-dy
ed-itable	ed-it-a-ble
spir-i-tu-al-ly	spir-it-u-al-ly
eigen-val-ue	ei-gen-val-ue
plunger	plung-er
taran-tu-la	ta-ran-tu-la
cere-bel-lum	cer-e-bel-lum
in-audi-ble	in-au-di-ble
shekel	shek-el
emet-ic	e-met-ic
un-com-fort-able	un-com-fort-a-ble
bungee	bun-gee
raspy	rasp-y
repack-age	re-pack-age
coastal	coast-al
hye-na	hy-e-na
byprod-uct	by-prod-uct
uni-lat-er-al-ly	u-ni-lat-er-al-ly
caprice	ca-price
bazaar	ba-zaar
macro-cosm	mac-ro-cosm
per-fidy	per-fi-dy
parish	par-ish
tribu-la-tion	trib-u-la-tion
rack-e-teer-ing	rack-et-eer-ing
volatile	vol-a-tile
postage	post-age
fri-ary	fri-ar-y
ovoid	o-void
nico-tine	nic-o-tine
over-lap	o-ver-lap
penal-ty	pen-al-ty
wary	war-y
cog-nizant	cog-ni-zant
dra-con-ian	dra-co-ni-an
cagey	cag-ey
plebiscite	pleb-i-scite
thaw-ing	thawing
un-touch-able	un-touch-a-ble
over-lie	o-ver-lie
kine-mat-ics	kin-e-mat-ics
moun-taineer-ing	moun-tain-eer-ing
post-mod-ernist	post-mod-ern-ist
me-te-o-rol-o-gy	me-te-or-ol-o-gy
erup-tive	e-rup-tive
unin-sur-able	un-in-sur-a-ble
ebul-lience	e-bul-lience
aviary	a-vi-ar-y
missal	mis-sal
di-atom-ic	di-a-tom-ic
overeat	o-ver-eat
crenel-la-tions	cren-el-la-tions
cre-ative-ly	cre-a-tive-ly
racy	rac-y
un-frozen	un-fro-zen
con-fi-den-tial-i-ty	con-fi-den-ti-al-i-ty
de-f-i-n-i-tion-al	def-i-ni-tion-al
every	eve-ry
med-ica-tion	med-i-ca-tion
dic-ta-to-r-i-al	dic-ta-to-ri-al
skua	sku-a
unswerv-ing	un-swerv-ing
petrol-o-gy	pe-trol-o-gy
un-adapt-ed	un-a-dapt-ed
hand-picked	handpicked
ban-knote	bank-note
vari-cose	var-i-cose
whacko	whack-o
emit-ter	e-mit-ter
skir-mish-ing	skirmishing
forest-ed	forested
dis-am-biguate	dis-am-big-u-ate
gua-camole	gua-ca-mo-le
macaw	ma-caw
expo	ex-po
shoplift-ing	shop-lift-ing
ovu-la-tion	ov-u-la-tion
bio-chemist	bi-o-chem-ist
stat-uette	stat-u-ette
evade	e-vade
bi-car-bon-ate	bi-car-bo-nate
com-mis-sari-at	com-mis-sar-i-at
avoid-ance	a-void-ance
res-cuer	res-cu-er
in-stan-ta-neous-ly	in-stan-ta-ne-ous-ly
papa	pa-pa
ate-lier	at-el-ier
over-draw	o-ver-draw
sug-ary	sug-ar-y
un-fash-ion-able	un-fash-ion-a-ble
vacu-ity	va-cu-i-ty
poly-he-dron	pol-y-he-dron
prophet	proph-et
vial	vi-al
sabra	sa-bra
his-tol-ogy	his-tol-o-gy
masochist	mas-och-ist
timetable	time-ta-ble
in-sup-port-able	in-sup-port-a-ble
mono-chrome	mon-o-chrome
in-dica-tive	in-dic-a-tive
ques-tion-able	ques-tion-a-ble
gaudy	gaud-y
de-mo-graph-ics	dem-o-graph-ics
hab-er-dash-ery	hab-er-dash-er-y
duel	du-el
in-valu-able	in-val-u-a-ble
physics	phys-ics
repast	re-past
scraper	scrap-er
hal-ibut	hal-i-but
ex-tra-mur-al	ex-tra-mu-ral
asex-u-al	a-sex-u-al
mantra	man-tra
at-tribu-tive	at-trib-u-tive
far-away	far-a-way
re-deemable	re-deem-a-ble
soupy	soup-y
cham-pi-onship	cham-pi-on-ship
read-mis-sion	re-ad-mis-sion
frailty	frail-ty
elec-tro-mo-tive	e-lec-tro-mo-tive
erec-tion	e-rec-tion
fundrais-ing	fund-rais-ing
parental	pa-ren-tal
im-pro-visato-ry	im-pro-vi-sa-to-ry
busi-nesslike	busi-ness-like
ibis	i-bis
un-ap-pre-cia-tive	un-ap-pre-ci-a-tive
legume	leg-ume
elec-tron	e-lec-tron
as-besto-sis	as-bes-to-sis
forester	for-est-er
around	a-round
squalid	squal-id
or-tho-doxy	or-tho-dox-y
transcon-ti-nen-tal	trans-con-ti-nen-tal
apol-o-gy	a-pol-o-gy
re-assess	re-as-sess
ure-thane	u-re-thane
re-stroom	rest-room
peren-ni-al-ly	per-en-ni-al-ly
egress	e-gress
in-ter-preter	in-ter-pret-er
sta-tionery	sta-tion-er-y
un-sea-son-able	un-sea-son-a-ble
com-plaisant	com-plai-sant
stormy	storm-y
dis-ci-pli-nary	dis-ci-pli-nar-y
mater	ma-ter
repack	re-pack
felo-nious	fe-lo-ni-ous
in-cur-able	in-cur-a-ble
id-io-path-ic	id-i-o-path-ic
cou-turi-er	cou-tu-ri-er
dis-cor-dant	dis-cord-ant
hon-orif-ic	hon-or-if-ic
for-get-table	for-get-ta-ble
tweedy	tweed-y
bad-minton	bad-min-ton
lilac	li-lac
syn-onym	syn-o-nym
courtship	court-ship
in-ex-tin-guish-able	in-ex-tin-guish-a-ble
hookah	hook-ah
col-lapsi-ble	col-laps-i-ble
naval	na-val
bean-ery	bean-er-y
un-sur-pass-able	un-sur-pass-a-ble
volt-meter	volt-me-ter
mas-cara	mas-car-a
blankly	blank-ly
aqualung	aq-ua-lung
me-dia	me-di-a
over-es-ti-mate	o-ver-es-ti-mate
carafe	ca-rafe
leg-isla-tive	leg-is-la-tive
salient	sa-li-ent
rec-i-p-ro-cate	re-cip-ro-cate
fu-ner-ary	fu-ner-ar-y
orig-i-nal	o-rig-i-nal
dere-lic-tion	der-e-lic-tion
poseur	po-seur
iconog-ra-phy	i-co-nog-ra-phy
or-biter	or-bit-er
heresy	her-e-sy
wafer	wa-fer
es-calade	es-ca-lade
re-al-ness	real-ness
spon-sored	sponsored
ego-cen-tric	e-go-cen-tric
hip-popota-mus	hip-po-pot-a-mus
melan-cho-lia	mel-an-cho-li-a
wel-com-ing	wel-co-ming
recla-ma-tion	rec-la-ma-tion
deu-teri-um	deu-te-ri-um
arch-dio-cese	arch-di-o-cese
ge-neti-cist	ge-net-i-cist
corvette	cor-vette
pipeline	pipe-line
en-fee-bled	enfeebled
duo	du-o
sym-biont	sym-bi-ont
lentil	len-til
over-sexed	o-ver-sexed
erased	e-rased
seis-mome-ter	seis-mom-e-ter
clover	clo-ver
costar	co-star
sonata	so-na-ta
pes-simism	pes-si-mism
pipette	pi-pette
frosty	frost-y
gu-ber-na-to-r-i-al	gu-ber-na-to-ri-al
lozenge	loz-enge
oral	o-ral
opac-i-ty	o-pac-i-ty
fran-chisee	fran-chi-see
duchy	duch-y
collinear	col-lin-e-ar
dodgem	dodg-em
spunky	spunk-y
frilly	frill-y
dif-fer-ing	differing
hangar	hang-ar
mod-ernism	mod-ern-ism
icon-ic	i-con-ic
causal-ly	caus-al-ly
por-traitist	por-trait-ist
brushy	brush-y
oakum	oa-kum
irid-i-um	i-rid-i-um
ethics	eth-ics
propin-quity	pro-pin-qui-ty
ep-ithe-lial	ep-i-the-li-al
inat-ten-tive	in-at-ten-tive
morale	mo-rale
colonic	co-lon-ic
fash-ion-ably	fash-ion-a-bly
restive	res-tive
singly	sin-gly
pleas-antry	pleas-ant-ry
beanstalk	bean-stalk
wind-surfer	wind-surf-er
para-psy-chol-o-gy	par-a-psy-chol-o-gy
oily	oil-y
steeple-chase	stee-ple-chase
prodi-gal	prod-i-gal
spir-i-tu-al-ism	spir-it-u-al-ism
para-mour	par-a-mour
de-ca-pod	dec-a-pod
stratos-phere	strat-o-sphere
unchris-t-ian	un-chris-tian
ap-praisal	ap-prais-al
bio-engi-neer-ing	bi-o-en-gi-neer-ing
unit-ed	u-nit-ed
ditch-ing	ditching
vine-gar	vin-e-gar
syl-labary	syl-la-bar-y
schema	sche-ma
but-tery	but-ter-y
enig-ma	e-nig-ma
sketchy	sketch-y
hy-pox-ia	hy-pox-i-a
con-stituent	con-stit-u-ent
drom-e-dary	drom-e-dar-y
get-away	get-a-way
pizze-ria	piz-ze-ri-a
re-li-able	re-li-a-ble
boron	bo-ron
cleaver	cleav-er
haughty	haugh-ty
sporran	spor-ran
un-record-ed	un-re-cord-ed
alarm	a-larm
glac-i-er	gla-cier
potable	po-ta-ble
pre-sentable	pre-sent-a-ble
jour-nalese	jour-nal-ese
mi-crodot	mi-cro-dot
clank-ing	clan-king
corn-flower	corn-flow-er
salmon	salm-on
aro-mat-ic	ar-o-mat-ic
iso-late	i-so-late
telecom-mut-ing	te-le-com-mu-ting
howdy	how-dy
repa-tri-a-tion	re-pa-tri-a-tion
any-body	an-y-bod-y
specif-i-cal-ly	spe-cif-i-cal-ly
delu-sion-al	de-lu-sion-al
un-elect-ed	un-e-lect-ed
curvy	curv-y
wilder-ness	wil-der-ness
bac-te-r-i-al	bac-te-ri-al
fundrais-er	fund-rais-er
ther-mome-ter	ther-mom-e-ter
graphite	graph-ite
un-re-pairable	un-re-pair-a-ble
roast-ed	roasted
jiffy	jif-fy
con-cor-dant	con-cord-ant
vinyl	vi-nyl
con-sum-able	con-sum-a-ble
weapon	weap-on
in-equity	in-eq-ui-ty
rounders	round-ers
avenge	a-venge
con-ge-nial	con-gen-ial
samu-rai	sam-u-rai
du-op-oly	du-op-o-ly
ne-go-tiable	ne-go-ti-a-ble
pelvic	pel-vic
iso-lat-ed	i-so-lat-ed
au-tonomous-ly	au-ton-o-mous-ly
grid-iron	grid-i-ron
scanty	scant-y
ir-ra-tional	ir-ra-tion-al
cheery	cheer-y
record-ing	re-cord-ing
rose-mary	rose-mar-y
holdup	hold-up
wun-derkind	wun-der-kind
scruti-ny	scru-ti-ny
boa	bo-a
based	based
bar-bar-ian	bar-bar-i-an
per-mafrost	per-ma-frost
killjoy	kill-joy
pe-trel	pet-rel
odor-ous	o-dor-ous
eleven	e-lev-en
avi-a-tor	a-vi-a-tor
tuner	tun-er
rudi-men-ta-ry	ru-di-men-ta-ry
bear-able	bear-a-ble
overqual-i-fied	o-ver-qual-i-fied
tripoli	trip-o-li
kilo	ki-lo
scrupu-lous-ly	scru-pu-lous-ly
sapi-ent	sa-pi-ent
chapel	chap-el
snig-ger-ing	sniggering
quartzite	quartz-ite
beefy	beef-y
di-nosaur	di-no-saur
asyn-chro-nous	a-syn-chro-nous
podgy	podg-y
cam-panile	cam-pa-ni-le
can-dlelit	can-dle-lit
money-len-der	mon-ey-lend-er
mis-shapen	mis-shap-en
un-re-pen-tant	un-re-pent-ant
monau-r-al	mon-au-ral
febrile	fe-brile
hostler	hos-tler
sandy	sand-y
colo-nial-ist	co-lo-ni-al-ist
il-menite	il-men-ite
resur-gent	re-sur-gent
gaga	ga-ga
male-fac-tor	mal-e-fac-tor
ia-tro-genic	i-at-ro-gen-ic
trusty	trust-y
penin-su-lar	pen-in-su-lar
doc-tor-ing	doctoring
over-anx-ious	o-ver-anx-ious
rainy	rain-y
squea-mish	squeam-ish
apex	a-pex
owlet	owl-et
chalet	cha-let
un-govern-able	un-gov-ern-a-ble
apos-ta-sy	a-pos-ta-sy
feath-ery	feath-er-y
cashew	cash-ew
prepo-si-tion-al	prep-o-si-tion-al
with-ered	withered
enig-mat-ic	en-ig-mat-ic
over-print	o-ver-print
phy-loge-ny	phy-log-e-ny
paragon	par-a-gon
gamy	gam-y
firmware	firm-ware
weepy	weep-y
stron-tium	stron-ti-um
largo	lar-go
sub-servient	sub-ser-vi-ent
moth-er-stobe	mo-ther-stobe
swinger	swing-er
ex-oskele-ton	ex-o-skel-e-ton
manome-ter	ma-nom-e-ter
con-san-guineous	con-san-guin-e-ous
mat-te	matte
sa-tanism	sa-tan-ism
unan-i-mous	u-nan-i-mous
every-thing	eve-ry-thing
va-sec-to-my	vas-ec-to-my
icy	i-cy
her-aldry	her-ald-ry
mossy	mos-sy
ner-vous	nerv-ous
mi-cro-surgery	mi-cro-sur-ger-y
im-per-turbable	im-per-turb-a-ble
condi-ment	con-di-ment
goer	go-er
arable	ar-a-ble
dri-ven	driv-en
vulpine	vul-pine
motile	mo-tile
flota-tion	flo-ta-tion
de-ser-ti-fi-ca-tion	de-sert-i-fi-ca-tion
cologne	co-logne
over-tone	o-ver-tone
pinafore	pin-a-fore
cara-cal	car-a-cal
bizarre	bi-zarre
ef-fron-tery	ef-fron-ter-y
san-i-tary	san-i-tar-y
forte	for-te
cun-nilin-gus	cun-ni-lin-gus
ne-ma-tode	nem-a-tode
in-fini-tive	in-fin-i-tive
buffer	buff-er
dandy	dan-dy
over-seer	o-ver-se-er
cli-ma-tol-ogy	cli-ma-tol-o-gy
apogee	ap-o-gee
viper	vi-per
stipend	sti-pend
shaven	shav-en
para-keet	par-a-keet
over-com-pen-sate	o-ver-com-pen-sate
gra-tu-itous	gra-tu-i-tous
elfin	elf-in
epi-graph	ep-i-graph
uni-lat-er-al-ist	u-ni-lat-er-al-ist
detox	de-tox
dis-heart-en-ing	dis-hear-te-ning
privy	priv-y
welling-ton	wel-ling-ton
onto	on-to
growler	growl-er
bene-dic-tion	ben-e-dic-tion
as-trologer	as-trol-o-ger
gra-tu-ity	gra-tu-i-ty
po-ten-tial-i-ty	po-ten-ti-al-i-ty
pre-his-toric	pre-his-tor-ic
ide-ol-o-gy	i-de-ol-o-gy
ema-ci-at-ed	e-ma-ci-at-ed
un-scrupu-lous	un-scru-pu-lous
frozen	fro-zen
steadi-ness	stead-i-ness
oblit-er-a-tion	ob-lit-er-a-tion
saucy	sau-cy
open	o-pen
dumper	dump-er
cyanide	cy-a-nide
recre-ation	rec-re-a-tion
idea	i-de-a
em-bed-d-a-ble	em-bed-da-ble
essence	es-sence
bio-chem-istry	bi-o-chem-is-try
crock-ery	crock-er-y
shiv-er-ing	shivering
in-cisor	in-ci-sor
stinky	stink-y
con-tractible	con-tract-i-ble
cowherd	cow-herd
in-tre-pid	in-trep-id
gen-eros-i-ty	gen-er-os-i-ty
sar-to-r-i-al	sar-to-ri-al
recog-ni-tion	rec-og-ni-tion
foible	foi-ble
atoll	at-oll
prospect	pros-pect
labi-um	la-bi-um
iden-ti-fi-ca-tion	i-den-ti-fi-ca-tion
aque-ous	a-que-ous
prof-itably	prof-it-a-bly
dy-namism	dy-na-mism
miniskirt	min-i-skirt
prover-bial	pro-ver-bi-al
tox-i-c-i-ty	tox-ic-i-ty
manor	man-or
longevi-ty	lon-gev-i-ty
out-landish	out-land-ish
wastage	wast-age
rec-om-mend-ed	recommended
cheeky	cheek-y
mo-les-ter	mo-lest-er
rege-late	re-ge-late
reroutes	re-routes
del-i-catessen	del-i-ca-tes-sen
ephemeris	e-phem-er-is
om-nibus	om-ni-bus
ca-cao	ca-ca-o
orig-i-na-tor	o-rig-i-na-tor
ethanol	eth-a-nol
no-table	no-ta-ble
facet	fac-et
demigod	dem-i-god
unar-tic-u-lat-ed	un-ar-tic-u-lat-ed
fragili-ty	fra-gil-i-ty
drifter	drift-er
moody	mood-y
brigade	bri-gade
in-ge-nious	in-gen-ious
in-con-ve-nient	in-con-ven-ient
melo-dra-mat-ic	mel-o-dra-mat-ic
ri-ot-ing	ri-o-ting
baleen	ba-leen
seda-tive	sed-a-tive
break-away	break-a-way
res-onate	res-o-nate
elec-tro	e-lec-tro
over-throw	o-ver-throw
con-sulate	con-su-late
gatepost	gate-post
there-upon	there-up-on
open-er	o-pen-er
odi-um	o-di-um
melee	me-lee
zebu	ze-bu
coura-geous	cou-ra-geous
lega-tion	le-ga-tion
plaza	pla-za
ir-repara-ble	ir-rep-a-ra-ble
glia	gli-a
maudlin	maud-lin
som-brero	som-bre-ro
jokey	jok-ey
table-ware	ta-ble-ware
replic-a-ble	rep-li-ca-ble
seal-ing	sealing
worsted	wor-sted
type-writer	type-writ-er
un-fet-tered	unfettered
kriegspiel	krieg-spiel
un-quench-able	un-quench-a-ble
trac-ery	trac-er-y
iambic	i-am-bic
ran-corous	ran-cor-ous
trace-able	trace-a-ble
dis-ori-en-ta-tion	dis-o-ri-en-ta-tion
hal-lelu-jah	hal-le-lu-jah
cav-ernous	cav-ern-ous
trans-fer-able	trans-fer-a-ble
ma-joli-ca	ma-jol-i-ca
japon-i-ca	ja-pon-i-ca
epis-temic	ep-i-ste-mic
sacro-sanct	sac-ro-sanct
dyad	dy-ad
euro	eu-ro
ir-re-sistible	ir-re-sist-i-ble
biotech-nol-o-gy	bi-o-tech-nol-o-gy
babysit-ter	ba-by-sit-ter
liqueur	li-queur
ga-lop	gal-op
de-liv-ery	de-liv-er-y
se-quencer	se-quenc-er
imag-in-able	im-ag-i-na-ble
dozen	doz-en
strate-gi-cal-ly	stra-te-gi-cal-ly
un-abat-ed	un-a-bat-ed
poly-ester	pol-y-es-ter
over-hand	o-ver-hand
odor-if-er-ous	o-dor-if-er-ous
cyan	cy-an
sagac-i-ty	sa-gac-i-ty
amused	a-mused
nervy	nerv-y
pub-lished	published
tele-text	tel-e-text
symp-to-matic	symp-to-mat-ic
re-gency	re-gen-cy
com-pendi-um	com-pen-di-um
echoic	e-cho-ic
enu-mer-a-tor	e-nu-mer-a-tor
shipown-er	ship-own-er
my-opic	my-op-ic
res-olute-ly	res-o-lute-ly
elec-tri-cal	e-lec-tri-cal
hi-ero-glyph	hi-er-o-glyph
un-in-for-ma-tive	un-in-form-a-tive
stormer	storm-er
wadi	wa-di
de-con-struc-tive	deconstructive
lan-der	land-er
dila-tor	di-la-tor
faulty	fault-y
car-rion	car-ri-on
canon-ic	ca-non-ic
heifer	heif-er
cine	cin-e
re-splen-dent	re-splend-ent
pyra-mid	pyr-a-mid
castoff	cast-off
tacho-graph	tach-o-graph
docile	doc-ile
syn-ovial	syn-o-vi-al
mit-i-gat-ing	mitigating
meta-physics	met-a-phys-ics
im-paction	im-pac-tion
promis-so-ry	prom-is-so-ry
facile	fac-ile
topog-ra-phy	to-pog-ra-phy
drift-ing	drif-ting
aza-lea	a-zal-ea
hy-drother-mal	hy-dro-ther-mal
ini-tial-ly	in-i-tial-ly
aque-duct	aq-ue-duct
taxis	tax-is
mock-ery	mock-er-y
mort-gagor	mort-ga-gor
hi-ero-glyph-ic	hi-er-o-glyph-ic
de-scen-der	de-scend-er
prepar-a-tive	pre-par-a-tive
calo-rie	cal-o-rie
servile	ser-vile
tribesman	tribes-man
py-rotech-nics	py-ro-tech-nics
solem-ni-ty	so-lem-ni-ty
unglam-orous	un-glam-or-ous
pres-ti-gious	pres-tig-ious
stealthy	stealth-y
deficit	def-i-cit
telecom-mu-ni-ca-tion	tel-e-com-mu-ni-ca-tion
strate-gist	strat-e-gist
thyris-tor	thy-ris-tor
menswear	mens-wear
dis-claimer	dis-claim-er
diva	di-va
ruin	ru-in
sleazy	slea-zy
pre-dict-ed	predicted
restora-tion	res-to-ra-tion
arum	ar-um
phil-an-thropic	phil-an-throp-ic
pony-tail	po-ny-tail
real	re-al
atom-ic-i-ty	at-o-mic-i-ty
stew-ardess	stew-ard-ess
starfish	star-fish
curie	cu-rie
im-ma-te-r-i-al	im-ma-te-ri-al
giblets	gib-lets
in-sipid	in-sip-id
goa-tee	goat-ee
sacral	sa-cral
show-ery	show-er-y
de-spon-den-cy	de-spond-en-cy
asi-nine	as-i-nine
para-med-ical	par-a-med-i-cal
apos-tro-phe	a-pos-tro-phe
hi-jack-ing	hi-jac-king
helper	help-er
un-trace-able	un-trace-a-ble
rea-son-ably	rea-son-a-bly
lyri-cal	lyr-i-cal
pol-lard-ed	pollarded
archer	arch-er
kitchen-ware	kitch-en-ware
ledger	ledg-er
treaty	trea-ty
brew-ery	brew-er-y
hobo	ho-bo
synapse	syn-apse
con-tigu-ous	con-tig-u-ous
penury	pen-u-ry
blus-ter-ing	blustering
hero-ical-ly	he-ro-i-cal-ly
para-mil-i-tary	par-a-mil-i-tar-y
un-fore-see-able	un-fore-see-a-ble
reti-na	ret-i-na
coinage	coin-age
supreme	su-preme
amaz-ing	a-maz-ing
rhetor-i-cal	rhe-tor-i-cal
artery	ar-ter-y
evan-ge-lis-tic	e-van-ge-lis-tic
epi-taph	ep-i-taph
xenon	xe-non
louis	lou-is
homi-cide	hom-i-cide
rheumat-ics	rheu-mat-ics
decor	de-cor
samovar	sam-o-var
callable	call-a-ble
holler	hol-ler
celiba-cy	cel-i-ba-cy
libero	li-be-ro
moldy	mold-y
dis-cre-tionary	dis-cre-tion-ar-y
mar-itime	mar-i-time
sided	sid-ed
snaky	snak-y
un-us-able	un-us-a-ble
poly-cyclic	pol-y-cy-clic
punch-line	punchline
baronet	bar-on-et
ici-cle	i-ci-cle
bereft	be-reft
painstak-ing	pains-tak-ing
cathe-dral	ca-the-dral
per-me-able	per-me-a-ble
con-veyance	con-vey-ance
tele-pho-to	tel-e-pho-to
over-charge	o-ver-charge
about	a-bout
stat-uesque	stat-u-esque
bour-geoisie	bour-geoi-sie
over-ground	o-ver-ground
fetish	fet-ish
lithos-phere	lith-o-sphere
iso-met-ric	i-so-met-ric
sup-ple-men-tary	sup-ple-men-ta-ry
er-bium	er-bi-um
filmic	film-ic
mar-moset	mar-mo-set
im-moral-i-ty	im-mo-ral-i-ty
reaper	reap-er
com-press-ibil-i-ty	com-pres-si-bil-i-ty
in-quisi-to-r-i-al	in-quis-i-to-ri-al
okapi	o-ka-pi
tablet	tab-let
ex-pi-ra-to-ry	ex-pir-a-to-ry
mis-aligned	mis-a-ligned
es-cha-tol-ogy	es-cha-tol-o-gy
sesame	ses-a-me
con-formable	con-form-a-ble
despot-ic	des-pot-ic
po-litesse	pol-i-tesse
planter	plant-er
ahead	a-head
thievish	thiev-ish
ovum	o-vum
atro-cious	a-tro-cious
entab-la-ture	en-tab-la-ture
epi-gram	ep-i-gram
schemer	schem-er
stu-dious	stu-di-ous
plucky	pluck-y
reprisal	re-pris-al
also	al-so
midi	mid-i
su-per-posed	superposed
minute	mi-nute
painful	pain-ful
raf-fia	raf-fi-a
mi-cro-com-put-er	mi-cro-com-pu-ter
builder	build-er
itchy	itch-y
subto-tal	sub-to-tal
break-able	break-a-ble
tiller	till-er
mis-nomer	mis-no-mer
un-invit-ing	un-in-vit-ing
ob-jec-tion-able	ob-jec-tion-a-ble
over-laden	o-ver-lad-en
chrysan-the-mum	chry-san-the-mum
friendlily	friend-li-ly
tiny	ti-ny
methanol	meth-a-nol
ru-inous	ru-in-ous
stony	ston-y
de-tainee	de-tain-ee
prophe-cy	proph-e-cy
cretinous	cre-tin-ous
modal-i-ty	mo-dal-i-ty
equidis-tant	e-qui-dis-tant
hawthorn	haw-thorn
hy-draulic	hy-drau-lic
chaffinch	chaf-finch
tick-et-ed	ticketed
taskmas-ter	task-mas-ter
bio-mass	bi-o-mass
anx-i-ety	anx-i-e-ty
pseudo-pod	pseu-do-pod
un-ob-ser-vant	un-ob-serv-ant
in-no-v-a-tive	in-no-va-tive
op-ti-misti-cal-ly	op-ti-mis-ti-cal-ly
aro-mather-a-py	a-ro-ma-ther-a-py
nonex-is-tence	non-ex-ist-ence
com-pelling	com-pel-ling
rock-etry	rock-et-ry
psalmody	psal-mo-dy
over-flow-ing	o-ver-flo-wing
trace-abil-i-ty	trace-a-bil-i-ty
emen-da-tion	e-men-da-tion
deeply	deep-ly
peri-patet-ic	per-i-pa-tet-ic
army	ar-my
cur-ricu-lum	cur-ric-u-lum
some-body	some-bod-y
astray	a-stray
colobus	col-o-bus
dy-namo	dy-na-mo
pot-tery	pot-ter-y
baron	bar-on
cougar	cou-gar
dis-cotheque	dis-co-theque
lusti-ly	lust-i-ly
apolo-get-i-cal-ly	a-pol-o-get-i-cal-ly
panoram-ic	pan-o-ram-ic
nymp-holep-sy	nym-pho-lep-sy
su-per-fluity	su-per-flu-i-ty
leg-endary	leg-end-ar-y
ge-o-mag-net-i-cal-ly	ge-o-mag-ne-ti-cal-ly
renter	rent-er
omis-sion	o-mis-sion
re-cruiter	re-cruit-er
pussy	pus-sy
tem-porar-i-ly	tem-po-rar-i-ly
over-drive	o-ver-drive
op-er-a-tional-ly	op-er-a-tion-al-ly
dishy	dish-y
re-portage	re-port-age
cin-e-matog-ra-phy	cin-e-ma-tog-ra-phy
trans-porter	trans-port-er
soda	so-da
decade	dec-ade
fortress	for-tress
taxi-der-mist	tax-i-der-mist
any-more	an-y-more
gleam-ing	gleaming
killer	kil-ler
sus-tain-able	sus-tain-a-ble
calorif-ic	cal-o-rif-ic
falset-to	fal-set-to
can-tilevered	cantilevered
asun-der	a-sun-der
re-versed	reversed
mnemon-ics	mne-mon-ics
lever-age	lev-er-age
peri	pe-ri
desul-to-ry	des-ul-to-ry
con-fronta-tion-al	con-fron-ta-tion-al
meanie	mean-ie
crossover	cross-o-ver
over-lay	o-ver-lay
dis-rep-utable	dis-rep-u-ta-ble
cre-ation-ist	cre-a-tion-ist
hy-dropho-bic	hy-dro-pho-bic
gam-bling	gam-bling
mini-cab	min-i-cab
only	on-ly
ap-plica-tive	ap-pli-ca-tive
pecan	pe-can
mayflower	may-flow-er
dis-abuse	dis-a-buse
uni-ver-sal-ist	u-ni-ver-sal-ist
punc-til-ious	punc-til-i-ous
rapid-ly	rap-id-ly
hasti-ly	hast-i-ly
stu-dious-ly	stu-di-ous-ly
slip-ping	slipping
her-i-tabil-i-ty	her-it-a-bil-i-ty
dairy-man	dair-y-man
pinkie	pink-ie
tele-vised	televised
can-nery	can-ner-y
stargaze	star-gaze
in-deli-bly	in-del-i-bly
de-mo-c-ra-t-i-cal-ly	dem-o-crat-i-cal-ly
polyandry	pol-y-an-dry
bat-tery	bat-ter-y
em-ploy-able	em-ploy-a-ble
es-planade	es-pla-nade
eli-sion	e-li-sion
scur-rilous	scur-ril-ous
ho-mo-gene-ity	ho-mo-ge-ne-i-ty
taxi-cab	tax-i-cab
dinghy	din-ghy
pro-tease	pro-te-ase
au-topi-lot	au-to-pi-lot
polo-ni-um	po-lo-ni-um
en-durable	en-dur-a-ble
un-der-study	un-der-stud-y
bothy	both-y
sub-jec-tivism	sub-jec-tiv-ism
crum-bling	crumbling
un-ac-cept-ably	un-ac-cept-a-bly
porky	pork-y
weightlift-ing	weight-lift-ing
un-even-ly	un-e-ven-ly
de-for-mi-ty	de-form-i-ty
di-aphrag-mat-ic	di-a-phrag-mat-ic
pro-boscis	pro-bos-cis
lachry-mal	lach-ry-mal
panties	pant-ies
ship-builder	ship-build-er
dan-de-lion	dan-de-li-on
nurs-ery-man	nurs-er-y-man
dele-tion	de-le-tion
beanie	bean-ie
monogamy	mo-nog-a-my
flagon	flag-on
hindquar-ters	hind-quar-ters
mi-croc-ode	mi-cro-code
con-traindi-ca-tion	con-tra-in-di-ca-tion
respire	re-spire
con-struc-tivist	con-struc-tiv-ist
frisky	frisk-y
harem	har-em
redi-rect	re-di-rect
ir-ri-tabil-i-ty	ir-ri-ta-bil-i-ty
megas-tar	meg-a-star
physi-cist	phys-i-cist
surfer	surf-er
rant-i-ng	ranting
gen-tri-fied	gentrified
con-troller	con-trol-ler
elu-ci-date	e-lu-ci-date
unin-su-lat-ed	un-in-su-lat-ed
frown-ing	frowning
slav-ery	slav-er-y
en-chant-ed	enchanted
velour	ve-lour
gan-glion	gan-gli-on
delin-quen-cy	de-lin-quen-cy
urea	u-re-a
brava-do	bra-va-do
miser-ly	mi-ser-ly
murky	murk-y
idol-a-try	i-dol-a-try
evo-lute	ev-o-lute
feath-erlight	feath-er-light
poky	pok-y
theoc-ra-cy	the-oc-ra-cy
cursed	curs-ed
punky	punk-y
triplex	tri-plex
ede-ma	e-de-ma
unto	un-to
skintight	skin-tight
un-awak-ened	un-a-wak-ened
molyb-de-num	mo-lyb-de-num
galaxy	gal-ax-y
pro-tec-torate	pro-tec-tor-ate
sonar	so-nar
in-ter-roga-tor	in-ter-ro-ga-tor
co-conut	co-co-nut
give-away	give-a-way
ante	an-te
barom-e-ter	ba-rom-e-ter
rasper	rasp-er
rea-son-able	rea-son-a-ble
prophet-ess	proph-et-ess
in-spi-ra-tional	in-spi-ra-tion-al
mul-ti-me-ter	mul-tim-e-ter
unim-ped-ed	un-im-ped-ed
elo-quence	el-o-quence
wreck-ing	wrecking
epi-dem-ic	ep-i-dem-ic
dis-abil-i-ty	dis-a-bil-i-ty
un-re-served-ly	un-re-serv-ed-ly
ide-al	i-de-al
backchat	back-chat
measly	mea-sly
elec-tri-cian	e-lec-tri-cian
tan-nery	tan-ner-y
brand-ing	branding
coun-ter-rev-o-lu-tion-ary	coun-ter-rev-o-lu-tion-ar-y
di-alec-tic	di-a-lec-tic
messy	mess-y
au-r-al	au-ral
twilit	twi-lit
arranger	ar-rang-er
yippee	yip-pee
hoary	hoar-y
en-v-i-ron	en-vi-ron
hy-drangea	hy-dran-gea
herbal	herb-al
polygamy	po-lyg-a-my
viewfind-er	view-find-er
vac-uole	vac-u-ole
diskette	disk-ette
mono-mi-al	mo-no-mi-al
heart-en-ing	heartening
lava-to-r-i-al	lav-a-to-ri-al
iron-ing	i-ron-ing
harpists	har-pists
in-de-ter-minable	in-de-ter-mi-na-ble
in-quisi-tor	in-quis-i-tor
id-iomat-ic	id-i-o-mat-ic
spillage	spill-age
moral-ism	mor-al-ism
promis-cu-ity	prom-is-cu-i-ty
an-ti-body	an-ti-bod-y
refuge	ref-uge
meta-mor-pho-sis	met-a-mor-pho-sis
moral-ly	mor-al-ly
dis-putable	dis-put-a-ble
coven	cov-en
char-cu-terie	char-cu-te-rie
re-vival-ism	re-viv-al-ism
ram-shackle	ram-shack-le
reap-point	re-ap-point
dri-ve	drive
porno-graph-ic	por-no-graph-ic
leav-ened	leavened
os-tracism	os-tra-cism
apoc-a-lypse	a-poc-a-lypse
roughshod	rough-shod
trea-sur-er	treas-ur-er
monoc-u-lar	mo-noc-u-lar
slushy	slush-y
di-vider	di-vid-er
prowess	prow-ess
di-aphanous	di-aph-a-nous
sea-son-able	sea-son-a-ble
heartache	heart-ache
beaker	beak-er
topaz	to-paz
cor-re-spon-dent	cor-re-spond-ent
par-al-lelism	par-al-lel-ism
mega-lo-ma-nia	meg-a-lo-ma-ni-a
el-der-flower	el-der-flow-er
mini-bar	min-i-bar
siphon	si-phon
neu-ronal	neu-ron-al
gullible	gul-li-ble
demon-stra-tion	dem-on-stra-tion
catalep-sy	cat-a-lep-sy
melan-choly	mel-an-chol-y
who-dunit	who-dun-it
psy-choso-cial	psy-cho-so-cial
eti-quette	et-i-quette
cra-nial	cra-ni-al
mi-crosec-ond	mi-cro-sec-ond
armpit	arm-pit
ap-pendage	ap-pend-age
polo	po-lo
char-i-o-teer	char-i-ot-eer
catgut	cat-gut
over-pow-er-ing	o-ver-pow-er-ing
bes-tiary	bes-ti-ar-y
pumice	pum-ice
or-bital	or-bit-al
asym-met-ri-cal	a-sym-met-ri-cal
cater	ca-ter
jeal-ousy	jeal-ous-y
car-roty	car-rot-y
tute-lary	tu-te-lar-y
reval-ue	re-val-ue
radar	ra-dar
dwin-dling	dwindling
un-stop-pable	un-stop-pa-ble
vex-ing	vexing
causal-i-ty	cau-sal-i-ty
lulu	lu-lu
envy	en-vy
agency	a-gen-cy
scat-tered	scattered
blood-thirsty	blood-thirst-y
elec-tro-car-dio-gram	e-lec-tro-car-di-o-gram
ex-ult-ing	exulting
ex-pect-ed	expected
pharaoh	phar-aoh
gawky	gawk-y
si-lencer	si-lenc-er
botanist	bot-a-nist
strug-gling	struggling
in-de-pen-dence	in-de-pend-ence
dis-playable	displayable
mono-lith	mon-o-lith
inat-ten-tion	in-at-ten-tion
an-ti-sta-t-ic	an-ti-stat-ic
ex-pend-able	ex-pend-a-ble
ex-plana-to-ry	ex-plan-a-to-ry
ni-hilist	ni-hil-ist
beefeater	beef-eat-er
share-able	share-a-ble
as-para-gus	as-par-a-gus
anom-aly	a-nom-a-ly
bloody	blood-y
cu-ra-to-r-i-al	cu-ra-to-ri-al
aqua-naut	aq-ua-naut
detox-i-fy	de-tox-i-fy
lithi-um	lith-i-um
changeover	change-o-ver
im-munol-o-gy	im-mu-nol-o-gy
lega-tee	leg-a-tee
archdea-con	arch-dea-con
her-mitage	her-mit-age
silage	si-lage
sago	sa-go
enor-mi-ty	e-nor-mi-ty
sier-ra	si-er-ra
ca-nary	ca-nar-y
ca-su-istry	cas-u-ist-ry
whiskey	whis-key
elec-tor	e-lec-tor
hatch-ery	hatch-er-y
labi-al	la-bi-al
city	cit-y
mini	min-i
ru-ined	ruined
joey	jo-ey
obe-di-ent-ly	o-be-di-ent-ly
flick-er-ing	flickering
claus-tro-pho-bia	claus-tro-pho-bi-a
repet-i-tive	re-pet-i-tive
venue	ven-ue
os-teopa-thy	os-te-op-a-thy
rewrite	re-write
dea-coness	dea-con-ess
re-tini-tis	ret-i-ni-tis
crys-talline	crys-tal-line
avens	av-ens
halo	ha-lo
de-tectably	de-tect-a-bly
palatal	pal-a-tal
mono-lith-ic	mon-o-lith-ic
clavi-chord	clav-i-chord
stealth-ily	stealth-i-ly
dis-pos-able	dis-pos-a-ble
avi-a-tion	a-vi-a-tion
poly-merase	pol-y-mer-ase
un-con-scionable	un-con-scion-a-ble
serai	se-ra-i
wrestler	wres-tler
playfel-low	play-fel-low
bluesy	blues-y
anon	a-non
rel-a-tivis-tic	rel-a-tiv-is-tic
va-ri-ety	va-ri-e-ty
tu-atara	tu-a-ta-ra
pass-able	pass-a-ble
pussy-cat	pussycat
hardy	har-dy
dri-vable	driv-a-ble
chorea	cho-re-a
metas-ta-sis	me-tas-ta-sis
sparkle	spar-kle
opi-ate	o-pi-ate
ma-tri-lin-eal	mat-ri-lin-e-al
sta-mi-na	stam-i-na
tit-ter-ing	tittering
bo-som	bos-om
anony-mous	a-non-y-mous
mis-align-ment	mis-a-lign-ment
gaiter	gait-er
carpal	car-pal
pres-tidig-i-ta-tion	pres-ti-dig-i-ta-tion
un-steady	un-stead-y
foghorn	fog-horn
eerie	ee-rie
medal	med-al
sa-fari	sa-fa-ri
so-cialite	so-cial-ite
in-ex-orably	in-ex-o-ra-bly
stunt-ed	stunted
even-tu-al-ly	e-ven-tu-al-ly
cus-tomer	cus-tom-er
mankind	man-kind
nasal	na-sal
ho-n-our	ho-nour
cat-a-clysmic	cat-a-clys-mic
health-ily	health-i-ly
geom-e-try	ge-om-e-try
thrifty	thrift-y
bearskin	bear-skin
sloven-ly	slov-en-ly
epi-demi-ol-o-gy	ep-i-de-mi-ol-o-gy
feal-ty	fe-al-ty
clayey	clay-ey
ir-re-solv-able	ir-re-solv-a-ble
elec-tro-cute	e-lec-tro-cute
dairy-ing	dair-y-ing
re-union	re-un-ion
cheesy	chees-y
ho-minid	hom-i-nid
harshen	harsh-en
pyra-mi-dal	py-ram-i-dal
axle	ax-le
re-arrange-ment	re-ar-range-ment
di-rec-torate	di-rec-to-rate
as-siduity	as-si-du-i-ty
drink-able	drink-a-ble
fid-gety	fidg-et-y
in-dec-lin-able	in-de-clin-a-ble
orang	o-rang
mio-sis	mi-o-sis
bal-cony	bal-co-ny
potash	pot-ash
gal-vanome-ter	gal-va-nom-e-ter
sta-t-ics	stat-ics
rep-til-ian	rep-til-i-an
com-menter	com-ment-er
pro-pri-ety	pro-pri-e-ty
se-lectee	se-lect-ee
pe-riphrastic	per-i-phras-tic
chromite	chro-mite
pyrite	py-rite
coter-mi-nous	co-ter-mi-nous
con-trol-lable	con-trol-la-ble
mistyp-ings	mis-ty-pings
biop-sy	bi-op-sy
asy-lum	a-sy-lum
in-ad-ver-tent-ly	in-ad-vert-ent-ly
over-ripe	o-ver-ripe
dis-cred-itable	dis-cred-it-a-ble
steadi-ly	stead-i-ly
irate	i-rate
lamp-lighter	lamp-light-er
es-capism	es-cap-ism
com-mis-sioned	commissioned
unso-cial	un-so-cial
lava	la-va
trashy	trash-y
he-li-copter	hel-i-cop-ter
omi-nous-ly	om-i-nous-ly
crus-tacean	crus-ta-cean
tasty	tast-y
trans-for-ma-tive	trans-form-a-tive
con-fronta-tion	con-fron-ta-tion
un-sellable	un-sell-a-ble
caramel	car-a-mel
no-tice-able	no-tice-a-ble
rata-touille	ra-ta-touille
fatu-ous	fat-u-ous
de-mog-ra-ph-er	de-mog-ra-pher
astrad-dle	a-strad-dle
over-feed	o-ver-feed
astig-ma-tism	a-stig-ma-tism
ab-solute-ly	ab-so-lute-ly
litur-gi-cal	li-tur-gi-cal
en-force-able	en-force-a-ble
ob-se-quious	ob-se-qui-ous
viol	vi-ol
antonym	an-to-nym
teleg-ra-phy	te-leg-ra-phy
stranger	stran-ger
uned-i-fy-ing	un-ed-i-fy-ing
halon	hal-on
de-riva-tion	der-i-va-tion
elu-ci-da-tion	e-lu-ci-da-tion
dis-agree-ment	dis-a-gree-ment
me-te-orite	me-te-or-ite
pewter	pew-ter
in-tra-mur-al	in-tra-mu-ral
sander	sand-er
swarm-ing	swarming
emo-tion-al-ly	e-mo-tion-al-ly
re-pro-ducibil-i-ty	re-pro-duc-i-bil-i-ty
vir-tu-oso	vir-tu-o-so
leak-ing	leaking
scream-ing	screaming
tetra-he-dron	tet-ra-he-dron
ex-tend-able	ex-tend-a-ble
het-ero-sex-u-al-i-ty	het-er-o-sex-u-al-i-ty
waspish	wasp-ish
siren	si-ren
squadron	squad-ron
mono-lin-gual	mon-o-lin-gual
toluene	tol-u-ene
over-win-ter	o-ver-win-ter
gestalt	ge-stalt
thug-gery	thug-ger-y
loathing	loath-ing
re-bury	re-bur-y
cu-rio	cu-ri-o
li-able	li-a-ble
uni-tary	u-ni-tar-y
unas-suaged	un-as-suaged
opin-ion	o-pin-ion
iris	i-ris
nest-ing	nesting
pre-sen-ta-tion	pres-en-ta-tion
blaster	blast-er
epi-gram-mat-ic	ep-i-gram-mat-ic
ap-palling-ly	ap-pall-ing-ly
coda	co-da
om-nipresent	om-ni-pres-ent
car-bona-ceous	car-bo-na-ceous
boule-vard	boul-e-vard
coro-ner	cor-o-ner
afraid	a-fraid
re-uni-fi-ca-tion	re-u-ni-fi-ca-tion
ap-plic-a-bil-i-ty	ap-pli-ca-bil-i-ty
legged	leg-ged
leaky	leak-y
shoplift	shop-lift
penul-ti-mate	pe-nul-ti-mate
kelvin	kel-vin
daisy	dai-sy
wealthy	wealth-y
look-ing	looking
cheer-ing	cheering
bar-barous	bar-ba-rous
swarthy	swarth-y
ceme-tery	cem-e-ter-y
brainy	brain-y
alive	a-live
prof-itabil-i-ty	prof-it-a-bil-i-ty
crozi-er	cro-zier
domi-no	dom-i-no
reap-pear-ance	re-ap-pear-ance
chrono-graph	chron-o-graph
or-nithol-o-gist	or-ni-thol-o-gist
howler	howl-er
mor-phia	mor-phi-a
glaciat-ed	gla-ci-at-ed
ghana	ghana
depre-da-tion	dep-re-da-tion
fool-ery	fool-er-y
manda-to-ry	man-da-to-ry
mistle-toe	mis-tle-toe
every-one	eve-ry-one
pheromone	pher-o-mone
caveat	ca-ve-at
ap-pari-tion	ap-pa-ri-tion
seg-ment-ed	seg-men-ted
forego	fore-go
wa-terbed	wa-ter-bed
evoca-tive	e-voc-a-tive
phy-lac-tery	phy-lac-ter-y
ide-al-ism	i-de-al-ism
cobalt	co-balt
tangy	tang-y
ir-re-mov-able	ir-re-mov-a-ble
pa-troness	pa-tron-ess
gra-tu-itous-ly	gra-tu-i-tous-ly
de-spi-ca-ble	des-pi-ca-ble
smoky	smok-y
emo-tive	e-mo-tive
in-ter-lock-ing	in-ter-loc-king
backer	back-er
in-nu-mer-able	in-nu-mer-a-ble
maisonette	mai-son-ette
re-spectable	re-spect-a-ble
curlew	cur-lew
mar-ke-teer	mar-ket-eer
satchel	satch-el
mildewy	mil-dew-y
pirou-ette	pir-ou-ette
mar-ketable	mar-ket-a-ble
milord	mi-lord
su-prema-cist	su-prem-a-cist
minute-ly	mi-nute-ly
rephrase	re-phrase
strudel	stru-del
pro-pa-gan-dist	prop-a-gan-dist
foxy	fox-y
fermi-on	fer-mi-on
for-syth-ia	for-syth-i-a
metronome	met-ro-nome
machi-na-tion	mach-i-na-tion
rhetoric	rhet-o-ric
famine	fam-ine
derelict	der-e-lict
un-der-body	un-der-bod-y
here-inafter	here-in-af-ter
glut-tony	glut-ton-y
awestruck	awe-struck
sleepy	sleep-y
neg-ligee	neg-li-gee
coma	co-ma
purview	pur-view
sober-ing	sobering
stumpy	stump-y
be-trothal	be-troth-al
dis-solute	dis-so-lute
capri-ole	cap-ri-ole
budgeri-gar	budg-er-i-gar
cari-bou	car-i-bou
leath-ery	leath-er-y
repli-ca	rep-li-ca
glut-to-nous	glut-ton-ous
con-tention	con-ten-tion
he-liotrope	he-li-o-trope
unan-i-mous-ly	u-nan-i-mous-ly
pseu-do-ny-mous	pseu-don-y-mous
topo-log-i-cal	top-o-log-i-cal
polon-aise	pol-o-naise
ethno-graph-ic	eth-no-graph-ic
mucky	muck-y
lugubri-ous	lu-gu-bri-ous
lep-rechaun	lep-re-chaun
damni-fy	dam-ni-fy
dis-turbing-ly	dis-turb-ing-ly
witch-ery	witch-er-y
walkover	walk-o-ver
orca	or-ca
over-spill	o-ver-spill
skele-ton	skel-e-ton
ob-scu-ran-tism	ob-scu-rant-ism
overt	o-vert
idol-a-trous	i-dol-a-trous
mag-is-te-r-i-al	mag-is-te-ri-al
sideshow	side-show
su-per-fi-cial-i-ty	su-per-fi-ci-al-i-ty
reprise	re-prise
protest	pro-test
re-alpoli-tik	re-al-po-li-tik
fel-la-tio	fel-la-ti-o
cagoule	ca-goule
ura-ni-um	u-ra-ni-um
on-tol-ogy	on-tol-o-gy
equal-i-ty	e-qual-i-ty
brassiere	bras-siere
hy-per-boloid	hy-per-bo-loid
cough-ing	coughing
de-sali-na-tion	de-sal-i-na-tion
con-spir-a-to-r-i-al	con-spir-a-to-ri-al
hypochon-dria	hy-po-chon-dri-a
emul-sion	e-mul-sion
triplet	tri-plet
telekine-sis	tel-e-ki-ne-sis
crier	cri-er
seedling	seed-ling
record-ed	re-cor-ded
car-borun-dum	car-bo-run-dum
ocean	o-cean
retic-u-lat-ed	re-tic-u-lat-ed
discog-ra-phy	dis-cog-ra-phy
dweller	dwell-er
patho-log-i-cal-ly	path-o-log-i-cal-ly
cata-ton-ic	cat-a-ton-ic
awhile	a-while
barony	bar-o-ny
er-gonom-ics	er-go-nom-ics
graphol-o-gy	graph-ol-o-gy
laugh-ably	laugh-a-bly
dis-abled	dis-a-bled
chili	chil-i
tremen-dous	tre-men-dous
undis-cov-ered	un-dis-cov-ered
prompter	prompt-er
beloved	be-lov-ed
pauci-ty	pau-ci-ty
eu-phemistic	eu-phe-mis-tic
menis-cus	me-nis-cus
copy-right	cop-y-right
cupo-la	cu-po-la
seascape	sea-scape
lighter	light-er
de-gauss-ing	degaussing
geno-cide	gen-o-cide
au-gury	au-gu-ry
lemon-ade	lem-on-ade
reap-ply	re-ap-ply
nether	neth-er
auger	au-ger
keynote	key-note
pastis	pas-tis
anti	an-ti
among	a-mong
ini-tia-tor	in-i-ti-a-tor
tun-able	tun-a-ble
charis-ma	cha-ris-ma
bal-alai-ka	bal-a-lai-ka
min-is-te-r-i-al	min-is-te-ri-al
re-align-ment	re-a-lign-ment
diplo-mat	dip-lo-mat
un-du-lat-ing	un-du-la-ting
di-gestible	di-gest-i-ble
over-shad-ow	o-ver-shad-ow
in-de-ci-pher-able	in-de-ci-pher-a-ble
usu-al-ly	u-su-al-ly
propen-si-ty	pro-pen-si-ty
vari-ate	var-i-ate
de-plorable	de-plor-a-ble
sub-species	sub-spe-cies
quencher	quench-er
sto-ical	sto-i-cal
man-ager-ess	man-ag-er-ess
de-liv-er-able	de-liv-er-a-ble
philo-soph-i-cal	phil-o-soph-i-cal
leo-tard	le-o-tard
con-stituen-cy	con-stit-u-en-cy
bac-carat	bac-ca-rat
im-par-tial-i-ty	im-par-ti-al-i-ty
un-trans-lat-able	un-trans-lat-a-ble
oblig-ing-ly	o-blig-ing-ly
mis-cel-la-neous	mis-cel-la-ne-ous
de-nial	de-ni-al
un-able	un-a-ble
trendy	trend-y
im-muno-sup-pres-sion	im-mu-no-sup-pres-sion
hearthrug	hearth-rug
elope	e-lope
co-mestible	co-mes-ti-ble
ben-e-fi-cia-ry	ben-e-fi-ci-ar-y
badtem-pered	bad-tem-pered
isosce-les	i-sos-ce-les
rangy	rang-y
over-sleep	o-ver-sleep
rachis	ra-chis
pronom-i-nal	pro-nom-i-nal
gov-er-nance	gov-ern-ance
upon	up-on
con-ser-v-a-tive	con-serv-a-tive
rein-vest	re-in-vest
ap-nea	ap-ne-a
stratos-pher-ic	strat-o-spher-ic
rein-te-gra-tion	re-in-te-gra-tion
paci-fy	pac-i-fy
so-ci-olin-guis-tics	so-ci-o-lin-guis-tics
seance	se-ance
mar-que	marque
mul-tira-cial	mul-ti-ra-cial
ex-che-quer	ex-cheq-uer
farad	far-ad
prov-ably	prov-a-bly
va-porous	va-por-ous
ethos	e-thos
ashamed	a-shamed
knitwear	knit-wear
re-former	re-form-er
sahib	sa-hib
ri-fled	rifled
caiman	cai-man
schoolmistress	school-mis-tress
tremo-lo	trem-o-lo
tapi-o-ca	tap-i-o-ca
ra-dius	ra-di-us
over-play	o-ver-play
corset	cor-set
arc-ing	arcing
clam-p-down	clamp-down
retroac-tive-ly	ret-ro-ac-tive-ly
bom-bardier	bom-bar-dier
be-atif-ic	be-a-tif-ic
livid	liv-id
de-tach-able	de-tach-a-ble
macabre	ma-ca-bre
ra-dio-car-bon	ra-di-o-car-bon
limpet	lim-pet
lessor	les-sor
spanker	spank-er
un-sea-son-ably	un-sea-son-a-bly
ha-giog-ra-phy	hag-i-og-ra-phy
de-fen-dant	de-fend-ant
doubtless-ly	doubt-less-ly
crazy	cra-zy
un-equiv-o-cal-ly	un-e-quiv-o-cal-ly
oval	o-val
grandios-i-ty	gran-di-os-i-ty
toothy	tooth-y
millpond	mill-pond
genoa	gen-o-a
prosce-ni-um	pro-sce-ni-um
rani	ra-ni
un-opened	un-o-pened
unit	u-nit
elo-cu-tion	el-o-cu-tion
polem-i-cal	po-lem-i-cal
un-com-mu-nica-tive	un-com-mu-ni-ca-tive
styl-is-tics	sty-lis-tics
no-ti-fi-able	no-ti-fi-a-ble
apart-ness	a-part-ness
ex-ploita-tive	ex-ploit-a-tive
prog-en-i-tor	pro-gen-i-tor
mea-sure-ment	meas-ure-ment
bumpy	bump-y
co-eval	co-e-val
papule	pap-ule
teach-able	teach-a-ble
gravi-ton	grav-i-ton
mica	mi-ca
cervix	cer-vix
bar-l-ey-corn	bar-ley-corn
pe-rusal	pe-rus-al
spinach	spin-ach
cyclic	cy-clic
philol-o-gy	phi-lol-o-gy
eco-log-i-cal-ly	ec-o-log-i-cal-ly
con-for-mi-ty	con-form-i-ty
prove-nance	prov-e-nance
mega-lith-ic	meg-a-lith-ic
scrib-bling	scribbling
bre-viary	bre-vi-ar-y
au-toma-ton	au-tom-a-ton
copy-cat	cop-y-cat
per-mit-ting	permitting
paean	pae-an
mega	meg-a
periscope	per-i-scope
lega-cy	leg-a-cy
eater	eat-er
kestrel	kes-trel
con-t-a-m-i-na-tion	con-tam-i-na-tion
sun-burned	sunburned
apolo-getic	a-pol-o-get-ic
medic	med-ic
pout-ing	pouting
re-spectabil-i-ty	re-spect-a-bil-i-ty
kitchen	kitch-en
swimwear	swim-wear
sealant	seal-ant
beret	be-ret
notwith-stand-ing	not-with-stand-ing
turfy	turf-y
undy-ing	un-dy-ing
reci-procity	rec-i-proc-i-ty
over-cast	o-ver-cast
bindery	bind-er-y
poly-chro-mat-ic	pol-y-chro-mat-ic
es-capist	es-cap-ist
sunken	sunk-en
porno	por-no
piti-less	pit-i-less
poly-the-is-tic	pol-y-the-is-tic
edi-tion	e-di-tion
gory	gor-y
periglacial	per-i-gla-cial
doer	do-er
den-tistry	den-tis-try
gramo-phone	gram-o-phone
de-r-ate	de-rate
flamin-go	fla-min-go
place-bo	pla-ce-bo
in-fantry	in-fan-try
com-plain-ing	complaining
bolero	bo-le-ro
dreamy	dream-y
fal-ter-ing	fal-te-ring
bi-og-ra-ph-er	bi-og-ra-pher
mus-ke-teer	mus-ket-eer
sur-vivor	sur-vi-vor
obelisk	ob-e-lisk
tar-ragon	tar-ra-gon
mis-sy	miss-y
mi-croor-gan-ism	mi-cro-or-gan-ism
ide-o-log-i-cal-ly	i-de-o-log-i-cal-ly
emi-rate	e-mir-ate
residue	res-i-due
ego-tism	e-go-tism
rosary	ro-sa-ry
seag-ull	sea-gull
lo-quaci-ty	lo-quac-i-ty
piv-otal	piv-ot-al
lul-la-by	lull-a-by
yogi	yo-gi
stripling	strip-ling
mer-chantable	mer-chant-a-ble
pre-dictably	pre-dict-a-bly
video-con-fer-enc-ing	vid-e-o-con-fer-enc-ing
as-cen-der	as-cend-er
tele-scope	tel-e-scope
prepo-si-tion	prep-o-si-tion
car-cino-gen-e-sis	car-cin-o-gen-e-sis
un-hesi-tat-ing	un-hes-i-tat-ing
re-sult-ing	resulting
over-hang	o-ver-hang
burly	bur-ly
bur-geon-ing	burgeoning
valise	va-lise
mal-leable	mal-le-a-ble
cryo-stat	cry-o-stat
unique	u-nique
banker	bank-er
mon-e-tarism	mon-e-ta-rism
bug-gered	buggered
glitzy	glitz-y
ap-pre-cia-bly	ap-pre-ci-a-bly
con-ve-nient-ly	con-ven-ient-ly
crater	cra-ter
con-tem-po-rary	con-tem-po-rar-y
aver	a-ver
cus-tom-ary	cus-tom-ar-y
de-con-t-a-m-i-na-tion	de-con-tam-i-na-tion
propane	pro-pane
tele-sales	tel-e-sales
islet	is-let
over-crowd	o-ver-crowd
un-de-ni-able	un-de-ni-a-ble
moral	mor-al
tri-atom-ic	tri-a-tom-ic
reim-ple-ment-ed	reimplemented
petu-lance	pet-u-lance
tepid	tep-id
mas-tery	mas-ter-y
tarsal	tar-sal
eques-tri-an-ism	e-ques-tri-an-ism
uni-di-rec-tion-al	u-ni-di-rec-tion-al
turgid	tur-gid
teenage	teen-age
orig-i-nate	o-rig-i-nate
iron-works	i-ron-works
spinal	spi-nal
backpedal	back-ped-al
usurp-er	u-surp-er
omit	o-mit
un-ques-tion-able	un-ques-tion-a-ble
igua-na	i-gua-na
any-how	an-y-how
dif-fer-en-tiable	dif-fer-en-ti-a-ble
prankster	prank-ster
mort-gagee	mort-ga-gee
trade-marked	trademarked
shandy	shan-dy
mora-to-ri-um	mor-a-to-ri-um
rock-ery	rock-er-y
warhorse	war-horse
evict	e-vict
re-li-ably	re-li-a-bly
cru-cible	cru-ci-ble
junker	jun-ker
springy	spring-y
navel	na-vel
laud-ed	lauded
dossier	dos-si-er
tiara	ti-ar-a
crafty	craft-y
cy-clotron	cy-clo-tron
ax-il-lary	ax-il-lar-y
tum-bled	tumbled
very	ver-y
un-holy	un-ho-ly
unas-sist-ed	un-as-sist-ed
pupa	pu-pa
mau-soleum	mau-so-le-um
per-fumery	per-fum-er-y
un-ordered	un-or-dered
para-noia	par-a-noi-a
peri-na-tal	per-i-na-tal
uni-formed	u-ni-formed
geo-syn-chro-nous	ge-o-syn-chro-nous
au-thoress	au-thor-ess
sus-pend-ed	sus-pen-ded
needy	need-y
crinkly	crin-kly
semi-fi-nal-ist	sem-i-fi-nal-ist
vi-able	vi-a-ble
de-signed-ly	de-sign-ed-ly
chan-cellery	chan-cel-ler-y
elapse	e-lapse
heiress	heir-ess
imam	i-mam
hy-dro-elec-tric	hy-dro-e-lec-tric
beery	beer-y
adapt	a-dapt
rub-bishy	rub-bish-y
mas-sacre	mas-sa-cre
mer-ce-nary	mer-ce-nar-y
data-base	da-ta-base
poli-ty	pol-i-ty
repa-ra-tion	rep-a-ra-tion
ne-go-tia-tor	ne-go-ti-a-tor
uni-verse	u-ni-verse
cus-tody	cus-to-dy
arouse	a-rouse
monarch	mon-arch
nobly	no-bly
ep-ithe-li-um	ep-i-the-li-um
dassie	das-sie
pointil-lism	poin-til-lism
over-dose	o-ver-dose
flanker	flank-er
quan-tifi-ca-tion	quan-ti-fi-ca-tion
serendip-i-ty	ser-en-dip-i-ty
scan-dalous	scan-dal-ous
syn-onymy	syn-on-y-my
moorhen	moor-hen
paunchy	paunch-y
pageantry	pag-eant-ry
amaze	a-maze
literati	lit-e-ra-ti
cheru-bic	che-ru-bic
jester	jest-er
aban-don-ment	a-ban-don-ment
decile	dec-ile
un-palat-able	un-pal-at-a-ble
suet	su-et
flotil-la	flo-til-la
aun-tie	aunt-ie
un-count-able	un-count-a-ble
en-cycli-cal	en-cyc-li-cal
round-about	round-a-bout
sky-scraper	sky-scrap-er
man-age-able	man-age-a-ble
avari-cious	av-a-ri-cious
mys-tery	mys-ter-y
oral-ly	o-ral-ly
coralline	cor-al-line
para-medic	par-a-med-ic
im-puni-ty	im-pu-ni-ty
kerosene	ker-o-sene
stroller	stroll-er
bur-sary	bur-sa-ry
para-mount-cy	par-a-mount-cy
mar-keter	mar-ket-er
serene-ly	se-rene-ly
over-spend	o-ver-spend
beau-teous	beau-te-ous
elu-sive	e-lu-sive
breast-feed-ing	breastfeeding
coca	co-ca
proph-esy	proph-e-sy
ar-rhyth-mia	ar-rhyth-mi-a
evanes-cent	ev-a-nes-cent
over-re-act	o-ver-re-act
resid-ual	re-sid-u-al
palate	pal-ate
im-pro-pri-ety	im-pro-pri-e-ty
seroneg-a-tive	se-ro-neg-a-tive
elude	e-lude
counter	coun-ter
over-shoot	o-ver-shoot
droopy	droop-y
cheva-lier	chev-a-lier
monomer	mon-o-mer
thriller	thrill-er
scholas-ti-cism	scho-las-ti-cism
philis-tine	phil-is-tine
eval-u-a-tive	e-val-u-a-tive
mimet-ic	mi-met-ic
scratchy	scratch-y
an-niver-sary	an-ni-ver-sa-ry
breakup	break-up
pedol-o-gy	pe-dol-o-gy
pavil-ion	pa-vil-ion
me-nial	me-ni-al
redo-lent	red-o-lent
mil-lisec-ond	mil-li-sec-ond
tri-adic	tri-ad-ic
pul-monary	pul-mo-nar-y
video	vid-e-o
cathar-tic	ca-thar-tic
shiv-ery	shiv-er-y
in-hab-it-able	in-hab-it-a-ble
mus-cu-loskele-tal	mus-cu-lo-skel-e-tal
poltroon	pol-troon
tonal	ton-al
bi-l-abi-al	bi-la-bi-al
re-spectably	re-spect-a-bly
jugu-lar	jug-u-lar
brack-et-ed	bracketed
posit	pos-it
stopover	stop-o-ver
mod-icum	mod-i-cum
he-li-cal	hel-i-cal
avoid-able	a-void-a-ble
mis-ery	mis-er-y
sauer-kraut	sau-er-kraut
en-graver	en-grav-er
habi-ta-tion	hab-i-ta-tion
chloro-phyll	chlo-ro-phyll
an-throp-ic	an-thro-pic
tilde	til-de
per-turb-ing	perturbing
tru-cu-lent	truc-u-lent
the-atri-cals	the-at-ri-cals
tear-away	tear-a-way
kook-abur-ra	kook-a-bur-ra
pedi-gree	ped-i-gree
lectern	lec-tern
dis-ori-en-tat-ed	disorientated
busty	bust-y
hero-ism	her-o-ism
mi-cro-bial	mi-cro-bi-al
uni-ver-sal-i-ty	u-ni-ver-sal-i-ty
ex-plo-ration	ex-plo-ra-tion
unim-pres-sive	un-im-pres-sive
in-sou-ciance	in-sou-ci-ance
ar-guable	ar-gu-a-ble
ha-track	hat-rack
mar-malade	mar-ma-lade
scalpel	scal-pel
reify	re-i-fy
Words with errors: 1895
Words with incorrect number of syllables: 1799
Total evluated: 6500
Perfect accuracy: 0.71
Number of syllables accuracy: 0.72
Average Levenshtein Distance(across incorrect words): 1.19
