Attempt	Real
con-stab-u-lary	con-stab-u-lar-y
gour-d	gourd
in-audi-ble	in-au-di-ble
vestibu-lar	ves-tib-u-lar
rev-er-en-t	rev-er-ent
calder-a	cal-de-ra
poly-mor-phis-m	pol-y-mor-phism
s-e-lec-t	se-lect
buoy	bu-oy
lager	la-ger
hand-bel-l	hand-bell
epi-demi-o-log-i-cal	ep-i-de-mi-o-log-i-cal
lath-e	lathe
bevy	bev-y
over-weight	o-ver-weight
cycli-cal	cy-cli-cal
im-puni-ty	im-pu-ni-ty
s-melt	smelt
s-plen-did	splen-did
shipown-er	ship-own-er
lacteal	lac-te-al
ap-pari-tion	ap-pa-ri-tion
cir-cling	circling
centi-grade	cen-ti-grade
au-tomat	au-to-mat
garter	gar-ter
dis-claimer	dis-claim-er
golfer	golf-er
lib-er-tar-i-an-is-m	lib-er-tar-i-an-ism
coupon	cou-pon
share-able	share-a-ble
or-ga-nized	or-gan-ized
het-ero-sex-u-al-i-ty	het-er-o-sex-u-al-i-ty
di-rec-torate	di-rec-to-rate
phy-loge-ny	phy-log-e-ny
di-uret-ic	di-u-ret-ic
eat-able	eat-a-ble
dis-traugh-t	dis-traught
topol-o-gy	to-pol-o-gy
s-tone-ma-son	stone-ma-son
hyp-ocrite	hyp-o-crite
re-duc-ible	re-duc-i-ble
shrim-p	shrimp
s-tuc-co	stuc-co
pro-pa-gan-da	prop-a-gan-da
c-itadel	cit-a-del
limou-sine	lim-ou-sine
es-capis-m	es-cap-ism
per-fidy	per-fi-dy
u-nim-peach-able	un-im-peach-a-ble
iron-ing	i-ron-ing
s-tiff-en	stiff-en
endgame	end-game
draugh-t	draught
de-cen-t	de-cent
y-acht-ing	yacht-ing
prod-uc-t	prod-uct
s-park-ly	spar-kly
sep-a-ratism	sep-a-ra-tism
sup-ple-men-tary	sup-ple-men-ta-ry
in-dis-putable	in-dis-put-a-ble
hayloft	hay-loft
archery	ar-cher-y
afraid	a-fraid
up-silon	up-si-lon
hobo	ho-bo
ir-ri-tabil-i-ty	ir-ri-ta-bil-i-ty
repa-tri-a-tion	re-pa-tri-a-tion
framer	fram-er
dotage	dot-age
fuz-z	fuzz
aza-lea	a-zal-ea
me-galith-ic	meg-a-lith-ic
g-lu-ta-mate	glu-ta-mate
di-alec-t	di-a-lect
read-abil-i-ty	read-a-bil-i-ty
brun-t	brunt
damnable	dam-na-ble
an-techam-ber	an-te-cham-ber
ni-troge-nous	ni-trog-e-nous
trans-porta-tion	trans-por-ta-tion
multi-na-tion-al	mul-ti-na-tion-al
ex-citable	ex-cit-a-ble
cruller	crul-ler
laden	lad-en
s-coundrel	scoun-drel
s-cam-p	scamp
transep-t	tran-sept
may-oral	may-or-al
touris-tic	tour-is-tic
s-park	spark
saga-cious	sa-ga-cious
drach-m	drachm
reaf-fir-ma-tion	re-af-fir-ma-tion
whisker	whisk-er
s-worn	sworn
moist-en	mois-ten
turnover	turn-o-ver
pur-port-ed	purported
undi-lut-ed	un-di-lut-ed
ra-bid	rab-id
nugget	nug-get
tan-nery	tan-ner-y
lov-able	lov-a-ble
top-i-ary	to-pi-ar-y
un-able	un-a-ble
elec-tron-ic-s	e-lec-tron-ics
clair-voy-an-t	clair-voy-ant
coac-tion	co-ac-tion
elu-ci-da-tion	e-lu-ci-da-tion
bazaar	ba-zaar
meta-mor-pho-sis	met-a-mor-pho-sis
i-n-ad-vis-able	in-ad-vis-a-ble
u-n-avoid-able	un-a-void-a-ble
lovesick	love-sick
in-dictable	in-dict-a-ble
birthright	birth-right
im-per-son-ation	im-per-son-a-tion
flanker	flank-er
zany	za-ny
delic-t	de-lict
fer-al	fe-ral
in-volve-men-t	in-volve-ment
dic-tio-n	dic-tion
stylis-tic-s	sty-lis-tics
re-spec-t	re-spect
sinis-tral	sin-is-tral
springer	spring-er
win-ery	win-er-y
coinage	coin-age
codling	cod-ling
tru-an-t	tru-ant
de-pend-abil-i-ty	de-pend-a-bil-i-ty
s-calp	scalp
zephyr	zeph-yr
hal-l	hall
satin	sat-in
s-pa-tial-ly	spa-tial-ly
coolan-t	cool-ant
un-abashed-ly	un-a-bash-ed-ly
steady	stead-y
can-ni-bal-is-m	can-ni-bal-ism
rene-gade	ren-e-gade
lam-plit	lamp-lit
far-m	farm
hal-ibut	hal-i-but
briskly	brisk-ly
apo-lit-i-cal	a-po-lit-i-cal
breathy	breath-y
geezer	gee-zer
idyl-l	i-dyll
mod-e	mode
l-o-gis-tic	lo-gis-tic
rapi-er	ra-pi-er
slav-ery	slav-er-y
holo-graph-ic	hol-o-graph-ic
s-ti-fling	sti-fling
s-tock-pile	stock-pile
h-es-i-tan-cy	hes-i-tan-cy
in-sulin	in-su-lin
mega-phone	meg-a-phone
s-plice	splice
de-cider	de-cid-er
raven	ra-ven
va-ri-ety	va-ri-e-ty
sauna	sau-na
vi-o-l	vi-ol
ca-cophonous	ca-coph-o-nous
u-ni-tary	u-ni-tar-y
fa-tal-is-m	fa-tal-ism
dis-turbing-ly	dis-turb-ing-ly
overeat	o-ver-eat
in-ter-locu-to-ry	in-ter-loc-u-to-ry
thau-maturge	thau-ma-turge
iri-des-cen-t	ir-i-des-cent
pi-anola	pi-a-no-la
rooftop	roof-top
ge-o-mag-net-i-cal-ly	ge-o-mag-ne-ti-cal-ly
cedil-la	ce-dil-la
re-mov-able	re-mov-a-ble
cele-b	ce-leb
megas-tar	meg-a-star
dredger	dredg-er
ir-recov-er-able	ir-re-cov-er-a-ble
diox-in	di-ox-in
s-care-crow	scare-crow
s-teeply	steep-ly
elec-tri-cal	e-lec-tri-cal
casi-no	ca-si-no
builder	build-er
in-signif-i-can-t	in-sig-nif-i-cant
chantry	chan-try
over-head	o-ver-head
s-moother	smooth-er
in-tac-t	in-tact
hexa-dec-i-mal	hex-a-dec-i-mal
chau-vin-is-m	chau-vin-ism
par-tic-i-pan-t	par-tic-i-pant
sooty	soot-y
d-is-fig-ure-men-t	dis-fig-ure-ment
gala	ga-la
ephemer-a	e-phem-er-a
bene-fac-tress	ben-e-fac-tress
bolero	bo-le-ro
salu-tary	sal-u-tar-y
i-nar-tic-u-late	in-ar-tic-u-late
ogle	o-gle
rip-pling	rippling
hy-drochlo-ride	hy-dro-chlo-ride
helpline	help-line
fig-u-ra-tive-ly	fig-ur-a-tive-ly
pearly	pearl-y
salien-t	sa-li-ent
bridal	brid-al
s-mooch	smooch
u-n-avoid-ably	un-a-void-a-bly
perky	perk-y
blun-der-ing	blundering
nasty	nas-ty
tou-sled	tousled
gloomy	gloom-y
lessee	les-see
pec-toral	pec-to-ral
tri-den-t	tri-dent
mono-ton-ic	mon-o-ton-ic
at-tribute	at-trib-ute
s-ta-tion-mas-ter	sta-tion-mas-ter
squirearchy	squire-ar-chy
over-step	o-ver-step
re-fur-bish-men-t	re-fur-bish-ment
k-ing-fish-er	king-fish-er
rever-ie	rev-er-ie
in-fec-t	in-fect
omega	o-me-ga
labyrinth	lab-y-rinth
s-light	slight
haiku	hai-ku
fraugh-t	fraught
pedestal	ped-es-tal
over-feed	o-ver-feed
pun-ish-men-t	pun-ish-ment
col-le-gial	col-le-gi-al
killer	kil-ler
ha-track	hat-rack
lumpen	lum-pen
pol-lu-tan-t	pol-lu-tant
chim-p	chimp
s-ta-tis-ti-cal	sta-tis-ti-cal
un-pro-nounce-able	un-pro-nounce-a-ble
pro-pri-etress	pro-pri-e-tress
g-nat	gnat
ig-no-min-ious	ig-no-min-i-ous
rosette	ro-sette
ini-tial	in-i-tial
seis-mome-ter	seis-mom-e-ter
rain-fal-l	rain-fall
avail-abil-i-ty	a-vail-a-bil-i-ty
crin-kled	crinkled
sym-po-sium	sym-po-si-um
re-can-t	re-cant
batik	ba-tik
plumba-go	plum-ba-go
skim-p	skimp
dearie	dear-ie
un-du-lat-ing	un-du-la-ting
chore-o-graph-ic	cho-re-o-graph-ic
un-en-durable	un-en-dur-a-ble
temptress	tempt-ress
mar-que	marque
s-mash-ing	smash-ing
in-ter-change-able	in-ter-change-a-ble
restive	res-tive
look-ing	looking
rapid	rap-id
high-lander	high-lan-der
gov-ern-ing	governing
elec-tri-fy	e-lec-tri-fy
s-tun-t	stunt
testy	tes-ty
hu-man-i-tar-i-an-is-m	hu-man-i-tar-i-an-ism
s-peak-ing	speak-ing
respire	re-spire
router	rout-er
in-cor-rupt-ible	in-cor-rupt-i-ble
cir-cum-spec-t	cir-cum-spect
s-caled	scaled
s-traight-away	straight-a-way
pi-o-n	pi-on
erup-tion	e-rup-tion
rack-et-s	rack-ets
e-vanes-cen-t	ev-a-nes-cent
treaty	trea-ty
de-mo-li-tion	dem-o-li-tion
psy-choki-ne-sis	psy-cho-ki-ne-sis
jit-tery	jit-ter-y
sole-cis-m	sol-e-cism
s-cam	scam
i-n-ac-ti-va-tion	in-ac-ti-va-tion
un-ob-tain-able	un-ob-tain-a-ble
beamy	beam-y
synapse	syn-apse
geno-type	gen-o-type
en-large-men-t	en-large-ment
mus-ke-teer	mus-ket-eer
punky	punk-y
s-norkel	snor-kel
awestruc-k	awe-struck
rat-tlesnake	rat-tle-snake
w-hole-saler	whole-sal-er
urchin	ur-chin
whaler	whal-er
feb-ru-ary	feb-ru-ar-y
verisimil-i-tude	ver-i-si-mil-i-tude
body	bod-y
facet	fac-et
s-pate	spate
ev-ery-body	eve-ry-bod-y
minesweep-er	mine-sweep-er
rel-e-van-t	rel-e-vant
bat-ter-ing	battering
s-lop-pi-ness	slop-pi-ness
salu-bri-ous	sa-lu-bri-ous
un-ser-vice-able	un-ser-vice-a-ble
poky	pok-y
po-ten-tial-i-ty	po-ten-ti-al-i-ty
dis-ori-en-t	dis-o-ri-ent
elec-tro-cute	e-lec-tro-cute
bowsprit	bow-sprit
waster	wast-er
curlew	cur-lew
miser-li-ness	mi-ser-li-ness
la-ryn-geal	la-ryn-ge-al
w-hole-some	whole-some
reaf-fir-m	re-af-firm
de-struc-t	de-struct
ir-rev-er-en-t	ir-rev-er-ent
un-sa-vory	un-sa-vor-y
touris-m	tour-ism
mea-sure	meas-ure
hor-mon-al	hor-mo-nal
bar-bar-ian	bar-bar-i-an
edit-ed	edited
atavis-tic	at-a-vis-tic
howler	howl-er
umpteenth	ump-teenth
monothe-is-m	mon-o-the-ism
ship-men-t	ship-ment
en-dow-men-t	en-dow-ment
a-gen-t	a-gent
un-ex-plain-able	un-ex-plain-a-ble
in-valid	in-va-lid
tribu-la-tion	trib-u-la-tion
ten-an-t	ten-ant
bur-nished	burnished
enig-mat-ic	en-ig-mat-ic
incog-ni-to	in-cog-ni-to
re-in-state-men-t	re-in-state-ment
blud-geon	bludg-eon
de-odor-an-t	de-o-dor-ant
tantrum	tan-trum
chili	chil-i
there-upon	there-up-on
ha-giog-ra-phy	hag-i-og-ra-phy
d-if-fu-sive	dif-fu-sive
del-i-ques-cen-t	del-i-ques-cent
id-i-olec-t	id-i-o-lect
di-aphrag-m	di-a-phragm
asep-tic	a-sep-tic
chom-p	chomp
es-carp-men-t	es-carp-ment
omi-nous	om-i-nous
book-binder	book-bind-er
palu-dal	pa-lu-dal
dis-con-nec-t	dis-con-nect
pro-ba-tion-ary	pro-ba-tion-ar-y
medicine	med-i-cine
gas-troin-testi-nal	gas-tro-in-tes-ti-nal
rogu-ish	ro-guish
in-former	in-form-er
shep-herd-ing	shepherding
silage	si-lage
unre-deemed	un-re-deemed
diploid	dip-loid
pur-suan-t	pur-su-ant
baroque	ba-roque
ca-cao	ca-ca-o
com-pe-ten-t	com-pe-tent
bank-able	bank-a-ble
trace-able	trace-a-ble
chi-huahua	chi-hua-hua
weighty	weight-y
auburn	au-burn
i-n-ac-tion	in-ac-tion
aquat-ic	a-quat-ic
erec-t	e-rect
w-hole-sale	whole-sale
k-er-nel	ker-nel
chaos	cha-os
palatal	pal-a-tal
an-niver-sary	an-ni-ver-sa-ry
legate	leg-ate
re-uni-fy	re-u-ni-fy
palm-istry	palm-is-try
mag-ne-si-a	mag-ne-sia
in-stal-l	in-stall
u-n-achiev-able	un-a-chiev-a-ble
en-ti-tle-men-t	en-ti-tle-ment
pres-bytery	pres-by-ter-y
d-if-fi-den-t	dif-fi-dent
stopover	stop-o-ver
grouchy	grouch-y
rheo-stat	rhe-o-stat
read-just	re-ad-just
non-con-for-mi-ty	non-con-form-i-ty
dy-nasty	dy-nas-ty
cobalt	co-balt
thriller	thrill-er
d-if-fer-en-tial	dif-fer-en-tial
s-nap-py	snap-py
whim-per-ing	whimpering
in-fante	in-fan-te
ru-inous	ru-in-ous
para-noid	par-a-noid
polypho-ny	po-lyph-o-ny
gra-tu-itous	gra-tu-i-tous
rein-tro-duc-tion	re-in-tro-duc-tion
mus-cle-d	mus-cled
sawyer	saw-yer
crater	cra-ter
s-ly-ly	sly-ly
wa-ter-fron-t	wa-ter-front
jel-l	jell
un-equiv-o-cal-ly	un-e-quiv-o-cal-ly
over-bear-ing	o-ver-bear-ing
g-ly-col	gly-col
squeaky	squeak-y
u-til-i-tar-i-an-is-m	u-til-i-tar-i-an-ism
ma-chete	ma-chet-e
ranter	rant-er
com-forter	com-fort-er
s-cape	scape
causal	caus-al
turgid	tur-gid
s-lide	slide
give-away	give-a-way
pass-able	pass-a-ble
po-ten-t	po-tent
molten	mol-ten
s-tand-point	stand-point
be-liev-able	be-liev-a-ble
loca-tive	loc-a-tive
t-int-ed	tinted
mono-lin-gual	mon-o-lin-gual
shaven	shav-en
asyn-chro-nous	a-syn-chro-nous
mi-cro-com-put-er	mi-cro-com-pu-ter
s-niff-in-g	sniffing
homonym	hom-o-nym
catholic	cath-o-lic
over-view	o-ver-view
painful-ly	pain-ful-ly
stal-l	stall
cochlea	coch-le-a
s-tudy	stud-y
ar-den-t	ar-dent
re-sul-tan-t	re-sult-ant
lun-cheon	lunch-eon
as-cen-dan-t	as-cend-ant
sel-l	sell
door-bel-l	door-bell
pletho-ra	pleth-o-ra
hy-per-boloid	hy-per-bo-loid
s-tun-ning	stun-ning
epi-taxy	ep-i-tax-y
ax-e	axe
com-pli-men-t	com-pli-ment
sui-ci-dal	su-i-cid-al
de-ity	de-i-ty
tourni-quet	tour-ni-quet
aright	a-right
stymie	sty-mie
gen-eros-i-ty	gen-er-os-i-ty
para-troop-s	par-a-troops
sen-tinel	sen-ti-nel
en-er-get-ic-s	en-er-get-ics
swishy	swish-y
in-dis-putably	in-dis-put-a-bly
de-viance	de-vi-ance
reval-ue	re-val-ue
mono-ma-ni-a	mon-o-ma-ni-a
sol-diery	sol-dier-y
laud-ed	lauded
modal	mod-al
odor-ous	o-dor-ous
s-light-ing	slight-ing
racon-teur	rac-on-teur
turquoise	tur-quoise
pirou-ette	pir-ou-ette
ex-ult-ing	exulting
corset	cor-set
glis-ten-ing	gli-ste-ning
pe-trel	pet-rel
banger	bang-er
leisure-ly	lei-sure-ly
in-con-ve-nience	in-con-ven-ience
pornog-ra-phy	por-nog-ra-phy
dis-moun-t	dis-mount
mod-ernist	mod-ern-ist
bulky	bulk-y
rea-son-able	rea-son-a-ble
d-e-fi-cien-cy	de-fi-cien-cy
machi-na-tion	mach-i-na-tion
geo-ther-mal	ge-o-ther-mal
pilchard	pil-chard
tele-gram	tel-e-gram
undis-guised	un-dis-guised
p-re-serve	pre-serve
un-de-vel-ope-d	un-de-vel-oped
tec-ton-ic-s	tec-ton-ics
in-ge-nious-ly	in-gen-ious-ly
very	ver-y
canon-ic	ca-non-ic
un-heroic	un-he-ro-ic
geri-atric-s	ger-i-at-rics
rounder-s	round-ers
s-mudge	smudge
fer-n	fern
apoplexy	ap-o-plex-y
horo-scope	hor-o-scope
s-abo-teur	sab-o-teur
om-nipo-tence	om-nip-o-tence
jin-go-is-m	jin-go-ism
muf-f	muff
re-peater	re-peat-er
pa-pyrus	pa-py-rus
conifer	co-ni-fer
pedi-gree	ped-i-gree
em-bossed	embossed
cor-re-spon-den-t	cor-re-spond-ent
reroutes	re-routes
i-n-ac-cu-rate	in-ac-cu-rate
com-fort-ably	com-fort-a-bly
carousel	car-ou-sel
medusa	me-du-sa
s-lash-er	slash-er
purga-tive	pur-ga-tive
es-capee	es-cap-ee
dis-cre-tionary	dis-cre-tion-ar-y
cli-toris	clit-o-ris
rigid-i-ty	ri-gid-i-ty
jumper	jump-er
gi-antism	gi-ant-ism
di-elec-tric	di-e-lec-tric
un-demon-stra-tive	un-de-mon-stra-tive
cut-lery	cut-ler-y
beget	be-get
mod-icum	mod-i-cum
pastille	pas-tille
gen-uine-ness	gen-u-ine-ness
think-able	think-a-ble
sys-temic	sys-tem-ic
gospel	gos-pel
foible	foi-ble
im-preg-nable	im-preg-na-ble
syl-labub	syl-la-bub
s-lan-t	slant
satyr	sa-tyr
un-ruly	un-ru-ly
y-ou	you
mal-treat-men-t	mal-treat-ment
sier-ra	si-er-ra
m-i-lieu	mi-lieu
h-es-i-tan-t	hes-i-tant
dis-agree-able	dis-a-gree-a-ble
sub-tex-t	sub-text
civic-s	civ-ics
damask	dam-ask
wether	weth-er
min-uet	min-u-et
atyp-i-cal	a-typ-i-cal
cor-rup-t	cor-rupt
su-per-natan-t	su-per-na-tant
pol-lard-ed	pollarded
rem-nan-t	rem-nant
k-nave	knave
ob-se-quious	ob-se-qui-ous
imag-in-able	im-ag-i-na-ble
c-og-nizance	cog-ni-zance
dat-able	dat-a-ble
vene-re-al	ve-ne-re-al
sub-atom-ic	sub-a-tom-ic
ar-rester	ar-rest-er
con-sular	con-su-lar
wrestling	wres-tling
cougar	cou-gar
schooner	schoon-er
sum-mery	sum-mer-y
bowlder	bowl-der
cation	cat-i-on
ge-nial-i-ty	ge-ni-al-i-ty
re-minder	re-mind-er
elo-quen-t	el-o-quent
over-fil-l	o-ver-fill
s-lip-page	slip-page
tailplane	tail-plane
lanky	lank-y
in-con-gruity	in-con-gru-i-ty
s-mall-ish	small-ish
palati-nate	pa-lat-i-nate
ele-giac	el-e-gi-ac
read-mis-sion	re-ad-mis-sion
i-n-un-da-tion	in-un-da-tion
s-now-bound	snow-bound
overt-ly	o-vert-ly
relic-t	rel-ict
s-nig-ger	snig-ger
derelic-t	der-e-lict
reap-point	re-ap-point
heron	her-on
reprisal	re-pris-al
ten-t	tent
de-men-ti-a	de-men-tia
idly	i-dly
vam-p	vamp
periscope	per-i-scope
u-n-ad-dressed	un-ad-dressed
porta-bil-i-ty	port-a-bil-i-ty
fisticuff-s	fist-i-cuffs
ma-jorette	ma-jor-ette
turntable	turn-ta-ble
crazy	cra-zy
vine-gar	vin-e-gar
ter-tiary	ter-ti-ar-y
t-elecom-mut-ing	te-le-com-mu-ting
over-hand	o-ver-hand
elec-tri-cal-ly	e-lec-tri-cal-ly
thrifty	thrift-y
s-teel-work-s	steel-works
mi-mosa	mi-mo-sa
de-vour-ing	devouring
s-lack	slack
mega-lith	meg-a-lith
daun-t	daunt
s-luice	sluice
post-mistress	post-mis-tress
cross-road-s	cross-roads
pre-sum-ably	pre-sum-a-bly
choco-late	choc-o-late
im-munoas-say	im-mu-no-as-say
rad-i-cal-is-m	rad-i-cal-ism
ukulele	u-ku-le-le
un-usu-al-ly	un-u-su-al-ly
laugh-ably	laugh-a-bly
the-atri-cal-s	the-at-ri-cals
undis-tort-ed	un-dis-tort-ed
para-noia	par-a-noi-a
sup-ple-men-t	sup-ple-ment
valen-tine	val-en-tine
di-nosaur	di-no-saur
even-ly	e-ven-ly
iso-lat-ed	i-so-lat-ed
im-pre-sari-o	im-pre-sa-ri-o
s-ince	since
s-trap-less	strap-less
s-later	slat-er
s-lip	slip
polon-aise	pol-o-naise
s-mirk-ing	smirking
gov-er-nance	gov-ern-ance
fleshy	flesh-y
li-able	li-a-ble
metaphor-i-cal	met-a-phor-i-cal
ma-lig-nan-t	ma-lig-nant
api-ary	a-pi-ar-y
wrap-around	wrap-a-round
unin-spired	un-in-spired
za-p	zap
con-form-ity	con-form-i-ty
yel-l	yell
lay-of-f	lay-off
rob-bery	rob-ber-y
m-is-for-tune	mis-for-tune
non-even-t	non-e-vent
sev-ered	severed
stipend	sti-pend
ini-ti-a-tion	in-i-ti-a-tion
som-brero	som-bre-ro
s-tim-u-lat-ing	stim-u-lat-ing
con-tractible	con-tract-i-ble
puffy	puf-fy
corkscrew	cork-screw
pro-tect-ed	protected
scrupu-lous	scru-pu-lous
dal-liance	dal-li-ance
crim-p	crimp
redo-len-t	red-o-lent
wor-m	worm
bradawl	brad-awl
steadi-ness	stead-i-ness
i-cosa-he-dron	i-co-sa-he-dron
tanker	tank-er
s-nap-shot	snap-shot
a-vian	a-vi-an
shindig	shin-dig
mut-t	mutt
s-lug-gish	slug-gish
gal-axy	gal-ax-y
re-tini-tis	ret-i-ni-tis
cheeky	cheek-y
funky	funk-y
tra-chea	tra-che-a
plea-sur-able	pleas-ur-a-ble
ob-scu-ran-tist	ob-scu-rant-ist
con-vivial	con-viv-i-al
un-elect-ed	un-e-lect-ed
mag-ne-sium	mag-ne-si-um
s-coot	scoot
turnout	turn-out
anus	a-nus
over-sized	o-ver-sized
ratepay-er	rate-pay-er
ple-nary	ple-na-ry
su-per-nu-mer-ary	su-per-nu-mer-ar-y
crick-eter	crick-et-er
paci-fist	pac-i-fist
s-tate	state
ede-ma	e-de-ma
end-s	ends
repack-age	re-pack-age
s-now	snow
limpet	lim-pet
leg-isla-tive	leg-is-la-tive
detri-men-t	det-ri-ment
hero-is-m	her-o-ism
sign-er-s	sign-ers
deathbed	death-bed
s-care	scare
clien-tele	cli-en-tele
up-hol-stery	up-hol-ster-y
mealy	meal-y
ini-tial-ly	in-i-tial-ly
e-mol-u-men-t	e-mol-u-ment
zona-tion	zo-na-tion
s-mooth-ly	smooth-ly
shilling	shil-ling
de-tec-t	de-tect
s-nif-fer	sniff-er
im-per-fec-t	im-per-fect
piv-otal	piv-ot-al
biomorph	bi-o-morph
trainee	train-ee
cream-ery	cream-er-y
pro-le-tari-at	pro-le-tar-i-at
ce-men-t	ce-ment
tubu-lar	tu-bu-lar
mere-tri-cious	mer-e-tri-cious
diplo-ma	di-plo-ma
tex-t	text
illiq-uid	il-liq-uid
cor-moran-t	cor-mo-rant
adop-t	a-dopt
deci-bel	dec-i-bel
over-coat	o-ver-coat
con-jec-tural	con-jec-tur-al
u-p-land	up-land
mo-nop-oly	mo-nop-o-ly
con-demned	condemned
in-de-fati-ga-ble	in-de-fat-i-ga-ble
de-cay-ing	decaying
con-stituen-t	con-stit-u-ent
u-n-a-mused	un-a-mused
re-pro-ducibly	re-pro-duc-i-bly
math-s	maths
lamp-lighter	lamp-light-er
fifty	fif-ty
pira-cy	pi-ra-cy
goatskin	goat-skin
carotid	ca-rot-id
throaty	throat-y
crit-i-cis-m	crit-i-cism
poly-mor-phous	pol-y-mor-phous
rar-efac-tion	rar-e-fac-tion
d-war-f	dwarf
en-gi-neered	engineered
oner-ous	on-er-ous
sunken	sunk-en
ven-omous	ven-om-ous
s-tore-keep-er	store-keep-er
chem-istry	chem-is-try
re-cessed	recessed
com-po-nen-t	com-po-nent
hi-er-ar-ch	hi-er-arch
guardian-ship	guard-i-an-ship
gofer	go-fer
dis-tur-b	dis-turb
p-res-ence	pres-ence
e-u-pho-ri-a	eu-pho-ri-a
lauda-to-ry	laud-a-to-ry
moral-ly	mor-al-ly
tar-ty	tart-y
bi-sec-t	bi-sect
triple	tri-ple
ob-jec-tion-able	ob-jec-tion-a-ble
cov-et-ed	coveted
un-holy	un-ho-ly
switchgear	switch-gear
ide-al-is-tic	i-de-al-is-tic
so-bri-ety	so-bri-e-ty
bristly	bris-tly
glan-s	glans
goa-tee	goat-ee
at-mo-spher-ic-s	at-mos-pher-ics
par-enter-al	par-en-ter-al
sun-burned	sunburned
s-tun-ner	stun-ner
par-adis-e	par-a-dise
man-age-men-t	man-age-ment
geo-physic-s	ge-o-phys-ics
d-if-fus-er	dif-fus-er
strudel	stru-del
wall-flower	wall-flow-er
sol-ven-t	sol-vent
watch-able	watch-a-ble
litho-graph	lith-o-graph
unin-sur-able	un-in-sur-a-ble
ridicu-lous-ly	ri-dic-u-lous-ly
poltroon	pol-troon
un-der-study	un-der-stud-y
in-domitable	in-dom-i-ta-ble
fash-ion-able	fash-ion-a-ble
testis	tes-tis
s-tair-head	stair-head
rosary	ro-sa-ry
deu-teri-um	deu-te-ri-um
in-ter-atom-ic	in-ter-a-tom-ic
satirist	sat-i-rist
there-about-s	there-a-bouts
ease-men-t	ease-ment
busy	bus-y
scrip-t	script
reroute	re-route
im-pu-den-t	im-pu-dent
re-ori-en-ta-tion	re-o-ri-en-ta-tion
kwacha	kwa-cha
costar	co-star
jus-ti-fi-able	jus-ti-fi-a-ble
s-pank-ing	spank-ing
bound-ary	bound-a-ry
har-mo-nious-ly	har-mo-ni-ous-ly
cox-com-b	cox-comb
bio-engi-neer-ing	bi-o-en-gi-neer-ing
dis-en-gage-men-t	dis-en-gage-ment
tele-path-ic	tel-e-path-ic
s-tokes	stokes
vivid	viv-id
a-p-a-thet-ic	ap-a-thet-ic
s-nore	snore
de-func-t	de-funct
tri-bunal	tri-bu-nal
drowsy	drow-sy
s-ta-tion-ary	sta-tion-ar-y
syn-onym	syn-o-nym
toka-mak	to-ka-mak
rel-a-tivis-tic	rel-a-tiv-is-tic
dig-ni-tary	dig-ni-tar-y
de-tach-men-t	de-tach-ment
babysit-ter	ba-by-sit-ter
eter-nal-ly	e-ter-nal-ly
gneis-s	gneiss
clas-si-cis-m	clas-si-cism
tropopause	trop-o-pause
jour-nal-is-m	jour-nal-ism
c-om-men-da-tion	com-men-da-tion
s-lab	slab
chuf-f	chuff
camper	camp-er
trigonom-e-try	trig-o-nom-e-try
shaman	sha-man
un-en-force-able	un-en-force-a-ble
over-much	o-ver-much
cre-ative-ly	cre-a-tive-ly
vis-i-ta-tion	vis-it-a-tion
break-able	break-a-ble
depre-da-tion	dep-re-da-tion
un-usu-al	un-u-su-al
feath-ery	feath-er-y
winger	wing-er
gin-sen-g	gin-seng
cus-tom-s	cus-toms
trans-mo-gri-fy	trans-mog-ri-fy
ex-cel-sior	ex-cel-si-or
reper-cus-sion	re-per-cus-sion
potable	po-ta-ble
rib-aldry	rib-ald-ry
dis-tiller	dis-till-er
wag-gery	wag-ger-y
de-ter-ren-t	de-ter-rent
au-dio-vi-su-al	au-di-o-vis-u-al
sim-per-ing	simpering
bases	ba-ses
pi-rat-ed	pirated
tan-gen-t	tan-gent
hy-drazine	hy-dra-zine
n-od	nod
is-lander	is-land-er
en-abled	e-na-bled
para-m-ag-net-ic	par-a-mag-net-ic
weed-s	weeds
turnip	tur-nip
rapid-ly	rap-id-ly
mono-mi-al	mo-no-mi-al
awhile	a-while
s-tock	stock
dopey	dope-y
kinder-garten	kin-der-gar-ten
elec-tor	e-lec-tor
para-ble	par-a-ble
re-fresh-men-t	re-fresh-ment
glasshouse	glass-house
s-can-sion	scan-sion
makeshift	make-shift
scrip-tural	scrip-tur-al
pinafore	pin-a-fore
methanol	meth-a-nol
presto	pres-to
gamy	gam-y
pen-i-ten-tiary	pen-i-ten-tia-ry
va-sec-to-my	vas-ec-to-my
pam-phle-teer	pam-phlet-eer
s-cape-goat	scape-goat
mi-cro-cos-m	mi-cro-cosm
trackbed	track-bed
aorist	a-o-rist
en-tan-gle-men-t	en-tan-gle-ment
s-mut-ty	smut-ty
ne-go-tia-tor	ne-go-ti-a-tor
in-sipid	in-sip-id
eater	eat-er
im-prove-men-t	im-prove-ment
leisured	lei-sured
opaque	o-paque
quencher	quench-er
pe-tit	pet-it
nougat	nou-gat
s-corch	scorch
ar-guably	ar-gu-a-bly
s-ti-fle	sti-fle
s-i-nu-soid	si-nus-oid
aux-il-iary	aux-il-ia-ry
prepar-a-tive	pre-par-a-tive
propane	pro-pane
piety	pi-e-ty
epi-logue	ep-i-logue
s-teeple-chase	stee-ple-chase
re-vival-is-m	re-viv-al-ism
in-clemen-t	in-clem-ent
prospec-t	pros-pect
s-tu-por	stu-por
de-fines	def-ines
s-nap	snap
em-bassy	em-bas-sy
elvish	elv-ish
gen-i-tali-a	gen-i-ta-li-a
spoilage	spoil-age
prodi-gy	prod-i-gy
spher-oid	sphe-roid
n-ear-by	near-by
gut-tural	gut-tur-al
in-cip-i-en-t	in-cip-i-ent
medi-ocrity	me-di-oc-ri-ty
negate	ne-gate
re-moval	re-mov-al
wastrel	wast-rel
tor-men-t	tor-ment
pu-ri-tanis-m	pu-ri-tan-ism
punch-able	punch-a-ble
drap-ery	dra-per-y
cor-rec-t	cor-rect
ex-or-bi-tan-t	ex-or-bi-tant
un-frozen	un-fro-zen
un-rea-son-able	un-rea-son-a-ble
un-for-get-table	un-for-get-ta-ble
mag-netism	mag-net-ism
beg-gary	beg-gar-y
hermeneu-tic-s	her-me-neu-tics
duo-logue	du-o-logue
glo-be-trot-ting	globe-trot-ting
s-phyg-mo-manome-ter	sphyg-mo-ma-nom-e-ter
pru-den-t	pru-dent
up-fron-t	up-front
s-tu-pe-fy	stu-pe-fy
cheru-bic	che-ru-bic
m-nemon-ic	mne-mon-ic
pointil-lis-m	poin-til-lism
en-hance-men-t	en-hance-ment
laven-der	lav-en-der
hearti-ly	heart-i-ly
stretchy	stretch-y
isosce-les	i-sos-ce-les
painstak-ing-ly	pains-tak-ing-ly
virus	vi-rus
dis-heart-en-ing	dis-hear-te-ning
filthy	filth-y
dy-nam-ic-s	dy-nam-ics
papil-la	pa-pil-la
deeply	deep-ly
un-der-gar-men-t	un-der-gar-ment
s-take	stake
frontage	front-age
beat-i-tude	be-at-i-tude
nether-most	neth-er-most
de-ter-gen-t	de-ter-gent
habit	hab-it
roundel	roun-del
gerund	ger-und
manikin	man-i-kin
ex-trav-a-gan-t	ex-trav-a-gant
or-ga-nize	or-gan-ize
rent-ed	rented
so-ci-olin-guis-tic-s	so-ci-o-lin-guis-tics
non-cha-lan-t	non-cha-lant
plen-teous	plen-te-ous
detox	de-tox
driver-less	driv-er-less
athe-is-tic	a-the-is-tic
gad-getry	gadg-et-ry
b-otanist	bot-a-nist
manor	man-or
linoleum	li-no-le-um
sub-trop-ic-s	sub-trop-ics
in-dic-t	in-dict
theta	the-ta
rivulet	riv-u-let
ma-chin-ery	ma-chin-er-y
leisure	lei-sure
liv-able	liv-a-ble
morsel	mor-sel
leath-ery	leath-er-y
but-t	butt
recharge-able	re-charge-a-ble
knel-l	knell
sanc-tu-ary	sanc-tu-ar-y
callable	call-a-ble
petard	pe-tard
con-sign-men-t	con-sign-ment
su-per-posed	superposed
tri-umphal	tri-um-phal
ath-let-ic-s	ath-let-ics
boater	boat-er
s-tone	stone
rigid	rig-id
wolfish	wolf-ish
s-lim-mer	slim-mer
ge-neti-cist	ge-net-i-cist
ex-tra-ditable	ex-tra-dit-a-ble
s-ce-nari-o	sce-nar-i-o
cin-e-matog-ra-phy	cin-e-ma-tog-ra-phy
os-teopa-thy	os-te-op-a-thy
telekine-sis	tel-e-ki-ne-sis
the-atri-cal	the-at-ri-cal
s-tove	stove
desert	de-sert
ir-re-vo-ca-bly	ir-rev-o-ca-bly
im-muno-log-i-cal	im-mu-no-log-i-cal
gelati-nous	ge-lat-i-nous
el-e-men-t	el-e-ment
chamomile	cham-o-mile
po-litesse	pol-i-tesse
cesspool	cess-pool
pe-cu-liar-i-ty	pe-cu-li-ar-i-ty
tara-masala-ta	ta-ra-ma-sa-la-ta
rai-men-t	rai-ment
poros-i-ty	po-ros-i-ty
i-con-o-clas-m	i-con-o-clasm
choline	cho-line
ephor	eph-or
re-len-t	re-lent
platelet	plate-let
s-mack	smack
er-r	err
ne-ma-tode	nem-a-tode
mis-man-age-men-t	mis-man-age-ment
over-pay	o-ver-pay
rain-stor-m	rain-storm
s-nif-fle	snif-fle
even-song	e-ven-song
ar-ti-fi-cial-i-ty	ar-ti-fi-ci-al-i-ty
tele-o-log-i-cal	tel-e-o-log-i-cal
ex-porter	ex-port-er
car-bonyl	car-bon-yl
bidi-rec-tion-al	bi-di-rec-tion-al
queasy	quea-sy
muster	mus-ter
dis-sec-t	dis-sect
en-v-i-ron	en-vi-ron
mud-dling	muddling
s-lope	slope
poplar	pop-lar
per-centile	per-cen-tile
cy-tochrome	cy-to-chrome
ar-chi-tec-t	ar-chi-tect
showy	show-y
washout	wash-out
ship-builder	ship-build-er
ex-igu-ous	ex-ig-u-ous
cor-nu-copi-a	cor-nu-co-pi-a
y-ours	yours
recre-ation	rec-re-a-tion
s-lash-ing	slash-ing
phrase-ol-o-gy	phra-se-ol-o-gy
roofer	roof-er
mishap	mis-hap
s-lick	slick
flood-ing	flooding
mazur-ka	ma-zur-ka
bondage	bond-age
epilep-sy	ep-i-lep-sy
scrib-bling	scribbling
protest-ing	protesting
co-her-en-t	co-her-ent
overt	o-vert
lyrist	lyr-ist
pati-na-tion	pat-i-na-tion
y-ore	yore
re-freshed	refreshed
nurs-ery-men	nurs-er-y-men
record-ing	re-cord-ing
im-petu-ous	im-pet-u-ous
hemi-sphere	hem-i-sphere
meso-sphere	mes-o-sphere
sub-lu-nary	sub-lu-nar-y
bar-rack-s	bar-racks
per-fec-t	per-fect
undis-closed	un-dis-closed
frosty	frost-y
so-cialite	so-cial-ite
an-te-dilu-vian	an-te-di-lu-vi-an
catarrh	ca-tarrh
rook-ery	rook-er-y
forestry	for-est-ry
en-vi-ron-men-t	en-vi-ron-ment
an-thro-pocen-tric	an-thro-po-cen-tric
ver-bosi-ty	ver-bos-i-ty
c-it-rate	cit-rate
as-bestos	as-bes-tos
nurs-ery-man	nurs-er-y-man
topo-graph-i-cal	top-o-graph-i-cal
boron	bo-ron
di-a-betes	di-a-be-tes
prop-s	props
s-nifter	snif-ter
im-p	imp
dis-con-ti-nu-ity	dis-con-ti-nu-i-ty
u-nas-suaged	un-as-suaged
provin-cial-is-m	pro-vin-cial-ism
hater	hat-er
tele-phon-ist	te-leph-o-nist
re-ac-tionary	re-ac-tion-ar-y
beady	bead-y
minibus	min-i-bus
xeno-pho-bi-a	xen-o-pho-bi-a
tetra	tet-ra
enu-mer-ate	e-nu-mer-ate
ef-fer-ves-cen-t	ef-fer-ves-cent
pi-anis-si-mo	pi-a-nis-si-mo
as-trin-gen-t	as-trin-gent
odd-s	odds
sprawl-ing	sprawling
u-n-aligned	un-a-ligned
crys-talline	crys-tal-line
tun-able	tun-a-ble
ex-emp-t	ex-empt
bru-tal-is-m	bru-tal-ism
beryl-li-um	be-ryl-li-um
e-choic	e-cho-ic
taber-na-cle	tab-er-nac-le
con-denser	con-dens-er
method-ol-o-gy	meth-od-ol-o-gy
con-duct-ed	conducted
mi-cro-farad	mi-cro-far-ad
s-lant-wise	slant-wise
lazy	la-zy
al-ready	al-read-y
over-do	o-ver-do
provider	pro-vid-er
e-q-ui-ty	eq-ui-ty
id-iot	id-i-ot
tel-l	tell
lugubri-ous	lu-gu-bri-ous
iron-mon-ger	i-ron-mon-ger
tri-bune	trib-une
rheuma-tol-o-gy	rheu-ma-tol-o-gy
dormer	dor-mer
s-mug	smug
mega	meg-a
repli-ca-tor	rep-li-ca-tor
prepo-si-tion	prep-o-si-tion
s-tand-stil-l	stand-still
van-dal-is-m	van-dal-ism
labi-um	la-bi-um
elec-tro-dy-nam-ic-s	e-lec-tro-dy-nam-ics
pectin	pec-tin
b-lis-ter-ing	blis-ter-ing
ranker	rank-er
in-salu-bri-ous	in-sa-lu-bri-ous
above	a-bove
s-nip-pet	snip-pet
in-ter-ac-t	in-ter-act
fore-see-able	fore-see-a-ble
pol-i-tic-s	pol-i-tics
cabaret	cab-a-ret
im-ple-men-t	im-ple-ment
cred-it-wor-thy	cred-it-worth-y
mag-nil-o-quen-t	mag-nil-o-quent
periglacial	per-i-gla-cial
cre-osote	cre-o-sote
en-rich-men-t	en-rich-ment
spiky	spik-y
erad-i-cat-ed	e-rad-i-cat-ed
prodi-gal	prod-i-gal
na-iad	nai-ad
shiny	shin-y
e-cono-met-ric-s	e-con-o-met-rics
piv-ot-ed	pivoted
re-gali-a	re-ga-li-a
se-nior	sen-ior
iso-topic	i-so-top-ic
trea-sur-er	treas-ur-er
washy	wash-y
diplo-mat-i-cal-ly	dip-lo-mat-i-cal-ly
biorhyth-m	bi-o-rhythm
diskette	disk-ette
dowry	dow-ry
deis-m	de-ism
earnest-ness	ear-nest-ness
je-junum	je-ju-num
ped-a-gogy	ped-a-go-gy
pharao-h	phar-aoh
re-in-force-men-t	re-in-force-ment
in-ex-orably	in-ex-o-ra-bly
peni-cillin	pen-i-cil-lin
s-lay	slay
poignant-ly	poign-ant-ly
budgie	budg-ie
pre-tender	pre-tend-er
s-niper	snip-er
man-i-cured	ma-ni-cured
i-nane	in-ane
bushel	bush-el
ragout	ra-gout
anony-mous	a-non-y-mous
sub-ter-ranean	sub-ter-ra-ne-an
g-lut-tony	glut-ton-y
trans-plan-t	trans-plant
pos-i-tivist	pos-i-tiv-ist
gestalt	ge-stalt
apron	a-pron
mono-syl-lab-ic	mon-o-syl-lab-ic
mimicry	mim-ic-ry
cir-cuitous	cir-cu-i-tous
en-chant-ed	enchanted
s-ten-to-ri-an	sten-to-ri-an
epis-te-mol-o-gy	e-pis-te-mol-o-gy
parsnip	pars-nip
re-ac-tan-t	re-ac-tant
tenor	ten-or
vil-lager	vil-lag-er
gib-ber-ing	gibbering
re-vival	re-viv-al
war-m	warm
bond-ing	bonding
re-dun-dan-t	re-dun-dant
trendy	trend-y
joyride	joy-ride
in-ter-roga-to-ry	in-ter-rog-a-to-ry
saucepan	sauce-pan
dis-rep-utable	dis-rep-u-ta-ble
sain-t	saint
an-tithe-sis	an-tith-e-sis
suf-fi-cien-t	suf-fi-cient
com-ple-men-tary	com-ple-men-ta-ry
re-vam-p	re-vamp
in-tu-ition	in-tu-i-tion
taster	tast-er
seabird	sea-bird
res-onate	res-o-nate
car-cino-gen	car-cin-o-gen
sub-cu-ta-neous	sub-cu-ta-ne-ous
lega-tee	leg-a-tee
seg-men-t	seg-ment
con-tain-men-t	con-tain-ment
jaun-t	jaunt
aquar-i-um	a-quar-i-um
melan-cho-li-a	mel-an-cho-li-a
mul-ti-lat-er-al-is-m	mul-ti-lat-er-al-ism
bur-gundy	bur-gun-dy
hook-ing	hooking
em-body	em-bod-y
op-er-a-tional	op-er-a-tion-al
napoleon	na-po-le-on
aug-men-t	aug-ment
chi-nois-erie	chi-noi-se-rie
pyra-mid	pyr-a-mid
hy-per-tex-t	hy-per-text
monar-chy	mon-ar-chy
re-unite	re-u-nite
shoelace	shoe-lace
lemon	lem-on
atom-ic	a-tom-ic
anvil	an-vil
s-lum	slum
reclu-sive	re-clu-sive
pullover	pull-o-ver
s-lob-ber-ing	slobbering
s-laugh-ter-house	slaugh-ter-house
re-stric-t	re-strict
recheck	re-check
puerile	pu-er-ile
es-timable	es-ti-ma-ble
roughage	rough-age
par-tial-i-ty	par-ti-al-i-ty
ben-der	bend-er
s-tat-ed	stat-ed
thril-l	thrill
stil-l	still
mauler	maul-er
monas-tic	mo-nas-tic
im-per-ti-nen-t	im-per-ti-nent
s-loshed	sloshed
riv-ier-a	riv-i-er-a
purview	pur-view
de-po-si-tion	dep-o-si-tion
transna-tion-al	trans-na-tion-al
in-sur-gen-t	in-sur-gent
rec-om-mend-ed	recommended
recita-tion	rec-i-ta-tion
frontal	fron-tal
awning	awn-ing
in-fir-mary	in-fir-ma-ry
s-noop	snoop
mon-o-clon-al	mon-o-clo-nal
foren-sic	fo-ren-sic
whomev-er	whom-ev-er
dis-ori-en-ta-tion	dis-o-ri-en-ta-tion
un-record-ed	un-re-cord-ed
tac-t	tact
triplex	tri-plex
copy-ist	cop-y-ist
v-int-ner	vint-ner
lieu-tenan-t	lieu-ten-ant
su-per-hero	su-per-he-ro
preach-ing	preaching
shoplifter	shop-lift-er
trans-par-en-t	trans-par-ent
hov-e	hove
ref-er-ee-ing	re-fe-ree-ing
de-crepit	de-crep-it
craven	cra-ven
col-lo-qui-al-is-m	col-lo-qui-al-ism
s-tar-lit	star-lit
sus-pender-s	sus-pend-ers
foundry	found-ry
lu-natic	lu-na-tic
li-brary	li-brar-y
print-able	print-a-ble
lit-er-ary	lit-er-ar-y
di-ana	di-an-a
jus-ti-fi-ably	jus-ti-fi-a-bly
rosin	ros-in
ex-hi-bi-tion-is-m	ex-hi-bi-tion-ism
con-stric-t	con-strict
p-re-s-e-lec-t	pre-se-lect
s-calpel	scal-pel
spillage	spill-age
aris-to-crat-ic	a-ris-to-crat-ic
so-cioe-co-nom-ic	so-ci-o-ec-o-nom-ic
monies	mon-ies
han-dover	hand-o-ver
even-tu-al-ly	e-ven-tu-al-ly
overuse	o-ver-use
her-i-ta-ble	her-it-a-ble
cleanup	clean-up
con-fi-den-t	con-fi-dent
hy-per-bole	hy-per-bo-le
pro-trac-t	pro-tract
viceroy	vice-roy
on-ag-er	on-a-ger
ide-al-ly	i-de-al-ly
jerky	jerk-y
as-tro-physi-cist	as-tro-phys-i-cist
menis-cus	me-nis-cus
heather	heath-er
con-cor-dan-t	con-cord-ant
salty	salt-y
pan-tomime	pan-to-mime
mater	ma-ter
damni-fy	dam-ni-fy
pre-dict-ed	predicted
easy-go-ing	eas-y-go-ing
con-vert-ible	con-vert-i-ble
savvy	sav-vy
hand-bil-l	hand-bill
o-r-a-to-ry	or-a-to-ry
table-land	ta-ble-land
earnest-ly	ear-nest-ly
re-gret-table	re-gret-ta-ble
quan-tifi-able	quan-ti-fi-a-ble
evo-lute	ev-o-lute
navel	na-vel
flaun-t	flaunt
io-ta	i-o-ta
de-sirous	de-sir-ous
pesky	pes-ky
r-e-fit	re-fit
sub-sidy	sub-si-dy
over-ween-ing	o-ver-ween-ing
bowl-s	bowls
em-pow-er-men-t	em-pow-er-ment
his-toric	his-tor-ic
sur-moun-t	sur-mount
at-tain-able	at-tain-a-ble
bur-p	burp
fore-fron-t	fore-front
liken	lik-en
ruf-f	ruff
timescale	time-scale
in-con-stan-t	in-con-stant
abuse	a-buse
en-trench-men-t	en-trench-ment
dim-pled	dimpled
roast-ed	roasted
stinger	sting-er
over-shot	o-ver-shot
hero-ical-ly	he-ro-i-cal-ly
gal-vanome-ter	gal-va-nom-e-ter
bul-l	bull
undi-gest-ed	un-di-gest-ed
hypochon-dri-a	hy-po-chon-dri-a
lega-tor	le-ga-tor
bias	bi-as
land-for-m	land-form
ex-porta-bil-i-ty	ex-por-ta-bi-li-ty
teenag-er	teen-ag-er
e-dic-t	e-dict
power-boat	pow-er-boat
tele-vised	televised
apoc-ryphal	a-poc-ry-phal
ethanol	eth-a-nol
sagac-i-ty	sa-gac-i-ty
meri-no	me-ri-no
filmic	film-ic
dero-gate	der-o-gate
tiger-ish	ti-ger-ish
ex-ten-t	ex-tent
gener-ic	ge-ner-ic
poignan-t	poign-ant
mid-ship-s	mid-ships
dauber	daub-er
legroom	leg-room
arid	ar-id
fein-t	feint
dis-pens-able	dis-pen-sa-ble
s-corched	scorched
re-frig-er-an-t	re-frig-er-ant
awash	a-wash
sul-tana	sul-tan-a
bluish	blu-ish
eon	e-on
macaw	ma-caw
manes	ma-nes
in-stan-ta-neous-ly	in-stan-ta-ne-ous-ly
misty	mist-y
s-noop-ing	snooping
s-cat-ter-ing	scat-ter-ing
sala-cious	sa-la-cious
or-biter	or-bit-er
around	a-round
s-lim	slim
de-crepi-tude	de-crep-i-tude
le-gionary	le-gion-ar-y
nib-s	nibs
dele-te-ri-ous	del-e-te-ri-ous
s-pade	spade
syn-ovial	syn-o-vi-al
s-wot	swot
kosher	ko-sher
wom-b	womb
char-m	charm
satire	sat-ire
epig-ra-phy	e-pig-ra-phy
her-itage	her-it-age
en-durable	en-dur-a-ble
bish-opric	bish-op-ric
con-fi-dan-t	con-fi-dant
s-to-ry-telling	sto-ry-tell-ing
laager	laa-ger
re-sult-ing	resulting
reaper	reap-er
pic-turesque	pic-tur-esque
anteater	ant-eat-er
s-ta-men	sta-men
un-healthy	un-health-y
mo-lasses	mo-las-ses
cor-dial	cor-di-al
em-i-nen-t	em-i-nent
bleat-ing	bleating
n-od-ule	nod-ule
peren-ni-al	per-en-ni-al
apol-o-gist	a-pol-o-gist
s-loth-ful	sloth-ful
moral	mor-al
brava-do	bra-va-do
e-bul-lien-t	e-bul-lient
seafood	sea-food
shrub-bery	shrub-ber-y
over-es-ti-ma-tion	o-ver-es-ti-ma-tion
s-ta-tion	sta-tion
ex-piry	ex-pi-ry
risot-to	ri-sot-to
seclu-sion	se-clu-sion
polysac-cha-ride	pol-y-sac-cha-ride
re-cruit-men-t	re-cruit-ment
s-tock-tak-ing	stock-tak-ing
ren-t	rent
grinder	grind-er
pre-cau-tion-ary	pre-cau-tion-ar-y
con-ti-nen-t	con-ti-nent
s-trait-en	strait-en
s-lip-per-i-ness	slip-per-i-ness
cele-ri-ac	ce-ler-i-ac
electro-mechan-i-cal	e-lec-tro-me-chan-i-cal
i-n-or-di-nate	in-or-di-nate
id-io-path-ic	id-i-o-path-ic
medic-i-nal	me-dic-i-nal
floater	float-er
mal-l	mall
ine-bri-a-tion	in-e-bri-a-tion
bedrid-den	bed-rid-den
the-is-m	the-ism
valiant-ly	val-iant-ly
high-t	hight
y-our	your
s-mat-ter-ing	smat-ter-ing
seance	se-ance
sub-species	sub-spe-cies
hadron	had-ron
trans-for-m	trans-form
l-o-gis-ti-cal	lo-gis-ti-cal
s-trand	strand
pid-gin	pidg-in
big-otry	big-ot-ry
moun-tain-sid-e	moun-tain-side
renowned	re-nowned
e-d-u-ca-tion	ed-u-ca-tion
bio-chem-istry	bi-o-chem-is-try
de-jec-t	de-ject
g-lan-du-lar	glan-du-lar
s-tench	stench
wattage	watt-age
s-trato-spher-i-cal-ly	stratospherically
ptero-dactyl	pter-o-dac-tyl
pur-veyance	pur-vey-ance
con-gealed	congealed
nut-s	nuts
u-topi-an	u-to-pi-an
sa-far-i	sa-fa-ri
missal	mis-sal
s-lipped	slipped
un-in-ter-pretable	un-in-ter-pret-a-ble
lega-to	le-ga-to
over-lie	o-ver-lie
valance	val-ance
raspy	rasp-y
re-gen-t	re-gent
groat-s	groats
trapeze	tra-peze
mono	mon-o
over-ly-ing	o-ver-ly-ing
en-force-men-t	en-force-ment
er-a	e-ra
s-woop	swoop
chas-ten-ing	chastening
dan-de-lion	dan-de-li-on
hul-la-baloo	hul-la-ba-loo
heat-wave	heatwave
oop-s	oops
par-tic-u-lar-is-m	par-tic-u-lar-ism
mis-shapen	mis-shap-en
u-p-load	up-load
s-carce	scarce
s-naky	snak-y
handrail	hand-rail
in-ces-t	in-cest
even	e-ven
elfin	elf-in
zealot	zeal-ot
to-po-graph-ic	top-o-graph-ic
soupy	soup-y
l-iti-gious	li-ti-gious
ca-reerist	ca-reer-ist
pro-fes-sion-al-is-m	pro-fes-sion-al-ism
del-i-catessen	del-i-ca-tes-sen
haulage	haul-age
apho-ris-m	aph-o-rism
sonorous	so-no-rous
hy-dropho-bi-a	hy-dro-pho-bi-a
n-ode	node
bullish	bull-ish
as-sen-t	as-sent
u-p-lift-ed	uplifted
herbage	herb-age
in-fini-tive	in-fin-i-tive
avi-a-tion	a-vi-a-tion
u-n-aware	un-a-ware
piteous	pit-e-ous
punc-til-ious	punc-til-i-ous
in-valu-able	in-val-u-a-ble
elec-tri-cian	e-lec-tri-cian
s-mart	smart
over-heat	o-ver-heat
bide-t	bi-det
undy-ing	un-dy-ing
cheater	cheat-er
whether	wheth-er
or-di-nary	or-di-nar-y
i-n-ac-tiv-i-ty	in-ac-tiv-i-ty
dero-ga-tion	der-o-ga-tion
bumpy	bump-y
bony	bon-y
po-ten-tiome-ter	po-ten-ti-om-e-ter
glossy	gloss-y
ure-a	u-re-a
ser-van-t	serv-ant
epi-demi-ol-o-gist	ep-i-de-mi-ol-o-gist
het-erol-o-gous	het-er-ol-o-gous
for-cep-s	for-ceps
s-jam-bok	sjam-bok
creak-ing	creaking
s-ports-man	sports-man
hand-bal-l	hand-ball
s-mite	smite
hauli-er	haul-ier
ridicu-lous-ness	ri-dic-u-lous-ness
over-time	o-ver-time
trea-sure	treas-ure
tur-f	turf
seaborne	sea-borne
ter-ror-is-m	ter-ror-ism
scholas-tic	scho-las-tic
dolomite	do-lo-mite
rein-tro-duce	re-in-tro-duce
vinyl	vi-nyl
arable	ar-a-ble
con-tra-dic-t	con-tra-dict
grandee	gran-dee
cata-ma-ran	cat-a-ma-ran
bul-b	bulb
in-ter-preter	in-ter-pret-er
hookah	hook-ah
sug-ary	sug-ar-y
leisurewear	lei-sure-wear
delu-sive	de-lu-sive
mis-cel-la-neous	mis-cel-la-ne-ous
gig-gling	giggling
de-scen-dan-t	de-scend-ant
igua-na	i-gua-na
haughty	haugh-ty
for-warder	for-ward-er
peas-an-t	peas-ant
evo-lu-tion-ary	ev-o-lu-tion-ar-y
mono-rail	mon-o-rail
o-nion	on-ion
de-plorable	de-plor-a-ble
over-ex-po-sure	o-ver-ex-po-sure
elec-trophore-sis	e-lec-tro-pho-re-sis
de-ni-able	de-ni-a-ble
markup	mark-up
tiger	ti-ger
in-cum-ben-t	in-cum-bent
even-tide	e-ven-tide
coro-ner	cor-o-ner
dis-qui-etude	dis-qui-e-tude
s-lay-er	slay-er
s-pac-er	spac-er
c-om-mend	com-mend
elec-trode	e-lec-trode
syl-lo-gis-m	syl-lo-gism
un-der-de-vel-ope-d	un-der-de-vel-oped
s-tan-chion	stan-chion
car-away	car-a-way
d-u-al	du-al
rub-bishy	rub-bish-y
wear-able	wear-a-ble
whiten	whit-en
s-teel	steel
cur-b	curb
place-men-t	place-ment
pold-er	pol-der
in-tern-men-t	in-tern-ment
waspish	wasp-ish
con-fron-t	con-front
s-in-ter	sin-ter
in-sa-tiable	in-sa-tia-ble
heretic	her-e-tic
odi-um	o-di-um
un-work-able	un-work-a-ble
re-com-bi-nan-t	re-com-bi-nant
gree-nie	green-ie
hang-over	hang-o-ver
puni-tive	pu-ni-tive
toupee	tou-pee
cy-to-plas-m	cy-to-plasm
le-gal-is-m	le-gal-ism
daffy	daf-fy
pre-cooked	precooked
s-tu-den-t	stu-dent
la-ten-t	la-tent
censer	cen-ser
glassy	glass-y
tremen-dous	tre-men-dous
iron	i-ron
l-la-ma	lla-ma
ge-nom-ic	ge-no-mic
vit-ri-olic	vit-ri-ol-ic
pro-cure-men-t	pro-cure-ment
bat-tery	bat-ter-y
preda-to-ry	pred-a-to-ry
re-lax-ation	re-lax-a-tion
dis-able	dis-a-ble
s-tunned	stunned
armpit	arm-pit
over-reach	o-ver-reach
de-mount-able	de-mount-a-ble
pussy-cat	pussycat
trace-abil-i-ty	trace-a-bil-i-ty
ir-re-press-ible	ir-re-press-i-ble
repet-i-tive	re-pet-i-tive
river-ine	riv-er-ine
apoc-a-lyp-tic	a-poc-a-lyp-tic
classy	class-y
suit-ably	suit-a-bly
midair	mid-air
as-tronomer	as-tron-o-mer
lentil	len-til
es-cu-d-o	es-cu-do
op-por-tunis-m	op-por-tun-ism
xenon	xe-non
per-sis-tent-ly	per-sist-ent-ly
iron-work	i-ron-work
stri-den-t	stri-dent
milky	milk-y
pu-rifi-ca-tion	pu-ri-fi-ca-tion
epis-te-mo-log-i-cal	e-pis-te-mo-log-i-cal
procla-ma-tion	proc-la-ma-tion
wicked-ly	wick-ed-ly
coral	cor-al
opi-ate	o-pi-ate
gaseous	gas-e-ous
lig-a-men-t	lig-a-ment
rainy	rain-y
s-trat-e-gy	strat-e-gy
u-n-af-ford-able	un-af-ford-a-ble
bagatelle	bag-a-telle
s-tub-bly	stub-bly
mu-cosa	mu-co-sa
area	ar-e-a
emet-ic	e-met-ic
cer-ti-fi-able	cer-ti-fi-a-ble
fet-tered	fettered
cru-cible	cru-ci-ble
open-ly	o-pen-ly
kudu	ku-du
s-tar-ling	star-ling
re-state-men-t	re-state-ment
s-tam-p	stamp
re-strain-t	re-straint
dancer	danc-er
duo	du-o
car-boxyl	car-box-yl
longish	long-ish
silk-wor-m	silk-worm
lop-per-s	lop-pers
cryo-genic	cry-o-gen-ic
toi-letries	toi-let-ries
retic-u-lar	re-tic-u-lar
laun-derette	laun-der-ette
lin-ear	lin-e-ar
de-signed-ly	de-sign-ed-ly
over-pop-u-la-tion	o-ver-pop-u-la-tion
book-stal-l	book-stall
quirky	quirk-y
anon	a-non
in-spi-ra-tional	in-spi-ra-tion-al
mis-er-ably	mis-er-a-bly
ex-per-i-men-t	ex-per-i-ment
doubter	doubt-er
s-nort	snort
reprise	re-prise
facile	fac-ile
we-b	web
tox-i-c	tox-ic
u-n-awares	un-a-wares
away	a-way
toil-s	toils
weary-ing	wea-ry-ing
thievish	thiev-ish
wheezy	wheez-y
hindquar-ter-s	hind-quar-ters
philo-soph-i-cal-ly	phil-o-soph-i-cal-ly
glam-orous	glam-or-ous
l-it-i-gan-t	lit-i-gant
marcher	march-er
s-trapped	strapped
mil-lenar-i-an	mil-le-nar-i-an
i-n-un-date	in-un-date
un-drink-able	un-drink-a-ble
oph-thalmic	oph-thal-mic
posthu-mous-ly	post-hu-mous-ly
cryo-stat	cry-o-stat
elitism	e-lit-ism
in-ven-t	in-vent
kook-abur-ra	kook-a-bur-ra
un-invit-ing	un-in-vit-ing
p-re-sen-ta-tion-al	pres-en-ta-tion-al
ben-t	bent
delux-e	de-luxe
s-nout	snout
can-t	cant
reim-ple-ment-ed	reimplemented
dere-lic-tion	der-e-lic-tion
pi-quan-t	pi-quant
hedgerow	hedge-row
puma	pu-ma
ex-ac-t	ex-act
remap	re-map
doyen	doy-en
pig-ment-ed	pig-men-ted
voca-tive	voc-a-tive
prov-i-den-t	prov-i-dent
species	spe-cies
chimera	chi-me-ra
steplad-der	step-lad-der
mis-coun-t	mis-count
e-quip-men-t	e-quip-ment
piton	pi-ton
in-ter-jec-t	in-ter-ject
re-dis-cov-ery	re-dis-cov-er-y
dis-putable	dis-put-a-ble
s-cone	scone
propul-sion	pro-pul-sion
pre-his-toric	pre-his-tor-ic
sec-t	sect
cheer-s	cheers
cater-er	ca-ter-er
climber	climb-er
prover-bial	pro-ver-bi-al
b-o-rax	bo-rax
semi-fi-nal	sem-i-fi-nal
deca-dence	dec-a-dence
man-i-festo	man-i-fes-to
can-non-bal-l	can-non-ball
rein-ter-pret	re-in-ter-pret
distaff	dis-taff
sec-on-dar-i-ly	sec-ond-ar-i-ly
de-pri-va-tion	dep-ri-va-tion
bauble	bau-ble
myelin	my-e-lin
g-land	gland
timetable	time-ta-ble
hon-our	ho-nour
teenaged	teen-aged
con-sti-tu-tion-al-is-m	con-sti-tu-tion-al-ism
mas-sacre	mas-sa-cre
s-teed	steed
in-ter-con-nec-t	in-ter-con-nect
d-if-fer-ence	dif-fer-ence
c-ity	cit-y
in-con-testable	in-con-test-a-ble
se-nior-i-ty	sen-ior-i-ty
hearsay	hear-say
church-war-den	church-ward-en
pro-gressed	progressed
cu-rat-ed	curated
fly-over	fly-o-ver
fundrais-er	fund-rais-er
war-ran-t	war-rant
ru-mi-nan-t	ru-mi-nant
cabri-o-let	cab-ri-o-let
elec-tro-cu-tion	e-lec-tro-cu-tion
ex-pan-sion-is-m	ex-pan-sion-ism
emir	e-mir
duik-er	dui-ker
or-bital	or-bit-al
in-spec-torate	in-spec-tor-ate
u-n-adorned	un-a-dorned
dis-place-men-t	dis-place-ment
in-n	inn
heiress	heir-ess
draught-s	draughts
s-neak-i-ly	sneak-i-ly
fo-men-t	fo-ment
seedbed	seed-bed
pikestaff	pike-staff
crazi-ness	cra-zi-ness
t-wo-some	two-some
s-pare	spare
sec-u-lar-is-m	sec-u-lar-ism
d-if-fuse	dif-fuse
un-man-age-able	un-man-age-a-ble
con-tent-men-t	con-tent-ment
prodi-gious	pro-di-gious
testos-terone	tes-tos-ter-one
u-n-al-lo-cat-ed	un-al-lo-cat-ed
break-away	break-a-way
hab-it-able	hab-it-a-ble
copy-right	cop-y-right
petu-lance	pet-u-lance
stinker	stink-er
en-fee-bled	enfeebled
un-al-ter-able	un-al-ter-a-ble
ar-senic	ar-se-nic
in-ter-roga-tor	in-ter-ro-ga-tor
un-know-able	un-know-a-ble
s-tay	stay
modal-i-ty	mo-dal-i-ty
medal-lion	me-dal-lion
balus-ter	bal-us-ter
chamois	cham-ois
freely	free-ly
video-tape	vid-e-o-tape
over-es-ti-mate	o-ver-es-ti-mate
hubris-tic	hu-bris-tic
ped-i-men-t	ped-i-ment
pester	pes-ter
axle	ax-le
busi-ly	bus-i-ly
macaque	ma-caque
in-do-len-t	in-do-lent
n-erve	nerve
mega-volt	meg-a-volt
in-san-i-tary	in-san-i-tar-y
mar-quetry	mar-que-try
bal-moral	bal-mor-al
worka-day	work-a-day
postal	post-al
de-monolo-gy	de-mon-ol-o-gy
oblate	ob-late
ema-ci-a-tion	e-ma-ci-a-tion
s-liv-er	sliv-er
repa-ra-tion	rep-a-ra-tion
episode	ep-i-sode
hellish	hell-ish
stingy	stin-gy
s-toned	stoned
decre-men-t	dec-re-ment
en-joy-able	en-joy-a-ble
philoso-pher	phi-los-o-pher
re-spectable	re-spect-a-ble
mono-pole	mon-o-pole
granny	gran-ny
sies-ta	si-es-ta
is-suance	is-su-ance
k-ilo-hertz	kil-o-hertz
soloist	so-lo-ist
in-quisi-tor	in-quis-i-tor
ap-pendage	ap-pend-age
firmware	firm-ware
labi-al	la-bi-al
pre-cep-t	pre-cept
tem-po-rary	tem-po-rar-y
as-sign-men-t	as-sign-ment
ap-por-tion-men-t	ap-por-tion-ment
courage	cour-age
ex-cus-able	ex-cus-a-ble
cleaver-s	cleav-ers
in-cor-rec-t	in-cor-rect
moray	mo-ray
aper-ture	ap-er-ture
whif-f	whiff
colo-nial-ist	co-lo-ni-al-ist
neuter	neu-ter
min-istry	min-is-try
grainy	grain-y
cli-toral	clit-o-ral
baili-wick	bail-i-wick
s-to-ry-line	sto-ry-line
re-im-burse-men-t	re-im-burse-ment
rec-on-cil-able	rec-on-cil-a-ble
as-cetic	as-cet-ic
woody	wood-y
foot-baller	foot-ball-er
con-ceiv-able	con-ceiv-a-ble
com-peti-tor	com-pet-i-tor
com-mand-men-t	com-mand-ment
dis-cred-it-ed	discredited
elec-tro-mo-tive	e-lec-tro-mo-tive
unerring	un-err-ing
owlet	owl-et
handy	hand-y
p-ithy	pith-y
di-choto-my	di-chot-o-my
sar-i	sa-ri
vari-ant	var-i-ant
valise	va-lise
de-pen-den-t	de-pend-ent
mo-tocross	mo-to-cross
n-od-dy	nod-dy
viaduc-t	vi-a-duct
en-thalpy	en-thal-py
com-ple-men-t	com-ple-ment
enig-ma	e-nig-ma
in-choate	in-cho-ate
bene-fac-tion	ben-e-fac-tion
re-alpoli-tik	re-al-po-li-tik
u-ni-for-m	u-ni-form
grasshop-per	grass-hop-per
epi-der-mis	ep-i-der-mis
com-mence-men-t	com-mence-ment
across	a-cross
aba-cus	ab-a-cus
democ-ra-cy	de-moc-ra-cy
tele-ol-o-gy	tel-e-ol-o-gy
u-nan-swer-able	un-an-swer-a-ble
put-t	putt
par-alin-guis-tic	par-a-lin-guis-tic
mus-cu-loskele-tal	mus-cu-lo-skel-e-tal
unini-ti-at-ed	un-in-i-ti-at-ed
g-lycine	gly-cine
topo-log-i-cal	top-o-log-i-cal
miniskirt	min-i-skirt
dis-burse-men-t	dis-burse-ment
undi-rect-ed	un-di-rect-ed
pen-sion-able	pen-sion-a-ble
plu-ral-is-m	plu-ral-ism
regime	re-gime
saline	sa-line
s-tim-u-lan-t	stim-u-lant
poly-mer	pol-y-mer
poundage	pound-age
corny	corn-y
forego	fore-go
por-traitist	por-trait-ist
s-tock-ade	stock-ade
bel-liger-en-t	bel-lig-er-ent
le-nien-t	le-ni-ent
re-peat-able	re-peat-a-ble
at-tack-ing	attacking
patchy	patch-y
salmon	salm-on
arch-dio-cese	arch-di-o-cese
back-bencher	back-bench-er
phys-iog-no-my	phys-i-og-no-my
stony	ston-y
over-lay	o-ver-lay
viewfind-er	view-find-er
un-sellable	un-sell-a-ble
s-nail	snail
mas-t	mast
re-de-ploy-men-t	re-de-ploy-ment
ni-hilis-tic	ni-hil-is-tic
grass-root-s	grass-roots
veni-son	ven-i-son
d-if-fract	dif-fract
beeswax	bees-wax
dick-en-s	dick-ens
tena-cious-ly	te-na-cious-ly
geron-toc-ra-cy	ger-on-toc-ra-cy
both-ered	bothered
pen-t	pent
d-in-gle	din-gle
teleg-ra-phy	te-leg-ra-phy
parochial	pa-ro-chi-al
caseload	case-load
misog-y-nis-tic	mi-sog-y-nis-tic
unlove-ly	un-love-ly
il-lim-itable	il-lim-it-a-ble
in-tol-er-an-t	in-tol-er-ant
se-ca-teurs	sec-a-teurs
pas-san-t	pas-sant
syl-labary	syl-la-bar-y
plexus	plex-us
over-rule	o-ver-rule
wal-l	wall
japon-i-ca	ja-pon-i-ca
leg-endary	leg-end-ar-y
dossier	dos-si-er
limo	lim-o
un-read-able	un-read-a-ble
woodsmoke	wood-smoke
lithol-o-gy	li-thol-o-gy
en-tice-men-t	en-tice-ment
e-mer-gen-t	e-mer-gent
c-om-mend-able	com-mend-a-ble
reval-u-a-tion	re-val-u-a-tion
bullfinch	bull-finch
ev-i-den-t	ev-i-dent
v-enue	ven-ue
e-s-py	es-py
cun-nilin-gus	cun-ni-lin-gus
pres-tidig-i-ta-tion	pres-ti-dig-i-ta-tion
mag-ne-to-hy-dro-dy-nam-ic-s	mag-ne-to-hy-dro-dy-nam-ics
muti-nous	mu-ti-nous
coro-n-a	co-ro-na
s-cal-lop	scal-lop
e-lastin	e-las-tin
cir-cum-lo-cu-to-ry	cir-cum-loc-u-to-ry
sub-ur-b	sub-urb
transpon-der	tran-spon-der
un-con-tain-able	un-con-tain-a-ble
aqua	aq-ua
event-ful	e-vent-ful
ex-plo-ration	ex-plo-ra-tion
jeal-ousy	jeal-ous-y
her-mitage	her-mit-age
wicked-ness	wick-ed-ness
rein-car-na-tion	re-in-car-na-tion
re-align-men-t	re-a-lign-ment
fore-ar-m	fore-arm
un-mea-sur-able	un-meas-ur-a-ble
de-ter-mi-nan-t	de-ter-mi-nant
boot-s	boots
s-tom-achache	stom-ach-ache
nasal	na-sal
soli-tude	sol-i-tude
em-bo-som	em-bos-om
bumper	bump-er
ben-e-fi-cia-ry	ben-e-fi-ci-ar-y
ep-silon	ep-si-lon
col-lec-tivis-m	col-lec-tiv-ism
cade-t	ca-det
s-pleen	spleen
athe-is-m	a-the-ism
k-itchen-ware	kitch-en-ware
s-lip-stream	slip-stream
blus-ter-ing	blustering
resur-gen-t	re-sur-gent
isother-mal	i-so-ther-mal
kalei-do-scope	ka-lei-do-scope
jokey	jok-ey
p-neu-mat-ic	pneu-mat-ic
crony	cro-ny
over-crowd-ed	o-ver-crow-ded
brouha-ha	brou-ha-ha
eigh-teenth	eight-eenth
hefty	heft-y
eroti-cis-m	e-rot-i-cism
dis-agree	dis-a-gree
ver-dan-t	ver-dant
over-tone	o-ver-tone
ril-l	rill
cen-trifuge	cen-tri-fuge
sub-servien-t	sub-ser-vi-ent
con-ceiv-ably	con-ceiv-a-bly
avun-cu-lar	a-vun-cu-lar
bil-liard-s	bil-liards
physic	phys-ic
cu-rios-i-ty	cu-ri-os-i-ty
con-sul-tan-cy	con-sult-an-cy
ap-pre-cia-ble	ap-pre-ci-a-ble
im-agery	im-age-ry
kine-mat-ic-s	kin-e-mat-ics
epi-graph	ep-i-graph
un-nec-es-sary	un-nec-es-sar-y
em-ploy-men-t	em-ploy-ment
lancet	lan-cet
stripy	strip-y
despot-ic	des-pot-ic
ovum	o-vum
s-plurge	splurge
decla-ma-tion	dec-la-ma-tion
car-cino-gen-e-sis	car-cin-o-gen-e-sis
opal	o-pal
crisper	crisp-er
com-mu-nica-tive	com-mu-ni-ca-tive
ap-t	apt
corol-lary	cor-ol-lar-y
piti-less	pit-i-less
de-scen-den-t	de-scend-ent
cordiller-a	cor-dil-le-ra
in-tra-venous	in-tra-ve-nous
di-ver-gen-t	di-ver-gent
s-cot	scot
i-n-escapably	in-es-cap-a-bly
un-com-fort-ably	un-com-fort-a-bly
halite	hal-ite
des-orp-tion	de-sorp-tion
z-inc	zinc
poly-atom-ic	pol-y-a-tom-ic
clema-tis	clem-a-tis
cas-sowary	cas-so-war-y
pana-ma	pan-a-ma
bar-bel-l	bar-bell
tele-sales	tel-e-sales
hero-ine	her-o-ine
tem-po-rar-ily	tem-po-rar-i-ly
pe-cu-niary	pe-cu-ni-ar-y
trap-s	traps
gen-t	gent
palate	pal-ate
be-fal-l	be-fall
per-pe-tu-ity	per-pe-tu-i-ty
par-ent-ing	parenting
dishar-mo-ny	dis-har-mo-ny
tam-bourine	tam-bou-rine
dodgem	dodg-em
s-nick	snick
dan-druf-f	dan-druff
leapfrog	leap-frog
clemen-cy	clem-en-cy
squalid	squal-id
saunter	saun-ter
regi-cide	reg-i-cide
monogamy	mo-nog-a-my
polit-buro	po-lit-bu-ro
comet	com-et
bindweed	bind-weed
dogs-body	dogs-bod-y
el-e-gan-t	el-e-gant
fermion	fer-mi-on
ruler	rul-er
tri-umvi-rate	tri-um-vi-rate
coralline	cor-al-line
cam-panol-o-gy	cam-pa-nol-o-gy
roundup	round-up
lazy-bones	la-zy-bones
elo-quence	el-o-quence
s-tar-let	star-let
den-t	dent
cousin	cous-in
Words with errors: 2229
Words with incorrect number of syllables: 2046
Total evluated: 6500
Perfect accuracy: 0.66
Number of syllables accuracy: 0.69
Average Levenshtein Distance(across incorrect words): 1.21
