Attempt	Real
col-lapsi-ble	col-laps-i-ble
catholic	cath-o-lic
binoc-u-lar	bin-oc-u-lar
pen-i-ten-tiary	pen-i-ten-tia-ry
tele-ol-o-gy	tel-e-ol-o-gy
cowslip	cow-slip
er-bium	er-bi-um
obei-sance	o-bei-sance
avalanche	av-a-lanche
negate	ne-gate
clemen-cy	clem-en-cy
blud-geon	bludg-eon
queasy	quea-sy
capy-bara	cap-y-ba-ra
mossy	mos-sy
tax-able	tax-a-ble
doc-u-men-tary	doc-u-men-ta-ry
telex	tel-ex
duo	du-o
palace	pal-ace
u-n-avoid-able	un-a-void-a-ble
poster	post-er
in-ter-dis-ci-pli-nary	in-ter-dis-ci-pli-nar-y
prefer-ably	pref-er-a-bly
ringlet	ring-let
re-tal-ia-to-ry	re-tal-i-a-to-ry
satire	sat-ire
un-print-able	un-print-a-ble
tri-umphal	tri-um-phal
hack-able	hack-a-ble
delux-e	de-luxe
di-ar-rhea	di-ar-rhe-a
u-n-ac-cept-ably	un-ac-cept-a-bly
moray	mo-ray
con-tention	con-ten-tion
t-ed	ted
shiny	shin-y
shoring	shor-ing
camshaft	cam-shaft
over-view	o-ver-view
spinal	spi-nal
thyris-tor	thy-ris-tor
prepo-si-tion	prep-o-si-tion
brunette	bru-nette
cred-it-wor-thy	cred-it-worth-y
froward	fro-ward
drinker	drink-er
in-elas-tic	in-e-las-tic
midlife	mid-life
ne-ma-tode	nem-a-tode
carotene	car-o-tene
rainy	rain-y
ron-dav-el	ron-da-vel
en-fran-chise-men-t	en-fran-chise-ment
s-tum-bling	stum-bling
cat-a-com-b	cat-a-comb
sub-trop-ic-s	sub-trop-ics
s-port-ing	sport-ing
u-p-lift-ed	uplifted
gleam-ing	gleaming
over-hang	o-ver-hang
sharp-en-er	shar-pen-er
s-toke	stoke
dig-ni-tary	dig-ni-tar-y
bom-bard-men-t	bom-bard-ment
vari-cose	var-i-cose
b-otanist	bot-a-nist
cy-ber-net-ic-s	cy-ber-net-ics
cos-set-ed	cosseted
merid-ion-al	me-rid-i-o-nal
ar-guably	ar-gu-a-bly
s-narl	snarl
balus-ter	bal-us-ter
unswerv-ing	un-swerv-ing
fifty	fif-ty
tableau	tab-leau
phil-an-thropic	phil-an-throp-ic
re-ver-ber-an-t	re-ver-ber-ant
un-reach-able	un-reach-a-ble
bedrock	bed-rock
motet	mo-tet
soli-taire	sol-i-taire
cam-era-man	cam-er-a-man
je-junum	je-ju-num
in-duc-t	in-duct
paramed-i-cal	par-a-med-i-cal
s-can	scan
boa	bo-a
brief-in-g	brief-ing
del-i-ques-cen-t	del-i-ques-cent
pres-i-den-t	pres-i-dent
car-dioid	car-di-oid
tramway	tram-way
neu-ro-science	neu-ro-sci-ence
book-stal-l	book-stall
lethar-gic	le-thar-gic
s-tatis-tic	sta-tis-tic
goulash	gou-lash
in-ces-san-t	in-ces-sant
mer-chan-t	mer-chant
id-io-path-ic	id-i-o-path-ic
glas-nos-t	glas-nost
tonedeaf	tone-deaf
con-tin-gen-t	con-tin-gent
guardian	guard-i-an
s-to-ry-telling	sto-ry-tell-ing
a-gen-t	a-gent
bel-l	bell
taxi-dermy	tax-i-der-my
elo-quence	el-o-quence
pli-er-s	pli-ers
sala-man-der	sal-a-man-der
iso-la-tion-is-m	i-so-la-tion-ism
u-n-avail-ing	un-a-vail-ing
s-tar-lit	star-lit
ex-pi-ra-to-ry	ex-pir-a-to-ry
pedes-tri-an	pe-des-tri-an
thum-b	thumb
wilder-ness	wil-der-ness
de-featist	de-feat-ist
dyad	dy-ad
awash	a-wash
dis-cernible	dis-cern-i-ble
cov-e	cove
pharao-h	phar-aoh
cedil-la	ce-dil-la
c-on-cil-i-ate	con-cil-i-ate
pan-the-is-m	pan-the-ism
back-bencher	back-bench-er
i-n-or-di-nate	in-or-di-nate
neu-tral-is-m	neu-tral-ism
roast-ed	roasted
mor-dan-t	mor-dant
physic-s	phys-ics
abaft	a-baft
biped	bi-ped
swindler	swin-dler
para-dox-i-cal	par-a-dox-i-cal
syco-phancy	syc-o-phan-cy
cleanup	clean-up
l-ynx	lynx
ri-boflavin	ri-bo-fla-vin
geo-chem-istry	ge-o-chem-is-try
con-tac-t	con-tact
lyri-cist	lyr-i-cist
s-take	stake
cornea	cor-ne-a
lithi-um	lith-i-um
in-co-her-en-t	in-co-her-ent
sub-servience	sub-ser-vi-ence
foun-t	fount
ap-praisal	ap-prais-al
supine	su-pine
mod-esty	mod-es-ty
mic-turi-tion	mic-tu-ri-tion
s-lith-er	slith-er
oph-thalmic	oph-thal-mic
at-mo-spher-ic	at-mos-pher-ic
brain-stor-m	brain-storm
stopover	stop-o-ver
com-plaisan-t	com-plai-sant
mendele-vi-um	men-de-le-vi-um
ma-joli-ca	ma-jol-i-ca
pati-na-tion	pat-i-na-tion
tri-adic	tri-ad-ic
ex-tin-guish-men-t	ex-tin-guish-ment
over-ac-tive	o-ver-ac-tive
cara-cal	car-a-cal
drudgery	drudg-er-y
luke-war-m	luke-warm
fa-nati-cis-m	fa-nat-i-cism
pinafore	pin-a-fore
drap-ery	dra-per-y
psy-cho-me-t-ric	psy-cho-met-ric
pho-to-volta-ic	pho-to-vol-ta-ic
pipette	pi-pette
mayfly	may-fly
es-tab-lish-men-t	es-tab-lish-ment
o-belisk	ob-e-lisk
ir-re-solv-able	ir-re-solv-a-ble
mega	meg-a
away	a-way
im-paction	im-pac-tion
aque-ous	a-que-ous
duster	dust-er
puis-san-t	pu-is-sant
i-n-ac-ces-si-ble	in-ac-ces-si-ble
me-te-o-rol-o-gist	me-te-or-ol-o-gist
foolscap	fools-cap
an-t	ant
s-now-man	snow-man
hooky	hook-y
polygamy	po-lyg-a-my
masochist	mas-och-ist
g-land	gland
atom	at-om
im-prov-i-den-t	im-prov-i-dent
gas-troin-testi-nal	gas-tro-in-tes-ti-nal
spi-dery	spi-der-y
spinet	spin-et
re-dis-cov-ery	re-dis-cov-er-y
e-voca-tive	e-voc-a-tive
over-anx-ious	o-ver-anx-ious
pur-suance	pur-su-ance
partheno-gen-e-sis	par-the-no-gen-e-sis
in-abil-i-ty	in-a-bil-i-ty
iso-la-tion	i-so-la-tion
megabyte	meg-a-byte
os-teopath	os-te-o-path
em-piri-cis-m	em-pir-i-cism
blitzkrieg	blitz-krieg
liken	lik-en
ar-ranger	ar-rang-er
s-mall-hold-ing	small-hold-ing
colosto-my	co-los-to-my
tac-t	tact
ave	a-ve
lin-gerie	lin-ge-rie
planter	plant-er
trans-porter	trans-port-er
birdie	bird-ie
ir-repara-ble	ir-rep-a-ra-ble
trencher	trench-er
pol-l	poll
mag-ne-to-hy-dro-dy-nam-ic-s	mag-ne-to-hy-dro-dy-nam-ics
parachutist	par-a-chut-ist
n-ode	node
sabra	sa-bra
amoun-t	a-mount
tom-fool-ery	tom-fool-er-y
drainage	drain-age
in-ter-op-er-abil-i-ty	in-ter-op-er-a-bil-i-ty
s-park	spark
s-ta-sis	sta-sis
s-cout-ing	scout-ing
ex-ult-ing	exulting
s-cary	scar-y
s-liv-er	sliv-er
hy-dropho-bic	hy-dro-pho-bic
gaiter	gait-er
c-on-cil-i-a-tion	con-cil-i-a-tion
rel-a-tivis-m	rel-a-tiv-ism
lassie	las-sie
g-lyph	glyph
paving	pav-ing
fiendish	fiend-ish
trans-ac-t	trans-act
wa-ter-work-s	wa-ter-works
d-u-al	du-al
chara-banc	char-a-banc
s-campi	scam-pi
joey	jo-ey
retro-fit	ret-ro-fit
mis-er-ably	mis-er-a-bly
dis-band-men-t	dis-band-ment
dis-obe-di-ence	dis-o-be-di-ence
urine	u-rine
s-ludge	sludge
hauler	haul-er
parish	par-ish
in-sipid	in-sip-id
weasel	wea-sel
ju-ridi-cal	ju-rid-i-cal
move-men-t	move-ment
un-ob-tain-able	un-ob-tain-a-ble
pen-nan-t	pen-nant
en-docrine	en-do-crine
pho-to-elec-tric	pho-to-e-lec-tric
n-erve-less	nerve-less
decre-men-t	dec-re-ment
tremor	trem-or
vicin-i-ty	vi-cin-i-ty
ver-dan-t	ver-dant
earnest	ear-nest
s-mut-ty	smut-ty
psy-cholin-guis-tic-s	psy-cho-lin-guis-tics
de-mount-able	de-mount-a-ble
so-cialite	so-cial-ite
wolfhound	wolf-hound
calorime-ter	cal-o-rim-e-ter
un-al-ter-able	un-al-ter-a-ble
dart-s	darts
re-trac-t	re-tract
poignant-ly	poign-ant-ly
i-n-ap-pro-pri-ate	in-ap-pro-pri-ate
con-tain-men-t	con-tain-ment
s-cen-t	scent
alive	a-live
mis-con-duc-t	mis-con-duct
de-sir-able	de-sir-a-ble
scrumhalf	scrum-half
in-evitable	in-ev-i-ta-ble
any-way	an-y-way
tantrum	tan-trum
s-cat-tered	scattered
caprice	ca-price
com-mu-ni-can-t	com-mu-ni-cant
ven-t	vent
ex-citable	ex-cit-a-ble
signet	sig-net
liqueur	li-queur
i-n-ac-tion	in-ac-tion
u-p-lift	up-lift
wis-p	wisp
enu-mer-a-tor	e-nu-mer-a-tor
avion-ic-s	a-vi-on-ics
es-sen-tial-is-m	es-sen-tial-ism
s-cythe	scythe
con-tam-i-nan-t	con-tam-i-nant
l-it-i-gan-t	lit-i-gant
s-nug-ly	snug-ly
gun-nery	gun-ner-y
pen-i-ten-t	pen-i-tent
pur-port-ed	purported
cream-ery	cream-er-y
disin-gen-u-ous	dis-in-gen-u-ous
apothe-cary	a-poth-e-car-y
s-ince	since
dairy	dair-y
s-tra-tus	stra-tus
brew-ery	brew-er-y
s-caf-fold	scaf-fold
proac-tive	pro-ac-tive
qua-drat-ic	quad-rat-ic
polyun-sat-u-rat-ed	pol-y-un-sat-u-rat-ed
y-olk	yolk
coast-ing	coasting
s-trat-i-fi-ca-tion	strat-i-fi-ca-tion
reprise	re-prise
geno-type	gen-o-type
sur-viv-able	sur-viv-a-ble
en-doge-nous	en-dog-e-nous
idio-syn-cratic	id-i-o-syn-crat-ic
ra-dio-met-ric	ra-di-o-met-ric
turn-about	turn-a-bout
s-in-u-ous	sin-u-ous
po-litesse	pol-i-tesse
u-n-aware	un-a-ware
poly-mer	pol-y-mer
s-nake	snake
tri-maran	tri-ma-ran
crotch-ety	crotch-et-y
ap-pli-can-t	ap-pli-cant
peanut	pea-nut
un-even-ly	un-e-ven-ly
di-gester	di-gest-er
maser	ma-ser
d-e-duc-tion	de-duc-tion
pre-pared-ness	pre-par-ed-ness
rekin-dle	re-kin-dle
ir-re-vo-ca-bly	ir-rev-o-ca-bly
anger	an-ger
avi-a-tor	a-vi-a-tor
pur-veyance	pur-vey-ance
sil-vered	silvered
leisure	lei-sure
en-dear-men-t	en-dear-ment
flotil-la	flo-til-la
reaf-fir-m	re-af-firm
l-it-i-ga-tion	lit-i-ga-tion
distaff	dis-taff
in-ter-de-pen-den-t	in-ter-de-pend-ent
in-stan-t	in-stant
fleshy	flesh-y
sav-agery	sav-age-ry
ten-t	tent
s-culp-t	sculpt
s-word-fish	sword-fish
lantern	lan-tern
hayloft	hay-loft
quan-tifi-ca-tion	quan-ti-fi-ca-tion
s-cut-tle	scut-tle
peri-na-tal	per-i-na-tal
s-lump	slump
u-niden-ti-fi-able	un-i-den-ti-fi-a-ble
dis-avow	dis-a-vow
car-rion	car-ri-on
kalei-do-scop-ic	ka-lei-do-scop-ic
pri-mar-i-ly	pri-ma-ri-ly
s-lam	slam
flinty	flint-y
wrap-around	wrap-a-round
mon-e-taris-m	mon-e-ta-rism
dis-ori-ent-ed	disoriented
gra-di-en-t	gra-di-ent
tetchy	tetch-y
lazi-ly	la-zi-ly
in-tel-lec-tu-al-is-m	in-tel-lec-tu-al-ism
garage	ga-rage
weaver	weav-er
sym-bion-t	sym-bi-ont
fil-a-men-t	fil-a-ment
mistle-toe	mis-tle-toe
premise	prem-ise
crispy	crisp-y
curlew	cur-lew
ap-pre-cia-bly	ap-pre-ci-a-bly
sullen	sul-len
b-lis-ter-ing	blis-ter-ing
k-i-nase	ki-nase
islet	is-let
sus-tain-ably	sus-tain-a-bly
monoc-u-lar	mo-noc-u-lar
sen-ti-men-tal-is-m	sen-ti-men-tal-ism
im-mutable	im-mu-ta-ble
y-outh-ful	youth-ful
con-form-ity	con-form-i-ty
u-topi-a	u-to-pi-a
bas-ketry	bas-ket-ry
cat-e-chis-m	cat-e-chism
moral	mor-al
en-list-men-t	en-list-ment
k-it	kit
s-moother	smooth-er
chevron	chev-ron
mus-ke-teer	mus-ket-eer
reap-pear	re-ap-pear
touristy	tour-ist-y
gazetteer	gaz-et-teer
bungee	bun-gee
s-lut	slut
medusa	me-du-sa
any-ways	an-y-ways
babysit	ba-by-sit
in-sid-e	in-side
s-tat-ed	stat-ed
imag-in-ings	im-ag-in-ings
gam-bling	gam-bling
s-plin-t	splint
know-able	know-a-ble
in-ves-tiga-tive	in-ves-ti-ga-tive
eleventh	e-lev-enth
tol-l	toll
eter-nal-ly	e-ter-nal-ly
dis-pos-able	dis-pos-a-ble
test-ing	testing
prodi-gious	pro-di-gious
re-liv-e	re-live
revenan-t	rev-e-nant
turnover	turn-o-ver
talkie	talk-ie
semi-cir-cu-lar	sem-i-cir-cu-lar
fluffy	fluff-y
cus-tomer	cus-tom-er
okapi	o-ka-pi
s-trato-sphere	strat-o-sphere
a-p-a-thet-ic	ap-a-thet-ic
waspish	wasp-ish
in-nocu-ous	in-noc-u-ous
gur-gling	gurgling
antler	ant-ler
e-u-phemistic	eu-phe-mis-tic
re-alpoli-tik	re-al-po-li-tik
re-ceiv-able	re-ceiv-a-ble
d-if-fer-en-t	dif-fer-ent
cy-tochrome	cy-to-chrome
dullard	dull-ard
velo-drome	ve-lo-drome
cun-nilin-gus	cun-ni-lin-gus
moun-taineer	moun-tain-eer
racy	rac-y
cen-tipede	cen-ti-pede
mul-tira-cial	mul-ti-ra-cial
bur-glary	bur-gla-ry
topo-graph-i-cal	top-o-graph-i-cal
urol-o-gist	u-rol-o-gist
pan-t	pant
blowup	blow-up
shandy	shan-dy
in-fan-t	in-fant
diplo-mat	dip-lo-mat
elo-quen-t	el-o-quent
foot-baller	foot-ball-er
trage-di-an	tra-ge-di-an
sub-unit	sub-u-nit
coro-nal	cor-o-nal
seclu-sion	se-clu-sion
s-neak	sneak
megas-tar	meg-a-star
over-ture	o-ver-ture
translit-er-ate	trans-lit-er-ate
dis-com-fort-ing	discomforting
u-n-armed	un-armed
im-por-tan-t	im-por-tant
fore-fron-t	fore-front
ga-mete	gam-ete
recom-mence	re-com-mence
un-bear-able	un-bear-a-ble
s-lack-er	slack-er
hand-picked	handpicked
trunk-s	trunks
brochure	bro-chure
re-versed	reversed
c-og-nizan-t	cog-ni-zant
s-played	splayed
gaze-bo	ga-ze-bo
s-now-drop	snow-drop
brutish	brut-ish
repli-ca-tor	rep-li-ca-tor
deputy	dep-u-ty
kinswom-an	kins-wom-an
fisticuff-s	fist-i-cuffs
umpteenth	ump-teenth
pro-trac-t	pro-tract
felony	fel-o-ny
be-lit-tling	belittling
nul-l	null
covenan-t	cov-e-nant
teacup	tea-cup
gaga	ga-ga
les-bian	les-bi-an
de-pend-abil-i-ty	de-pend-a-bil-i-ty
coun-ter-ac-t	coun-ter-act
b-otany	bot-a-ny
per-cu-ta-neous	per-cu-ta-ne-ous
ex-oti-cis-m	ex-ot-i-cism
per-fectibil-i-ty	per-fect-i-bil-i-ty
over-hand	o-ver-hand
elec-tric-i-ty	e-lec-tric-i-ty
en-tomb-men-t	en-tomb-ment
un-re-mark-able	un-re-mark-a-ble
en-tice-men-t	en-tice-ment
s-loshed	sloshed
pho-to-genic	pho-to-gen-ic
haiku	hai-ku
coral	cor-al
species	spe-cies
grassy	grass-y
s-peak-er	speak-er
un-beat-able	un-beat-a-ble
hail-stor-m	hail-storm
s-e-lec-tion	se-lec-tion
sac-risty	sac-ris-ty
flaky	flak-y
rein-car-nate	re-in-car-nate
as-pec-t	as-pect
berserk	ber-serk
triv-ial	triv-i-al
s-phyg-mo-manome-ter	sphyg-mo-ma-nom-e-ter
s-low	slow
un-der-cur-ren-t	un-der-cur-rent
quo-tien-t	quo-tient
newsy	news-y
s-nuff-box	snuff-box
over-whelm	o-ver-whelm
pep-pered	peppered
clever	clev-er
patho-log-i-cal-ly	path-o-log-i-cal-ly
chom-p	chomp
ob-scu-ran-tist	ob-scu-rant-ist
elixir	e-lix-ir
pecan	pe-can
habi-ta-tion	hab-i-ta-tion
sym-po-sium	sym-po-si-um
elec-tion	e-lec-tion
eosin	e-o-sin
teleme-try	te-lem-e-try
tril-l	trill
e-dic-t	e-dict
fri-ary	fri-ar-y
s-cathing	scath-ing
flota-tion	flo-ta-tion
un-trans-lat-able	un-trans-lat-a-ble
s-cald	scald
halon	hal-on
d-in-gle	din-gle
whoop-s	whoops
re-plan-t	re-plant
elec-trol-y-sis	e-lec-trol-y-sis
prof-itabil-i-ty	prof-it-a-bil-i-ty
pub-licly	pub-lic-ly
kerosene	ker-o-sene
lurid	lu-rid
mini-bar	min-i-bar
limpet	lim-pet
aun-t	aunt
ex-tend-ing	extending
k-ing	king
puni-tive	pu-ni-tive
re-flec-t	re-flect
dis-uni-ty	dis-u-ni-ty
usu-al-ly	u-su-al-ly
c-ity	cit-y
un-abashed	un-a-bashed
arch-dio-cese	arch-di-o-cese
bul-letin	bul-le-tin
a-vian	a-vi-an
s-mooth-ness	smooth-ness
c-on-cil-ia-tor	con-cil-i-a-tor
d-e-duce	de-duce
s-mug	smug
con-nect-ing	con-nec-ting
le-gionary	le-gion-ar-y
minute	mi-nute
s-lot-ted	slot-ted
aster-n	a-stern
per-jury	per-ju-ry
ge-o-mag-net-i-cal-ly	ge-o-mag-ne-ti-cal-ly
s-toned	stoned
as-sis-tan-t	as-sis-tant
boule-vard	boul-e-vard
se-man-tic-s	se-man-tics
re-phrases	re-phra-ses
we-b	web
re-uni-fi-ca-tion	re-u-ni-fi-ca-tion
s-ling	sling
vine-gar	vin-e-gar
pre-dict-ed	predicted
wrestler	wres-tler
assig-na-tion	as-sig-na-tion
grainy	grain-y
ex-em-plary	ex-em-pla-ry
award	a-ward
p-re-serve	pre-serve
glo-be-trot-ting	globe-trot-ting
bat-tle-men-t	bat-tle-ment
crois-san-t	crois-sant
leather	leath-er
glacia-tion	gla-ci-a-tion
in-tifa-da	in-ti-fa-da
k-itsch	kitsch
mono-graph	mon-o-graph
quif-f	quiff
over-charge	o-ver-charge
slaver	slav-er
dioce-san	di-oc-e-san
aplom-b	a-plomb
par-a-bola	pa-rab-o-la
table-cloth	ta-ble-cloth
cor-ti-cos-teroid	cor-ti-co-ster-oid
u-n-alike	un-a-like
un-der-e-d-u-cat-ed	un-der-ed-u-cat-ed
mil-i-tarist	mil-i-ta-rist
augite	au-gite
s-tim-u-lan-t	stim-u-lant
b-otan-i-cal	bo-tan-i-cal
u-nim-ped-ed	un-im-ped-ed
ben-t	bent
n-u-mis-mat-ic-s	nu-mis-mat-ics
record-ing	re-cord-ing
cordite	cord-ite
chronome-ter	chro-nom-e-ter
pos-i-tivist	pos-i-tiv-ist
idea	i-de-a
geo-met-ric	ge-o-met-ric
ep-ithe-li-um	ep-i-the-li-um
psy-cho-anal-y-sis	psy-cho-a-nal-y-sis
re-cidi-vis-m	re-cid-i-vism
s-tar-ry	star-ry
crazy	cra-zy
dereg-u-late	de-reg-u-late
canon-ic	ca-non-ic
recre-ation-al	rec-re-a-tion-al
lethal	le-thal
cack-ling	cackling
kril-l	krill
tablet	tab-let
uten-sil	u-ten-sil
e-cho	ech-o
n-im-bly	nim-bly
mul-ti-level	mul-ti-lev-el
necro-sis	ne-cro-sis
jam-b	jamb
calum-ny	cal-um-ny
peas-an-t	peas-ant
break-able	break-a-ble
s-tock-ist	stock-ist
but-t	butt
hip-popota-mus	hip-po-pot-a-mus
fairy	fair-y
im-pe-cu-nious	im-pe-cu-ni-ous
para-ble	par-a-ble
s-nif-f	sniff
punch-able	punch-a-ble
i-n-ap-pro-pri-ate-ly	in-ap-pro-pri-ate-ly
uned-i-fy-ing	un-ed-i-fy-ing
trade-marked	trademarked
s-worn	sworn
dis-sec-t	dis-sect
hy-drazine	hy-dra-zine
con-scrip-t	con-script
over-dose	o-ver-dose
ax-e	axe
skew-ered	skewered
in-sou-ciant	in-sou-ci-ant
pesti-len-t	pes-ti-lent
groat-s	groats
vale-dic-tion	val-e-dic-tion
scenery	scen-er-y
saga	sa-ga
emir	e-mir
ac-coun-t	ac-count
s-cum	scum
lyri-cal	lyr-i-cal
c-om-mend-able	com-mend-a-ble
spillage	spill-age
man-darin	man-da-rin
or-biter	or-bit-er
pro-nounce-men-t	pro-nounce-ment
het-ero-sex-u-al-i-ty	het-er-o-sex-u-al-i-ty
stil-l	still
doc-tor-ing	doctoring
dia-lec-tic	di-a-lec-tic
seden-tary	sed-en-tar-y
s-mooth-ly	smooth-ly
both-ered	bothered
s-core-board	score-board
ini-tial-ly	in-i-tial-ly
celandine	cel-an-dine
her-aldry	her-ald-ry
tan-nery	tan-ner-y
pold-er	pol-der
gantry	gan-try
mar-riage-able	mar-riage-a-ble
cov-et-ed	coveted
hul-la-baloo	hul-la-ba-loo
s-tate	state
in-cip-i-en-t	in-cip-i-ent
brun-t	brunt
s-cent-ed	scent-ed
bar-racu-d-a	bar-ra-cu-da
over-shot	o-ver-shot
turgid	tur-gid
purga-tive	pur-ga-tive
are-na	a-re-na
dis-traugh-t	dis-traught
saucepan	sauce-pan
un-charis-mat-ic	un-char-is-mat-ic
syn-chronic-i-ty	syn-chro-nic-i-ty
clumpy	clump-y
rev-o-lu-tion-ary	rev-o-lu-tion-ar-y
s-neak-i-ly	sneak-i-ly
sep-a-ratism	sep-a-ra-tism
takeover	take-o-ver
pouter	pout-er
in-eluctable	in-e-luc-ta-ble
breezy	breez-y
philol-o-gy	phi-lol-o-gy
podi-um	po-di-um
e-ques-tri-an-is-m	e-ques-tri-an-ism
tithing	tith-ing
unabridged	un-a-bridged
u-n-am-bi-tious	un-am-bi-tious
sickbed	sick-bed
s-mall-hold-er	small-hold-er
per-man-ganate	per-man-ga-nate
con-junc-t	con-junct
semi-fi-nal	sem-i-fi-nal
sus-pec-t	sus-pect
ap-pease-men-t	ap-pease-ment
seascape	sea-scape
open-er	o-pen-er
en-dother-mic	en-do-ther-mic
radar	ra-dar
un-able	un-a-ble
piti-less	pit-i-less
un-equiv-o-cal-ly	un-e-quiv-o-cal-ly
seroneg-a-tive	se-ro-neg-a-tive
pro-ce-du-ral-ly	pro-ce-dur-al-ly
in-ter-me-di-ary	in-ter-me-di-ar-y
jan-u-ary	jan-u-ar-y
over-pro-duced	overproduced
bene-fac-tress	ben-e-fac-tress
e-quiv-a-len-t	e-quiv-a-lent
respire	re-spire
hypochon-dri-a	hy-po-chon-dri-a
punc-til-ious	punc-til-i-ous
awning	awn-ing
budgeri-gar	budg-er-i-gar
en-cycli-cal	en-cyc-li-cal
duo-logue	du-o-logue
el-e-gan-t	el-e-gant
s-mudgy	smudg-y
preterite	pret-er-ite
meta-mor-phosed	metamorphosed
cat-tery	cat-te-ry
mega-phone	meg-a-phone
prophe-cy	proph-e-cy
ra-tio-nal	ra-tion-al
im-pon-der-able	im-pon-der-a-ble
s-tud	stud
de-monolo-gy	de-mon-ol-o-gy
re-assem-bly	re-as-sem-bly
in-ter-change-ably	in-ter-change-a-bly
ir-re-versible	ir-re-vers-i-ble
nurs-ery-man	nurs-er-y-man
tele-vised	televised
ide-al	i-de-al
odome-ter	o-dom-e-ter
var-ie-gat-ed	var-i-e-gat-ed
jin-go-is-m	jin-go-ism
re-gali-a	re-ga-li-a
s-nout	snout
brand-ing	branding
re-cruiter	re-cruit-er
tem-po-rary	tem-po-rar-y
s-paniel	span-iel
vagabond	vag-a-bond
no-ti-fi-able	no-ti-fi-a-ble
furtive-ly	fur-tive-ly
s-loop	sloop
weed-s	weeds
un-ut-ter-able	un-ut-ter-a-ble
over-step	o-ver-step
trous-er	trou-ser
fran-chisee	fran-chi-see
n-odal	nod-al
machis-mo	ma-chis-mo
awhile	a-while
cor-pu-len-t	cor-pu-lent
en-v-i-ron	en-vi-ron
pen-tame-ter	pen-tam-e-ter
me-chan-ic-s	me-chan-ics
cherub	cher-ub
un-in-ter-pretable	un-in-ter-pret-a-ble
dat-able	dat-a-ble
bar-rack-s	bar-racks
penum-bra	pe-num-bra
au-to-bah-n	au-to-bahn
deco-rum	de-co-rum
apoplexy	ap-o-plex-y
s-care-crow	scare-crow
bronchial	bron-chi-al
boyfriend	boy-friend
be-muse-men-t	be-muse-ment
busy-body	bus-y-bod-y
mid-wifer-y	mid-wife-ry
in-her-i-ta-ble	in-her-it-a-ble
gen-i-tali-a	gen-i-ta-li-a
risot-to	ri-sot-to
tho-raci-c	tho-rac-ic
friendlily	friend-li-ly
con-vic-t	con-vict
flashy	flash-y
per-sis-tent-ly	per-sist-ent-ly
top-sy-turvy	top-sy-tur-vy
bil-iary	bil-i-ar-y
my-opi-a	my-o-pi-a
tweedy	tweed-y
undis-ci-plined	un-dis-ci-plined
re-deemable	re-deem-a-ble
re-mov-able	re-mov-a-ble
fo-men-t	fo-ment
en-durance	en-dur-ance
o-r-a-to-ry	or-a-to-ry
rem-nan-t	rem-nant
grad-u-al-is-m	grad-u-al-ism
fetishist	fet-ish-ist
vivid-ly	viv-id-ly
holis-ti-cal-ly	ho-lis-ti-cal-ly
se-nior-i-ty	sen-ior-i-ty
hys-terec-to-my	hys-ter-ec-to-my
rem-i-nis-cen-t	rem-i-nis-cent
de-posi-tary	de-pos-i-tar-y
mi-cro-farad	mi-cro-far-ad
lounger	loung-er
ex-is-tence	ex-ist-ence
in-nard-s	in-nards
in-ex-tin-guish-able	in-ex-tin-guish-a-ble
ba-ro-nial	ba-ro-ni-al
pream-p	pre-amp
naked	na-ked
hawthorn	haw-thorn
v-enue	ven-ue
u-nadul-ter-at-ed	un-a-dul-ter-at-ed
gable	ga-ble
e-d-u-cate	ed-u-cate
leisured	lei-sured
relic-t	rel-ict
il-menite	il-men-ite
nun-nery	nun-ner-y
lik-able	lik-a-ble
daf-fodil	daf-fo-dil
tox-i-c-i-ty	tox-ic-i-ty
ter-m	term
an-techam-ber	an-te-cham-ber
s-teed	steed
mega-lo-ma-ni-ac	meg-a-lo-ma-ni-ac
unre-deemed	un-re-deemed
oboe	o-boe
para-nor-mal	par-a-nor-mal
en-counter	en-coun-ter
parochial-is-m	pa-ro-chi-al-ism
undis-crim-i-nat-ing	un-dis-crim-i-nat-ing
so-cioe-co-nom-ic	so-ci-o-ec-o-nom-ic
n-im-bus	nim-bus
moral-i-ty	mo-ral-i-ty
in-er-ti-a	in-er-tia
metas-ta-sis	me-tas-ta-sis
sedan	se-dan
stinker	stink-er
read-able	read-a-ble
f-reak-ish	freak-ish
baoba-b	ba-o-bab
doubtless-ly	doubt-less-ly
cretinous	cre-tin-ous
aor-tic	a-or-tic
em-ployed	employed
de-fer-men-t	de-fer-ment
reaper	reap-er
sleazy	slea-zy
sacra-men-tal	sac-ra-men-tal
an-tag-o-nis-m	an-tag-o-nism
over-crowd	o-ver-crowd
ir-re-press-ible	ir-re-press-i-ble
mi-cro-elec-tron-ic-s	mi-cro-e-lec-tron-ics
dereg-u-la-tion	de-reg-u-lation
spel-l	spell
re-pay-men-t	re-pay-ment
l-itotes	li-to-tes
ho-mo-ge-neous	ho-mo-ge-ne-ous
undis-guised	un-dis-guised
s-tol-id	stol-id
syl-labub	syl-la-bub
masseur	mas-seur
monau-ral	mon-au-ral
s-tair-head	stair-head
prospec-tus	pro-spec-tus
residu-um	re-sid-u-um
lamp-lighter	lamp-light-er
raider	raid-er
s-par-row	spar-row
pa-pyrus	pa-py-rus
porta-bil-i-ty	port-a-bil-i-ty
in-signif-i-can-t	in-sig-nif-i-cant
cater	ca-ter
limp-ing	limping
s-tud-ded	stud-ded
mar-keter	mar-ket-er
muster	mus-ter
fold-ing	folding
s-pline	spline
m-is-for-tune	mis-for-tune
ar-cana	ar-ca-na
polemi-cist	po-lem-i-cist
tenor	ten-or
quadri-lat-er-al	quad-ri-lat-er-al
poi-sonous	poi-son-ous
s-calp	scalp
mo-lasses	mo-las-ses
ined-i-ble	in-ed-i-ble
en-trench-men-t	en-trench-ment
bassist	bass-ist
tirade	ti-rade
ex-cus-able	ex-cus-a-ble
legate	leg-ate
s-cale	scale
lisp-ing	lis-ping
translu-cen-t	trans-lu-cent
op-er-a-tional	op-er-a-tion-al
s-tonework	stone-work
fraud-u-len-t	fraud-u-lent
ge-neti-cist	ge-net-i-cist
unglam-orous	un-glam-or-ous
asep-tic	a-sep-tic
eeri-ly	ee-ri-ly
k-ilo-hertz	kil-o-hertz
civic	civ-ic
pearly	pearl-y
cur-able	cur-a-ble
ca-su-istry	cas-u-ist-ry
dance-able	dance-a-ble
canon-i-cal	ca-non-i-cal
s-mashed	smashed
sim-plis-m	sim-plism
chameleon	cha-me-le-on
s-tupid	stu-pid
i-n-un-date	in-un-date
cys-teine	cys-te-ine
payable	pay-a-ble
s-chem-ing	schem-ing
an-thro-pocen-tric	an-thro-po-cen-tric
golfer	golf-er
prag-mat-ic-s	prag-mat-ics
satir-ic	sa-tir-ic
killer	kil-ler
avun-cu-lar	a-vun-cu-lar
en-force-men-t	en-force-ment
urchin	ur-chin
s-trange	strange
damsel	dam-sel
elec-tri-cian	e-lec-tri-cian
tiger-ish	ti-ger-ish
cur-tilage	cur-ti-lage
power-boat	pow-er-boat
cation	cat-i-on
around	a-round
de-viance	de-vi-ance
per-fidy	per-fi-dy
s-mug-gle	smug-gle
un-wary	un-war-y
sewage	sew-age
en-slave-men-t	en-slave-ment
steadi-ness	stead-i-ness
com-pelling	com-pel-ling
s-po-rad-i-cal-ly	spo-rad-i-cal-ly
telling	tell-ing
over-pow-er	o-ver-pow-er
de-sali-na-tion	de-sal-i-na-tion
re-vival	re-viv-al
over-drive	o-ver-drive
odor-if-er-ous	o-dor-if-er-ous
prostate	pros-tate
s-pare	spare
whomev-er	whom-ev-er
tal-l	tall
over-man-tel	o-ver-man-tel
sophist	soph-ist
mono-plane	mon-o-plane
e-van-ge-lis-m	e-van-ge-lism
router	rout-er
ex-cep-tion-able	ex-cep-tion-a-ble
reser-va-tion	res-er-va-tion
sober-ly	so-ber-ly
laud-s	lauds
s-tormer	storm-er
seedbed	seed-bed
xenon	xe-non
rea-son-ably	rea-son-a-bly
er-r	err
temptress	tempt-ress
ool-o-gy	o-ol-o-gy
lega-tee	leg-a-tee
func-tion-al-is-m	func-tion-al-ism
apoc-ryphal	a-poc-ry-phal
telethon	tel-e-thon
s-tore-room	store-room
breast-feed-ing	breastfeeding
workspace	work-space
in-ef-fi-cien-t	in-ef-fi-cient
framer	fram-er
nico-tine	nic-o-tine
brava-do	bra-va-do
fusil-lade	fu-sil-lade
plushy	plush-y
gelati-nous	ge-lat-i-nous
anon	a-non
bowlder	bowl-der
weighty	weight-y
in-dig-nan-t	in-dig-nant
in-clemen-t	in-clem-ent
s-laugh-ter	slaugh-ter
over-run	o-ver-run
undy-ing	un-dy-ing
ten-antry	ten-ant-ry
s-teril-i-ty	ste-ril-i-ty
undis-mayed	un-dis-mayed
s-in-cere-ly	sin-cere-ly
s-nif-fer	sniff-er
s-neak-ing	sneak-ing
s-tor-age	stor-age
halite	hal-ite
monastery	mon-as-ter-y
bilin-gual	bi-lin-gual
s-tratig-ra-phy	stra-tig-ra-phy
pen-chan-t	pen-chant
quintessen-tial-ly	quin-tes-sen-tial-ly
en-durable	en-dur-a-ble
u-n-awak-ened	un-a-wak-ened
at-tain-able	at-tain-a-ble
so-h	soh
bathos	ba-thos
op-eretta	op-er-et-ta
con-gru-en-t	con-gru-ent
deca-dence	dec-a-dence
semi-fi-nal-ist	sem-i-fi-nal-ist
baroness	bar-on-ess
su-per-natan-t	su-per-na-tant
at-trib-ut-able	at-trib-ut-a-ble
un-for-giv-able	un-for-giv-a-ble
for-syth-ia	for-syth-i-a
fire-bal-l	fire-ball
satirist	sat-i-rist
poly-syl-lab-ic	pol-y-syl-lab-ic
elec-tive	e-lec-tive
hy-drochlo-ride	hy-dro-chlo-ride
s-parkle	spar-kle
het-ero-gene-ity	het-er-o-ge-ne-i-ty
fid-get	fidg-et
thaw-ing	thawing
count-able	count-a-ble
cu-rare	cu-ra-re
rafter	raft-er
ra-tio-nale	ra-tion-ale
cut-lery	cut-ler-y
reshow	re-show
re-assess	re-as-sess
s-tun-ning-ly	stun-ning-ly
rene-go-ti-ate	re-ne-go-ti-ate
s-trag-gly	strag-gly
seedy	seed-y
boun-teous	boun-te-ous
sexy	sex-y
s-tand-point	stand-point
pro-tec-t	pro-tect
septet	sep-tet
eighty	eight-y
wear-able	wear-a-ble
dis-tin-guish-able	dis-tin-guish-a-ble
litho-graph-ic	lith-o-graph-ic
sur-vivor	sur-vi-vor
fu-ner-ary	fu-ner-ar-y
so-lace	sol-ace
mis-di-rec-t	mis-di-rect
an-throp-ic	an-thro-pic
suit-ably	suit-a-bly
phle-boto-my	phle-bot-o-my
s-lop-pi-ness	slop-pi-ness
s-lash-er	slash-er
re-al-is-m	re-al-ism
re-ori-en-ta-tion	re-o-ri-en-ta-tion
car-cino-genic	car-cin-o-gen-ic
polon-aise	pol-o-naise
lo-quac-ity	lo-quac-i-ty
here-upon	here-up-on
s-traw	straw
crescen-do	cre-scen-do
s-nub	snub
kamikaze	ka-mi-ka-ze
dis-con-nec-t	dis-con-nect
surgery	sur-ger-y
ef-ful-gen-t	ef-ful-gent
no-to-ri-ety	no-to-ri-e-ty
ex-pect-ed	expected
plat-for-m	plat-form
u-nimag-in-able	un-im-ag-i-na-ble
manor	man-or
overindul-gence	o-ver-in-dul-gence
re-tractable	re-tract-a-ble
epi-cure	ep-i-cure
lament-ed	la-ment-ed
banker	bank-er
per-cep-t	per-cept
cere-bel-lum	cer-e-bel-lum
ob-stet-ric-s	ob-stet-rics
s-words-man	swords-man
colon	co-lon
d-ab-bing	dab-bing
phi-lan-thropist	phi-lan-thro-pist
eat-able	eat-a-ble
over-ride	o-ver-ride
chrysan-the-mum	chry-san-the-mum
astray	a-stray
pavil-ion	pa-vil-ion
s-tore-house	store-house
s-now	snow
graphol-o-gy	graph-ol-o-gy
land-fal-l	land-fall
flammable	flam-ma-ble
lega-tor	le-ga-tor
discog-ra-phy	dis-cog-ra-phy
gen-uine-ly	gen-u-ine-ly
in-creduli-ty	in-cre-du-li-ty
sier-ra	si-er-ra
pro-pri-ety	pro-pri-e-ty
petrol-o-gy	pe-trol-o-gy
frilly	frill-y
sel-l	sell
dozen	doz-en
pelvic	pel-vic
flossy	floss-y
ide-al-i-ty	i-de-al-i-ty
bases	ba-ses
nar-cis-sis-m	nar-cis-sism
in-former	in-form-er
u-ni-lat-er-al-is-m	u-ni-lat-er-al-ism
i-n-ad-e-quate	in-ad-e-quate
post-mod-ernism	post-mod-ern-ism
ovu-la-tion	ov-u-la-tion
novice	nov-ice
achieve-men-t	a-chieve-ment
any-thing	an-y-thing
aqua-naut	aq-ua-naut
pos-i-tivis-m	pos-i-tiv-ism
quotable	quot-a-ble
over-time	o-ver-time
s-tar-tling	star-tling
s-tarlight	star-light
wan-t	want
co-va-len-t	co-va-lent
bur-r	burr
hero-in	her-o-in
tor-toise-shel-l	tor-toise-shell
baroque	ba-roque
elec-tron-ic	e-lec-tron-ic
wun-derkind	wun-der-kind
s-pa-cious	spa-cious
ex-trater-ri-to-ri-al	ex-tra-ter-ri-to-ri-al
an-tic-s	an-tics
demon-stra-bly	de-mon-stra-bly
eva-sion	e-va-sion
porter	por-ter
sub-terfuge	sub-ter-fuge
sus-pend-ed	sus-pen-ded
de-pic-t	de-pict
here-inafter	here-in-af-ter
ra-dia-tive	ra-di-a-tive
taskmas-ter	task-mas-ter
in-hab-i-tan-t	in-hab-it-ant
mores	mo-res
break-away	break-a-way
backspace	back-space
un-proven	un-prov-en
pen-tathlon	pen-tath-lon
in-di-gestible	in-di-gest-i-ble
epig-ra-phy	e-pig-ra-phy
bio-met-ric-s	bi-o-met-rics
en-joy-able	en-joy-a-ble
seal-ing	sealing
para-phrase	par-a-phrase
ir-ra-tional	ir-ra-tion-al
cochlea	coch-le-a
k-loof	kloof
char-cu-terie	char-cu-te-rie
s-traight-away	straight-a-way
faceted	fac-et-ed
tes-ta-men-tary	tes-ta-men-ta-ry
gymkhana	gym-kha-na
e-u-phemis-m	eu-phe-mism
phy-lac-tery	phy-lac-ter-y
elec-tri-fi-ca-tion	e-lec-tri-fi-ca-tion
bene-fac-tor	ben-e-fac-tor
as-pi-ran-t	as-pir-ant
painful	pain-ful
pre-pon-der-an-t	pre-pon-der-ant
a-part-men-t	a-part-ment
s-naky	snak-y
sausage	sau-sage
verisimil-i-tude	ver-i-si-mil-i-tude
ap-par-en-t	ap-par-ent
dirty	dirt-y
dis-ci-plinar-i-an	dis-ci-pli-nar-i-an
sig-nif-i-can-t	sig-nif-i-cant
obey	o-bey
cathar-sis	ca-thar-sis
meta-mor-phose	met-a-mor-phose
dandy	dan-dy
mis-t	mist
pin-t	pint
good-night	goodnight
polyg-a-mous	po-lyg-a-mous
pro-le-tari-at	pro-le-tar-i-at
d-win-dling	dwindling
un-read-able	un-read-a-ble
in-jury	in-ju-ry
dishy	dish-y
ap-proach-able	ap-proach-a-ble
minu-ti-ae	mi-nu-ti-ae
astride	a-stride
prefa-to-ry	pref-a-to-ry
precinc-t	pre-cinct
steplad-der	step-lad-der
fugi-tive	fu-gi-tive
bad-land-s	bad-lands
con-dem-n	con-demn
com-fort-able	com-fort-a-ble
melt-ed	melted
defama-tion	def-a-ma-tion
mo-tocross	mo-to-cross
valid-ly	val-id-ly
k-i-lo	ki-lo
pho-tore-cep-tor	pho-to-re-cep-tor
notepa-per	note-pa-per
over-cook	o-ver-cook
singer	sing-er
in-do-len-t	in-do-lent
mag-ne-sium	mag-ne-si-um
mis-aligned	mis-a-ligned
y-oung	young
steady	stead-y
electro-mechan-i-cal	e-lec-tro-me-chan-i-cal
dowdy	dow-dy
kudu	ku-du
imag-i-na-tive	im-ag-i-na-tive
s-tormy	storm-y
pread-o-les-cen-t	pre-ad-o-les-cent
sea-son-able	sea-son-a-ble
remix	re-mix
poly-phon-ic	pol-y-phon-ic
g-narl	gnarl
groupie	group-ie
winder	wind-er
quadru-ply	quad-ru-ply
s-cat	scat
s-tu-dentship	stu-dent-ship
karaoke	kar-a-o-ke
wran-gling	wrangling
wail-ing	wailing
trumpery	trump-er-y
sep-a-ratist	sep-a-ra-tist
epi-demi-ol-o-gy	ep-i-de-mi-ol-o-gy
undis-tin-guished	un-dis-tin-guished
ig-no-min-ious	ig-no-min-i-ous
mono-rail	mon-o-rail
in-de-pen-den-t	in-de-pend-ent
un-ob-ser-van-t	un-ob-serv-ant
s-tar-ling	star-ling
guinea	guin-ea
s-mirk	smirk
schemer	schem-er
dero-ga-tion	der-o-ga-tion
quirky	quirk-y
rea-son-able	rea-son-a-ble
hexa-dec-i-mal	hex-a-dec-i-mal
al-l	all
semi-con-scious	sem-i-con-scious
meanie	mean-ie
bluesy	blues-y
promis-cu-ity	prom-is-cu-i-ty
im-petu-ous	im-pet-u-ous
dis-mal-l-y	dis-mal-ly
longevi-ty	lon-gev-i-ty
fil-i-buster	fil-i-bus-ter
as-tro-physi-cist	as-tro-phys-i-cist
hooli-gan	hoo-li-gan
rear-m	re-arm
curly	curl-y
glin-t	glint
impi	im-pi
ex-pen-di-ture	ex-pend-i-ture
tem-per-a-men-t	tem-per-a-ment
dis-cre-tionary	dis-cre-tion-ar-y
switchgear	switch-gear
over-hear	o-ver-hear
s-pat-u-la	spat-u-la
lily	lil-y
bullish	bull-ish
pro-pa-gan-da	prop-a-gan-da
s-parse	sparse
s-lice	slice
genome	ge-nome
dis-cov-ery	dis-cov-er-y
rangy	rang-y
lovesick	love-sick
in-stinc-t	in-stinct
g-nos-tic	gnos-tic
coax-i-al	co-ax-i-al
anony-mous-ly	a-non-y-mous-ly
able	a-ble
freighter	freight-er
h-m-m	hmm
seisin	sei-sin
spe-cial-is-m	spe-cial-ism
papule	pap-ule
dacha	da-cha
avail	a-vail
prefer-men-t	pre-fer-ment
demigod	dem-i-god
s-lot	slot
encage	en-cage
fein-t	feint
nu-tri-en-t	nu-tri-ent
ex-e-cutable	ex-e-cut-a-ble
u-nas-sist-ed	un-as-sist-ed
across	a-cross
verdi-gris	ver-di-gris
foxy	fox-y
d-e-fi-cien-cy	de-fi-cien-cy
ibis	i-bis
shoplifter	shop-lift-er
het-ero-ge-neous	het-er-o-ge-ne-ous
sedi-tion	se-di-tion
purview	pur-view
necro-man-tic	nec-ro-man-tic
cor-moran-t	cor-mo-rant
l-iti-gious	li-ti-gious
mis-s	miss
en-thralling	en-thral-ling
s-ta-tis-tics	sta-tis-tics
boater	boat-er
pro-pri-etor-ship	pro-pri-e-tor-ship
col-liery	col-lier-y
epis-te-mo-log-i-cal	e-pis-te-mo-log-i-cal
retel-l	re-tell
ap-plica-tive	ap-pli-ca-tive
docile	doc-ile
clam-p-down	clamp-down
ape-ri-od-ic	a-pe-ri-od-ic
prece-dence	prec-e-dence
nurs-ery	nurs-er-y
bar-bel-l	bar-bell
ine-bri-a-tion	in-e-bri-a-tion
p-re-sen-ta-tion	pres-en-ta-tion
s-toep	stoep
epis-to-lary	e-pis-to-lar-y
im-mea-sur-able	im-meas-ur-a-ble
o-ri-gin	or-i-gin
u-n-am-bigu-ous	un-am-big-u-ous
servi-ette	ser-vi-ette
height-ened	heightened
delic-t	de-lict
gaslight	gas-light
head-mistress	head-mis-tress
in-suf-fi-cien-t	in-suf-fi-cient
metatarsal	met-a-tar-sal
fig-u-ra-tive	fig-ur-a-tive
hoary	hoar-y
premis-es	prem-is-es
pari-ah	pa-ri-ah
bar-b	barb
pig-men-t	pig-ment
oblique	o-blique
s-trait-ened	strait-ened
saucy	sau-cy
drifter	drift-er
tena-cious-ly	te-na-cious-ly
nowa-days	now-a-days
per-fec-tion-is-m	per-fec-tion-ism
poly-he-dron	pol-y-he-dron
af-fec-t	af-fect
ob-serv-able	ob-serv-a-ble
essence	es-sence
wa-ver-ing	wavering
drafty	draft-y
about	a-bout
s-now-drift	snow-drift
s-tu-pe-fy	stu-pe-fy
ped-a-gogy	ped-a-go-gy
chi-ropodis-t	chi-rop-o-dist
s-trat-e-gy	strat-e-gy
s-cle-ro-sis	scle-ro-sis
tawdry	taw-dry
dizzy	diz-zy
e-s-o-ter-i-ca	es-o-ter-i-ca
at-temp-t	at-tempt
ni-hilis-m	ni-hil-ism
pim-p	pimp
with-er-s	with-ers
im-mov-able	im-mov-a-ble
showjumper-s	show-jum-pers
pro-tea	pro-te-a
bap-tismal	bap-tis-mal
de-mo-graph-ic-s	dem-o-graph-ics
physic	phys-ic
s-lash-ing	slash-ing
mys-ti-cis-m	mys-ti-cism
s-tain-less	stain-less
con-ceiv-ably	con-ceiv-a-bly
el-e-men-t	el-e-ment
any-body	an-y-bod-y
ver-biage	ver-bi-age
over-sleep	o-ver-sleep
wicked-ness	wick-ed-ness
i-n-un-da-tion	in-un-da-tion
madri-gal	mad-ri-gal
steady-ing	steadying
s-tarter	start-er
kosher	ko-sher
crawler	crawl-er
s-tomp-ing	stomp-ing
in-con-tro-vert-ible	in-con-tro-vert-i-ble
petal	pet-al
lazy-bones	la-zy-bones
seafron-t	sea-front
p-reser-va-tive	pre-serv-a-tive
rosin	ros-in
chromi-um	chro-mi-um
blither-ing	blith-er-ing
mi-crodot	mi-cro-dot
parch-men-t	parch-ment
welly	wel-ly
gul-l	gull
racial	ra-cial
noisy	nois-y
gusty	gust-y
im-per-me-able	im-per-me-a-ble
con-struc-t	con-struct
crofter	croft-er
in-con-solable	in-con-sol-a-ble
phys-io-ther-a-py	phys-i-o-ther-a-py
bougainvil-lea	bou-gain-vil-le-a
overkil-l	o-ver-kill
fetid	fet-id
bushy	bush-y
ide-ol-o-gy	i-de-ol-o-gy
mar-itime	mar-i-time
trireme	tri-reme
tele-scop-ic	tel-e-scop-ic
iso-bar	i-so-bar
kine-mat-ic-s	kin-e-mat-ics
silen-t	si-lent
di-ver-sion-ary	di-ver-sion-ar-y
de-r-ate	de-rate
trans-fer-able	trans-fer-a-ble
mono-pole	mon-o-pole
chester-field	ches-ter-field
bindweed	bind-weed
trea-sonous	trea-son-ous
moral-is-tic	mor-al-is-tic
key-boardis-t	key-board-ist
vit-ri-olic	vit-ri-ol-ic
satrap	sa-trap
cru-ci-for-m	cru-ci-form
fontanel	fon-ta-nel
sen-ti-men-t	sen-ti-ment
de-noue-men-t	de-noue-ment
trouper	troup-er
pro-tec-torate	pro-tec-tor-ate
con-sis-ten-t	con-sist-ent
ap-pel-lan-t	ap-pel-lant
stringer	string-er
dele-tion	de-le-tion
semide-tached	sem-i-de-tached
poly-styrene	pol-y-sty-rene
cousin	cous-in
d-if-fer-en-tial	dif-fer-en-tial
diskette	disk-ette
over-done	o-ver-done
pre-tex-t	pre-text
growler	growl-er
stager	stag-er
roomy	room-y
hi-jack-ing	hi-jac-king
aloud	a-loud
pornog-ra-phy	por-nog-ra-phy
muti-nous	mu-ti-nous
blus-ter-ing	blustering
mogul	mo-gul
b-e-fit	be-fit
postal	post-al
flamin-go	fla-min-go
callable	call-a-ble
quiv-er-ing	quivering
memo-ri-al	me-mo-ri-al
un-ques-tion-ably	un-ques-tion-a-bly
char-m	charm
valen-tine	val-en-tine
edi-tion	e-di-tion
the-atri-cal	the-at-ri-cal
peas-antry	peas-ant-ry
im-puni-ty	im-pu-ni-ty
deci-bel	dec-i-bel
par-tic-i-pan-t	par-tic-i-pant
couloir	cou-loir
artis-tic	ar-tis-tic
crevice	crev-ice
un-abashed-ly	un-a-bash-ed-ly
u-nim-pres-sive	un-im-pres-sive
u-n-a-mused	un-a-mused
abuse	a-buse
vinyl	vi-nyl
garbage	gar-bage
trans-plan-t	trans-plant
propul-sive	pro-pul-sive
pedan-t	ped-ant
in-com-bustible	in-com-bus-ti-ble
i-den-ti-fi-able	i-den-ti-fi-a-ble
over-val-ue	o-ver-val-ue
nightwear	night-wear
nec-es-sary	nec-es-sar-y
en-fee-bled	enfeebled
navel	na-vel
glow-wor-m	glow-worm
re-cal-l	re-call
pas-san-t	pas-sant
coro-na-tion	cor-o-na-tion
s-nob-bery	snob-ber-y
res-onate	res-o-nate
broody	brood-y
puerile	pu-er-ile
wave-for-m	wave-form
trilin-gual	tri-lin-gual
ne-glec-t	ne-glect
hy-per-tex-t	hy-per-text
bak-ery	bak-er-y
politi-cian	pol-i-ti-cian
ev-ery	eve-ry
ev-ery-where	eve-ry-where
m-i-lieu	mi-lieu
undiplo-mat-ic	un-dip-lo-mat-ic
s-tock-bro-ker	stock-brok-er
bru-tal-is-m	bru-tal-ism
meta-physic-s	met-a-phys-ics
hon-esty	hon-es-ty
domi-cil-iary	dom-i-cil-i-ar-y
s-ly-ly	sly-ly
bad-ger	badg-er
lacy	lac-y
s-low-ly	slow-ly
copla-nar	co-pla-nar
frat-ri-ci-dal	frat-ri-cid-al
bidi-rec-tion-al	bi-di-rec-tion-al
midrif-f	mid-riff
aor-ta	a-or-ta
pout-ing	pouting
frivol	friv-ol
sen-t	sent
bul-gy	bulg-y
re-order	re-or-der
s-cor-pi-on	scor-pi-on
causative	caus-a-tive
show-ery	show-er-y
falset-to	fal-set-to
b-lessed	bless-ed
pover-ty	pov-er-ty
azure	az-ure
s-lipped	slipped
paraf-fin	par-af-fin
pre-ven-t	pre-vent
shindig	shin-dig
silli-ness	sil-li-ness
plu-ral-is-m	plu-ral-ism
flagon	flag-on
homi-cide	hom-i-cide
op-po-nen-t	op-po-nent
wa-ter-fal-l	wa-ter-fall
hon-our	ho-nour
s-carab	scar-ab
pe-tit	pet-it
monothe-is-tic	mon-o-the-is-tic
iron-work-s	i-ron-works
un-promis-ing	un-prom-is-ing
su-per-nu-mer-ary	su-per-nu-mer-ar-y
para-dox-i-cal-ly	par-a-dox-i-cal-ly
epi-dem-ic	ep-i-dem-ic
fever-ish-ly	fe-ver-ish-ly
painful-ly	pain-ful-ly
oblige	o-blige
s-lab	slab
breath-able	breath-a-ble
gala	ga-la
net-bal-l	net-ball
prodi-gy	prod-i-gy
over-pro-duc-tion	o-ver-pro-duc-tion
con-tradis-tinc-tion	con-tra-dis-tinc-tion
va-can-t	va-cant
ve-he-men-t	ve-he-ment
vari-a-tion	var-i-a-tion
cashier	cash-ier
eye-d	eyed
seafood	sea-food
u-n-ac-count-able	un-ac-count-a-ble
over-growth	o-ver-growth
con-cur-ren-t	con-cur-rent
ban-ter-ing	bantering
read-mit	re-ad-mit
rein-ven-t	re-in-vent
dis-tiller	dis-till-er
d-if-fer-ent-ly	dif-fer-ent-ly
glaciat-ed	gla-ci-at-ed
gen-eros-i-ty	gen-er-os-i-ty
s-ta-tion	sta-tion
s-porty	sport-y
em-i-nen-t	em-i-nent
pu-ri-tanis-m	pu-ri-tan-ism
brack-et-ed	bracketed
chronol-o-gy	chro-nol-o-gy
decile	dec-ile
de-moun-t	de-mount
c-ityscape	cit-y-scape
mag-ne-si-a	mag-ne-sia
cygnet	cyg-net
fit-men-t	fit-ment
dan-druf-f	dan-druff
s-tar	star
mousy	mous-y
ef-flu-en-t	ef-flu-ent
s-nap-shot	snap-shot
ar-madil-lo	ar-ma-dil-lo
beady	bead-y
cir-cling	circling
vis-ual-ly	vis-u-al-ly
pop-ulist	pop-u-list
postlude	post-lude
hindquar-ter-s	hind-quar-ters
biomass	bi-o-mass
hin-t	hint
com-mit-men-t	com-mit-ment
chro-mo-so-ma-l	chro-mo-so-mal
de-caf-feinate	de-caf-fein-ate
ful-l	full
temer-i-ty	te-mer-i-ty
s-to-ry-line	sto-ry-line
any-how	an-y-how
wel-com-ing	wel-co-ming
as-sort-men-t	as-sort-ment
holis-tic	ho-lis-tic
gan-g-ly	gan-gly
good-s	goods
nugget	nug-get
bonobo	bo-no-bo
re-spectably	re-spect-a-bly
crunchy	crunch-y
resin	res-in
machi-na-tion	mach-i-na-tion
tru-is-m	tru-ism
in-ge-nu-ity	in-ge-nu-i-ty
de-scen-t	de-scent
rap-proche-men-t	rap-proche-ment
s-neer	sneer
s-lop	slop
b-room-stick	broom-stick
va-ri-ety	va-ri-e-ty
throw-away	throw-a-way
cade-t	ca-det
fur-rowed	furrowed
fidu-cia-ry	fi-du-ci-ar-y
suc-cinc-t	suc-cinct
moc-casin	moc-ca-sin
mid-ship-s	mid-ships
deca-den-t	dec-a-dent
sa-far-i	sa-fa-ri
dodger	dodg-er
spir-i-tu-al-ist	spir-it-u-al-ist
un-ordered	un-or-dered
un-en-force-able	un-en-force-a-ble
con-sumeris-m	con-sum-er-ism
school-teacher	school-teach-er
rain-fal-l	rain-fall
biotech-nol-o-gy	bi-o-tech-nol-o-gy
rhea	rhe-a
obli-ga-tion	ob-li-ga-tion
para-sol	par-a-sol
tumes-cen-t	tu-mes-cent
geo-ther-mal	ge-o-ther-mal
n-ev-er	nev-er
rein-car-na-tion	re-in-car-na-tion
d-warfed	dwarfed
mauler	maul-er
re-sent-men-t	re-sent-ment
melee	me-lee
sewing	sew-ing
brasserie	bras-se-rie
macrophage	mac-ro-phage
s-cant	scant
sum-mery	sum-mer-y
pizzi-ca-to	piz-zi-ca-to
link-able	link-a-ble
avow	a-vow
literati	lit-e-ra-ti
prompter	prompt-er
s-mall-ish	small-ish
di-a-bolis-m	di-ab-o-lism
read-abil-i-ty	read-a-bil-i-ty
rock-etry	rock-et-ry
valid	val-id
aver	a-ver
reroutes	re-routes
mili-ti-a	mi-li-tia
cas-sowary	cas-so-war-y
reac-qui-si-tion	re-ac-qui-si-tion
de-ten-t	de-tent
con-tigu-ous	con-tig-u-ous
dy-namo	dy-na-mo
fre-quent-ed	frequented
aplen-ty	a-plen-ty
con-se-quen-t	con-se-quent
in-ca-pable	in-ca-pa-ble
skim-p	skimp
chanter	chant-er
ridicu-lous-ness	ri-dic-u-lous-ness
crooked	crook-ed
choral	cho-ral
r-eread	re-read
bather	bath-er
im-prison	im-pris-on
dis-ori-en-tat-ed	disorientated
un-healthy	un-health-y
mar-ketabil-i-ty	mar-ket-a-bil-i-ty
cognoscen-ti	co-gno-scen-ti
a-tol-l	at-oll
teatime	tea-time
di-elec-tric	di-e-lec-tric
de-mo-li-tion	dem-o-li-tion
re-sis-tan-t	re-sist-ant
e-d-u-ca-tor	ed-u-ca-tor
pom-padour	pom-pa-dour
despo-tism	des-pot-ism
navvy	nav-vy
veg-etable	veg-e-ta-ble
over-stretch	o-ver-stretch
in-suf-fer-able	in-suf-fer-a-ble
over-staffed	overstaffed
video	vid-e-o
e-tu-i	e-tui
dom-i-nan-t	dom-i-nant
join-t	joint
s-pam	spam
breathy	breath-y
copi-er	cop-i-er
porky	pork-y
filthy	filth-y
bologna	bo-lo-gna
s-tock-ade	stock-ade
gloat-ing	gloating
k-ing-dom	king-dom
su-per-b	su-perb
g-lut-tonous	glut-ton-ous
jumper	jump-er
throaty	throat-y
vari-abil-i-ty	var-i-a-bil-i-ty
hos-pitable	hos-pi-ta-ble
aba-cus	ab-a-cus
per-son-able	per-son-a-ble
trap-s	traps
in-deco-rous	in-dec-o-rous
trapeze	tra-peze
be-fud-dling	befuddling
gratic-ule	grat-i-cule
de-nial	de-ni-al
teleg-ra-phy	te-leg-ra-phy
fal-l	fall
bistable	bi-sta-ble
im-agery	im-age-ry
w-hole-heart-ed-ly	whole-heart-ed-ly
gelig-nite	gel-ig-nite
arise	a-rise
sec-u-lar-is-m	sec-u-lar-ism
ir-rev-er-en-t	ir-rev-er-ent
remap	re-map
blos-som-ing	blossoming
propo-si-tion-al	prop-o-si-tion-al
deu-teri-um	deu-te-ri-um
an-ti-quary	an-ti-quar-y
grantee	gran-tee
de-trac-t	de-tract
u-nar-tic-u-lat-ed	un-ar-tic-u-lat-ed
sur-moun-t	sur-mount
ca-nary	ca-nar-y
par-tic-u-lar-is-m	par-tic-u-lar-ism
beryl-li-um	be-ryl-li-um
vol-ley-bal-l	vol-ley-ball
ha-rass-ing	harassing
reval-ue	re-val-ue
sym-bol-is-m	sym-bol-ism
turn-around	turn-a-round
un-con-trol-lable	un-con-trol-la-ble
im-ple-menter	im-ple-ment-er
mas-tery	mas-ter-y
schnapp-s	schnapps
in-gre-di-en-t	in-gre-di-ent
la-ryn-geal	la-ryn-ge-al
ax-il-lary	ax-il-lar-y
declar-a-tive	de-clar-a-tive
emit-ter	e-mit-ter
in-ward-s	in-wards
in-hala-tion	in-ha-la-tion
pan-theon	pan-the-on
for-giv-able	for-giv-a-ble
re-seller	re-sell-er
hear-ken	heark-en
ne-go-tiable	ne-go-ti-a-ble
s-tole	stole
xeno-phobe	xen-o-phobe
un-in-hab-it-able	un-in-hab-it-a-ble
tubu-lar	tu-bu-lar
fir-m	firm
con-ceal-men-t	con-ceal-ment
coxswain	cox-swain
wiring	wir-ing
down-fal-l	down-fall
topaz	to-paz
valiant	val-iant
mae-stro	maes-tro
re-lax-ation	re-lax-a-tion
teleprint-er	tel-e-print-er
briskly	brisk-ly
cleaver-s	cleav-ers
sounder	sound-er
erup-t	e-rupt
thriller	thrill-er
u-ni-for-m	u-ni-form
un-pleas-an-t	un-pleas-ant
seren-i-ty	se-ren-i-ty
a-ca-dem-ic	ac-a-dem-ic
in-con-sid-er-able	in-con-sid-er-a-ble
procla-ma-tion	proc-la-ma-tion
s-teer-age	steer-age
delin-quen-t	de-lin-quent
d-well	dwell
dis-qui-etude	dis-qui-e-tude
tarot	ta-rot
bi-car-bon-ate	bi-car-bo-nate
s-cabbed	scabbed
coralline	cor-al-line
over-reach	o-ver-reach
un-demo-crat-ic	un-dem-o-crat-ic
anorex-i-c	an-o-rex-ic
bistro	bis-tro
causal-ly	caus-al-ly
polem-i-cal	po-lem-i-cal
pilchard	pil-chard
u-nar-guable	un-ar-gu-a-ble
ul-tra-son-ic-s	ul-tra-son-ics
calorif-ic	cal-o-rif-ic
un-lac-ing	un-lacing
dusty	dust-y
s-esame	ses-a-me
gerund	ger-und
tra-di-tion-al-is-m	tra-di-tion-al-ism
en-vi-able	en-vi-a-ble
g-lut-tony	glut-ton-y
g-nash	gnash
any	an-y
de-nier	de-ni-er
s-lip-pery	slip-per-y
reval-u-a-tion	re-val-u-a-tion
labi-um	la-bi-um
s-pas-mod-ic	spas-mod-ic
op-ti-mistic	op-ti-mis-tic
ra-dio-graph	ra-di-o-graph
video-taped	videotaped
ve-nial	ve-ni-al
babysit-ting	babysitting
f-reaky	freak-y
gov-ern-men-t	gov-ern-ment
s-calar	sca-lar
so-ci-etal	so-ci-e-tal
dis-parag-ing	dis-par-ag-ing
dither	dith-er
ser-f	serf
weedy	weed-y
carafe	ca-rafe
com-mu-nica-tive-ness	com-mu-ni-ca-tive-ness
medal	med-al
re-splen-den-t	re-splend-ent
forest-ed	forested
ir-re-triev-ably	ir-re-triev-a-bly
tur-bu-len-t	tur-bu-lent
p-re-set	pre-set
co-mestible	co-mes-ti-ble
pa-tri-lin-eal	pat-ri-lin-e-al
s-api-en-t	sa-pi-ent
in-flammable	in-flam-ma-ble
ganger	gang-er
detox-i-fi-ca-tion	de-tox-i-fi-ca-tion
s-port	sport
e-bul-lien-t	e-bul-lient
busker	busk-er
sonorous	so-no-rous
lin-ear	lin-e-ar
recharge-able	re-charge-a-ble
restart	re-start
n-od-ule	nod-ule
stretchy	stretch-y
sub-ur-bia	sub-ur-bi-a
backgam-mon	back-gam-mon
cylin-der	cyl-in-der
haystack	hay-stack
jerkin	jer-kin
chaos	cha-os
s-car-i-ly	scar-i-ly
costar	co-star
s-lim	slim
tra-chea	tra-che-a
aris-toc-ra-cy	ar-is-toc-ra-cy
over-pay	o-ver-pay
lofty	loft-y
mag-ne-tome-ter	mag-ne-tom-e-ter
liquor-ish	liq-uor-ish
wim-p	wimp
net-work-ing	networking
menar-che	men-ar-che
s-ta-tion-er	sta-tion-er
s-e-lec-t	se-lect
cope-d	coped
yel-l	yell
in-dex-ing	indexing
manes	ma-nes
lemon	lem-on
techno-pho-bic	tech-no-pho-bic
casi-no	ca-si-no
grenadier	gren-a-dier
lega-tion	le-ga-tion
im-per-ma-nen-t	im-per-ma-nent
pirou-ette	pir-ou-ette
gen-uine-ness	gen-u-ine-ness
as-segai	as-se-gai
preschool	pre-school
broadsword	broad-sword
d-e-lec-ta-ble	de-lec-ta-ble
illiq-uid	il-liq-uid
suf-frag-ist	suf-fra-gist
naugh-t	naught
in-ten-t	in-tent
dowry	dow-ry
epi-graph	ep-i-graph
atavis-m	at-a-vism
tele-tex-t	tel-e-text
manger	man-ger
glit-tery	glit-ter-y
toil-s	toils
paramour	par-a-mour
where-about-s	where-a-bouts
qui-etus	qui-e-tus
cer-ti-fi-able	cer-ti-fi-a-ble
springer	spring-er
it-s	its
seaborne	sea-borne
baloney	ba-lo-ney
gatepost	gate-post
u-ni-for-mi-ty	u-ni-form-i-ty
bowsprit	bow-sprit
dis-agree-men-t	dis-a-gree-ment
rain-stor-m	rain-storm
tele-pho-to	tel-e-pho-to
in-scrutable	in-scru-ta-ble
in-trauter-ine	in-tra-u-ter-ine
em-place-men-t	em-place-ment
scrawny	scrawn-y
tran-scen-den-t	tran-scend-ent
ptero-dactyl	pter-o-dac-tyl
preda-tor	pred-a-tor
un-re-cov-er-able	un-re-cov-er-a-ble
bud-get	budg-et
pathogen	path-o-gen
hypochon-dri-a-cal	hy-po-chon-dri-a-cal
s-traight	straight
d-if-fract	dif-fract
im-moral-i-ty	im-mo-ral-i-ty
dis-place-men-t	dis-place-ment
ini-ti-a-tion	in-i-ti-a-tion
hy-dro-dy-nam-ic-s	hy-dro-dy-nam-ics
leucine	leu-cine
codling	cod-ling
e-s-planade	es-pla-nade
geosyn-chronous	ge-o-syn-chro-nous
tar-if-f	tar-iff
preva-lence	prev-a-lence
s-care-mon-ger	scare-mon-ger
ex-ten-t	ex-tent
dis-tinc-t	dis-tinct
con-sid-er-able	con-sid-er-a-ble
naive	na-ive
leer-ing	leering
cra-nial	cra-ni-al
naked-ness	na-ked-ness
ini-tia-tive	in-i-ti-a-tive
lizard	liz-ard
flan-nelette	flan-nel-ette
up-heaval	up-heav-al
body-build-ing	bod-y-build-ing
neu-ronal	neu-ron-al
reti-na	ret-i-na
easel	ea-sel
di-atom	di-a-tom
doily	doi-ly
ureter	u-re-ter
de-ter-minable	de-ter-mi-na-ble
hourly	hour-ly
unchecked	un-checked
de-rail-men-t	de-rail-ment
monog-a-mous-ly	mo-nog-a-mous-ly
camel	cam-el
bi-l-abi-al	bi-la-bi-al
palimpses-t	pal-imp-sest
dumb-bel-l	dumb-bell
grass-root-s	grass-roots
autarchy	au-tar-chy
ob-struc-tion-is-m	ob-struc-tion-ism
sumo	su-mo
res-ur-rec-t	res-ur-rect
repro-bate	rep-ro-bate
ep-ithe-lial	ep-i-the-li-al
drom-e-dary	drom-e-dar-y
epis-tle	e-pis-tle
sec-t	sect
com-forter	com-fort-er
ar-guable	ar-gu-a-ble
s-tock-room	stock-room
un-pre-dictable	un-pre-dict-a-ble
dev-il-men-t	dev-il-ment
un-sus-tain-able	un-sus-tain-a-ble
cur-tained	curtained
bac-teri-um	bac-te-ri-um
rani	ra-ni
un-easy	un-eas-y
sus-tain-abil-i-ty	sus-tain-a-bil-i-ty
n-erd	nerd
gneis-s	gneiss
pedol-o-gy	pe-dol-o-gy
ar-bi-trary	ar-bi-trar-y
s-tate-men-t	state-ment
im-per-son-ator	im-per-son-a-tor
en-trap-men-t	en-trap-ment
ema-ci-a-tion	e-ma-ci-a-tion
in-de-pen-dent-ly	in-de-pend-ent-ly
look-ing	looking
in-dica-tive	in-dic-a-tive
apex	a-pex
phrase-ol-o-gy	phra-se-ol-o-gy
vi-able	vi-a-ble
geo-phys-i-cal	ge-o-phys-i-cal
resur-gence	re-sur-gence
fin-ery	fin-er-y
plen-teous	plen-te-ous
dredger	dredg-er
s-tates-man-ship	states-man-ship
hy-per-boloid	hy-per-bo-loid
satiny	sat-in-y
vir-u-len-t	vir-u-lent
com-pan-ion-able	com-pan-ion-a-ble
mus-cu-loskele-tal	mus-cu-lo-skel-e-tal
co-rian-der	co-ri-an-der
catal-y-sis	ca-tal-y-sis
trendy	trend-y
best-seller	best-sell-er
tele-o-log-i-cal	tel-e-o-log-i-cal
ar-ran-t	ar-rant
s-take-hold-er	stake-hold-er
knowl-edge-able	knowl-edge-a-ble
api-an	a-pi-an
u-n-avail-abil-i-ty	un-a-vail-a-bil-i-ty
spon-sored	sponsored
k-er-atin	ker-a-tin
loess	lo-ess
retroac-tive	ret-ro-ac-tive
pe-ri-as-tron	per-i-as-tron
sor-cery	sor-cer-y
con-ver-gen-t	con-ver-gent
any-more	an-y-more
ji-u-jit-su	jiu-jit-su
fre-quen-t	fre-quent
romper	romp-er
u-n-af-ford-able	un-af-ford-a-ble
retroac-tive-ly	ret-ro-ac-tive-ly
subto-tal	sub-to-tal
over-spend	o-ver-spend
hy-draulic-s	hy-drau-lics
ru-mi-nan-t	ru-mi-nant
mono-cul-ture	mon-o-cul-ture
be-fud-dled	befuddled
skul-l	skull
clash-ing	clashing
in-ven-t	in-vent
re-pro-cess	re-proc-ess
steve-dore	ste-ve-dore
tele-vise	tel-e-vise
feb-ru-ary	feb-ru-ar-y
pal-l	pall
dis-ori-en-ta-tion	dis-o-ri-en-ta-tion
un-prece-dent-ed	un-prec-e-dent-ed
ev-ery-thing	eve-ry-thing
puffer	puff-er
miser-li-ness	mi-ser-li-ness
bal-l	ball
per-for-m	per-form
ex-or-bi-tan-t	ex-or-bi-tant
vestibule	ves-ti-bule
mi-croscopy	mi-cros-co-py
er-a	e-ra
im-pu-den-t	im-pu-dent
es-tu-ary	es-tu-ar-y
io-dide	i-o-dide
s-mite	smite
petu-lan-t	pet-u-lant
g-lyc-erol	glyc-er-ol
musty	mus-ty
rounder	round-er
leg-isla-tive	leg-is-la-tive
de-scen-der	de-scend-er
tren-chan-t	trench-ant
char-i-o-teer	char-i-ot-eer
pussy-cat	pussycat
es-calade	es-ca-lade
elec-tron	e-lec-tron
repa-tri-a-tion	re-pa-tri-a-tion
in-struc-t	in-struct
macroe-co-nom-ic	mac-ro-ec-o-nom-ic
pa-tri-o-tism	pa-tri-ot-ism
in-sur-mount-able	in-sur-mount-a-ble
pro-tease	pro-te-ase
e-co-log-i-cal	ec-o-log-i-cal
over-come	o-ver-come
b-land-ly	bland-ly
saver	sav-er
ide-al-is-tic	i-de-al-is-tic
rec-on-cil-able	rec-on-cil-a-ble
codex	co-dex
spokes-woman	spokes-wom-an
s-traight-for-ward	straight-for-ward
arith-metic	a-rith-me-tic
wicked-ly	wick-ed-ly
gateau	ga-teau
re-di-rect-ion	re-di-rec-tion
fishy	fish-y
rhap-sody	rhap-so-dy
over-re-act-s	o-ver-re-acts
preter-nat-u-ral	pre-ter-nat-u-ral
com-mence-men-t	com-mence-ment
re-word-ings	re-word-ings
erad-i-cat-ed	e-rad-i-cat-ed
repar-tee	rep-ar-tee
marzi-pan	mar-zi-pan
per-ti-nen-t	per-ti-nent
his-tamine	his-ta-mine
linger	lin-ger
poignan-cy	poign-an-cy
s-pas-tic	spas-tic
quest-ing	questing
ele-phan-tine	el-e-phan-tine
mega-ton	meg-a-ton
s-e-lec-tor	se-lec-tor
necro-man-cy	nec-ro-man-cy
as-sertive	as-ser-tive
shoplift-ing	shop-lift-ing
hap-py-goluck-y	hap-py-go-luck-y
petard	pe-tard
nightlife	night-life
g-naw	gnaw
p-re-sentable	pre-sent-a-ble
tal-c	talc
col-le-gial	col-le-gi-al
aphe-lion	a-phe-li-on
classy	class-y
com-peti-tor	com-pet-i-tor
celiba-cy	cel-i-ba-cy
dis-ci-plinary	dis-ci-pli-nar-y
brigadier	brig-a-dier
ukulele	u-ku-le-le
s-ten-cil	sten-cil
s-lop-py	slop-py
in-so-len-t	in-so-lent
bear-able	bear-a-ble
e-quip-men-t	e-quip-ment
sorghum	sor-ghum
gob-bledy-gook	gob-ble-dy-gook
rheuma-tol-o-gy	rheu-ma-tol-o-gy
above	a-bove
arum	ar-um
undig-ni-fied	un-dig-ni-fied
ripen	rip-en
moldy	mold-y
in-evitably	in-ev-i-ta-bly
quadruped	quad-ru-ped
repast	re-past
as-cen-t	as-cent
pronom-i-nal	pro-nom-i-nal
ra-bid	rab-id
re-duc-tion-is-m	re-duc-tion-ism
gassy	gas-sy
earnest-ly	ear-nest-ly
s-culp-tural	sculp-tur-al
en-vi-ron-s	en-vi-rons
de-func-t	de-funct
gavotte	ga-votte
mere-tri-cious	mer-e-tri-cious
periscope	per-i-scope
de-tach-men-t	de-tach-ment
s-toope-d	stooped
re-versible	re-vers-i-ble
con-flic-t	con-flict
stetho-scope	steth-o-scope
to-bac-conist	to-bac-co-nist
cafe-te-ri-a	caf-e-te-ri-a
en-force-able	en-force-a-ble
s-lan-der-ous	slan-der-ous
Words with errors: 2247
Words with incorrect number of syllables: 2056
Total evluated: 6500
Perfect accuracy: 0.65
Number of syllables accuracy: 0.68
Average Levenshtein Distance(across incorrect words): 1.22
