Attempt	Real
micro-organ-ism	mi-cro-or-gan-ism
howdy	how-dy
pari-ah	pa-ri-ah
blitzkrieg	blitz-krieg
s-tud	stud
c-on-cil-iar	con-cil-i-ar
trust-ed	trusted
i-n-escapably	in-es-cap-a-bly
sher-if-f	sher-iff
dullard	dull-ard
ca-su-istry	cas-u-ist-ry
syl-labub	syl-la-bub
s-nif-f	sniff
ev-ery-day	eve-ry-day
p-re-sen-ter	pre-sent-er
s-lot	slot
ir-rel-e-van-t	ir-rel-e-vant
man-dolin	man-do-lin
l-itur-gi-cal	li-tur-gi-cal
con-tention	con-ten-tion
os-teopa-thy	os-te-op-a-thy
phys-io-ther-a-py	phys-i-o-ther-a-py
ether	e-ther
para-m-ag-net-ic	par-a-mag-net-ic
school-teacher	school-teach-er
co-in-ci-den-t	co-in-ci-dent
c-ityscape	cit-y-scape
wormy	worm-y
s-tock-ing	stock-ing
un-du-lat-ing	un-du-la-ting
fish-ery	fish-er-y
s-lim-line	slim-line
s-nipe	snipe
un-fore-see-able	un-fore-see-a-ble
fruiter	fruit-er
u-n-awak-ened	un-a-wak-ened
ex-ocrine	ex-o-crine
a-vian	a-vi-an
hobo	ho-bo
idyl-l	i-dyll
un-elect-ed	un-e-lect-ed
s-loop	sloop
quater-nion	qua-ter-ni-on
wis-p	wisp
mono-phon-ic	mon-o-phon-ic
de-fend-ing	defending
pecan	pe-can
re-cal-ci-tran-t	re-cal-ci-trant
scenery	scen-er-y
roundel	roun-del
gam-bling	gam-bling
night-fal-l	night-fall
ar-guable	ar-gu-a-ble
barom-e-ter	ba-rom-e-ter
glas-nos-t	glas-nost
pro-trac-t	pro-tract
dis-en-fran-chise-men-t	dis-en-fran-chise-ment
u-n-am-bigu-ous	un-am-big-u-ous
item	i-tem
in-hala-tion	in-ha-la-tion
calorime-ter	cal-o-rim-e-ter
wapi-ti	wap-i-ti
ranger	rang-er
mul-ti-pro-cess-ing	mul-ti-proc-ess-ing
sub-jec-tivis-m	sub-jec-tiv-ism
k-ing	king
l-it-mus	lit-mus
in-fla-tion-ary	in-fla-tion-ar-y
fel-la-tio	fel-la-ti-o
tram-p	tramp
preva-lence	prev-a-lence
medal	med-al
con-sumerist	con-sum-er-ist
im-per-me-able	im-per-me-a-ble
lachry-mose	lach-ry-mose
salience	sa-li-ence
poly-atom-ic	pol-y-a-tom-ic
an-tibi-ot-ic	an-ti-bi-ot-ic
penin-su-lar	pen-in-su-lar
s-nuf-fle	snuf-fle
carotene	car-o-tene
gra-tu-ity	gra-tu-i-ty
ini-tial	in-i-tial
un-pre-dictabil-i-ty	un-pre-dict-a-bil-i-ty
s-ketch-book	sketch-book
enor-mous-ly	e-nor-mous-ly
aback	a-back
mi-di	mid-i
shandy	shan-dy
unglam-orous	un-glam-or-ous
me-te-oric	me-te-or-ic
b-land-ly	bland-ly
poli-ty	pol-i-ty
serai	se-ra-i
far-away	far-a-way
lyrist	lyr-ist
s-tan-dard	stand-ard
ra-j	raj
neu-ronal	neu-ron-al
com-fort-able	com-fort-a-ble
bud-get	budg-et
eye-d	eyed
wimpy	wimp-y
sali-vate	sal-i-vate
whistler	whis-tler
phonon	pho-non
hexagon	hex-a-gon
n-ev-er	nev-er
i-n-ac-tiv-i-ty	in-ac-tiv-i-ty
bereft	be-reft
hairy	hair-y
knol-l	knoll
re-mark-able	re-mark-a-ble
odome-ter	o-dom-e-ter
data-base	da-ta-base
talon	tal-on
may-oral	may-or-al
over-weight	o-ver-weight
d-if-fer-ence	dif-fer-ence
chamomile	cham-o-mile
paraf-fin	par-af-fin
p-re-sen-ta-tion-al	pres-en-ta-tion-al
un-prof-itable	un-prof-it-a-ble
mere-tri-cious	mer-e-tri-cious
ap-pre-cia-ble	ap-pre-ci-a-ble
phrasal	phras-al
macaw	ma-caw
broadsword	broad-sword
rec-ol-lec-t	rec-ol-lect
tele-vi-sion	tel-e-vi-sion
petu-lan-t	pet-u-lant
glow-wor-m	glow-worm
bish-opric	bish-op-ric
in-vestor	in-ves-tor
megas-tar	meg-a-star
pre-fec-t	pre-fect
un-opened	un-o-pened
avail	a-vail
over-fly	o-ver-fly
askew	a-skew
ap-proach-able	ap-proach-a-ble
necro-mancer	nec-ro-man-cer
de-con-struc-t	de-con-struct
eon	e-on
au-thoress	au-thor-ess
uned-i-fy-ing	un-ed-i-fy-ing
simil-i-tude	si-mil-i-tude
s-lap-stick	slap-stick
pleat-ed	pleated
s-tu-dentship	stu-dent-ship
porno-graph-ic	por-no-graph-ic
trumpery	trump-er-y
s-tunned	stunned
the-atri-cal	the-at-ri-cal
pro-ges-terone	pro-ges-ter-one
dis-senter	dis-sent-er
s-e-lectee	se-lect-ee
arum	ar-um
prompter	prompt-er
penum-bra	pe-num-bra
hered-i-ty	he-red-i-ty
un-set-tling	unsettling
wispy	wisp-y
d-elec-ta-tion	de-lec-ta-tion
river-side	riv-er-side
philo-soph-i-cal	phil-o-soph-i-cal
phos-pho-r	phos-phor
tol-l	toll
drink-able	drink-a-ble
pold-er	pol-der
alive	a-live
s-caf-fold-ing	scaf-fold-ing
lacteal	lac-te-al
asymp-to-matic	a-symp-to-mat-ic
quiet-ness	qui-et-ness
tachy-car-dia	tach-y-car-di-a
in-nard-s	in-nards
s-tor-age	stor-age
sooty	soot-y
mu-cosa	mu-co-sa
over-sim-pli-fi-ca-tion	o-ver-sim-pli-fi-ca-tion
d-if-fer-ing	differing
dais	da-is
bleat-ing	bleating
ap-pli-can-t	ap-pli-cant
veg-e-tar-i-an-is-m	veg-e-tar-i-an-ism
hare-bel-l	hare-bell
demo-crat	dem-o-crat
lit-er-al-is-m	lit-er-al-ism
no-to-ri-ety	no-to-ri-e-ty
s-plit	split
cuf-f	cuff
elide	e-lide
re-uni-fy	re-u-ni-fy
vi-o-len-t	vi-o-lent
biodegrad-able	bi-o-de-grad-a-ble
s-lalom	sla-lom
gallery	gal-ler-y
strug-gling	struggling
cus-tom-ary	cus-tom-ar-y
by-stander	by-stand-er
lazy-bones	la-zy-bones
over-throw	o-ver-throw
polyandry	pol-y-an-dry
rol-l	roll
malev-o-lence	ma-lev-o-lence
her-i-tabil-i-ty	her-it-a-bil-i-ty
prison	pris-on
o-vary	o-va-ry
an-tifreeze	an-ti-freeze
dancer	danc-er
meta-mor-phis-m	met-a-mor-phism
propul-sion	pro-pul-sion
mega-lo-ma-ni-a	meg-a-lo-ma-ni-a
s-cold	scold
cognoscen-ti	co-gno-scen-ti
dean-ery	dean-er-y
un-playable	un-play-a-ble
gramo-phone	gram-o-phone
recheck	re-check
s-light	slight
voyeur	vo-yeur
restau-ran-t	res-tau-rant
castel-lat-ed	cas-tel-lat-ed
heat-wave	heatwave
geno-type	gen-o-type
dol-l	doll
u-n-af-ford-able	un-af-ford-a-ble
un-cre-ative	un-cre-a-tive
short-s	shorts
eigen-func-tion	ei-gen-func-tion
footwear	foot-wear
un-fash-ion-able	un-fash-ion-a-ble
cliquey	cli-quey
polypep-tide	pol-y-pep-tide
e-s-prit	es-prit
athe-is-tic	a-the-is-tic
un-print-able	un-print-a-ble
apoc-ryphal	a-poc-ry-phal
pan-das	pan-das
corny	corn-y
e-s-o-ter-ic	es-o-ter-ic
brunette	bru-nette
bizarre	bi-zarre
mic-turi-tion	mic-tu-ri-tion
driv-able	driv-a-ble
lapel	la-pel
sul-tana	sul-tan-a
dis-ori-ent-ed	disoriented
piety	pi-e-ty
hu-man-is-m	hu-man-ism
adap-t	a-dapt
id-iot	id-i-ot
elec-tive	e-lec-tive
o-culist	oc-u-list
trilo-bite	tri-lo-bite
changeover	change-o-ver
base-bal-l	base-ball
s-car-i-fy	scar-i-fy
as-so-cia-tive	as-so-ci-a-tive
gos-sipy	gos-sip-y
con-flict-ual	con-flic-tu-al
fuch-si-a	fuch-sia
sole-cis-m	sol-e-cism
for-get-table	for-get-ta-ble
geo-physic-s	ge-o-phys-ics
across	a-cross
queru-lous	quer-u-lous
painful-ly	pain-ful-ly
weari-ly	wea-ri-ly
s-lop-pi-ness	slop-pi-ness
psy-chopath	psy-cho-path
prophet	proph-et
u-niden-ti-fi-able	un-i-den-ti-fi-a-ble
pseudony-mous	pseu-don-y-mous
choosy	choos-y
cuboid	cu-boid
tox-i-c	tox-ic
com-plain-t	com-plaint
p-re-serve	pre-serve
precipice	prec-i-pice
u-nan-nounced	un-an-nounced
s-tran-gle-hold	stran-gle-hold
vacu-ity	va-cu-i-ty
teatime	tea-time
ridicu-lous-ly	ri-dic-u-lous-ly
ar-bore-tum	ar-bo-re-tum
impi-ety	im-pi-e-ty
cesspit	cess-pit
des-tiny	des-ti-ny
lanky	lank-y
leer-ing	leering
cider	ci-der
in-flic-t	in-flict
com-b	comb
hero-ical-ly	he-ro-i-cal-ly
ir-re-duc-ible	ir-re-duc-i-ble
i-con-o-clas-m	i-con-o-clasm
es-trange-men-t	es-trange-ment
coro-net	cor-o-net
strin-gen-t	strin-gent
sanc-ti-mo-nious	sanc-ti-mo-ni-ous
philoso-pher	phi-los-o-pher
flinch-ing	flin-ching
hia-tus	hi-a-tus
detox	de-tox
rein-tro-duce	re-in-tro-duce
cys-t	cyst
climber	climb-er
suc-cinc-t	suc-cinct
semi-con-duct-ing	sem-i-con-duct-ing
boater	boat-er
rif-f	riff
turgid	tur-gid
pul-l	pull
un-solv-able	un-solv-a-ble
re-sis-tance	re-sist-ance
turn-around	turn-a-round
solem-ni-ty	so-lem-ni-ty
sa-far-i	sa-fa-ri
s-tran-gled	strangled
diplo-ma-cy	di-plo-ma-cy
kalei-do-scop-ic	ka-lei-do-scop-ic
trouper	troup-er
pi-caresque	pic-a-resque
en-riched	enriched
mer-chantable	mer-chant-a-ble
en-tan-gle-men-t	en-tan-gle-ment
sonar	so-nar
cologne	co-logne
garbage	gar-bage
fiz-z	fizz
bunker	bun-ker
geron-tol-o-gy	ger-on-tol-o-gy
erode	e-rode
chal-lenger	chal-leng-er
in-con-ve-nien-t	in-con-ven-ient
dis-rup-t	dis-rupt
ragged	rag-ged
in-her-i-ta-ble	in-her-it-a-ble
dra-mat-ic-s	dra-mat-ics
seroneg-a-tive	se-ro-neg-a-tive
tru-an-t	tru-ant
dili-gent-ly	dil-i-gent-ly
lazuli	laz-u-li
brioche	bri-oche
vit-ri-olic	vit-ri-ol-ic
raven-ing	rav-en-ing
s-pas-mod-ic	spas-mod-ic
rosette	ro-sette
redo-len-t	red-o-lent
sewage	sew-age
brochure	bro-chure
soloist	so-lo-ist
antler	ant-ler
out-fal-l	out-fall
de-crepit	de-crep-it
s-tar-ship	star-ship
unlov-ing	un-lov-ing
conur-ba-tion	con-ur-ba-tion
cur-tail-men-t	cur-tail-ment
over-ly-ing	o-ver-ly-ing
syn-onym	syn-o-nym
archangel	arch-an-gel
flanker	flank-er
cherub	cher-ub
tele-pho-ny	te-leph-o-ny
dentin	den-tin
p-re-s-e-lec-t	pre-se-lect
unglazed	un-glazed
duo	du-o
blood-wor-m	blood-worm
s-trait	strait
nonex-is-tence	non-ex-ist-ence
con-temptible	con-tempt-i-ble
autarchy	au-tar-chy
s-mall-ness	small-ness
tou-sled	tousled
oxy-gen	ox-y-gen
s-moother	smooth-er
s-lab	slab
ruf-f	ruff
cutout	cut-out
speci-fici-ty	spec-i-fic-i-ty
m-i-lieu	mi-lieu
un-even-ly	un-e-ven-ly
spin-naker	spin-na-ker
quo-tien-t	quo-tient
chi-nois-erie	chi-noi-se-rie
ide-al	i-de-al
pe-trel	pet-rel
elec-tri-fy	e-lec-tri-fy
pom-p	pomp
over-pass	o-ver-pass
guilty	guilt-y
platelet	plate-let
u-nau-dit-ed	un-au-dit-ed
re-silience	re-sil-ience
back-wood-s	back-woods
sand-piper	sand-pi-per
u-n-ap-peal-ing	un-ap-peal-ing
fuz-z	fuzz
basal	ba-sal
in-fir-mary	in-fir-ma-ry
s-trange	strange
ref-er-en-t	ref-er-ent
spinal	spi-nal
bal-lis-tic-s	bal-lis-tics
per-me-able	per-me-a-ble
hab-er-dash-ery	hab-er-dash-er-y
pur-port-ed	purported
untest-ed	un-test-ed
t-in-ware	tin-ware
whisker	whisk-er
de-signed-ly	de-sign-ed-ly
s-cal-able	scal-a-ble
trans-for-m	trans-form
archdea-con-ry	arch-dea-con-ry
sum-mon-s	sum-mons
com-mence-men-t	com-mence-ment
para-dox	par-a-dox
dis-able	dis-a-ble
evening	eve-ning
hy-gien-ic	hy-gi-en-ic
ex-i-gen-t	ex-i-gent
in-vert-ed	inverted
en-teri-tis	en-ter-i-tis
sub-trac-t	sub-tract
cor-rup-t	cor-rupt
s-mart-ing	smart-ing
d-in-gle	din-gle
promp-t	prompt
cir-cum-lo-cu-to-ry	cir-cum-loc-u-to-ry
dopey	dope-y
rep-til-ian	rep-til-i-an
carpal	car-pal
un-ortho-dox	un-or-tho-dox
hermeneu-tic	her-me-neu-tic
dimin-u-en-do	di-min-u-en-do
erup-t	e-rupt
dis-cern-men-t	dis-cern-ment
tin-t	tint
no-tice-able	no-tice-a-ble
paramount-cy	par-a-mount-cy
s-toned	stoned
livid	liv-id
ac-coun-t	ac-count
dereg-u-la-tion	de-reg-u-lation
in-tel-lec-tu-al-is-m	in-tel-lec-tu-al-ism
bom-bard-men-t	bom-bard-ment
bradawl	brad-awl
plea-sur-able	pleas-ur-a-ble
con-tain-men-t	con-tain-ment
e-quian-gu-lar	e-qui-an-gu-lar
tel-l	tell
teapot	tea-pot
hero	he-ro
weed-s	weeds
ar-chi-tec-t	ar-chi-tect
yeti	yet-i
foxy	fox-y
em-bed-dable	em-bed-da-ble
s-cale	scale
s-ten-tor	sten-tor
oblate	ob-late
pro-po-nen-t	pro-po-nent
kestrel	kes-trel
patho-log-i-cal	path-o-log-i-cal
dis-tur-b	dis-turb
beamy	beam-y
frica-tive	fric-a-tive
holis-tic	ho-lis-tic
baguette	ba-guette
mis-nomer	mis-no-mer
coro-ner	cor-o-ner
ex-pand-able	ex-pand-a-ble
em-bolis-m	em-bo-lism
porter-age	por-ter-age
de-monolo-gy	de-mon-ol-o-gy
poseur	po-seur
lam-plit	lamp-lit
key-boardis-t	key-board-ist
con-fi-dan-t	con-fi-dant
meri-no	me-ri-no
ther-mome-ter	ther-mom-e-ter
apron	a-pron
un-steady	un-stead-y
video-tape	vid-e-o-tape
bar-bel-l	bar-bell
tri-den-t	tri-dent
u-n-am-bi-tious	un-am-bi-tious
soapy	soap-y
avenge	a-venge
marzi-pan	mar-zi-pan
ar-range-men-t	ar-range-ment
s-lick	slick
i-n-ad-e-qua-cy	in-ad-e-qua-cy
gra-nary	gra-na-ry
await	a-wait
athe-is-m	a-the-ism
sol-ven-t	sol-vent
jeer-ing	jeering
colos-sus	co-los-sus
in-di-gestible	in-di-gest-i-ble
bloomer	bloom-er
ashore	a-shore
stroller	stroll-er
hu-mankind	hu-man-kind
fit-men-t	fit-ment
s-cav-enge	scav-enge
w-ere-wolf	were-wolf
di-alec-ti-cal	di-a-lec-ti-cal
tele-path-ic	tel-e-path-ic
homi-cide	hom-i-cide
rene-go-ti-ate	re-ne-go-ti-ate
ovoid	o-void
s-teeple-chase	stee-ple-chase
dis-band-men-t	dis-band-ment
res-i-den-t	res-i-dent
ragout	ra-gout
lethal-ly	le-thal-ly
my-ocar-dial	my-o-car-di-al
sharp-en-er	shar-pen-er
potas-si-um	po-tas-si-um
in-con-ti-nen-t	in-con-ti-nent
face-tious	fa-ce-tious
c-it-i-zen-ry	cit-i-zen-ry
tenet	ten-et
broc-col-i	broc-co-li
je-junum	je-ju-num
weav-ing	weaving
con-tex-t	con-text
clash-ing	clashing
grandiose	gran-di-ose
idea	i-de-a
at-tribute	at-trib-ute
riv-ier-a	riv-i-er-a
se-nior	sen-ior
i-n-un-date	in-un-date
rar-efied	rar-e-fied
re-fresh-men-t	re-fresh-ment
banger	bang-er
b-i-fo-cal	bi-fo-cal
doily	doi-ly
pat-terned	patterned
unchris-tian	un-chris-tian
s-ta-tion-er	sta-tion-er
capri-cious	ca-pri-cious
u-p-lift	up-lift
d-if-fu-sive	dif-fu-sive
per-son-a	per-so-na
stealthy	stealth-y
gestalt	ge-stalt
be-fud-dled	befuddled
leav-ened	leavened
s-pear	spear
beg-gary	beg-gar-y
cus-tomer	cus-tom-er
stric-t	strict
sol-diery	sol-dier-y
teardrop	tear-drop
s-tra-tus	stra-tus
in-ter-sec-t	in-ter-sect
tele-graph	tel-e-graph
baloney	ba-lo-ney
her-s	hers
liquor-ish	liq-uor-ish
valid-ly	val-id-ly
re-spectable	re-spect-a-ble
in-ex-haustible	in-ex-haust-i-ble
men-di-can-t	men-di-cant
geo-sta-tion-ary	ge-o-sta-tion-ar-y
in-sol-ven-t	in-sol-vent
re-strain-t	re-straint
raster	ras-ter
recre-ation-al	rec-re-a-tion-al
per-ineum	per-i-ne-um
peas-an-t	peas-ant
ceme-tery	cem-e-ter-y
any-thing	an-y-thing
porta-bil-i-ty	port-a-bil-i-ty
in-no-cen-t	in-no-cent
rogu-ish	ro-guish
inkling	ink-ling
alar-m	a-larm
coastal	coast-al
colan-der	col-an-der
feud-is-t	feud-ist
apoth-e-o-sis	a-poth-e-o-sis
labi-al	la-bi-al
en-thu-si-as-m	en-thu-si-asm
s-lith-er	slith-er
suet	su-et
down-sid-e	down-side
lemon	lem-on
s-tance	stance
whif-f	whiff
eroge-nous	e-rog-e-nous
s-mash-ing	smash-ing
green-ery	green-er-y
ori-en-tate	o-ri-en-tate
sub-species	sub-spe-cies
rel-e-van-t	rel-e-vant
l-iti-gious	li-ti-gious
regime	re-gime
essence	es-sence
un-em-ploy-men-t	un-em-ploy-ment
hubris-tic	hu-bris-tic
ex-is-ten-t	ex-ist-ent
firkin	fir-kin
renown	re-nown
chrysalis	chrys-a-lis
colobus	col-o-bus
warpaint	war-paint
mantra	man-tra
cine	cin-e
ex-oge-nous	ex-og-e-nous
fraugh-t	fraught
n-ev-er-the-less	nev-er-the-less
ex-emp-t	ex-empt
phleg-m	phlegm
dis-tillery	dis-till-er-y
steamship	steam-ship
s-pade-work	spade-work
be-liev-abil-i-ty	be-liev-a-bil-i-ty
un-de-tectable	un-de-tect-a-ble
land-fal-l	land-fall
im-pro-visato-ry	im-pro-vi-sa-to-ry
ar-den-t	ar-dent
uten-sil	u-ten-sil
u-n-awares	un-a-wares
bluish	blu-ish
per-former	per-form-er
quotable	quot-a-ble
glitzy	glitz-y
post-mod-ernist	post-mod-ern-ist
de-cay-ing	decaying
scrol-l	scroll
fo-men-t	fo-ment
au-tonomous-ly	au-ton-o-mous-ly
gerund	ger-und
im-por-tan-t	im-por-tant
bi-l-abi-al	bi-la-bi-al
s-noek	snoek
lin-guis-tic-s	lin-guis-tics
sub-cu-ta-neous	sub-cu-ta-ne-ous
an-tag-o-nis-m	an-tag-o-nism
bun-gled	bungled
in-fantry	in-fan-try
s-to-ical	sto-i-cal
bologna	bo-lo-gna
detox-i-fi-ca-tion	de-tox-i-fi-ca-tion
s-trained	strained
for-man-t	for-mant
emul-sion	e-mul-sion
un-handy	un-hand-y
vi-sion-ary	vi-sion-ar-y
triplet	tri-plet
over-cast	o-ver-cast
s-now-drop	snow-drop
nightin-gale	night-in-gale
out-cal-l	out-call
cau-tion-ary	cau-tion-ar-y
re-s-e-lec-t	re-se-lect
un-emo-tion-al	un-e-mo-tion-al
whar-f	wharf
despot	des-pot
tiler	til-er
api-ary	a-pi-ar-y
pho-to-elec-tric	pho-to-e-lec-tric
sa-tanis-m	sa-tan-ism
ex-ecu-tor	ex-ec-u-tor
rigid-i-ty	ri-gid-i-ty
c-it-ron	cit-ron
pre-dictabil-i-ty	pre-dict-a-bil-i-ty
melan-choly	mel-an-chol-y
mis-an-thropy	mis-an-thro-py
whomev-er	whom-ev-er
re-uni-fi-ca-tion	re-u-ni-fi-ca-tion
pa-tois	pat-ois
pleas-antry	pleas-ant-ry
mil-i-taris-tic	mil-i-ta-ris-tic
undis-turbed	un-dis-turbed
seg-ment-ed	seg-men-ted
biomass	bi-o-mass
in-ef-fi-cien-t	in-ef-fi-cient
ima-go	i-ma-go
polo-ni-um	po-lo-ni-um
bion-ic	bi-on-ic
ex-po-nen-t	ex-po-nent
glo-be-trot-ting	globe-trot-ting
lyri-cis-m	lyr-i-cism
ephemeris	e-phem-er-is
sloven-ly	slov-en-ly
viper	vi-per
un-ob-jec-tion-able	un-ob-jec-tion-a-ble
s-care-crow	scare-crow
parsnip	pars-nip
jumper	jump-er
s-cab	scab
sep-a-ratism	sep-a-ra-tism
ex-trem-is-m	ex-trem-ism
re-gret-table	re-gret-ta-ble
s-lim-mer	slim-mer
crosstalk	cross-talk
prowler	prowl-er
hy-draulic	hy-drau-lic
palu-dal	pa-lu-dal
elec-tron	e-lec-tron
y-ours	yours
gooey	goo-ey
un-der-stand-able	un-der-stand-a-ble
s-loshed	sloshed
pin-t	pint
ori-en-tal-is-m	o-ri-en-tal-ism
s-in-u-ous	sin-u-ous
cram-p	cramp
sub-si-dence	sub-sid-ence
awestruc-k	awe-struck
mis-in-for-m	mis-in-form
s-teer-ing	steer-ing
in-equitable	in-eq-ui-ta-ble
cross-over	cross-o-ver
es-carp-men-t	es-carp-ment
es-pi-onage	es-pi-o-nage
so-lic-it-ing	soliciting
as-sis-tan-t	as-sis-tant
apoc-a-lyp-tic	a-poc-a-lyp-tic
trac-ery	trac-er-y
yel-lowed	yellowed
in-stal-l	in-stall
maya	ma-ya
be-twix-t	be-twixt
con-flic-t	con-flict
kinder-garten	kin-der-gar-ten
u-n-ac-com-mo-dat-ing	un-ac-com-mo-dat-ing
metatarsal	met-a-tar-sal
flammable	flam-ma-ble
fifti-eth	fif-ti-eth
guinea	guin-ea
in-fringe-men-t	in-fringe-ment
mar-riage-able	mar-riage-a-ble
out-landish	out-land-ish
n-im-ble	nim-ble
leaky	leak-y
un-in-ter-pretable	un-in-ter-pret-a-ble
hayloft	hay-loft
u-nasked	un-asked
in-cur-able	in-cur-a-ble
i-a-tro-genic	i-at-ro-gen-ic
pa-paya	pa-pa-ya
re-pro-ducible	re-pro-duc-i-ble
mys-tery	mys-ter-y
so-cioe-co-nom-ic	so-ci-o-ec-o-nom-ic
pi-rat-ed	pirated
elec-torate	e-lec-tor-ate
ephemer-al	e-phem-er-al
pesti-len-tial	pes-ti-len-tial
s-tudy	stud-y
e-u-pho-ni-um	eu-pho-ni-um
er-gonomic-s	er-go-nom-ics
lunchtime	lunch-time
fragili-ty	fra-gil-i-ty
pan-tomime	pan-to-mime
earnest-ness	ear-nest-ness
har-mo-nious-ly	har-mo-ni-ous-ly
rani	ra-ni
n-u-mis-mat-ic-s	nu-mis-mat-ics
out-skirt-s	out-skirts
vir-u-len-t	vir-u-lent
col-lec-tivis-m	col-lec-tiv-ism
re-order	re-or-der
saver	sav-er
hooli-gan	hoo-li-gan
ves-ti-gial	ves-tig-i-al
sen-t	sent
tele-vise	tel-e-vise
fil-i-buster	fil-i-bus-ter
timid	tim-id
elec-trolyte	e-lec-tro-lyte
in-ter-ci-ty	in-ter-cit-y
defini-tive-ly	de-fin-i-tive-ly
ro-mancer	ro-manc-er
shopfron-t	shop-front
demon-stra-bly	de-mon-stra-bly
open-er	o-pen-er
lovesick	love-sick
ra-dio-ther-a-py	ra-di-o-ther-a-py
gi-antism	gi-ant-ism
moldy	mold-y
s-traight	straight
domi-no	dom-i-no
s-mash	smash
om-nipo-ten-t	om-nip-o-tent
un-equiv-o-cal	un-e-quiv-o-cal
s-carab	scar-ab
mono-rail	mon-o-rail
stripling	strip-ling
cel-ery	cel-er-y
lega-to	le-ga-to
ar-senic	ar-se-nic
hashish	hash-ish
an-niver-sary	an-ni-ver-sa-ry
tapi-o-ca	tap-i-o-ca
chrono-graph	chron-o-graph
s-trag-gle	strag-gle
herbal	herb-al
hy-gien-e	hy-giene
un-linked	unlinked
ath-let-ic-s	ath-let-ics
poly-chrome	pol-y-chrome
tape-wor-m	tape-worm
plu-per-fec-t	plu-per-fect
d-is-fran-chise	dis-fran-chise
wrap-around	wrap-a-round
s-niper	snip-er
dugout	dug-out
stri-den-t	stri-dent
mir-ror-ing	mirroring
hy-drome-chan-ic-s	hy-dro-me-chan-ics
lessor	les-sor
com-plain-ing	complaining
groom-ing	grooming
in-ter-fer-e	in-ter-fere
s-take-hold-er	stake-hold-er
s-cared	scared
co-terie	co-te-rie
ac-cept-able	ac-cept-a-ble
bes-tiary	bes-ti-ar-y
neme-sis	nem-e-sis
over-draft	o-ver-draft
dis-ori-en-t	dis-o-ri-ent
ho-mo-mor-phis-m	ho-mo-mor-phism
hardy	har-dy
k-itsch	kitsch
s-moth-ered	smothered
mi-cro-bial	mi-cro-bi-al
panacea	pan-a-ce-a
er-bium	er-bi-um
in-stan-t	in-stant
drinker	drink-er
dis-turbing-ly	dis-turb-ing-ly
nestling	nest-ling
un-bear-ably	un-bear-a-bly
s-mall-hold-ing	small-hold-ing
grit-s	grits
boohoo	boo-hoo
phono-log-i-cal	pho-no-log-i-cal
crin-kled	crinkled
an-nu-ity	an-nu-i-ty
jus-ti-fi-ably	jus-ti-fi-a-bly
chasti-ty	chas-ti-ty
e-lastin	e-las-tin
sinewy	sin-ew-y
taxi-cab	tax-i-cab
s-capu-la	scap-u-la
ser-pen-t	ser-pent
re-coun-t	re-count
iso-ton-ic	i-so-ton-ic
roulette	rou-lette
lack-adaisi-cal	lack-a-dai-si-cal
re-union	re-un-ion
weapon	weap-on
sero-tonin	ser-o-to-nin
midlife	mid-life
de-gauss-ing	degaussing
shril-l	shrill
metal-lic	me-tal-lic
lig-and	li-gand
com-pen-sato-ry	com-pen-sa-to-ry
steplad-der	step-lad-der
laud-s	lauds
prov-ably	prov-a-bly
mac-a-roni	mac-a-ro-ni
here-upon	here-up-on
he-do-nis-m	he-don-ism
en-cycli-cal	en-cyc-li-cal
pygmy	pyg-my
s-tark-ly	stark-ly
froward	fro-ward
holo-graph-ic	hol-o-graph-ic
flotil-la	flo-til-la
dil-l	dill
con-fi-den-tial-i-ty	con-fi-den-ti-al-i-ty
e-cono-met-ric-s	e-con-o-met-rics
ter-rafor-m	ter-ra-form
b-o-rate	bo-rate
chem-istry	chem-is-try
n-im-bly	nim-bly
un-know-able	un-know-a-ble
com-forter	com-fort-er
tawny	taw-ny
s-cent-ed	scent-ed
over-man-tel	o-ver-man-tel
wicked-ness	wick-ed-ness
con-vivial	con-viv-i-al
in-tel-li-gen-t	in-tel-li-gent
opales-cen-t	o-pal-es-cent
cir-cuitous	cir-cu-i-tous
un-equiv-o-cal-ly	un-e-quiv-o-cal-ly
de-rail-men-t	de-rail-ment
au-tomat	au-to-mat
puni-tive	pu-ni-tive
de-r-ate	de-rate
raver	rav-er
clavi-chord	clav-i-chord
undiplo-mat-ic	un-dip-lo-mat-ic
illiq-uid	il-liq-uid
pen-sion-able	pen-sion-a-ble
valance	val-ance
chester-field	ches-ter-field
dy-namo	dy-na-mo
placid	plac-id
bilin-gual-is-m	bi-lin-gual-ism
yokel	yo-kel
evo-lu-tion-ary	ev-o-lu-tion-ar-y
depre-da-tion	dep-re-da-tion
read-mis-sion	re-ad-mis-sion
s-ti-fle	sti-fle
rosary	ro-sa-ry
swindler	swin-dler
reawak-en	re-a-wak-en
de-ter-min-is-m	de-ter-min-ism
res-onator	res-o-na-tor
rheuma-tol-o-gy	rheu-ma-tol-o-gy
s-tub-born	stub-born
en-tourage	en-tou-rage
metas-ta-sis	me-tas-ta-sis
ten-able	ten-a-ble
er-ran-t	er-rant
deca-den-t	dec-a-dent
heresy	her-e-sy
ex-ul-tan-t	ex-ult-ant
er-a	e-ra
un-ob-ser-van-t	un-ob-serv-ant
bib-lio-phile	bib-li-o-phile
dimwit	dim-wit
moun-taineer-ing	moun-tain-eer-ing
pro-lactin	pro-lac-tin
i-n-or-gan-ic	in-or-gan-ic
groat-s	groats
tiller	till-er
styling	styl-ing
elec-t	e-lect
traitor	trai-tor
i-n-ac-tive	in-ac-tive
antwer-p	antwerp
elec-tri-cal	e-lec-tri-cal
pe-tit	pet-it
plexus	plex-us
lol-lipop	lol-li-pop
vil-lainy	vil-lain-y
lam-p	lamp
re-sent-men-t	re-sent-ment
cu-nei-form	cu-ne-i-form
para-troop-er	par-a-troop-er
un-able	un-a-ble
clemen-t	clem-ent
se-quencer	se-quenc-er
aba-cus	ab-a-cus
con-duct-ed	conducted
u-n-avoid-able	un-a-void-a-ble
s-lay-er	slay-er
ure-thra	u-re-thra
silk-wor-m	silk-worm
brazen-ly	bra-zen-ly
com-mand-men-t	com-mand-ment
rev-o-lu-tion-ary	rev-o-lu-tion-ar-y
droopy	droop-y
e-s-pe-cial	es-pe-cial
pro-boscis	pro-bos-cis
can-ni-bal-is-m	can-ni-bal-ism
in-dul-gen-t	in-dul-gent
cap-i-tal-is-m	cap-i-tal-ism
nonessen-tial	non-es-sen-tial
dis-ar-ma-men-t	dis-ar-ma-ment
i-den-ti-fi-able	i-den-ti-fi-a-ble
hip-pocam-pus	hip-po-cam-pus
id-iom	id-i-om
rein-car-nate	re-in-car-nate
sies-ta	si-es-ta
ev-ery	eve-ry
un-fet-tered	unfettered
over-tone	o-ver-tone
out-sider	out-sid-er
holo-caust	hol-o-caust
li-bido	li-bi-do
even-tide	e-ven-tide
junker	jun-ker
ashamed	a-shamed
skintight	skin-tight
satin	sat-in
jean-s	jeans
vial	vi-al
procla-ma-tion	proc-la-ma-tion
tan-ger-ine	tan-ge-rine
psy-chother-a-pist	psy-cho-ther-a-pist
po-ten-tial-i-ty	po-ten-ti-al-i-ty
antrum	an-trum
foundry	found-ry
b-lis-ter-ing	blis-ter-ing
in-trauter-ine	in-tra-u-ter-ine
famine	fam-ine
su-per-hero	su-per-he-ro
melod-ic	me-lod-ic
s-tam-mer-ing	stammering
wind-fal-l	wind-fall
ter-tiary	ter-ti-ar-y
chromi-um	chro-mi-um
pil-l	pill
lech-ery	lech-er-y
ra-tio-nal	ra-tion-al
ge-o-mag-net-i-cal-ly	ge-o-mag-ne-ti-cal-ly
ool-o-gy	o-ol-o-gy
leucine	leu-cine
oviduc-t	o-vi-duct
doc-u-men-tary	doc-u-men-ta-ry
mer-ce-nary	mer-ce-nar-y
ma-jorette	ma-jor-ette
de-ity	de-i-ty
glacier	gla-cier
jaz-z	jazz
im-memo-ri-al	im-me-mo-ri-al
id-iomat-ic	id-i-o-mat-ic
opi-ate	o-pi-ate
souther-ly	south-er-ly
libero	li-be-ro
un-prece-dent-ed	un-prec-e-dent-ed
open	o-pen
s-tain-less	stain-less
racon-teur	rac-on-teur
s-traight-away	straight-a-way
s-tar-ling	star-ling
wom-b	womb
con-form-able	con-form-a-ble
brevi-ty	brev-i-ty
as-tro-physic-s	as-tro-phys-ics
messy	mess-y
caliph	ca-liph
aubergine	au-ber-gine
s-tom-a	sto-ma
lament-ed	la-ment-ed
astride	a-stride
pur-suer	pur-su-er
s-laugh-ter	slaugh-ter
busk-ing	busking
necro-man-tic	nec-ro-man-tic
ev-ery-where	eve-ry-where
or-biter	or-bit-er
quencher	quench-er
ar-chi-pel-ago	ar-chi-pel-a-go
im-pro-pri-ety	im-pro-pri-e-ty
triage	tri-age
wa-ver-ing	wavering
s-pline	spline
ver-i-fi-able	ver-i-fi-a-ble
im-pe-cu-nious	im-pe-cu-ni-ous
quizzi-cal	quiz-zi-cal
cafe-te-ri-a	caf-e-te-ri-a
s-lipped	slipped
far-m	farm
s-tranger	stran-ger
hon-esty	hon-es-ty
un-demo-crat-ic	un-dem-o-crat-ic
as-tronomer	as-tron-o-mer
fi-nis	fin-is
velo-drome	ve-lo-drome
louis	lou-is
re-ac-tan-t	re-ac-tant
b-otany	bot-a-ny
quadri-par-tite	quad-ri-par-tite
muslin	mus-lin
e-d-u-cat-ed	ed-u-cat-ed
pesky	pes-ky
con-se-quen-t	con-se-quent
vanil-la	va-nil-la
s-lip-stream	slip-stream
in-fre-quen-t	in-fre-quent
tra-cheoto-my	tra-che-ot-o-my
palate	pal-ate
ex-tra-galac-tic	ex-tra-ga-lac-tic
mauler	maul-er
repack	re-pack
w-hole-heart-ed-ly	whole-heart-ed-ly
avion-ic-s	a-vi-on-ics
re-sis-tan-t	re-sist-ant
macro	mac-ro
moi-ety	moi-e-ty
stapes	sta-pes
teacup	tea-cup
p-light	plight
re-tiree	re-tir-ee
needle-work	nee-dle-work
petrol-o-gy	pe-trol-o-gy
politic	pol-i-tic
vol-ley-bal-l	vol-ley-ball
s-cam-per	scamp-er
bur-sary	bur-sa-ry
cav-ernous	cav-ern-ous
even	e-ven
beefy	beef-y
mer-ri-men-t	mer-ri-ment
elec-tri-cian	e-lec-tri-cian
vil-lager	vil-lag-er
foundling	found-ling
in-tu-itive	in-tu-i-tive
un-sellable	un-sell-a-ble
monochro-mat-ic	mon-o-chro-mat-ic
cagoule	ca-goule
sober-ly	so-ber-ly
blotchy	blotch-y
y-ou	you
celebri-ty	ce-leb-ri-ty
in-ter-molec-u-lar	in-ter-mo-lec-u-lar
com-press-ibil-i-ty	com-pres-si-bil-i-ty
tripoli	trip-o-li
flota-tion	flo-ta-tion
rhodi-um	rho-di-um
quiv-er-ing	quivering
seaborne	sea-borne
bovine	bo-vine
en-vi-ron-men-tal-is-m	en-vi-ron-men-tal-ism
prod-uc-t	prod-uct
cour-tesy	cour-te-sy
tun-able	tun-a-ble
dis-playable	displayable
pe-riph-ery	pe-riph-er-y
about	a-bout
unloved	un-loved
dyad	dy-ad
earnest-ly	ear-nest-ly
pullover	pull-o-ver
piton	pi-ton
over-grown	o-ver-grown
seden-tary	sed-en-tar-y
grenade	gre-nade
fil-a-men-t	fil-a-ment
duck-bil-l	duck-bill
disin-gen-u-ous	dis-in-gen-u-ous
moorhen	moor-hen
rigid-i-fy	ri-gid-i-fy
asymp-tote	as-ymp-tote
cata-ton-ic	cat-a-ton-ic
ho-minid	hom-i-nid
em-bo-som	em-bos-om
va-grancy	va-gran-cy
decade	dec-ade
as-cen-t	as-cent
salu-tary	sal-u-tar-y
as-sess-men-t	as-sess-ment
ir-ri-tan-t	ir-ri-tant
s-pan	span
pin-bal-l	pin-ball
thau-maturge	thau-ma-turge
par-tial-i-ty	par-ti-al-i-ty
satel-lite	sat-el-lite
squeaky	squeak-y
rum-pled	rumpled
duo-logue	du-o-logue
cru-ci-for-m	cru-ci-form
re-port-ed	reported
bak-ery	bak-er-y
fishy	fish-y
postal	post-al
plaza	pla-za
de-con-struc-tive	deconstructive
un-sink-able	un-sink-a-ble
steadi-ly	stead-i-ly
han-dover	hand-o-ver
even-t	e-vent
cheery	cheer-y
seclu-sion	se-clu-sion
prof-i-teer-ing	profiteering
epi-cure	ep-i-cure
geo-cen-tric	ge-o-cen-tric
waxy	wax-y
s-train	strain
bar-racu-d-a	bar-ra-cu-da
s-lide	slide
opaque	o-paque
karate	ka-ra-te
dis-hon-esty	dis-hon-es-ty
pres-i-den-t	pres-i-dent
y-on	yon
hefty	heft-y
e-s-py	es-py
mogul	mo-gul
sarong	sa-rong
per-fec-tion-is-m	per-fec-tion-ism
unswerv-ing	un-swerv-ing
con-demned	condemned
maisonette	mai-son-ette
pro-pri-eto-ri-al	pro-pri-e-to-ri-al
boxy	box-y
tri-bunal	tri-bu-nal
rat-tlesnake	rat-tle-snake
s-core-card	score-card
seashore	sea-shore
u-nau-then-ti-cat-ed	un-au-then-ti-cat-ed
s-ling-shot	sling-shot
ir-ra-tional	ir-ra-tion-al
in-hos-pitable	in-hos-pi-ta-ble
ex-citable	ex-cit-a-ble
s-calp	scalp
p-salter	psal-ter
mileage	mile-age
roofer	roof-er
re-s-e-lect-ed	re-se-lected
vale-dic-tion	val-e-dic-tion
in-vest-men-t	in-vest-ment
rack-e-teer-ing	rack-et-eer-ing
scrapie	scrap-ie
centi-grade	cen-ti-grade
gur-gling	gurgling
forester	for-est-er
over-shoot	o-ver-shoot
over-rule	o-ver-rule
sec-ondary	sec-ond-ar-y
barefaced	bare-faced
temptress	tempt-ress
bol-stered	bolstered
in-sid-e	in-side
ve-he-men-t	ve-he-ment
over-land	o-ver-land
cor-dial	cor-di-al
gaga	ga-ga
vizier	vi-zier
coolan-t	cool-ant
n-ode	node
satchel	satch-el
siphon	si-phon
e-q-ui-tably	eq-ui-ta-bly
warmer	warm-er
signet	sig-net
be-witch-ing	bewitching
trapeze	tra-peze
s-tone	stone
re-pairable	re-pair-a-ble
avowed	a-vowed
s-traight-en	straight-en
tele-vised	televised
tillage	till-age
s-now-man	snow-man
d-warfed	dwarfed
s-tatis-tic	sta-tis-tic
s-to-ry-line	sto-ry-line
pho-to-volta-ic	pho-to-vol-ta-ic
s-noop-ing	snooping
para-mount	par-a-mount
de-scen-dan-t	de-scend-ant
edgy	edg-y
de-pend-able	de-pend-a-ble
in-frared	in-fra-red
s-mol-der	smol-der
pekan	pek-an
drap-ery	dra-per-y
leisurewear	lei-sure-wear
u-nattain-able	un-at-tain-a-ble
sundry	sun-dry
wiring	wir-ing
pe-cu-niary	pe-cu-ni-ar-y
clemen-cy	clem-en-cy
in-quiry	in-quir-y
showy	show-y
com-mit-men-t	com-mit-ment
stipend	sti-pend
kook-abur-ra	kook-a-bur-ra
punky	punk-y
u-ni-for-mi-ty	u-ni-form-i-ty
com-plaisan-t	com-plai-sant
un-re-served-ly	un-re-serv-ed-ly
u-nas-signed	un-as-signed
workspace	work-space
i-n-escapable	in-es-cap-a-ble
avid	av-id
hul-l	hull
porcine	por-cine
curvi-lin-ear	cur-vi-lin-e-ar
hangar	hang-ar
pre-pared-ness	pre-par-ed-ness
tar-ragon	tar-ra-gon
ar-ti-fi-cial-i-ty	ar-ti-fi-ci-al-i-ty
re-assess	re-as-sess
ashy	ash-y
deuteron	deu-ter-on
it-s	its
prospec-t	pros-pect
sac-risty	sac-ris-ty
mazy	ma-zy
pol-lu-tan-t	pol-lu-tant
u-n-adorned	un-a-dorned
vivid	viv-id
con-cussed	concussed
vine-gar	vin-e-gar
mi-ni	min-i
s-can-dal	scan-dal
erup-tive	e-rup-tive
noisy	nois-y
driver-less	driv-er-less
nephew	neph-ew
i-n-ad-e-quate-ly	in-ad-e-quate-ly
bel-liger-ence	bel-lig-er-ence
per-ora-tion	per-o-ra-tion
drowsy	drow-sy
nurs-ery-men	nurs-er-y-men
s-trand	strand
whoso-ev-er	who-so-ev-er
lifebelt	life-belt
enig-ma	e-nig-ma
sex-is-m	sex-ism
drom-e-dary	drom-e-dar-y
e-pochal	ep-och-al
tem-po-rary	tem-po-rar-y
ex-or-cis-m	ex-or-cism
sali-vary	sal-i-var-y
covert-ly	cov-ert-ly
painful	pain-ful
clam-p	clamp
de-sirous	de-sir-ous
in-dis-tinc-t	in-dis-tinct
s-nifter	snif-ter
sil-vered	silvered
book-binder	book-bind-er
ex-hibitor	ex-hib-i-tor
beloved	be-lov-ed
as-sailan-t	as-sail-ant
parent-age	par-ent-age
boule-vard	boul-e-vard
in-cum-ben-t	in-cum-bent
s-lough	slough
con-cate-na-tion	con-cat-e-na-tion
in-struc-t	in-struct
car-rion	car-ri-on
moun-taineer	moun-tain-eer
obe-di-en-t	o-be-di-ent
cov-et-ed	coveted
s-trato-spher-i-cal-ly	stratospherically
un-der-gar-men-t	un-der-gar-ment
em-broi-dery	em-broi-der-y
debonair	deb-o-nair
wafer	wa-fer
forcibly	for-ci-bly
con-toured	contoured
cor-re-spon-den-t	cor-re-spond-ent
molec-u-lar	mo-lec-u-lar
undis-tort-ed	un-dis-tort-ed
brief-in-g	brief-ing
draught-s	draughts
s-cant-i-ly	scant-i-ly
boast-ing	boas-ting
knowl-edge-able	knowl-edge-a-ble
hu-manoid	hu-man-oid
fash-ion-able	fash-ion-a-ble
s-cal-lop	scal-lop
bio-met-ric	bi-o-met-ric
d-if-fu-sion	dif-fu-sion
erot-i-ca	e-rot-i-ca
brio	bri-o
cli-toral	clit-o-ral
tumes-cen-t	tu-mes-cent
un-usu-al	un-u-su-al
monar-chy	mon-ar-chy
eru-di-tion	er-u-di-tion
for-mu-la-ry	for-mu-lar-y
here-inafter	here-in-af-ter
hypochon-dri-a-cal	hy-po-chon-dri-a-cal
provin-cial-is-m	pro-vin-cial-ism
frontal	fron-tal
s-hears	shears
s-tam-p	stamp
in-for-mat-ic-s	in-for-mat-ics
obe-di-ence	o-be-di-ence
decagon	dec-a-gon
elo-quen-t	el-o-quent
s-tar-tle	star-tle
makeover	make-o-ver
es-capade	es-ca-pade
unlov-able	un-lov-a-ble
s-cle-ro-sis	scle-ro-sis
b-light	blight
poundage	pound-age
camisole	cam-i-sole
s-niff-in-g	sniffing
in-ex-orably	in-ex-o-ra-bly
cleaver-s	cleav-ers
chaf-f	chaff
dila-tor	di-la-tor
de-mount-able	de-mount-a-ble
mist-imed	mis-timed
front-ed	fronted
o-live	ol-ive
modal-i-ty	mo-dal-i-ty
s-mudgy	smudg-y
bauble	bau-ble
s-trate-gist	strat-e-gist
par-a-bola	pa-rab-o-la
wa-ter-fal-l	wa-ter-fall
ec-topic	ec-top-ic
s-taid	staid
oily	oil-y
pread-o-les-cen-t	pre-ad-o-les-cent
over-flow	o-ver-flow
gra-di-en-t	gra-di-ent
mistyp-ings	mis-ty-pings
warthog	wart-hog
crevasse	cre-vasse
brasserie	bras-se-rie
bur-r	burr
re-main-s	re-mains
im-port-ed	imported
ki-net-ic-s	ki-net-ics
car-dioid	car-di-oid
fire-bom-b	fire-bomb
plu-ral-is-m	plu-ral-ism
s-mooth	smooth
com-mis-sari-at	com-mis-sar-i-at
viril-i-ty	vi-ril-i-ty
s-tone-ma-son	stone-ma-son
s-tair-head	stair-head
mandible	man-di-ble
lever-age	lev-er-age
in-ci-den-t	in-ci-dent
im-pru-den-t	im-pru-dent
over-sub-scribed	o-ver-sub-scribed
s-tuc-co	stuc-co
menu	men-u
no-body	no-bod-y
flesh-pot-s	flesh-pots
fire-bal-l	fire-ball
trans-paren-cy	trans-par-en-cy
dogs-body	dogs-bod-y
proac-tive	pro-ac-tive
leaflet	leaf-let
s-teeply	steep-ly
any-ways	an-y-ways
translit-er-ate	trans-lit-er-ate
sub-scriber	sub-scrib-er
hazy	ha-zy
sim-per-ing	simpering
k-er-atin	ker-a-tin
over-e-mo-tion-al	o-ver-e-mo-tion-al
freestyle	free-style
un-miss-able	un-miss-a-ble
hin-t	hint
syn-di-cal-is-m	syn-di-cal-ism
pe-riphrastic	per-i-phras-tic
coy-ote	coy-o-te
biotech-nol-o-gy	bi-o-tech-nol-o-gy
g-nat	gnat
medi-ocrity	me-di-oc-ri-ty
repast	re-past
op-tic-s	op-tics
suf-fi-cien-t	suf-fi-cient
pho-tore-cep-tor	pho-to-re-cep-tor
voca-tive	voc-a-tive
in-deli-bly	in-del-i-bly
v-ole	vole
stringy	string-y
sushi	su-shi
di-alec-t	di-a-lect
pageantry	pag-eant-ry
cle-f	clef
bank-able	bank-a-ble
cli-toris	clit-o-ris
e-h	eh
un-electable	un-e-lect-a-ble
un-der-achieve-men-t	un-der-a-chieve-ment
c-it-rus	cit-rus
ge-net-ic-s	ge-net-ics
buck-min-ster-fullerene	buck-min-ster-ful-ler-ene
un-re-peat-able	un-re-peat-a-ble
over-do	o-ver-do
vest-men-t	vest-ment
ketchup	ketch-up
coac-tion	co-ac-tion
hoary	hoar-y
crotch-ety	crotch-et-y
bug-gered	buggered
helper	help-er
courage	cour-age
c-itadel	cit-a-del
corkscrew	cork-screw
mas-sacre	mas-sa-cre
igloo	ig-loo
elec-tro-mo-tive	e-lec-tro-mo-tive
psy-choki-ne-sis	psy-cho-ki-ne-sis
lamp-lighter	lamp-light-er
smoky	smok-y
reti-nal	ret-i-nal
un-remit-ting	un-re-mit-ting
s-pear-head	spear-head
ap-palling-ly	ap-pall-ing-ly
im-per-fec-t	im-per-fect
s-words-man	swords-man
im-petu-ous	im-pet-u-ous
d-u-al	du-al
ha-giog-ra-phy	hag-i-og-ra-phy
op-por-tunis-tic	op-por-tun-is-tic
hazel	ha-zel
peremp-to-ry	per-emp-to-ry
rev-er-en-t	rev-er-ent
linkup	link-up
el-e-men-t	el-e-ment
s-cot	scot
ex-cerp-t	ex-cerpt
crum-b	crumb
colos-sal	co-los-sal
ravi-o-li	ra-vi-o-li
tal-en-t	tal-ent
petard	pe-tard
over-board	o-ver-board
comber	comb-er
cres-cen-t	cres-cent
u-nim-paired	un-im-paired
as-cen-dan-cy	as-cend-an-cy
suf-frag-ist	suf-fra-gist
sub-unit	sub-u-nit
un-palat-able	un-pal-at-a-ble
s-carci-ty	scar-ci-ty
carousel	car-ou-sel
gullible	gul-li-ble
hy-dropho-bic	hy-dro-pho-bic
apho-ris-m	aph-o-rism
recre-ation	rec-re-a-tion
cerise	ce-rise
heartache	heart-ache
im-ma-nen-t	im-ma-nent
chas-m	chasm
archetype	ar-che-type
mu-tan-t	mu-tant
timid-ly	tim-id-ly
lin-gerie	lin-ge-rie
cathar-tic	ca-thar-tic
turpi-tude	tur-pi-tude
di-rec-torate	di-rec-to-rate
un-in-hab-it-able	un-in-hab-it-a-ble
swarthy	swarth-y
un-so-licit-ed	un-so-lic-it-ed
macaque	ma-caque
demon-stra-tive	de-mon-stra-tive
cur-ran-t	cur-rant
ob-tain-able	ob-tain-a-ble
cathar-sis	ca-thar-sis
monothe-is-tic	mon-o-the-is-tic
domi-cile	dom-i-cile
lib-er-tar-i-an-is-m	lib-er-tar-i-an-ism
castof-f	cast-off
metic-u-lous-ly	me-tic-u-lous-ly
caiman	cai-man
pen-i-ten-tiary	pen-i-ten-tia-ry
oa-sis	o-a-sis
in-ter-jec-t	in-ter-ject
an-cien-t	an-cient
con-fronta-tion-al	con-fron-ta-tion-al
gaslight	gas-light
ex-trac-t	ex-tract
javelin	jave-lin
gala	ga-la
g-lycine	gly-cine
pathfind-er	path-find-er
reim-ple-ment-ed	reimplemented
unabridged	un-a-bridged
firmware	firm-ware
breast-feed	breastfeed
teenage	teen-age
e-n-ac-t	en-act
phys-iog-no-my	phys-i-og-no-my
pres-tidig-i-ta-tion	pres-ti-dig-i-ta-tion
con-sulate	con-su-late
d-if-fer-ent-ly	dif-fer-ent-ly
sym-bio-sis	sym-bi-o-sis
fer-men-t	fer-ment
apo-lit-i-cal	a-po-lit-i-cal
u-nadul-ter-at-ed	un-a-dul-ter-at-ed
es-calade	es-ca-lade
costar	co-star
lo-quac-ity	lo-quac-i-ty
break-away	break-a-way
im-pre-sari-o	im-pre-sa-ri-o
spir-i-tu-al-is-m	spir-it-u-al-ism
fusible	fu-si-ble
tute-lage	tu-te-lage
con-ser-va-tive	con-serv-a-tive
scrip-t	script
s-mat-ter-ing	smat-ter-ing
co-her-en-t	co-her-ent
trac-t	tract
s-melt-ing	smelting
c-on-cil-ia-tor	con-cil-i-a-tor
s-toke	stoke
bar-rack-s	bar-racks
so-cial-is-m	so-cial-ism
lazy	la-zy
isosce-les	i-sos-ce-les
ir-re-place-able	ir-re-place-a-ble
hon-our	ho-nour
d-e-ductible	de-duct-i-ble
freighter	freight-er
buf-fer	buff-er
comet	com-et
phi-lan-thropy	phi-lan-thro-py
re-gion-al-is-m	re-gion-al-ism
over-val-ue	o-ver-val-ue
qua-drat-ic	quad-rat-ic
kinky	kink-y
idyl-lic	i-dyl-lic
block-buster	block-bust-er
pearly	pearl-y
cor-re-spon-dence	cor-re-spond-ence
fool-hardy	fool-har-dy
dic-tio-n	dic-tion
reper-toire	rep-er-toire
saucepan	sauce-pan
leath-ery	leath-er-y
sus-tain-abil-i-ty	sus-tain-a-bil-i-ty
re-frig-er-an-t	re-frig-er-ant
in-stan-ta-neous	in-stan-ta-ne-ous
in-ces-t	in-cest
cy-clotron	cy-clo-tron
bio-ta	bi-o-ta
busker	busk-er
flood-ing	flooding
trackbed	track-bed
video-taped	videotaped
pu-ri-tanis-m	pu-ri-tan-ism
en-vi-ron-s	en-vi-rons
u-n-af-fect-ed	un-af-fect-ed
sub-con-ti-nen-t	sub-con-ti-nent
stealth-ily	stealth-i-ly
lender	lend-er
mis-man-age-men-t	mis-man-age-ment
artery	ar-ter-y
de-pen-den-cy	de-pend-en-cy
con-sti-tu-tion-al-is-m	con-sti-tu-tion-al-ism
rapid	rap-id
i-n-ap-pro-pri-ate-ly	in-ap-pro-pri-ate-ly
k-ib-butz	kib-butz
pe-ri-as-tron	per-i-as-tron
s-can-sion	scan-sion
bungee	bun-gee
brand-ed	bran-ded
bat-s	bats
iron-work	i-ron-work
heron	her-on
syn-ony-mous	syn-on-y-mous
con-sul-tan-cy	con-sult-an-cy
s-lan-der-ous	slan-der-ous
anon	a-non
s-cope	scope
motile	mo-tile
an-thracite	an-thra-cite
s-tomp-ing	stomp-ing
de-tach-men-t	de-tach-ment
wa-ter-fron-t	wa-ter-front
parochial-is-m	pa-ro-chi-al-ism
prob-a-bilis-tic	prob-a-bi-lis-tic
u-p-lift-ing	up-lift-ing
overt-ly	o-vert-ly
p-re-sentable	pre-sent-a-ble
sub-trop-ic-s	sub-trop-ics
u-n-apolo-get-ic	un-a-pol-o-get-ic
re-vival	re-viv-al
pogo	po-go
precinc-t	pre-cinct
feldspar	feld-spar
prophe-cy	proph-e-cy
good-s	goods
mayfly	may-fly
man-age-men-t	man-age-ment
cater	ca-ter
con-trast-ing	contrasting
de-scen-der	de-scend-er
ra-dioac-tiv-i-ty	ra-di-o-ac-tiv-i-ty
tractable	trac-ta-ble
speedy	speed-y
pow-dery	pow-der-y
loony	loon-y
re-li-ably	re-li-a-bly
con-sum-able	con-sum-a-ble
florist	flo-rist
brack-et-ed	bracketed
em-ploy-able	em-ploy-a-ble
dis-tinc-t	dis-tinct
draugh-t	draught
hel-l	hell
over-growth	o-ver-growth
dark-ened	dar-kened
s-plin-t	splint
lentil	len-til
prelate	prel-ate
s-tair-way	stair-way
su-per-fluity	su-per-flu-i-ty
ir-re-solv-able	ir-re-solv-a-ble
ap-pel-lan-t	ap-pel-lant
over-haul	o-ver-haul
in-vesti-ture	in-ves-ti-ture
mis-s	miss
over-com-pen-sate	o-ver-com-pen-sate
chivvy	chiv-vy
gas-troin-testi-nal	gas-tro-in-tes-ti-nal
dis-in-fec-tan-t	dis-in-fect-ant
pot-tery	pot-ter-y
im-agery	im-age-ry
reagen-t	re-a-gent
mer-curic	mer-cu-ric
cretin	cre-tin
l-o-gof-f	log-off
in-ten-t	in-tent
rein-ven-tion	re-in-ven-tion
carat	car-at
evil-do-er	e-vil-do-er
celiba-cy	cel-i-ba-cy
blood-thirsty	blood-thirst-y
phono-graph	pho-no-graph
i-n-or-di-nate	in-or-di-nate
par-don-able	par-don-a-ble
in-el-e-gan-t	in-el-e-gant
scholas-tic	scho-las-tic
s-mashed	smashed
e-quable	eq-ua-ble
per-ti-nen-t	per-ti-nent
jagged	jag-ged
de-bauch-ery	de-bauch-er-y
re-place-men-t	re-place-ment
preschool	pre-school
em-ploy-men-t	em-ploy-ment
mis-cel-lany	mis-cel-la-ny
aris-toc-ra-cy	ar-is-toc-ra-cy
het-ero-ge-neous	het-er-o-ge-ne-ous
cursed	curs-ed
pro-ject-ing	projecting
over-due	o-ver-due
valu-able	val-u-a-ble
residu-um	re-sid-u-um
in-con-testable	in-con-test-a-ble
hail-stor-m	hail-storm
pris-m	prism
chico-ry	chic-o-ry
s-plashy	splash-y
piv-otal	piv-ot-al
phooey	phoo-ey
pro-pi-onate	pro-pi-o-nate
s-nide	snide
s-pore	spore
cox-com-b	cox-comb
w-hole-saler	whole-sal-er
artiste	ar-tiste
en-large-men-t	en-large-ment
naughty	naugh-ty
blus-tery	blus-ter-y
re-sol-ven-t	re-sol-vent
nar-cis-sis-m	nar-cis-sism
peachy	peach-y
breathy	breath-y
u-n-aware	un-a-ware
su-per-abun-dan-t	su-per-a-bun-dant
bomb-shel-l	bomb-shell
treaty	trea-ty
gravy	gra-vy
s-nake	snake
trencher	trench-er
s-tair-case	stair-case
irony	i-ro-ny
polypropy-lene	pol-y-pro-pyl-ene
ca-reerist	ca-reer-ist
over-pro-duc-tion	o-ver-pro-duc-tion
gib-ber-ing	gibbering
triplex	tri-plex
opi-um	o-pi-um
pes-simist	pes-si-mist
erad-i-ca-tion	e-rad-i-ca-tion
trans-par-en-t	trans-par-ent
retest	re-test
il-lu-mi-nan-t	il-lu-mi-nant
potable	po-ta-ble
burly	bur-ly
emir	e-mir
dis-pos-able	dis-pos-a-ble
refuge	ref-uge
mock-ery	mock-er-y
pu-tres-cen-t	pu-tres-cent
dis-con-ti-nu-ity	dis-con-ti-nu-i-ty
cleanser	cleans-er
s-tock-room	stock-room
pael-la	pa-el-la
feath-erlight	feath-er-light
op-er-a-tional-ly	op-er-a-tion-al-ly
pos-i-tivis-m	pos-i-tiv-ism
briny	brin-y
avul-sion	a-vul-sion
s-tonework	stone-work
gu-nite	gun-ite
bowl-s	bowls
h-es-i-tan-t	hes-i-tant
civic	civ-ic
re-con-struc-t	re-con-struct
demo-crat-i-cal-ly	dem-o-crat-i-cal-ly
bari-tone	bar-i-tone
con-for-m	con-form
declam-a-to-ry	de-clam-a-to-ry
dis-moun-t	dis-mount
cashier	cash-ier
re-sult-ing	resulting
torus	to-rus
fever-ish	fe-ver-ish
risot-to	ri-sot-to
poly-mor-phic	pol-y-mor-phic
lager	la-ger
tri-bune	trib-une
in-vig-o-rate	in-vig-or-ate
tur-bocharg-er	tur-bo-charg-er
bion-ic-s	bi-on-ics
welder	weld-er
rachis	ra-chis
con-dem-n	con-demn
i-n-un-da-tion	in-un-da-tion
tonedeaf	tone-deaf
damni-fy	dam-ni-fy
retry	re-try
nonex-is-ten-t	non-ex-ist-ent
sen-hor	se-nhor
con-ti-nu-ity	con-ti-nu-i-ty
e-d-u-ca-tion-al-ly	ed-u-ca-tion-al-ly
seag-ul-l	sea-gull
s-can	scan
thun-der-stor-m	thun-der-storm
dusty	dust-y
kalei-do-scope	ka-lei-do-scope
bathrobe	bath-robe
s-lum-ber	slum-ber
tain-t	taint
re-for-esta-tion	re-for-est-a-tion
i-nan-i-mate	in-an-i-mate
diplo-mat-ic	dip-lo-mat-ic
tyran-ny	tyr-an-ny
sup-ple-men-t	sup-ple-ment
domi-cil-iary	dom-i-cil-i-ar-y
dodger	dodg-er
s-plurge	splurge
s-tate-hood	state-hood
re-ver-ber-an-t	re-ver-ber-ant
re-tal-ia-to-ry	re-tal-i-a-to-ry
re-place-able	re-place-a-ble
monar-chi-cal	mo-nar-chi-cal
corky	cork-y
chesty	chest-y
round-about	round-a-bout
chival-rous	chiv-al-rous
par-al-lelepiped	par-al-lel-e-pi-ped
sadis-tic	sa-dis-tic
ex-porta-bil-i-ty	ex-por-ta-bi-li-ty
con-stric-t	con-strict
com-mod-e	com-mode
elec-tro-car-dio-gram	e-lec-tro-car-di-o-gram
bedrag-gled	be-drag-gled
hearsay	hear-say
s-teep	steep
s-tac-ca-to	stac-ca-to
spir-i-tu-al-i-ty	spir-it-u-al-i-ty
celi-bate	cel-i-bate
m-nemon-ic	mne-mon-ic
un-mea-sur-able	un-meas-ur-a-ble
discog-ra-phy	dis-cog-ra-phy
con-duc-t	con-duct
bur-nished	burnished
sui-ci-dal	su-i-cid-al
ex-trater-res-tri-al	ex-tra-ter-res-tri-al
jazzy	jazz-y
tren-chant-ly	trench-ant-ly
de-caf-feinate	de-caf-fein-ate
s-pace	space
pres-bytery	pres-by-ter-y
lisp-ing	lis-ping
gen-uine-ly	gen-u-ine-ly
porter	por-ter
bather	bath-er
peep-s	peeps
un-al-ter-able	un-al-ter-a-ble
pep-pery	pep-per-y
dis-putable	dis-put-a-ble
per-i	pe-ri
dis-obey	dis-o-bey
gelatin	gel-a-tin
hy-per-tex-t	hy-per-text
rhodo-den-dron	rho-do-den-dron
hab-it-able	hab-it-a-ble
en-thralling	en-thral-ling
as-so-ciate	as-so-ci-ate
mar-ke-teer	mar-ket-eer
copy-ist	cop-y-ist
pro-bity	pro-bi-ty
species	spe-cies
colo-nial	co-lo-ni-al
f-reak	freak
bazooka	ba-zoo-ka
tho-raci-c	tho-rac-ic
paean	pae-an
duo-de-num	du-o-de-num
cir-cling	circling
s-pace-craft	space-craft
b-lessed	bless-ed
pe-rusal	pe-rus-al
brazen	bra-zen
bromine	bro-mine
im-pri-matur	im-pri-ma-tur
coast-ing	coasting
ridicu-lous	ri-dic-u-lous
de-ni-able	de-ni-a-ble
con-cep-t	con-cept
camper	camp-er
diesel	die-sel
cel-l	cell
rheumat-ic	rheu-mat-ic
in-vari-ably	in-var-i-a-bly
s-lug	slug
d-if-fi-dence	dif-fi-dence
veg-etable	veg-e-ta-ble
at-tain-men-t	at-tain-ment
e-m-a-na-tion	em-a-na-tion
s-corch	scorch
usurp-er	u-surp-er
e-clec-tic	ec-lec-tic
skater	skat-er
s-pade	spade
psy-chi-atric	psy-chi-at-ric
ex-cep-t	ex-cept
en-camp-men-t	en-camp-ment
com-ple-men-t	com-ple-ment
thrifty	thrift-y
grimy	grim-y
pony-tail	po-ny-tail
babysit-ter	ba-by-sit-ter
risky	risk-y
scrumhalf	scrum-half
s-tiff	stiff
s-corcher	scorch-er
lozenge	loz-enge
in-cor-rupt-ible	in-cor-rupt-i-ble
punchy	punch-y
crim-p	crimp
h-m-m	hmm
wrin-kled	wrinkled
he-li-copter	hel-i-cop-ter
lighter	light-er
dis-cour-tesy	dis-cour-te-sy
fuzzy	fuzz-y
y-oungish	young-ish
wave-for-m	wave-form
minute	mi-nute
hand-bil-l	hand-bill
loafer	loaf-er
winder	wind-er
ju-nior	jun-ior
spiky	spik-y
valen-tine	val-en-tine
promis-cu-ity	prom-is-cu-i-ty
flow-ery	flow-er-y
sabra	sa-bra
morass	mo-rass
de-co	dec-o
ghana	ghana
wigeon	wig-eon
s-trap-ping	strap-ping
s-i-nu-soid	si-nus-oid
detri-men-tal	det-ri-men-tal
hy-acinth	hy-a-cinth
fir-m	firm
para-nor-mal	par-a-nor-mal
car-cino-gen-e-sis	car-cin-o-gen-e-sis
za-p	zap
rosy	ros-y
physi-cian	phy-si-cian
tat-ter-s	tat-ters
k-ing-fish-er	king-fish-er
el-l	ell
pussy-cat	pussycat
tren-chan-t	trench-ant
deli	del-i
op-er-a-tional	op-er-a-tion-al
groundswell	ground-swell
hi-er-ar-ch	hi-er-arch
reap-pear	re-ap-pear
bistable	bi-sta-ble
bondage	bond-age
retic-u-lum	re-tic-u-lum
sealan-t	seal-ant
s-care	scare
s-trait-jack-et	strait-jack-et
te-dious	te-di-ous
tem-per-a-men-t	tem-per-a-ment
aquiline	aq-ui-line
de-ca-pod	dec-a-pod
rai-men-t	rai-ment
re-dun-dan-t	re-dun-dant
s-tu-pen-dous	stu-pen-dous
lectern	lec-tern
ethanol	eth-a-nol
prepara-to-ry	pre-par-a-to-ry
s-cores	scores
both-ered	bothered
delta	del-ta
s-plash-down	splash-down
modal	mod-al
unin-su-lat-ed	un-in-su-lat-ed
s-worn	sworn
seedbed	seed-bed
re-newed	renewed
nonen-ti-ty	non-en-ti-ty
any-how	an-y-how
graphite	graph-ite
grouchy	grouch-y
turfy	turf-y
b-e-fit	be-fit
event-ing	e-vent-ing
bubon-ic	bu-bon-ic
iri-des-cen-t	ir-i-des-cent
fi-deli-ty	fi-del-i-ty
gui-tarist	gui-tar-ist
trea-sure	treas-ure
vis-coun-t	vis-count
where-about-s	where-a-bouts
s-meg-ma	smeg-ma
gospel	gos-pel
dolomite	do-lo-mite
i-n-ac-cu-ra-cy	in-ac-cu-ra-cy
sali-va	sa-li-va
sub-jec-t	sub-ject
brouha-ha	brou-ha-ha
vari-abil-i-ty	var-i-a-bil-i-ty
em-place-men-t	em-place-ment
so-cio-cul-tur-al	so-ci-o-cul-tur-al
trigonom-e-try	trig-o-nom-e-try
van-dal-is-m	van-dal-ism
as-cen-dan-t	as-cend-ant
r-eread	re-read
courtier	cour-ti-er
pruri-en-t	pru-ri-ent
facet	fac-et
arise	a-rise
ready	read-y
jam-boree	jam-bo-ree
es-t	est
poly-no-mi-al	pol-y-no-mi-al
dis-abil-i-ty	dis-a-bil-i-ty
yel-l	yell
oper-a	o-pe-ra
mod-esty	mod-es-ty
prostaglandin	pros-ta-glan-din
delu-sive	de-lu-sive
avowed-ly	a-vow-ed-ly
catgut	cat-gut
s-neak-i-ly	sneak-i-ly
tusker	tusk-er
artis-tic	ar-tis-tic
bedrid-den	bed-rid-den
mil-ligram	mil-li-gram
gra-tu-itous-ly	gra-tu-i-tous-ly
ethos	e-thos
over-state-men-t	o-ver-state-ment
para-graph	par-a-graph
di-achron-ic	di-a-chron-ic
tremu-lous	trem-u-lous
protest	pro-test
kaolin	ka-o-lin
valiant	val-iant
rock-etry	rock-et-ry
tepid	tep-id
in-tra-venous-ly	in-tra-ve-nous-ly
pinafore	pin-a-fore
ir-re-proach-able	ir-re-proach-a-ble
charge-able	charge-a-ble
mil-i-tan-t	mil-i-tant
telepa-thy	te-lep-a-thy
sharply	sharp-ly
toughie	tough-ie
drea-r	drear
ga-lop	gal-op
s-pan-ner	span-ner
car-bonyl	car-bon-yl
reap-point	re-ap-point
m-is-fire	mis-fire
u-nas-sist-ed	un-as-sist-ed
relic-t	rel-ict
overindul-gence	o-ver-in-dul-gence
mis-ery	mis-er-y
mus-cle-d	mus-cled
manikin	man-i-kin
dis-plea-sure	dis-pleas-ure
s-teel-work	steel-work
even-tu-al	e-ven-tu-al
lino	li-no
iron-stone	i-ron-stone
sprayer	spray-er
teach-able	teach-a-ble
wind-surf-in-g	wind-surf-ing
pen-chan-t	pen-chant
plushy	plush-y
im-ple-menter	im-ple-ment-er
shel-l	shell
stere-o	ster-e-o
power-boat	pow-er-boat
hero-in	her-o-in
s-now-bal-l	snow-ball
e-ques-tri-an-is-m	e-ques-tri-an-ism
sec-t	sect
con-cor-dance	con-cord-ance
su-per-tanker	su-per-tank-er
ide-al-ist	i-de-al-ist
planter	plant-er
in-de-ter-minable	in-de-ter-mi-na-ble
sen-ti-men-tal-is-m	sen-ti-men-tal-ism
over-stretch	o-ver-stretch
mis-chievous	mis-chie-vous
over-ly	o-ver-ly
emet-ic	e-met-ic
s-lant-ed	slanted
per-hap-s	per-haps
clin-i-cian	cli-ni-cian
bil-l	bill
reshow	re-show
any-body	an-y-bod-y
bumper	bump-er
prom-is-sory	prom-is-so-ry
decile	dec-ile
crisply	crisp-ly
topol-o-gy	to-pol-o-gy
tremo-lo	trem-o-lo
in-com-men-su-rable	in-com-men-su-ra-ble
tremor	trem-or
t-ed	ted
c-on-cil-i-ate	con-cil-i-ate
myelin	my-e-lin
chrysan-the-mum	chry-san-the-mum
li-censee	li-cen-see
prebend	preb-end
dilu-en-t	dil-u-ent
ben-der	bend-er
horny	horn-y
im-pe-ri-al-is-m	im-pe-ri-al-ism
fifty	fif-ty
s-cud	scud
purview	pur-view
furtive	fur-tive
respire	re-spire
in-ter-preter	in-ter-pret-er
pi-quan-t	pi-quant
worsted	wor-sted
up-hol-stery	up-hol-ster-y
bean-ery	bean-er-y
trans-mo-gri-fy	trans-mog-ri-fy
clink-ing	clin-king
stuff-in-g	stuff-ing
lazi-ness	la-zi-ness
lega-tee	leg-a-tee
o-r-a-to-ri-o	or-a-to-ri-o
d-if-frac-tion	dif-frac-tion
poly-crys-talline	pol-y-crys-tal-line
en-chantress	en-chant-ress
milk-shake	milkshake
un-invit-ing	un-in-vit-ing
elu-ci-date	e-lu-ci-date
de-file-men-t	de-file-ment
masseuse	mas-seuse
recom-mence	re-com-mence
chi-huahua	chi-hua-hua
buildup	build-up
un-promis-ing	un-prom-is-ing
a-tol-l	at-oll
un-sea-son-ably	un-sea-son-a-bly
break-able	break-a-ble
bul-b	bulb
hellish	hell-ish
in-di-rec-t	in-di-rect
hauli-er	haul-ier
mirac-u-lous	mi-rac-u-lous
ne-glec-t	ne-glect
pul-monary	pul-mo-nar-y
u-nimag-i-na-tive	un-im-ag-i-na-tive
his-toric	his-tor-ic
un-drink-able	un-drink-a-ble
bil-iary	bil-i-ar-y
pa-tri-o-tism	pa-tri-ot-ism
mono-graph-ic	mon-o-graph-ic
en-dorse-men-t	en-dorse-ment
flus-tered	flustered
lumpy	lump-y
award	a-ward
shaver	shav-er
e-m-anate	em-a-nate
os-teopath	os-te-o-path
gneis-s	gneiss
c-it-i-zen-ship	cit-i-zen-ship
s-ta-men	sta-men
declar-a-tive	de-clar-a-tive
in-elas-tic	in-e-las-tic
cho-ris-ter	chor-is-ter
s-nore	snore
ar-ranger	ar-rang-er
cleanup	clean-up
s-trato-sphere	strat-o-sphere
dy-nasty	dy-nas-ty
buri-al	bur-i-al
pornog-ra-phy	por-nog-ra-phy
trans-plan-t	trans-plant
pro-tect-ed	protected
im-mutable	im-mu-ta-ble
urol-o-gist	u-rol-o-gist
curvy	curv-y
tri-adic	tri-ad-ic
pro-pa-gan-dis-t	prop-a-gan-dist
profli-ga-cy	prof-li-ga-cy
theta	the-ta
dowa-ger	dow-a-ger
baroque	ba-roque
de-odor-an-t	de-o-dor-ant
fein-t	feint
min-uet	min-u-et
pantry	pan-try
me-te-o-rol-o-gy	me-te-or-ol-o-gy
mis-t	mist
d-if-fer-en-tiable	dif-fer-en-ti-a-ble
s-neeze	sneeze
im-munoas-say	im-mu-no-as-say
homage	hom-age
con-struc-t	con-struct
siren	si-ren
s-tan-za	stan-za
muti-nous	mu-ti-nous
paci-fis-m	pac-i-fism
iso-topic	i-so-top-ic
ra-tio-nal-ly	ra-tion-al-ly
newsy	news-y
s-to-ry-telling	sto-ry-tell-ing
tulip	tu-lip
ki-mono	ki-mo-no
s-loth	sloth
glis-ten-ing	gli-ste-ning
rewritable	re-writ-a-ble
rarebit	rare-bit
de-tach-able	de-tach-a-ble
s-lan-t	slant
can-non-bal-l	can-non-ball
gazette	ga-zette
se-questered	se-ques-tered
owlish	owl-ish
beaver	bea-ver
whirlpool	whirl-pool
u-n-al-loyed	un-al-loyed
itin-er-an-t	i-tin-er-ant
coro-nary	cor-o-nar-y
s-ta-tis-tics	sta-tis-tics
ease-men-t	ease-ment
li-able	li-a-ble
marigold	mar-i-gold
con-sul-tan-t	con-sult-ant
d-if-fer-en-ti-a-tion	dif-fer-en-ti-a-tion
tick-et-ed	ticketed
perquisite	per-qui-site
stretchy	stretch-y
di-a-bolis-m	di-ab-o-lism
perdi-tion	per-di-tion
arachno-pho-bi-a	a-rach-no-pho-bi-a
s-louch-ing	slouching
s-can-dalous	scan-dal-ous
puz-zle-men-t	puz-zle-ment
rhubar-b	rhu-barb
sea-son-able	sea-son-a-ble
taxis	tax-is
florin	flor-in
s-tam-pede	stam-pede
s-carp	scarp
short-ter-m	short-term
fly-over	fly-o-ver
sus-pender-s	sus-pend-ers
shogun	sho-gun
mendele-vi-um	men-de-le-vi-um
fum-bling	fumbling
u-nim-por-tan-t	un-im-por-tant
reprise	re-prise
dipole	di-pole
s-cis-sors	scis-sors
lu-mi-nes-cen-t	lu-mi-nes-cent
Words with errors: 2282
Words with incorrect number of syllables: 2078
Total evluated: 6500
Perfect accuracy: 0.65
Number of syllables accuracy: 0.68
Average Levenshtein Distance(across incorrect words): 1.22
