Attempt	Real
gad-getry	gadg-et-ry
neon	ne-on
dimin-u-en-do	di-min-u-en-do
k-er-nel	ker-nel
re-pro-cess	re-proc-ess
fetishist	fet-ish-ist
s-cis-sors	scis-sors
bodice	bod-ice
quadri-par-tite	quad-ri-par-tite
s-tock-tak-ing	stock-tak-ing
frivol	friv-ol
s-tu-pe-fy	stu-pe-fy
porter-age	por-ter-age
chronome-ter	chro-nom-e-ter
desert	de-sert
im-mov-able	im-mov-a-ble
elec-tron-ic	e-lec-tron-ic
tremu-lous	trem-u-lous
cir-cum-spec-t	cir-cum-spect
over-due	o-ver-due
s-ta-tis-ti-cal	sta-tis-ti-cal
s-tock	stock
s-pank-ing	spank-ing
deco-rum	de-co-rum
s-carce	scarce
y-acht	yacht
car-avel	car-a-vel
bedrid-den	bed-rid-den
wolfhound	wolf-hound
lemur	le-mur
lama	la-ma
bomb-shel-l	bomb-shell
ar-madil-lo	ar-ma-dil-lo
em-broi-dery	em-broi-der-y
en-trench-men-t	en-trench-ment
s-nap	snap
s-tub-by	stub-by
deco-rous	dec-o-rous
idio-syn-crasy	id-i-o-syn-cra-sy
quadru-ply	quad-ru-ply
d-if-fer-en-ti-ate	dif-fer-en-ti-ate
prostaglandin	pros-ta-glan-din
un-sup-port-able	un-sup-port-a-ble
coun-ter-in-tu-itive	coun-ter-in-tu-i-tive
sub-sidy	sub-si-dy
ed-itable	ed-it-a-ble
spir-i-tu-al-ly	spir-it-u-al-ly
plunger	plung-er
taran-tu-la	ta-ran-tu-la
cere-bel-lum	cer-e-bel-lum
in-audi-ble	in-au-di-ble
shekel	shek-el
emet-ic	e-met-ic
un-com-fort-able	un-com-fort-a-ble
bungee	bun-gee
dis-tinc-t	dis-tinct
trac-t	tract
raspy	rasp-y
op-t	opt
repack-age	re-pack-age
coastal	coast-al
hye-na	hy-e-na
byprod-uc-t	by-prod-uct
dol-drum-s	dol-drums
fem-i-nis-m	fem-i-nism
caprice	ca-price
bazaar	ba-zaar
macro-cos-m	mac-ro-cosm
per-fidy	per-fi-dy
parish	par-ish
tribu-la-tion	trib-u-la-tion
stuff-in-g	stuff-ing
hellish	hell-ish
rack-e-teer-ing	rack-et-eer-ing
volatile	vol-a-tile
postage	post-age
s-cuf-f	scuff
fri-ary	fri-ar-y
s-culp-tress	sculp-tress
ovoid	o-void
nico-tine	nic-o-tine
s-cat-ter	scat-ter
un-wrap-s	un-wraps
over-lap	o-ver-lap
s-tock-ist	stock-ist
drea-r	drear
in-su-lan-t	in-su-lant
penal-ty	pen-al-ty
wary	war-y
c-og-nizan-t	cog-ni-zant
im-pa-tien-t	im-pa-tient
cagey	cag-ey
plebiscite	pleb-i-scite
thaw-ing	thawing
un-touch-able	un-touch-a-ble
over-lie	o-ver-lie
kine-mat-ic-s	kin-e-mat-ics
moun-taineer-ing	moun-tain-eer-ing
post-mod-ernist	post-mod-ern-ist
me-te-o-rol-o-gy	me-te-or-ol-o-gy
erup-tive	e-rup-tive
tape-wor-m	tape-worm
unin-sur-able	un-in-sur-a-ble
aviary	a-vi-ar-y
missal	mis-sal
di-atom-ic	di-a-tom-ic
overeat	o-ver-eat
crenel-la-tion-s	cren-el-la-tions
in-di-vid-u-al-is-m	in-di-vid-u-al-ism
cre-ative-ly	cre-a-tive-ly
g-narled	gnarled
racy	rac-y
un-frozen	un-fro-zen
con-fi-den-tial-i-ty	con-fi-den-ti-al-i-ty
ev-ery	eve-ry
skua	sku-a
tril-l	trill
unswerv-ing	un-swerv-ing
petrol-o-gy	pe-trol-o-gy
u-n-adapt-ed	un-a-dapt-ed
hand-picked	handpicked
ban-knote	bank-note
vari-cose	var-i-cose
y-achts-man	yachts-man
emit-ter	e-mit-ter
skir-mish-ing	skirmishing
forest-ed	forested
dis-am-biguate	dis-am-big-u-ate
gua-camole	gua-ca-mo-le
con-fron-t	con-front
macaw	ma-caw
shoplift-ing	shop-lift-ing
ovu-la-tion	ov-u-la-tion
bio-chemist	bi-o-chem-ist
s-tat-uette	stat-u-ette
un-in-tel-li-gen-t	un-in-tel-li-gent
bi-car-bon-ate	bi-car-bo-nate
com-mis-sari-at	com-mis-sar-i-at
avoid-ance	a-void-ance
blur-b	blurb
res-cuer	res-cu-er
in-stan-ta-neous-ly	in-stan-ta-ne-ous-ly
ate-lier	at-el-ier
ren-t	rent
over-draw	o-ver-draw
sug-ary	sug-ar-y
un-fash-ion-able	un-fash-ion-a-ble
vacu-ity	va-cu-i-ty
poly-he-dron	pol-y-he-dron
prophet	proph-et
vial	vi-al
sabra	sa-bra
masochist	mas-och-ist
timetable	time-ta-ble
i-n-ac-ti-va-tion	in-ac-ti-va-tion
in-sup-port-able	in-sup-port-a-ble
fel-l	fell
mono-chrome	mon-o-chrome
in-dica-tive	in-dic-a-tive
ques-tion-able	ques-tion-a-ble
gaudy	gaud-y
de-mo-graph-ic-s	dem-o-graph-ics
s-core	score
hab-er-dash-ery	hab-er-dash-er-y
weed-s	weeds
in-valu-able	in-val-u-a-ble
physic-s	phys-ics
repast	re-past
hal-ibut	hal-i-but
mantra	man-tra
per-tur-b	per-turb
s-trag-gle	strag-gle
ap-pease-men-t	ap-pease-ment
at-tribu-tive	at-trib-u-tive
out-ward-s	out-wards
plain-t	plaint
far-away	far-a-way
re-deemable	re-deem-a-ble
soupy	soup-y
cham-pi-onship	cham-pi-on-ship
read-mis-sion	re-ad-mis-sion
frailty	frail-ty
elec-tro-mo-tive	e-lec-tro-mo-tive
erec-tion	e-rec-tion
fundrais-ing	fund-rais-ing
con-ti-nen-t	con-ti-nent
parental	pa-ren-tal
im-pro-visato-ry	im-pro-vi-sa-to-ry
busi-nesslike	busi-ness-like
ibis	i-bis
u-n-ap-pre-cia-tive	un-ap-pre-ci-a-tive
legume	leg-ume
elec-tron	e-lec-tron
as-besto-sis	as-bes-to-sis
forester	for-est-er
around	a-round
squalid	squal-id
or-tho-doxy	or-tho-dox-y
transcon-ti-nen-tal	trans-con-ti-nen-tal
apol-o-gy	a-pol-o-gy
re-assess	re-as-sess
ure-thane	u-re-thane
re-stroom	rest-room
peren-ni-al-ly	per-en-ni-al-ly
mis-coun-t	mis-count
egress	e-gress
in-ter-preter	in-ter-pret-er
s-ta-tionery	sta-tion-er-y
un-sea-son-able	un-sea-son-a-ble
un-sol-d	un-sold
com-plaisan-t	com-plai-sant
s-tormy	storm-y
dis-ci-plinary	dis-ci-pli-nar-y
mater	ma-ter
repack	re-pack
s-todge	stodge
felo-nious	fe-lo-ni-ous
in-cur-able	in-cur-a-ble
k-lax-on	klax-on
id-io-path-ic	id-i-o-path-ic
for-man-t	for-mant
cou-turi-er	cou-tu-ri-er
dis-cor-dan-t	dis-cord-ant
hon-orif-ic	hon-or-if-ic
for-get-table	for-get-ta-ble
tweedy	tweed-y
s-tand-point	stand-point
bad-minton	bad-min-ton
lilac	li-lac
s-tar-tling	star-tling
syn-onym	syn-o-nym
courtship	court-ship
in-ex-tin-guish-able	in-ex-tin-guish-a-ble
hookah	hook-ah
col-lapsi-ble	col-laps-i-ble
naval	na-val
bean-ery	bean-er-y
un-sur-pass-able	un-sur-pass-a-ble
volt-meter	volt-me-ter
mas-cara	mas-car-a
blankly	blank-ly
aqualung	aq-ua-lung
over-es-ti-mate	o-ver-es-ti-mate
mag-ne-to-hy-dro-dy-nam-ic-s	mag-ne-to-hy-dro-dy-nam-ics
carafe	ca-rafe
leg-isla-tive	leg-is-la-tive
salien-t	sa-li-ent
fu-ner-ary	fu-ner-ar-y
dere-lic-tion	der-e-lic-tion
poseur	po-seur
s-tance	stance
i-conog-ra-phy	i-co-nog-ra-phy
in-dic-t	in-dict
or-biter	or-bit-er
heresy	her-e-sy
au-thor-i-tar-i-an-is-m	au-thor-i-tar-i-an-ism
wafer	wa-fer
es-calade	es-ca-lade
re-al-ness	real-ness
spon-sored	sponsored
hip-popota-mus	hip-po-pot-a-mus
melan-cho-li-a	mel-an-cho-li-a
wel-com-ing	wel-co-ming
recla-ma-tion	rec-la-ma-tion
deu-teri-um	deu-te-ri-um
arch-dio-cese	arch-di-o-cese
ge-neti-cist	ge-net-i-cist
corvette	cor-vette
en-fee-bled	enfeebled
s-low-ness	slow-ness
duo	du-o
sym-bion-t	sym-bi-ont
lentil	len-til
in-di-can-t	in-di-cant
bul-l	bull
erased	e-rased
seis-mome-ter	seis-mom-e-ter
clover	clo-ver
costar	co-star
sonata	so-na-ta
pes-simis-m	pes-si-mism
pipette	pi-pette
antwer-p	antwerp
s-in-u-ous	sin-u-ous
frosty	frost-y
quintessen-tial-ly	quin-tes-sen-tial-ly
lozenge	loz-enge
cy-berspace	cy-ber-space
opac-i-ty	o-pac-i-ty
fran-chisee	fran-chi-see
duchy	duch-y
s-tave	stave
collinear	col-lin-e-ar
dodgem	dodg-em
spunky	spunk-y
chim-p	chimp
duf-f	duff
frilly	frill-y
d-if-fer-ing	differing
hangar	hang-ar
mod-ernism	mod-ern-ism
dis-si-den-t	dis-si-dent
causal-ly	caus-al-ly
el-l	ell
por-traitist	por-trait-ist
brushy	brush-y
oakum	oa-kum
s-tokes	stokes
irid-i-um	i-rid-i-um
ethic-s	eth-ics
propin-quity	pro-pin-qui-ty
ep-ithe-lial	ep-i-the-li-al
i-nat-ten-tive	in-at-ten-tive
morale	mo-rale
colonic	co-lon-ic
fash-ion-ably	fash-ion-a-bly
restive	res-tive
s-ingly	sin-gly
pleas-antry	pleas-ant-ry
beanstalk	bean-stalk
wind-surfer	wind-surf-er
para-psy-chol-o-gy	par-a-psy-chol-o-gy
oily	oil-y
s-teeple-chase	stee-ple-chase
prodi-gal	prod-i-gal
spir-i-tu-al-is-m	spir-it-u-al-ism
s-nub	snub
paramour	par-a-mour
de-ca-pod	dec-a-pod
s-trato-sphere	strat-o-sphere
unchris-tian	un-chris-tian
ap-praisal	ap-prais-al
bio-engi-neer-ing	bi-o-en-gi-neer-ing
ditch-ing	ditching
s-to-chas-tic	sto-chas-tic
vine-gar	vin-e-gar
syl-labary	syl-la-bar-y
schema	sche-ma
but-tery	but-ter-y
enig-ma	e-nig-ma
s-ketchy	sketch-y
con-stituen-t	con-stit-u-ent
s-cores	scores
drom-e-dary	drom-e-dar-y
get-away	get-a-way
shal-l	shall
s-tate-hood	state-hood
pizze-ri-a	piz-ze-ri-a
re-li-able	re-li-a-ble
boron	bo-ron
cleaver	cleav-er
haughty	haugh-ty
s-porran	spor-ran
s-ly-ly	sly-ly
un-record-ed	un-re-cord-ed
alar-m	a-larm
glacier	gla-cier
potable	po-ta-ble
u-nat-tend-ed	un-at-tend-ed
p-re-sentable	pre-sent-a-ble
gym-nas-tic-s	gym-nas-tics
jour-nalese	jour-nal-ese
mi-crodot	mi-cro-dot
clank-ing	clan-king
d-e-duc-tive	de-duc-tive
salmon	salm-on
aro-mat-ic	ar-o-mat-ic
iso-late	i-so-late
t-elecom-mut-ing	te-le-com-mu-ting
howdy	how-dy
repa-tri-a-tion	re-pa-tri-a-tion
cur-tail-men-t	cur-tail-ment
any-body	an-y-bod-y
specif-i-cal-ly	spe-cif-i-cal-ly
en-dear-men-t	en-dear-ment
delu-sion-al	de-lu-sion-al
s-lay-er	slay-er
arm-s	arms
un-elect-ed	un-e-lect-ed
curvy	curv-y
wilder-ness	wil-der-ness
per-ti-nen-t	per-ti-nent
fundrais-er	fund-rais-er
puz-zle-men-t	puz-zle-ment
ther-mome-ter	ther-mom-e-ter
graphite	graph-ite
un-re-pairable	un-re-pair-a-ble
s-ling-shot	sling-shot
roast-ed	roasted
jiffy	jif-fy
con-cor-dan-t	con-cord-ant
vinyl	vi-nyl
de-rail-men-t	de-rail-ment
con-sum-able	con-sum-a-ble
weapon	weap-on
in-equity	in-eq-ui-ty
rounder-s	round-ers
avenge	a-venge
con-ge-nial	con-gen-ial
samu-rai	sam-u-rai
du-op-oly	du-op-o-ly
ne-go-tiable	ne-go-ti-a-ble
pelvic	pel-vic
iso-lat-ed	i-so-lat-ed
au-tonomous-ly	au-ton-o-mous-ly
grid-iron	grid-i-ron
s-cant-y	scant-y
ir-ra-tional	ir-ra-tion-al
cheery	cheer-y
record-ing	re-cord-ing
rose-mary	rose-mar-y
holdup	hold-up
wun-derkind	wun-der-kind
s-pam	spam
boa	bo-a
based	based
bar-bar-ian	bar-bar-i-an
per-mafrost	per-ma-frost
killjoy	kill-joy
d-ing	ding
pe-trel	pet-rel
odor-ous	o-dor-ous
eleven	e-lev-en
o-h	oh
avi-a-tor	a-vi-a-tor
tuner	tun-er
rudi-men-ta-ry	ru-di-men-ta-ry
bear-able	bear-a-ble
overqual-i-fied	o-ver-qual-i-fied
tripoli	trip-o-li
k-i-lo	ki-lo
scrupu-lous-ly	scru-pu-lous-ly
d-if-fract	dif-fract
tes-ta-men-t	tes-ta-ment
s-api-en-t	sa-pi-ent
chapel	chap-el
s-nig-ger-ing	sniggering
quartzite	quartz-ite
beefy	beef-y
re-liv-e	re-live
di-nosaur	di-no-saur
asyn-chro-nous	a-syn-chro-nous
podgy	podg-y
cam-panile	cam-pa-ni-le
can-dlelit	can-dle-lit
i-n-ac-cu-rate	in-ac-cu-rate
money-len-der	mon-ey-lend-er
mis-shapen	mis-shap-en
glan-s	glans
un-re-pen-tan-t	un-re-pent-ant
monau-ral	mon-au-ral
en-ter-tain-men-t	en-ter-tain-ment
s-toop	stoop
febrile	fe-brile
hostler	hos-tler
s-traight	straight
m-is-fire	mis-fire
sandy	sand-y
colo-nial-ist	co-lo-ni-al-ist
il-menite	il-men-ite
tri-den-t	tri-dent
resur-gen-t	re-sur-gent
gaga	ga-ga
male-fac-tor	mal-e-fac-tor
i-a-tro-genic	i-at-ro-gen-ic
trusty	trust-y
penin-su-lar	pen-in-su-lar
swar-m	swarm
doc-tor-ing	doctoring
s-lash-ing	slash-ing
over-anx-ious	o-ver-anx-ious
rainy	rain-y
stin-t	stint
squea-mish	squeam-ish
s-pa	spa
apex	a-pex
owlet	owl-et
chalet	cha-let
un-govern-able	un-gov-ern-a-ble
feath-ery	feath-er-y
cashew	cash-ew
prepo-si-tion-al	prep-o-si-tion-al
g-lyph	glyph
with-ered	withered
enig-mat-ic	en-ig-mat-ic
over-print	o-ver-print
phy-loge-ny	phy-log-e-ny
paragon	par-a-gon
gamy	gam-y
firmware	firm-ware
stron-tium	stron-ti-um
largo	lar-go
ef-ful-gen-t	ef-ful-gent
sub-servien-t	sub-ser-vi-ent
moth-er-stobe	mo-ther-stobe
swinger	swing-er
ex-oskele-ton	ex-o-skel-e-ton
manome-ter	ma-nom-e-ter
con-san-guineous	con-san-guin-e-ous
s-nook-er	snook-er
mat-te	matte
sa-tanis-m	sa-tan-ism
ev-ery-thing	eve-ry-thing
va-sec-to-my	vas-ec-to-my
s-cud	scud
her-aldry	her-ald-ry
mossy	mos-sy
n-er-vous	nerv-ous
mi-cro-surgery	mi-cro-sur-ger-y
im-per-turbable	im-per-turb-a-ble
condi-men-t	con-di-ment
h-es-i-tan-cy	hes-i-tan-cy
arable	ar-a-ble
vulpine	vul-pine
motile	mo-tile
vicar	vic-ar
flota-tion	flo-ta-tion
de-ser-ti-fi-ca-tion	de-sert-i-fi-ca-tion
cologne	co-logne
over-tone	o-ver-tone
s-tar-board	star-board
s-lop-py	slop-py
pinafore	pin-a-fore
cara-cal	car-a-cal
bizarre	bi-zarre
ef-fron-tery	ef-fron-ter-y
san-i-tary	san-i-tar-y
forte	for-te
cun-nilin-gus	cun-ni-lin-gus
ne-ma-tode	nem-a-tode
t-inc-ture	tinc-ture
in-fini-tive	in-fin-i-tive
buf-fer	buff-er
dandy	dan-dy
o-ver-seer	o-ver-se-er
a-pogee	ap-o-gee
mag-ne-si-a	mag-ne-sia
viper	vi-per
stipend	sti-pend
shaven	shav-en
para-keet	par-a-keet
re-de-ploy-men-t	re-de-ploy-ment
over-com-pen-sate	o-ver-com-pen-sate
gra-tu-itous	gra-tu-i-tous
elfin	elf-in
epi-graph	ep-i-graph
detox	de-tox
dis-heart-en-ing	dis-hear-te-ning
privy	priv-y
g-ly-col	gly-col
welling-ton	wel-ling-ton
growler	growl-er
bene-dic-tion	ben-e-dic-tion
as-trologer	as-trol-o-ger
gra-tu-ity	gra-tu-i-ty
in-nard-s	in-nards
po-ten-tial-i-ty	po-ten-ti-al-i-ty
trans-ceiver	trans-ceiv-er
re-mis-s	re-miss
mis-con-duc-t	mis-con-duct
pre-his-toric	pre-his-tor-ic
ide-ol-o-gy	i-de-ol-o-gy
ema-ci-at-ed	e-ma-ci-at-ed
un-scrupu-lous	un-scru-pu-lous
frozen	fro-zen
steadi-ness	stead-i-ness
oblit-er-a-tion	ob-lit-er-a-tion
saucy	sau-cy
mod-e	mode
open	o-pen
dumper	dump-er
cyanide	cy-a-nide
recre-ation	rec-re-a-tion
idea	i-de-a
em-bed-dable	em-bed-da-ble
essence	es-sence
bio-chem-istry	bi-o-chem-is-try
d-e-fi-cien-cy	de-fi-cien-cy
crock-ery	crock-er-y
shiv-er-ing	shivering
in-cisor	in-ci-sor
tar-if-f	tar-iff
stinky	stink-y
er-ran-t	er-rant
con-tractible	con-tract-i-ble
cowherd	cow-herd
in-trepid	in-trep-id
gen-eros-i-ty	gen-er-os-i-ty
po-et-ic-s	po-et-ics
recog-ni-tion	rec-og-ni-tion
un-der-ar-m	un-der-arm
b-less	bless
foible	foi-ble
a-tol-l	at-oll
prospec-t	pros-pect
hu-man-is-m	hu-man-ism
land-for-m	land-form
im-prov-i-den-t	im-prov-i-dent
labi-um	la-bi-um
aque-ous	a-que-ous
re-flec-t	re-flect
prof-itably	prof-it-a-bly
dy-namis-m	dy-na-mism
miniskirt	min-i-skirt
prover-bial	pro-ver-bi-al
tox-i-c-i-ty	tox-ic-i-ty
manor	man-or
i-n-ac-ces-si-ble	in-ac-ces-si-ble
longevi-ty	lon-gev-i-ty
n-ev-er-the-less	nev-er-the-less
out-landish	out-land-ish
wastage	wast-age
rec-om-mend-ed	recommended
cheeky	cheek-y
mo-lester	mo-lest-er
rege-late	re-ge-late
reroutes	re-routes
del-i-catessen	del-i-ca-tes-sen
ephemeris	e-phem-er-is
om-nibus	om-ni-bus
ca-cao	ca-ca-o
ethanol	eth-a-nol
no-table	no-ta-ble
facet	fac-et
dor-man-t	dor-mant
demigod	dem-i-god
u-nar-tic-u-lat-ed	un-ar-tic-u-lat-ed
s-ta-tor	sta-tor
fragili-ty	fra-gil-i-ty
drifter	drift-er
moody	mood-y
brigade	bri-gade
in-ge-nious	in-gen-ious
in-dif-fer-en-t	in-dif-fer-ent
in-con-ve-nien-t	in-con-ven-ient
melo-dra-mat-ic	mel-o-dra-mat-ic
ri-ot-ing	ri-o-ting
baleen	ba-leen
in-ex-pe-di-en-t	in-ex-pe-di-ent
seda-tive	sed-a-tive
break-away	break-a-way
res-onate	res-o-nate
elec-tro	e-lec-tro
re-con-struc-t	re-con-struct
over-throw	o-ver-throw
con-sulate	con-su-late
gatepost	gate-post
there-upon	there-up-on
open-er	o-pen-er
odi-um	o-di-um
melee	me-lee
coura-geous	cou-ra-geous
lega-tion	le-ga-tion
plaza	pla-za
ir-repara-ble	ir-rep-a-ra-ble
maudlin	maud-lin
som-brero	som-bre-ro
jokey	jok-ey
table-ware	ta-ble-ware
repli-ca-ble	rep-li-ca-ble
seal-ing	sealing
in-sec-t	in-sect
worsted	wor-sted
glin-t	glint
un-fet-tered	unfettered
kriegspiel	krieg-spiel
in-fras-truc-tural	in-fra-struc-tur-al
un-quench-able	un-quench-a-ble
mit-t	mitt
down-fal-l	down-fall
trac-ery	trac-er-y
i-ambic	i-am-bic
n-in-com-poop	nin-com-poop
ran-corous	ran-cor-ous
trace-able	trace-a-ble
dis-ori-en-ta-tion	dis-o-ri-en-ta-tion
hal-lelu-jah	hal-le-lu-jah
cav-ernous	cav-ern-ous
ex-trav-a-gan-t	ex-trav-a-gant
tin-t	tint
lit-er-al-is-m	lit-er-al-ism
trans-fer-able	trans-fer-a-ble
ma-joli-ca	ma-jol-i-ca
japon-i-ca	ja-pon-i-ca
epis-temic	ep-i-ste-mic
sacro-sanc-t	sac-ro-sanct
dyad	dy-ad
ir-re-sistible	ir-re-sist-i-ble
biotech-nol-o-gy	bi-o-tech-nol-o-gy
babysit-ter	ba-by-sit-ter
liqueur	li-queur
ga-lop	gal-op
de-liv-ery	de-liv-er-y
se-quencer	se-quenc-er
imag-in-able	im-ag-i-na-ble
dozen	doz-en
s-trate-gi-cal-ly	stra-te-gi-cal-ly
un-abat-ed	un-a-bat-ed
polyester	pol-y-es-ter
suc-cum-b	suc-cumb
over-hand	o-ver-hand
odor-if-er-ous	o-dor-if-er-ous
cyan	cy-an
sagac-i-ty	sa-gac-i-ty
n-ervy	nerv-y
pub-lished	published
kril-l	krill
tele-tex-t	tel-e-text
symp-to-matic	symp-to-mat-ic
s-to-ic	sto-ic
fiz-z	fizz
parch-men-t	parch-ment
com-pen-dium	com-pen-di-um
e-choic	e-cho-ic
s-tran-gles	stran-gles
enu-mer-a-tor	e-nu-mer-a-tor
shipown-er	ship-own-er
my-opic	my-op-ic
elec-tri-cal	e-lec-tri-cal
hi-ero-glyph	hi-er-o-glyph
un-in-for-ma-tive	un-in-form-a-tive
s-tormer	storm-er
de-con-struc-tive	deconstructive
lan-der	land-er
dila-tor	di-la-tor
car-rion	car-ri-on
s-cant-i-ness	scant-i-ness
canon-ic	ca-non-ic
heifer	heif-er
sex-tan-t	sex-tant
cine	cin-e
re-splen-den-t	re-splend-ent
pyra-mid	pyr-a-mid
s-cab-bard	scab-bard
castof-f	cast-off
tacho-graph	tach-o-graph
docile	doc-ile
syn-ovial	syn-o-vi-al
mit-i-gat-ing	mitigating
meta-physic-s	met-a-phys-ics
im-paction	im-pac-tion
chop-s	chops
prom-is-sory	prom-is-so-ry
facile	fac-ile
drift-ing	drif-ting
aza-lea	a-zal-ea
s-tu-por	stu-por
an-nul-men-t	an-nul-ment
ini-tial-ly	in-i-tial-ly
aque-duc-t	aq-ue-duct
com-man-dan-t	com-man-dant
taxis	tax-is
re-al-is-m	re-al-ism
mis-chievous	mis-chie-vous
mock-ery	mock-er-y
mort-gagor	mort-ga-gor
im-mi-nen-t	im-mi-nent
hi-ero-glyph-ic	hi-er-o-glyph-ic
de-scen-der	de-scend-er
prepar-a-tive	pre-par-a-tive
calo-rie	cal-o-rie
ex-pres-sion-is-m	ex-pres-sion-ism
s-trait-ened	strait-ened
servile	ser-vile
tribesman	tribes-man
s-worn	sworn
py-rotech-nic-s	py-ro-tech-nics
solem-ni-ty	so-lem-ni-ty
non-pay-men-t	non-pay-ment
s-tim-u-lan-t	stim-u-lant
unglam-orous	un-glam-or-ous
s-teel	steel
pres-ti-gious	pres-tig-ious
stealthy	stealth-y
d-eficit	def-i-cit
t-elecom-mu-ni-ca-tion	tel-e-com-mu-ni-ca-tion
s-trate-gist	strat-e-gist
s-trand-ed	strand-ed
thyris-tor	thy-ris-tor
s-tub-born-ness	stub-born-ness
menswear	mens-wear
dis-claimer	dis-claim-er
re-luc-tan-t	re-luc-tant
sleazy	slea-zy
pre-dict-ed	predicted
restora-tion	res-to-ra-tion
arum	ar-um
phil-an-thropic	phil-an-throp-ic
pony-tail	po-ny-tail
atom-ic-i-ty	at-o-mic-i-ty
stew-ardess	stew-ard-ess
s-cope	scope
k-ing-ly	king-ly
s-tarfish	star-fish
col-lo-qui-al-is-m	col-lo-qui-al-ism
curie	cu-rie
giblet-s	gib-lets
in-sipid	in-sip-id
goa-tee	goat-ee
sacral	sa-cral
af-fec-t	af-fect
show-ery	show-er-y
de-spon-den-cy	de-spond-en-cy
asi-nine	as-i-nine
paramed-i-cal	par-a-med-i-cal
hi-jack-ing	hi-jac-king
helper	help-er
grad-u-al-is-m	grad-u-al-ism
un-trace-able	un-trace-a-ble
rea-son-ably	rea-son-a-bly
lyri-cal	lyr-i-cal
pol-lard-ed	pollarded
archer	arch-er
k-itchen-ware	kitch-en-ware
mis-di-rec-t	mis-di-rect
ledger	ledg-er
s-light-ly	slight-ly
treaty	trea-ty
s-plen-did-ly	splen-did-ly
re-con-nec-t	re-con-nect
brew-ery	brew-er-y
s-lan-der	slan-der
hobo	ho-bo
mus-cle-d	mus-cled
synapse	syn-apse
con-tigu-ous	con-tig-u-ous
c-on-cil-i-a-tion	con-cil-i-a-tion
penury	pen-u-ry
blus-ter-ing	blustering
hero-ical-ly	he-ro-i-cal-ly
para-mil-i-tary	par-a-mil-i-tar-y
un-fore-see-able	un-fore-see-a-ble
stylish-ly	styl-ish-ly
s-pank	spank
s-tu-den-t	stu-dent
for-cep-s	for-ceps
re-trench-men-t	re-trench-ment
reti-na	ret-i-na
coinage	coin-age
dis-con-nec-t	dis-con-nect
re-sent-men-t	re-sent-ment
pa-ter-nal-is-m	pa-ter-nal-ism
supreme	su-preme
rhetor-i-cal	rhe-tor-i-cal
fuz-z	fuzz
s-low	slow
artery	ar-ter-y
con-scrip-t	con-script
epi-taph	ep-i-taph
xenon	xe-non
s-peak-er	speak-er
louis	lou-is
homi-cide	hom-i-cide
rheumat-ic-s	rheu-mat-ics
decor	de-cor
samovar	sam-o-var
callable	call-a-ble
holler	hol-ler
s-car	scar
celiba-cy	cel-i-ba-cy
libero	li-be-ro
moldy	mold-y
dis-cre-tionary	dis-cre-tion-ar-y
s-traight-for-ward-ly	straight-for-ward-ly
pom-p	pomp
mar-itime	mar-i-time
s-naky	snak-y
un-us-able	un-us-a-ble
poly-cyclic	pol-y-cy-clic
punch-line	punchline
baronet	bar-on-et
bereft	be-reft
painstak-ing	pains-tak-ing
ca-cophonous	ca-coph-o-nous
cathe-dral	ca-the-dral
per-me-able	per-me-a-ble
con-veyance	con-vey-ance
tele-pho-to	tel-e-pho-to
over-charge	o-ver-charge
about	a-bout
s-tat-uesque	stat-u-esque
bour-geoisie	bour-geoi-sie
over-ground	o-ver-ground
i-n-ap-pro-pri-ate	in-ap-pro-pri-ate
fetish	fet-ish
litho-sphere	lith-o-sphere
sup-ple-men-tary	sup-ple-men-ta-ry
thril-l	thrill
er-bium	er-bi-um
con-ven-t	con-vent
filmic	film-ic
mar-moset	mar-mo-set
im-moral-i-ty	im-mo-ral-i-ty
reaper	reap-er
com-press-ibil-i-ty	com-pres-si-bil-i-ty
in-quisi-to-ri-al	in-quis-i-to-ri-al
okapi	o-ka-pi
tablet	tab-let
ex-pi-ra-to-ry	ex-pir-a-to-ry
mis-aligned	mis-a-ligned
s-esame	ses-a-me
con-form-able	con-form-a-ble
despot-ic	des-pot-ic
po-litesse	pol-i-tesse
sup-ple-men-t	sup-ple-ment
planter	plant-er
thievish	thiev-ish
ovum	o-vum
s-coot	scoot
entab-la-ture	en-tab-la-ture
epi-gram	ep-i-gram
schemer	schem-er
s-tu-dious	stu-di-ous
cle-f	clef
reprisal	re-pris-al
mi-di	mid-i
su-per-posed	superposed
minute	mi-nute
painful	pain-ful
mi-cro-com-put-er	mi-cro-com-pu-ter
b-lis-ter	blis-ter
s-cant-i-ly	scant-i-ly
builder	build-er
s-plin-t	splint
itchy	itch-y
el-e-men-t	el-e-ment
k-loof	kloof
subto-tal	sub-to-tal
break-able	break-a-ble
fein-t	feint
tiller	till-er
mis-nomer	mis-no-mer
un-invit-ing	un-in-vit-ing
ob-jec-tion-able	ob-jec-tion-a-ble
over-laden	o-ver-lad-en
chrysan-the-mum	chry-san-the-mum
friendlily	friend-li-ly
de-port-men-t	de-port-ment
tiny	ti-ny
methanol	meth-a-nol
ru-inous	ru-in-ous
stony	ston-y
de-tainee	de-tain-ee
prophe-cy	proph-e-cy
cretinous	cre-tin-ous
ten-t	tent
modal-i-ty	mo-dal-i-ty
s-car-i-ly	scar-i-ly
e-quidis-tan-t	e-qui-dis-tant
vir-u-len-t	vir-u-lent
hawthorn	haw-thorn
cru-ci-for-m	cru-ci-form
hy-draulic	hy-drau-lic
im-per-ti-nen-t	im-per-ti-nent
chaffinch	chaf-finch
tick-et-ed	ticketed
taskmas-ter	task-mas-ter
biomass	bi-o-mass
anx-i-ety	anx-i-e-ty
un-ob-ser-van-t	un-ob-serv-ant
pho-net-ic-s	pho-net-ics
op-ti-misti-cal-ly	op-ti-mis-ti-cal-ly
aro-mather-a-py	a-ro-ma-ther-a-py
nonex-is-tence	non-ex-ist-ence
com-pelling	com-pel-ling
rock-etry	rock-et-ry
p-salmody	psal-mo-dy
over-flow-ing	o-ver-flo-wing
trace-abil-i-ty	trace-a-bil-i-ty
s-culp-tural	sculp-tur-al
deeply	deep-ly
peri-patet-ic	per-i-pa-tet-ic
army	ar-my
cur-ricu-lum	cur-ric-u-lum
un-em-ploy-men-t	un-em-ploy-ment
some-body	some-bod-y
astray	a-stray
colobus	col-o-bus
dy-namo	dy-na-mo
pot-tery	pot-ter-y
baron	bar-on
com-ple-men-t	com-ple-ment
cougar	cou-gar
dis-cotheque	dis-co-theque
lusti-ly	lust-i-ly
i-n-un-date	in-un-date
apolo-get-i-cal-ly	a-pol-o-get-i-cal-ly
panoram-ic	pan-o-ram-ic
nymp-holep-sy	nym-pho-lep-sy
s-hear-wa-ter	shear-wa-ter
su-per-fluity	su-per-flu-i-ty
leg-endary	leg-end-ar-y
ge-o-mag-net-i-cal-ly	ge-o-mag-ne-ti-cal-ly
s-lob-ber	slob-ber
renter	rent-er
fac-t	fact
omis-sion	o-mis-sion
re-cruiter	re-cruit-er
pussy	pus-sy
s-lope	slope
rem-nan-t	rem-nant
tem-po-rar-ily	tem-po-rar-i-ly
over-drive	o-ver-drive
op-er-a-tional-ly	op-er-a-tion-al-ly
dishy	dish-y
re-portage	re-port-age
cin-e-matog-ra-phy	cin-e-ma-tog-ra-phy
trans-porter	trans-port-er
decade	dec-ade
fortress	for-tress
taxi-der-mist	tax-i-der-mist
any-more	an-y-more
gleam-ing	gleaming
killer	kil-ler
sus-tain-able	sus-tain-a-ble
calorif-ic	cal-o-rif-ic
falset-to	fal-set-to
can-tilevered	cantilevered
flesh-pot-s	flesh-pots
re-versed	reversed
m-nemon-ic-s	mne-mon-ics
lever-age	lev-er-age
per-i	pe-ri
desul-to-ry	des-ul-to-ry
con-fronta-tion-al	con-fron-ta-tion-al
meanie	mean-ie
cross-over	cross-o-ver
over-lay	o-ver-lay
dis-rep-utable	dis-rep-u-ta-ble
cre-ation-ist	cre-a-tion-ist
s-ports-wear	sports-wear
s-ap-per	sap-per
hy-dropho-bic	hy-dro-pho-bic
t-ed	ted
va-can-t	va-cant
gam-bling	gam-bling
mini-cab	min-i-cab
workspace	work-space
ap-plica-tive	ap-pli-ca-tive
pecan	pe-can
mayflow-er	may-flow-er
ruf-f	ruff
dis-abuse	dis-a-buse
punc-til-ious	punc-til-i-ous
rapid-ly	rap-id-ly
hasti-ly	hast-i-ly
s-tu-dious-ly	stu-di-ous-ly
s-tool	stool
s-cant	scant
s-lip-ping	slipping
her-i-tabil-i-ty	her-it-a-bil-i-ty
dairy-man	dair-y-man
pinkie	pink-ie
tele-vised	televised
can-nery	can-ner-y
s-targaze	star-gaze
in-deli-bly	in-del-i-bly
demo-crat-i-cal-ly	dem-o-crat-i-cal-ly
polyandry	pol-y-an-dry
d-if-fer-en-tial-ly	dif-fer-en-tial-ly
pheas-an-t	pheas-ant
bat-tery	bat-ter-y
em-ploy-able	em-ploy-a-ble
e-s-planade	es-pla-nade
eli-sion	e-li-sion
s-cur-rilous	scur-ril-ous
ho-mo-mor-phis-m	ho-mo-mor-phism
ho-mo-gene-ity	ho-mo-ge-ne-i-ty
s-tri-at-ed	stri-at-ed
taxi-cab	tax-i-cab
d-inghy	din-ghy
pro-tease	pro-te-ase
au-topi-lot	au-to-pi-lot
polo-ni-um	po-lo-ni-um
rap-t	rapt
en-durable	en-dur-a-ble
un-der-study	un-der-stud-y
sub-jec-tivis-m	sub-jec-tiv-ism
crum-bling	crumbling
u-n-ac-cept-ably	un-ac-cept-a-bly
porky	pork-y
weightlift-ing	weight-lift-ing
dis-ar-ma-men-t	dis-ar-ma-ment
un-even-ly	un-e-ven-ly
de-for-mi-ty	de-form-i-ty
di-aphrag-mat-ic	di-a-phrag-mat-ic
pro-boscis	pro-bos-cis
lachry-mal	lach-ry-mal
panties	pant-ies
ship-builder	ship-build-er
dan-de-lion	dan-de-li-on
nurs-ery-man	nurs-er-y-man
dele-tion	de-le-tion
beanie	bean-ie
monogamy	mo-nog-a-my
flagon	flag-on
hindquar-ter-s	hind-quar-ters
a-p-a-thet-ic	ap-a-thet-ic
mi-crocode	mi-cro-code
con-traindi-ca-tion	con-tra-in-di-ca-tion
respire	re-spire
con-struc-tivist	con-struc-tiv-ist
frisky	frisk-y
harem	har-em
ir-ri-tabil-i-ty	ir-ri-ta-bil-i-ty
megas-tar	meg-a-star
physi-cist	phys-i-cist
surfer	surf-er
rant-ing	ranting
gen-tri-fied	gentrified
con-troller	con-trol-ler
elu-ci-date	e-lu-ci-date
unin-su-lat-ed	un-in-su-lat-ed
d-if-fer-en-t	dif-fer-ent
frown-ing	frowning
out-cal-l	out-call
slav-ery	slav-er-y
en-chant-ed	enchanted
velour	ve-lour
gan-glion	gan-gli-on
delin-quen-cy	de-lin-quen-cy
ure-a	u-re-a
brava-do	bra-va-do
miser-ly	mi-ser-ly
murky	murk-y
be-twix-t	be-twixt
evo-lute	ev-o-lute
feath-erlight	feath-er-light
poky	pok-y
theoc-ra-cy	the-oc-ra-cy
cursed	curs-ed
punky	punk-y
triplex	tri-plex
ede-ma	e-de-ma
dis-ar-m	dis-arm
s-ludge	sludge
s-lur-p	slurp
skintight	skin-tight
sur-re-al-is-m	sur-re-al-ism
u-n-awak-ened	un-a-wak-ened
molyb-de-num	mo-lyb-de-num
s-coff	scoff
c-it-i-zen-ship	cit-i-zen-ship
gal-axy	gal-ax-y
pro-tec-torate	pro-tec-tor-ate
sonar	so-nar
ret-i-cen-t	ret-i-cent
in-ter-roga-tor	in-ter-ro-ga-tor
co-conut	co-co-nut
e-s-pouse	es-pouse
give-away	give-a-way
m-i-lieu	mi-lieu
ante	an-te
barom-e-ter	ba-rom-e-ter
rasper	rasp-er
rea-son-able	rea-son-a-ble
prophet-ess	proph-et-ess
in-spi-ra-tional	in-spi-ra-tion-al
con-stric-t	con-strict
mul-ti-me-ter	mul-tim-e-ter
u-nim-ped-ed	un-im-ped-ed
elo-quence	el-o-quence
wreck-ing	wrecking
epi-dem-ic	ep-i-dem-ic
s-lang	slang
dis-abil-i-ty	dis-a-bil-i-ty
un-re-served-ly	un-re-serv-ed-ly
ide-al	i-de-al
backchat	back-chat
measly	mea-sly
elec-tri-cian	e-lec-tri-cian
tan-nery	tan-ner-y
brand-ing	branding
coun-ter-rev-o-lu-tion-ary	coun-ter-rev-o-lu-tion-ar-y
s-trange-ly	strange-ly
dia-lec-tic	di-a-lec-tic
messy	mess-y
twilit	twi-lit
s-nooze	snooze
ar-ranger	ar-rang-er
yippee	yip-pee
hoary	hoar-y
en-v-i-ron	en-vi-ron
hy-drangea	hy-dran-gea
herbal	herb-al
polygamy	po-lyg-a-my
in-so-len-t	in-so-lent
ma-lig-nan-t	ma-lig-nant
viewfind-er	view-find-er
knel-l	knell
vac-uole	vac-u-ole
diskette	disk-ette
mono-mi-al	mo-no-mi-al
heart-en-ing	heartening
lava-to-ri-al	lav-a-to-ri-al
iron-ing	i-ron-ing
s-tun-ning-ly	stun-ning-ly
harpist-s	har-pists
in-de-ter-minable	in-de-ter-mi-na-ble
in-quisi-tor	in-quis-i-tor
id-iomat-ic	id-i-o-mat-ic
lay-of-f	lay-off
spillage	spill-age
moral-is-m	mor-al-ism
promis-cu-ity	prom-is-cu-i-ty
an-ti-body	an-ti-bod-y
lu-mi-nes-cen-t	lu-mi-nes-cent
refuge	ref-uge
meta-mor-pho-sis	met-a-mor-pho-sis
moral-ly	mor-al-ly
dis-putable	dis-put-a-ble
coven	cov-en
char-cu-terie	char-cu-te-rie
re-vival-is-m	re-viv-al-ism
ram-shackle	ram-shack-le
reap-point	re-ap-point
pli-er-s	pli-ers
de-trac-t	de-tract
porno-graph-ic	por-no-graph-ic
leav-ened	leavened
os-tracis-m	os-tra-cism
apoc-a-lypse	a-poc-a-lypse
roughshod	rough-shod
s-ta-tion-er	sta-tion-er
trea-sur-er	treas-ur-er
monoc-u-lar	mo-noc-u-lar
s-lushy	slush-y
y-acht-ing	yacht-ing
di-vider	di-vid-er
di-aphanous	di-aph-a-nous
sea-son-able	sea-son-a-ble
s-pat-ter	spat-ter
heartache	heart-ache
beaker	beak-er
topaz	to-paz
cor-re-spon-den-t	cor-re-spond-ent
clif-f	cliff
mega-lo-ma-ni-a	meg-a-lo-ma-ni-a
mini-bar	min-i-bar
s-corch	scorch
siphon	si-phon
neu-ronal	neu-ron-al
gullible	gul-li-ble
demon-stra-tion	dem-on-stra-tion
catalep-sy	cat-a-lep-sy
melan-choly	mel-an-chol-y
who-dunit	who-dun-it
psy-choso-cial	psy-cho-so-cial
e-ti-quette	et-i-quette
cra-nial	cra-ni-al
mi-crosec-ond	mi-cro-sec-ond
armpit	arm-pit
ap-pendage	ap-pend-age
whar-f	wharf
char-i-o-teer	char-i-ot-eer
catgut	cat-gut
over-pow-er-ing	o-ver-pow-er-ing
bes-tiary	bes-ti-ar-y
pumice	pum-ice
or-bital	or-bit-al
s-cat	scat
asym-met-ri-cal	a-sym-met-ri-cal
cater	ca-ter
jeal-ousy	jeal-ous-y
car-roty	car-rot-y
tute-lary	tu-te-lar-y
reval-ue	re-val-ue
re-len-t	re-lent
radar	ra-dar
s-cab	scab
d-win-dling	dwindling
out-skirt-s	out-skirts
un-stop-pable	un-stop-pa-ble
vex-ing	vexing
causal-i-ty	cau-sal-i-ty
ex-tinc-t	ex-tinct
s-cat-tered	scattered
blood-thirsty	blood-thirst-y
elec-tro-car-dio-gram	e-lec-tro-car-di-o-gram
ex-ult-ing	exulting
monotony	mo-not-o-ny
ex-pect-ed	expected
s-trat-e-gy	strat-e-gy
pharao-h	phar-aoh
gawky	gawk-y
si-lencer	si-lenc-er
l-it-i-gan-t	lit-i-gant
b-otanist	bot-a-nist
strug-gling	struggling
in-de-pen-dence	in-de-pend-ence
dis-playable	displayable
par-lia-men-t	par-lia-ment
mono-lith	mon-o-lith
i-nat-ten-tion	in-at-ten-tion
ex-pend-able	ex-pend-a-ble
ex-plana-to-ry	ex-plan-a-to-ry
ni-hilist	ni-hil-ist
beefeater	beef-eat-er
share-able	share-a-ble
as-para-gus	as-par-a-gus
b-liss-ful-ly	bliss-ful-ly
anom-aly	a-nom-a-ly
scruf-f	scruff
ful-mi-nan-t	ful-mi-nant
aqua-naut	aq-ua-naut
detox-i-fy	de-tox-i-fy
lithi-um	lith-i-um
changeover	change-o-ver
im-munol-o-gy	im-mu-nol-o-gy
lega-tee	leg-a-tee
archdea-con	arch-dea-con
her-mitage	her-mit-age
silage	si-lage
enor-mi-ty	e-nor-mi-ty
sier-ra	si-er-ra
ca-nary	ca-nar-y
ca-su-istry	cas-u-ist-ry
whiskey	whis-key
elec-tor	e-lec-tor
hatch-ery	hatch-er-y
labi-al	la-bi-al
c-ity	cit-y
de-cam-p	de-camp
mi-ni	min-i
war-m	warm
ru-ined	ruined
blue-bel-l	blue-bell
joey	jo-ey
obe-di-ent-ly	o-be-di-ent-ly
d-is-fran-chise	dis-fran-chise
mul-ti-cul-tur-al-is-m	mul-ti-cul-tur-al-ism
flick-er-ing	flickering
repet-i-tive	re-pet-i-tive
wind-mil-l	wind-mill
v-enue	ven-ue
os-teopa-thy	os-te-op-a-thy
dea-coness	dea-con-ess
re-tini-tis	ret-i-ni-tis
crys-talline	crys-tal-line
aven-s	av-ens
de-tectably	de-tect-a-bly
palatal	pal-a-tal
s-now-drift	snow-drift
mono-lith-ic	mon-o-lith-ic
clavi-chord	clav-i-chord
stealth-ily	stealth-i-ly
dis-pos-able	dis-pos-a-ble
pin-bal-l	pin-ball
avi-a-tion	a-vi-a-tion
limou-sine	lim-ou-sine
poly-merase	pol-y-mer-ase
un-con-scionable	un-con-scion-a-ble
serai	se-ra-i
wrestler	wres-tler
b-land-ly	bland-ly
playfel-low	play-fel-low
gin-sen-g	gin-seng
bluesy	blues-y
anon	a-non
dumb-bel-l	dumb-bell
rel-a-tivis-tic	rel-a-tiv-is-tic
va-ri-ety	va-ri-e-ty
tu-atara	tu-a-ta-ra
pass-able	pass-a-ble
pussy-cat	pussycat
hardy	har-dy
driv-able	driv-a-ble
s-trag-gly	strag-gly
den-t	dent
chore-a	cho-re-a
metas-ta-sis	me-tas-ta-sis
s-parkle	spar-kle
opi-ate	o-pi-ate
ma-tri-lin-eal	mat-ri-lin-e-al
s-tami-na	stam-i-na
jel-l	jell
s-lur-ry	slur-ry
tit-ter-ing	tittering
in-tox-i-can-t	in-tox-i-cant
ex-is-ten-tial-is-m	ex-is-ten-tial-ism
bo-som	bos-om
anony-mous	a-non-y-mous
per-cep-t	per-cept
fraud-u-len-t	fraud-u-lent
mis-align-men-t	mis-a-lign-ment
gaiter	gait-er
s-lip-per	slip-per
s-pat-u-la	spat-u-la
carpal	car-pal
pres-tidig-i-ta-tion	pres-ti-dig-i-ta-tion
s-tork	stork
join-t	joint
un-steady	un-stead-y
foghorn	fog-horn
van-dal-is-m	van-dal-ism
eerie	ee-rie
medal	med-al
sa-far-i	sa-fa-ri
so-cialite	so-cial-ite
in-ex-orably	in-ex-o-ra-bly
sub-con-ti-nen-t	sub-con-ti-nent
sum-mon-s	sum-mons
s-tunt-ed	stunted
k-ib-butz	kib-butz
even-tu-al-ly	e-ven-tu-al-ly
in-dul-gen-t	in-dul-gent
cus-tomer	cus-tom-er
mankind	man-kind
oop-s	oops
stri-den-t	stri-dent
com-pe-ten-t	com-pe-tent
nasal	na-sal
hon-our	ho-nour
hy-drome-chan-ic-s	hy-dro-me-chan-ics
nu-tri-en-t	nu-tri-ent
pon-tif-f	pon-tiff
s-plash	splash
s-now-fal-l	snow-fall
cat-a-clysmic	cat-a-clys-mic
healthi-ly	health-i-ly
thrifty	thrift-y
de-ter-gen-t	de-ter-gent
bearskin	bear-skin
sloven-ly	slov-en-ly
epi-demi-ol-o-gy	ep-i-de-mi-ol-o-gy
feal-ty	fe-al-ty
clayey	clay-ey
ir-re-solv-able	ir-re-solv-a-ble
de-po-nen-t	de-po-nent
elec-tro-cute	e-lec-tro-cute
dairy-ing	dair-y-ing
dis-place-men-t	dis-place-ment
re-union	re-un-ion
cheesy	chees-y
dis-rup-t	dis-rupt
s-corn	scorn
ho-minid	hom-i-nid
harshen	harsh-en
pyra-mi-dal	py-ram-i-dal
axle	ax-le
re-arrange-ment	re-ar-range-ment
di-rec-torate	di-rec-to-rate
as-siduity	as-si-du-i-ty
drink-able	drink-a-ble
fid-gety	fidg-et-y
s-plash-down	splash-down
quo-tien-t	quo-tient
in-de-clin-able	in-de-clin-a-ble
mio-sis	mi-o-sis
bal-cony	bal-co-ny
potash	pot-ash
gal-vanome-ter	gal-va-nom-e-ter
stat-ic-s	stat-ics
rep-til-ian	rep-til-i-an
com-menter	com-ment-er
pro-pri-ety	pro-pri-e-ty
s-e-lectee	se-lect-ee
pe-riphrastic	per-i-phras-tic
nar-cis-sis-m	nar-cis-sism
chromite	chro-mite
phleg-m	phlegm
pyrite	py-rite
d-if-fer-ent-ly	dif-fer-ent-ly
coter-mi-nous	co-ter-mi-nous
con-trol-lable	con-trol-la-ble
mistyp-ings	mis-ty-pings
biop-sy	bi-op-sy
i-n-ad-ver-tent-ly	in-ad-vert-ent-ly
over-ripe	o-ver-ripe
dis-cred-itable	dis-cred-it-a-ble
steadi-ly	stead-i-ly
lamp-lighter	lamp-light-er
es-capis-m	es-cap-ism
com-mis-sioned	commissioned
unso-cial	un-so-cial
s-tur-geon	stur-geon
trashy	trash-y
he-li-copter	hel-i-cop-ter
omi-nous-ly	om-i-nous-ly
y-our	your
ab-sen-t	ab-sent
crus-tacean	crus-ta-cean
tasty	tast-y
trans-for-ma-tive	trans-form-a-tive
con-fronta-tion	con-fron-ta-tion
nightwear	night-wear
un-sellable	un-sell-a-ble
caramel	car-a-mel
no-tice-able	no-tice-a-ble
rain-stor-m	rain-storm
rata-touille	ra-ta-touille
in-er-ti-a	in-er-tia
com-plain-t	com-plaint
fatu-ous	fat-u-ous
d-is-fig-ure-men-t	dis-fig-ure-ment
good-s	goods
astrad-dle	a-strad-dle
over-feed	o-ver-feed
astig-ma-tism	a-stig-ma-tism
l-itur-gi-cal	li-tur-gi-cal
en-force-able	en-force-a-ble
ob-se-quious	ob-se-qui-ous
vi-o-l	vi-ol
antonym	an-to-nym
teleg-ra-phy	te-leg-ra-phy
s-tranger	stran-ger
uned-i-fy-ing	un-ed-i-fy-ing
pro-gram-mable	pro-gram-ma-ble
halon	hal-on
deriva-tion	der-i-va-tion
elu-ci-da-tion	e-lu-ci-da-tion
dis-agree-men-t	dis-a-gree-ment
me-te-orite	me-te-or-ite
mis-t	mist
s-coop	scoop
pewter	pew-ter
sander	sand-er
swarm-ing	swarming
wind-surf-in-g	wind-surf-ing
s-tore-house	store-house
s-plit	split
re-pro-ducibil-i-ty	re-pro-duc-i-bil-i-ty
vir-tu-oso	vir-tu-o-so
leak-ing	leaking
scream-ing	screaming
tetra-he-dron	tet-ra-he-dron
ex-tend-able	ex-tend-a-ble
het-ero-sex-u-al-i-ty	het-er-o-sex-u-al-i-ty
waspish	wasp-ish
siren	si-ren
squadron	squad-ron
mono-lin-gual	mon-o-lin-gual
toluene	tol-u-ene
over-win-ter	o-ver-win-ter
gestalt	ge-stalt
thug-gery	thug-ger-y
loathing	loath-ing
in-n	inn
b-i-fur-ca-tion	bi-fur-ca-tion
re-bury	re-bur-y
li-able	li-a-ble
u-ni-tary	u-ni-tar-y
u-nas-suaged	un-as-suaged
opin-ion	o-pin-ion
iris	i-ris
nest-ing	nesting
p-re-sen-ta-tion	pres-en-ta-tion
blaster	blast-er
epi-gram-mat-ic	ep-i-gram-mat-ic
ap-palling-ly	ap-pall-ing-ly
om-nipresen-t	om-ni-pres-ent
car-bona-ceous	car-bo-na-ceous
boule-vard	boul-e-vard
coro-ner	cor-o-ner
afraid	a-fraid
cal-l	call
re-uni-fi-ca-tion	re-u-ni-fi-ca-tion
back-wood-s	back-woods
legged	leg-ged
leaky	leak-y
shoplift	shop-lift
penul-ti-mate	pe-nul-ti-mate
kelvin	kel-vin
daisy	dai-sy
com-mit-men-t	com-mit-ment
wealthy	wealth-y
look-ing	looking
cheer-ing	cheering
bar-barous	bar-ba-rous
s-parse-ly	sparse-ly
swarthy	swarth-y
ceme-tery	cem-e-ter-y
brainy	brain-y
alive	a-live
prof-itabil-i-ty	prof-it-a-bil-i-ty
crozi-er	cro-zier
domi-no	dom-i-no
reap-pear-ance	re-ap-pear-ance
en-rich-men-t	en-rich-ment
chrono-graph	chron-o-graph
bar-bi-e	bar-bie
or-nithol-o-gist	or-ni-thol-o-gist
howler	howl-er
glaciat-ed	gla-ci-at-ed
in-cum-ben-t	in-cum-bent
ghana	ghana
depre-da-tion	dep-re-da-tion
ter-ror-is-m	ter-ror-ism
fool-ery	fool-er-y
s-lug-gard	slug-gard
manda-to-ry	man-da-to-ry
mistle-toe	mis-tle-toe
ev-ery-one	eve-ry-one
pheromone	pher-o-mone
caveat	ca-ve-at
ap-pari-tion	ap-pa-ri-tion
seg-ment-ed	seg-men-ted
forego	fore-go
wa-terbed	wa-ter-bed
re-pug-nan-t	re-pug-nant
e-voca-tive	e-voc-a-tive
phy-lac-tery	phy-lac-ter-y
ide-al-is-m	i-de-al-ism
in-co-her-en-t	in-co-her-ent
cobalt	co-balt
tangy	tang-y
cope-d	coped
ir-re-mov-able	ir-re-mov-a-ble
pa-troness	pa-tron-ess
gra-tu-itous-ly	gra-tu-i-tous-ly
k-it	kit
de-spi-ca-ble	des-pi-ca-ble
s-pas-tic	spas-tic
smoky	smok-y
met-ric-s	met-rics
in-ter-lock-ing	in-ter-loc-king
in-nu-mer-able	in-nu-mer-a-ble
s-pan-ner	span-ner
maisonette	mai-son-ette
as-cer-tain-men-t	as-cer-tain-ment
s-neak-i-ly	sneak-i-ly
in-ter-men-t	in-ter-ment
ac-coun-t	ac-count
re-spectable	re-spect-a-ble
curlew	cur-lew
mar-ke-teer	mar-ket-eer
satchel	satch-el
mildewy	mil-dew-y
pirou-ette	pir-ou-ette
mar-ketable	mar-ket-a-ble
ten-an-t	ten-ant
milord	mi-lord
ef-fer-ves-cen-t	ef-fer-ves-cent
in-de-cen-t	in-de-cent
minute-ly	mi-nute-ly
n-ear-by	near-by
strudel	stru-del
pro-pa-gan-dis-t	prop-a-gan-dist
n-od-ule	nod-ule
in-ter-cep-t	in-ter-cept
mag-netism	mag-net-ism
foxy	fox-y
fermion	fer-mi-on
for-syth-ia	for-syth-i-a
metronome	met-ro-nome
machi-na-tion	mach-i-na-tion
rhetoric	rhet-o-ric
famine	fam-ine
derelic-t	der-e-lict
un-der-body	un-der-bod-y
here-inafter	here-in-af-ter
g-lut-tony	glut-ton-y
catarrh	ca-tarrh
awestruc-k	awe-struck
ac-cep-t	ac-cept
s-tark	stark
neg-ligee	neg-li-gee
s-ta-tion	sta-tion
ax-e	axe
purview	pur-view
sober-ing	sobering
s-tumpy	stump-y
de-noue-men-t	de-noue-ment
be-trothal	be-troth-al
s-cale	scale
capri-ole	cap-ri-ole
budgeri-gar	budg-er-i-gar
cari-bou	car-i-bou
re-pen-t	re-pent
leath-ery	leath-er-y
repli-ca	rep-li-ca
g-lut-tonous	glut-ton-ous
con-tention	con-ten-tion
he-liotrope	he-li-o-trope
pseudony-mous	pseu-don-y-mous
topo-log-i-cal	top-o-log-i-cal
polon-aise	pol-o-naise
ethno-graph-ic	eth-no-graph-ic
lugubri-ous	lu-gu-bri-ous
s-tran-gle-hold	stran-gle-hold
lep-rechaun	lep-re-chaun
damni-fy	dam-ni-fy
dis-turbing-ly	dis-turb-ing-ly
witch-ery	witch-er-y
walkover	walk-o-ver
over-spill	o-ver-spill
s-lime	slime
skele-ton	skel-e-ton
ob-scu-ran-tism	ob-scu-rant-ism
overt	o-vert
sideshow	side-show
su-per-fi-cial-i-ty	su-per-fi-ci-al-i-ty
s-tar-tled	star-tled
ev-i-den-t	ev-i-dent
reprise	re-prise
protest	pro-test
re-alpoli-tik	re-al-po-li-tik
fel-la-tio	fel-la-ti-o
cagoule	ca-goule
t-in-foil	tin-foil
s-lake	slake
brassiere	bras-siere
hy-per-boloid	hy-per-bo-loid
cough-ing	coughing
de-sali-na-tion	de-sal-i-na-tion
hypochon-dri-a	hy-po-chon-dri-a
emul-sion	e-mul-sion
triplet	tri-plet
telekine-sis	tel-e-ki-ne-sis
crier	cri-er
seedling	seed-ling
record-ed	re-cor-ded
car-borun-dum	car-bo-run-dum
s-culp-tor	sculp-tor
retic-u-lat-ed	re-tic-u-lat-ed
discog-ra-phy	dis-cog-ra-phy
d-weller	dwell-er
patho-log-i-cal-ly	path-o-log-i-cal-ly
cata-ton-ic	cat-a-ton-ic
awhile	a-while
barony	bar-o-ny
s-laugh-ter-house	slaugh-ter-house
s-luice	sluice
re-cal-ci-tran-t	re-cal-ci-trant
pen-t	pent
er-gonomic-s	er-go-nom-ics
graphol-o-gy	graph-ol-o-gy
laugh-ably	laugh-a-bly
func-tion-al-is-m	func-tion-al-ism
s-tim-u-lus	stim-u-lus
ex-pec-t	ex-pect
s-port	sport
dis-abled	dis-a-bled
chili	chil-i
tremen-dous	tre-men-dous
graph-ic-s	graph-ics
undis-cov-ered	un-dis-cov-ered
prompter	prompt-er
beloved	be-lov-ed
pauci-ty	pau-ci-ty
e-u-phemistic	eu-phe-mis-tic
menis-cus	me-nis-cus
copy-right	cop-y-right
cupo-la	cu-po-la
seascape	sea-scape
lighter	light-er
de-gauss-ing	degaussing
sub-jec-t	sub-ject
geno-cide	gen-o-cide
au-gury	au-gu-ry
lemon-ade	lem-on-ade
reap-ply	re-ap-ply
dis-re-spec-t	dis-re-spect
nether	neth-er
s-lab	slab
bom-bard-men-t	bom-bard-ment
pun-gen-t	pun-gent
auger	au-ger
pastis	pas-tis
re-im-burse-men-t	re-im-burse-ment
ini-tia-tor	in-i-ti-a-tor
tun-able	tun-a-ble
charis-ma	cha-ris-ma
bal-alai-ka	bal-a-lai-ka
re-align-men-t	re-a-lign-ment
diplo-mat	dip-lo-mat
un-du-lat-ing	un-du-la-ting
di-gestible	di-gest-i-ble
over-shad-ow	o-ver-shad-ow
in-de-ci-pher-able	in-de-ci-pher-a-ble
usu-al-ly	u-su-al-ly
propen-si-ty	pro-pen-si-ty
vari-ate	var-i-ate
de-plorable	de-plor-a-ble
dis-en-gage-men-t	dis-en-gage-ment
sub-species	sub-spe-cies
quencher	quench-er
s-to-ical	sto-i-cal
man-ager-ess	man-ag-er-ess
in-struc-t	in-struct
de-liv-er-able	de-liv-er-a-ble
philo-soph-i-cal	phil-o-soph-i-cal
leo-tard	le-o-tard
con-stituen-cy	con-stit-u-en-cy
bac-carat	bac-ca-rat
spi-ran-t	spi-rant
im-par-tial-i-ty	im-par-ti-al-i-ty
un-trans-lat-able	un-trans-lat-a-ble
oblig-ing-ly	o-blig-ing-ly
b-land	bland
mis-cel-la-neous	mis-cel-la-ne-ous
de-nial	de-ni-al
phos-pho-r	phos-phor
un-able	un-a-ble
trendy	trend-y
im-muno-sup-pres-sion	im-mu-no-sup-pres-sion
hearthrug	hearth-rug
co-mestible	co-mes-ti-ble
ben-e-fi-cia-ry	ben-e-fi-ci-ar-y
cres-cen-t	cres-cent
badtem-pered	bad-tem-pered
isosce-les	i-sos-ce-les
rangy	rang-y
head-scar-f	head-scarf
over-sleep	o-ver-sleep
s-lam	slam
rachis	ra-chis
pronom-i-nal	pro-nom-i-nal
gov-er-nance	gov-ern-ance
con-ser-va-tive	con-serv-a-tive
rein-vest	re-in-vest
suf-fi-cien-t	suf-fi-cient
ap-nea	ap-ne-a
s-trato-spher-ic	strat-o-spher-ic
rein-te-gra-tion	re-in-te-gra-tion
paci-fy	pac-i-fy
per-hap-s	per-haps
so-ci-olin-guis-tic-s	so-ci-o-lin-guis-tics
se-can-t	se-cant
seance	se-ance
door-bel-l	door-bell
mar-que	marque
mul-tira-cial	mul-ti-ra-cial
ex-che-quer	ex-cheq-uer
farad	far-ad
s-teed	steed
prov-ably	prov-a-bly
va-porous	va-por-ous
luke-war-m	luke-warm
s-cotch	scotch
ethos	e-thos
ashamed	a-shamed
knitwear	knit-wear
re-former	re-form-er
sahib	sa-hib
ri-fled	rifled
caiman	cai-man
con-flu-en-t	con-flu-ent
schoolmistress	school-mis-tress
tremo-lo	trem-o-lo
tapi-o-ca	tap-i-o-ca
ra-dius	ra-di-us
over-play	o-ver-play
corset	cor-set
arc-ing	arcing
clam-p-down	clamp-down
d-u-al-i-ty	du-al-i-ty
retroac-tive-ly	ret-ro-ac-tive-ly
bom-bardier	bom-bar-dier
be-atif-ic	be-a-tif-ic
livid	liv-id
on-slaugh-t	on-slaught
de-tach-able	de-tach-a-ble
macabre	ma-ca-bre
s-traight-for-ward	straight-for-ward
ra-dio-car-bon	ra-di-o-car-bon
limpet	lim-pet
lessor	les-sor
s-panker	spank-er
trol-l	troll
un-sea-son-ably	un-sea-son-a-bly
s-e-lec-tive	se-lec-tive
ha-giog-ra-phy	hag-i-og-ra-phy
de-fen-dan-t	de-fend-ant
s-tur-dy	stur-dy
doubtless-ly	doubt-less-ly
crazy	cra-zy
un-equiv-o-cal-ly	un-e-quiv-o-cal-ly
grandios-i-ty	gran-di-os-i-ty
toothy	tooth-y
millpond	mill-pond
genoa	gen-o-a
prosce-ni-um	pro-sce-ni-um
rani	ra-ni
pream-p	pre-amp
un-opened	un-o-pened
e-lo-cu-tion	el-o-cu-tion
s-now-drop	snow-drop
en-vi-ron-s	en-vi-rons
dra-mat-ic-s	dra-mat-ics
duc-t	duct
k-ing	king
polem-i-cal	po-lem-i-cal
un-com-mu-nica-tive	un-com-mu-ni-ca-tive
stylis-tic-s	sty-lis-tics
no-ti-fi-able	no-ti-fi-a-ble
dis-so-nan-t	dis-so-nant
ex-ploita-tive	ex-ploit-a-tive
s-loshed	sloshed
mea-sure-men-t	meas-ure-ment
bumpy	bump-y
co-eval	co-e-val
papule	pap-ule
lin-t	lint
teach-able	teach-a-ble
gravi-ton	grav-i-ton
cervix	cer-vix
bar-l-ey-corn	bar-ley-corn
pe-rusal	pe-rus-al
spinach	spin-ach
mu-tan-t	mu-tant
tan-gen-t	tan-gent
cyclic	cy-clic
philol-o-gy	phi-lol-o-gy
ball-s	balls
e-co-log-i-cal-ly	ec-o-log-i-cal-ly
con-form-ity	con-form-i-ty
prove-nance	prov-e-nance
me-galith-ic	meg-a-lith-ic
scrib-bling	scribbling
bre-viary	bre-vi-ar-y
s-loth-ful	sloth-ful
in-fir-m	in-firm
es-carp-men-t	es-carp-ment
copy-cat	cop-y-cat
fer-ven-t	fer-vent
per-mit-ting	permitting
paean	pae-an
mega	meg-a
periscope	per-i-scope
lega-cy	leg-a-cy
eater	eat-er
kestrel	kes-trel
con-ceal-men-t	con-ceal-ment
en-gage-men-t	en-gage-ment
sun-burned	sunburned
apolo-get-ic	a-pol-o-get-ic
medic	med-ic
pout-ing	pouting
s-lick	slick
re-spectabil-i-ty	re-spect-a-bil-i-ty
s-mell	smell
k-itchen	kitch-en
swimwear	swim-wear
n-erd	nerd
sealan-t	seal-ant
beret	be-ret
turfy	turf-y
undy-ing	un-dy-ing
over-cast	o-ver-cast
bindery	bind-er-y
poly-chro-mat-ic	pol-y-chro-mat-ic
es-capist	es-cap-ist
sunken	sunk-en
porno	por-no
sign-er-s	sign-ers
piti-less	pit-i-less
poly-the-is-tic	pol-y-the-is-tic
edi-tion	e-di-tion
gory	gor-y
periglacial	per-i-gla-cial
den-tistry	den-tis-try
gramo-phone	gram-o-phone
de-r-ate	de-rate
s-ter-ile	ster-ile
flamin-go	fla-min-go
place-bo	pla-ce-bo
in-fantry	in-fan-try
com-plain-ing	complaining
bolero	bo-le-ro
dreamy	dream-y
fal-ter-ing	fal-te-ring
ge-net-ic-s	ge-net-ics
mus-ke-teer	mus-ket-eer
sur-vivor	sur-vi-vor
o-belisk	ob-e-lisk
tar-ragon	tar-ra-gon
mis-sy	miss-y
micro-organ-ism	mi-cro-or-gan-ism
ide-o-log-i-cal-ly	i-de-o-log-i-cal-ly
emi-rate	e-mir-ate
residue	res-i-due
rosary	ro-sa-ry
seag-ul-l	sea-gull
lo-quac-ity	lo-quac-i-ty
piv-otal	piv-ot-al
lul-la-by	lull-a-by
stripling	strip-ling
mer-chantable	mer-chant-a-ble
pre-dictably	pre-dict-a-bly
an-nal-s	an-nals
video-con-fer-enc-ing	vid-e-o-con-fer-enc-ing
as-cen-der	as-cend-er
tele-scope	tel-e-scope
prepo-si-tion	prep-o-si-tion
car-cino-gen-e-sis	car-cin-o-gen-e-sis
un-hesi-tat-ing	un-hes-i-tat-ing
re-sult-ing	resulting
over-hang	o-ver-hang
cy-ber-net-ic-s	cy-ber-net-ics
burly	bur-ly
dul-l	dull
u-n-ap-peal-ing	un-ap-peal-ing
bur-geon-ing	burgeoning
valise	va-lise
mal-leable	mal-le-a-ble
cryo-stat	cry-o-stat
banker	bank-er
mon-e-taris-m	mon-e-ta-rism
bug-gered	buggered
glitzy	glitz-y
u-n-am-bi-tious	un-am-bi-tious
ap-pre-cia-bly	ap-pre-ci-a-bly
con-ve-nient-ly	con-ven-ient-ly
re-ver-ber-an-t	re-ver-ber-ant
crater	cra-ter
l-o-gis-ti-cal	lo-gis-ti-cal
con-tem-po-rary	con-tem-po-rar-y
aver	a-ver
l-o-gis-ti-cal-ly	lo-gis-ti-cal-ly
cus-tom-ary	cus-tom-ar-y
propane	pro-pane
tele-sales	tel-e-sales
islet	is-let
s-trange-ness	strange-ness
over-crowd	o-ver-crowd
un-de-ni-able	un-de-ni-a-ble
ex-cerp-t	ex-cerpt
moral	mor-al
in-cor-rec-t	in-cor-rect
mer-ri-men-t	mer-ri-ment
tri-atom-ic	tri-a-tom-ic
reim-ple-ment-ed	reimplemented
tran-scrip-t	tran-script
petu-lance	pet-u-lance
tepid	tep-id
re-cen-t	re-cent
trans-for-m	trans-form
mas-tery	mas-ter-y
tarsal	tar-sal
s-lap	slap
e-ques-tri-an-is-m	e-ques-tri-an-ism
turgid	tur-gid
teenage	teen-age
iron-work-s	i-ron-works
spinal	spi-nal
numb-skul-l	numb-skull
n-u-mis-mat-ic	nu-mis-mat-ic
bla-tan-t	bla-tant
backpedal	back-ped-al
usurp-er	u-surp-er
w-ere-wolf	were-wolf
omit	o-mit
dis-coun-t	dis-count
un-ques-tion-able	un-ques-tion-a-ble
s-toned	stoned
igua-na	i-gua-na
any-how	an-y-how
pun-ish-men-t	pun-ish-ment
d-if-fer-en-tiable	dif-fer-en-ti-a-ble
prankster	prank-ster
mort-gagee	mort-ga-gee
trade-marked	trademarked
shandy	shan-dy
mora-to-ri-um	mor-a-to-ri-um
rock-ery	rock-er-y
il-l	ill
warhorse	war-horse
e-vic-t	e-vict
re-li-ably	re-li-a-bly
cru-cible	cru-ci-ble
peas-an-t	peas-ant
junker	jun-ker
springy	spring-y
navel	na-vel
el-e-gan-t	el-e-gant
d-ab-bing	dab-bing
de-ter-mi-nan-t	de-ter-mi-nant
laud-ed	lauded
dossier	dos-si-er
tiara	ti-ar-a
crafty	craft-y
cy-clotron	cy-clo-tron
ax-il-lary	ax-il-lar-y
tum-bled	tumbled
very	ver-y
su-per-b	su-perb
ar-ran-t	ar-rant
un-holy	un-ho-ly
u-nas-sist-ed	un-as-sist-ed
s-cour	scour
s-tra-tum	stra-tum
mau-soleum	mau-so-le-um
per-fumery	per-fum-er-y
un-ordered	un-or-dered
para-noia	par-a-noi-a
peri-na-tal	per-i-na-tal
geosyn-chronous	ge-o-syn-chro-nous
s-tark-ly	stark-ly
au-thoress	au-thor-ess
sus-pend-ed	sus-pen-ded
needy	need-y
crinkly	crin-kly
semi-fi-nal-ist	sem-i-fi-nal-ist
vi-able	vi-a-ble
re-pel-len-t	re-pel-lent
ban-ish-men-t	ban-ish-ment
de-signed-ly	de-sign-ed-ly
chan-cellery	chan-cel-ler-y
hy-dran-t	hy-drant
heiress	heir-ess
hy-dro-elec-tric	hy-dro-e-lec-tric
beery	beer-y
adap-t	a-dapt
rub-bishy	rub-bish-y
mas-sacre	mas-sa-cre
mer-ce-nary	mer-ce-nar-y
data-base	da-ta-base
poli-ty	pol-i-ty
un-fath-ome-d	un-fath-omed
repa-ra-tion	rep-a-ra-tion
ne-go-tia-tor	ne-go-ti-a-tor
cus-tody	cus-to-dy
arouse	a-rouse
monarch	mon-arch
nobly	no-bly
k-itsch	kitsch
ep-ithe-li-um	ep-i-the-li-um
dassie	das-sie
pointil-lis-m	poin-til-lism
con-struc-t	con-struct
over-dose	o-ver-dose
flanker	flank-er
in-suf-fi-cien-t	in-suf-fi-cient
quan-tifi-ca-tion	quan-ti-fi-ca-tion
serendip-i-ty	ser-en-dip-i-ty
s-cam	scam
sus-pec-t	sus-pect
s-can-dalous	scan-dal-ous
er-r	err
syn-onymy	syn-on-y-my
moorhen	moor-hen
e-s-o-ter-i-ca	es-o-ter-i-ca
paunchy	paunch-y
cen-tau-r	cen-taur
pageantry	pag-eant-ry
literati	lit-e-ra-ti
cheru-bic	che-ru-bic
jester	jest-er
a-ban-don-men-t	a-ban-don-ment
decile	dec-ile
un-palat-able	un-pal-at-a-ble
suet	su-et
flotil-la	flo-til-la
aun-tie	aunt-ie
un-count-able	un-count-a-ble
u-p-lift-ing	up-lift-ing
en-cycli-cal	en-cyc-li-cal
round-about	round-a-bout
sky-scraper	sky-scrap-er
man-age-able	man-age-a-ble
avari-cious	av-a-ri-cious
mys-tery	mys-ter-y
coralline	cor-al-line
para-medic	par-a-med-ic
im-puni-ty	im-pu-ni-ty
kerosene	ker-o-sene
stroller	stroll-er
bur-sary	bur-sa-ry
paramount-cy	par-a-mount-cy
mar-keter	mar-ket-er
per-fec-t	per-fect
serene-ly	se-rene-ly
s-lip-stream	slip-stream
b-lench	blench
man-ner-is-m	man-ner-ism
es-sen-tial-is-m	es-sen-tial-ism
over-spend	o-ver-spend
beau-teous	beau-te-ous
elu-sive	e-lu-sive
breast-feed-ing	breastfeeding
proph-esy	proph-e-sy
e-vanes-cen-t	ev-a-nes-cent
over-re-ac-t	o-ver-re-act
resid-u-al	re-sid-u-al
palate	pal-ate
im-pro-pri-ety	im-pro-pri-e-ty
seroneg-a-tive	se-ro-neg-a-tive
i-n-of-fen-sive	in-of-fen-sive
be-wil-der-men-t	be-wil-der-ment
counter	coun-ter
over-shoot	o-ver-shoot
droopy	droop-y
cheva-lier	chev-a-lier
in-fringe-men-t	in-fringe-ment
monomer	mon-o-mer
thriller	thrill-er
scholas-ti-cis-m	scho-las-ti-cism
s-chem-ing	schem-ing
philis-tine	phil-is-tine
mimet-ic	mi-met-ic
scratchy	scratch-y
s-cab-by	scab-by
s-mudge	smudge
in-can-des-cen-t	in-can-des-cent
an-niver-sary	an-ni-ver-sa-ry
breakup	break-up
s-tain-less	stain-less
pedol-o-gy	pe-dol-o-gy
tex-t	text
pavil-ion	pa-vil-ion
me-nial	me-ni-al
redo-len-t	red-o-lent
mil-lisec-ond	mil-li-sec-ond
tri-adic	tri-ad-ic
pul-monary	pul-mo-nar-y
video	vid-e-o
cathar-tic	ca-thar-tic
shiv-ery	shiv-er-y
in-hab-it-able	in-hab-it-a-ble
mus-cu-loskele-tal	mus-cu-lo-skel-e-tal
poltroon	pol-troon
tonal	ton-al
bi-l-abi-al	bi-la-bi-al
re-spectably	re-spect-a-bly
jugu-lar	jug-u-lar
brack-et-ed	bracketed
posit	pos-it
mal-l	mall
stopover	stop-o-ver
mod-icum	mod-i-cum
he-li-cal	hel-i-cal
avoid-able	a-void-a-ble
hy-dro-dy-nam-ic-s	hy-dro-dy-nam-ics
mis-ery	mis-er-y
sauer-kraut	sau-er-kraut
en-graver	en-grav-er
habi-ta-tion	hab-i-ta-tion
bat-tle-men-t	bat-tle-ment
chloro-phyl-l	chlo-ro-phyll
an-throp-ic	an-thro-pic
tilde	til-de
per-turb-ing	perturbing
pol-i-tic-s	pol-i-tics
com-mand-men-t	com-mand-ment
tru-cu-len-t	truc-u-lent
the-atri-cal-s	the-at-ri-cals
s-lack	slack
tear-away	tear-a-way
en-vi-ron-men-t	en-vi-ron-ment
im-po-ten-t	im-po-tent
kook-abur-ra	kook-a-bur-ra
in-dig-nan-t	in-dig-nant
un-der-gar-men-t	un-der-gar-ment
pedi-gree	ped-i-gree
lectern	lec-tern
dis-ori-en-tat-ed	disorientated
busty	bust-y
hero-is-m	her-o-ism
mi-cro-bial	mi-cro-bi-al
ex-plo-ration	ex-plo-ra-tion
u-nim-pres-sive	un-im-pres-sive
dis-in-fec-t	dis-in-fect
in-sou-ciance	in-sou-ci-ance
ar-guable	ar-gu-a-ble
ha-track	hat-rack
d-e-duc-tion	de-duc-tion
mar-malade	mar-ma-lade
s-calpel	scal-pel
reify	re-i-fy
im-ma-nen-t	im-ma-nent
Words with errors: 2261
Words with incorrect number of syllables: 2079
Total evluated: 6500
Perfect accuracy: 0.65
Number of syllables accuracy: 0.68
Average Levenshtein Distance(across incorrect words): 1.21
