Attempt	Real
count-er	coun-ter
ne-crop-sy	nec-rop-sy
un-wor-th-y	un-wor-thy
ran-co-r-ous	ran-cor-ous
bra-v-o	bra-vo
bluish	blu-ish
smug-gling	smuggling
i-b-is	i-bis
pleasure	pleas-ure
rea-wak-en	re-a-wak-en
cyc-li-cal	cy-cli-cal
li-quor	liq-uor
bur-geon-ing	burgeoning
doc-to-rate	doc-tor-ate
in-firm-i-ty	in-fir-mi-ty
new-s-a-gent	news-a-gent
con-troll-er	con-trol-ler
reu-ni-fi-ca-tion	re-u-ni-fi-ca-tion
step-father	step-fa-ther
iv-y	i-vy
de-vil-ry	dev-il-ry
nav-el	na-vel
cere-mo-ny	cer-e-mo-ny
il-li-quid	il-liq-uid
matri-arch	ma-tri-arch
bond-ing	bonding
ca-ter-pil-lar	cat-er-pil-lar
awestruck	awe-struck
pro-gramming	pro-gram-ming
trivi-al-i-ty	triv-i-al-i-ty
pro-f-ound-ly	pro-found-ly
o-ver-worked	overworked
deci-sive-ness	de-ci-sive-ness
smelt-ing	smelting
tri-gly-ceride	tri-glyc-er-ide
prem-a-ture-ly	pre-ma-ture-ly
ca-ta-ract	cat-a-ract
im-portant-ly	im-por-tant-ly
mi-cro-farad	mi-cro-far-ad
rock-e-try	rock-et-ry
subur-bi-a	sub-ur-bi-a
win-k-le	win-kle
un-so-ci-a-ble	un-so-cia-ble
mul-tilevel	mul-ti-lev-el
co-pra	cop-ra
busi-nes-s-like	busi-ness-like
pen-i-ten-tiar-y	pen-i-ten-tia-ry
mer-chandis-ing	mer-chan-dis-ing
cere-mo-ni-al	cer-e-mo-ni-al
broken	bro-ken
om-ni-po-tent	om-nip-o-tent
sto-kes	stokes
mar-su-pial	mar-su-pi-al
su-pre-ma-cist	su-prem-a-cist
hor-i-zon	ho-ri-zon
wicked	wick-ed
ti-me-l-i-ness	time-li-ness
po-ver-ty	pov-er-ty
scream-ing	screaming
tele-vised	televised
pub-lished	published
bas-sist	bass-ist
u-te-rine	u-ter-ine
mi-c-ro-phone	mi-cro-phone
milk-shake	milkshake
machin-er-y	ma-chin-er-y
an-ti-podes	an-tip-o-des
sum-mar-y	sum-ma-ry
dar-ter	dart-er
eer-i-ly	ee-ri-ly
modest-ly	mod-est-ly
vid-e-o-taped	videotaped
ex-traj-u-di-cial	ex-tra-ju-di-cial
flound-er	floun-der
pat-terned	patterned
ar-tis-try	art-ist-ry
pap-a-cy	pa-pa-cy
id-e-o-log-i-cal-ly	i-de-o-log-i-cal-ly
eas-y-going	eas-y-go-ing
devel-op-men-tal-ly	de-vel-op-men-tal-ly
blis-t-er	blis-ter
with-dra-wal	with-draw-al
in-aud-i-ble	in-au-di-ble
scam-per	scamp-er
mar-ke-t-er	mar-ket-er
glu-t-en	glu-ten
snow-s-torm	snow-storm
re-sin	res-in
bo-dy-guard	bod-y-guard
co-p-ro-lite	cop-ro-lite
clas-si-f-i-ca-to-ry	clas-si-fi-ca-to-ry
ca-m-e-o	cam-e-o
ca-thol-ic	cath-o-lic
ma-ny	man-y
o-var-y	o-va-ry
lem-o-nade	lem-on-ade
polk-a	pol-ka
rem-i-n-is-cence	rem-i-nis-cence
phob-ic	pho-bic
fault-ing	faulting
bi-er	bier
crav-en	cra-ven
di-agon-al	di-ag-o-nal
gale-na	ga-le-na
de-sic-ca-tor	des-ic-ca-tor
es-ta-blish	es-tab-lish
in-di-vi-si-ble	in-di-vis-i-ble
con-spec-if-ic	con-spe-cif-ic
feas-i-bly	fea-si-bly
tri-po-li	trip-o-li
arches	arch-es
do-tage	dot-age
lad-y-bird	la-dy-bird
stoi-cal	sto-i-cal
daily	dai-ly
with-ered	withered
gadge-try	gadg-et-ry
eyelet	eye-let
rec-o-v-er	re-cov-er
staphy-lo-coc-cus	staph-y-lo-coc-cus
ga-ze-lle	ga-zelle
me-lod-ra-mat-ic	mel-o-dra-mat-ic
ca-co-ph-o-nous	ca-coph-o-nous
em-ble-mat-ic	em-blem-at-ic
her-bi-cide	herb-i-cide
ta-b-le-cloth	ta-ble-cloth
sto-mach	stom-ach
hu-ma-n-oid	hu-man-oid
re-cir-c-u-late	re-cir-cu-late
stew-ed	stewed
con-vect-ed	convected
pro-spect	pros-pect
pre-mise	prem-ise
wa-terbed	wa-ter-bed
ca-da-ver	ca-dav-er
re-col-lect	rec-ol-lect
thereu-pon	there-up-on
en-count-er	en-coun-ter
prov-ok-ing	pro-vok-ing
skirm-ish	skir-mish
plen-i-po-ten-tiar-y	plen-i-po-ten-ti-ar-y
prof-i-teer-ing	profiteering
grann-y	gran-ny
burn-ings	bur-nings
min-is-ter-i-al	min-is-te-ri-al
furn-ish	fur-nish
heat-wave	heatwave
po-lygy-ny	po-lyg-y-ny
res-is-tiv-i-ty	re-sis-tiv-i-ty
re-scue	res-cue
haz-ar-dous	haz-ard-ous
paun-chy	paunch-y
palt-ry	pal-try
prol-on-ga-tion	pro-lon-ga-tion
vi-r-a-go	vi-ra-go
ref-in-ish	re-fin-ish
zool-o-gy	zo-ol-o-gy
fron-ti-er	fron-tier
crea-tive-ly	cre-a-tive-ly
maybe	may-be
un-cor-rob-orat-ed	un-cor-rob-o-rat-ed
ob-lige	o-blige
un-spok-en	un-spo-ken
con-sul-t-an-cy	con-sult-an-cy
vel-um	ve-lum
endangered	en-dan-gered
troika	troi-ka
mo-der-nism	mod-ern-ism
lon-e-l-i-ness	lone-li-ness
re-fugee	ref-u-gee
bi-got	big-ot
da-mask	dam-ask
pe-n-in-su-la	pen-in-su-la
lives-tock	live-stock
chaff-inch	chaf-finch
squir-e-ar-chy	squire-ar-chy
or-bi-ter	or-bit-er
sus-h-i	su-shi
cere-mo-ni-ous	cer-e-mo-ni-ous
for-thright	forth-right
sec-on-dar-i-ly	sec-ond-ar-i-ly
hol-ism	ho-lism
res-trict	re-strict
forek-nowl-edge	fore-knowl-edge
taunt-ing	taunting
shell-f-ish	shell-fish
re-stau-ra-teur	res-tau-ra-teur
trackbed	track-bed
season-ing	sea-son-ing
ref-o-cus	re-fo-cus
seaweed	sea-weed
de-vil-ment	dev-il-ment
un-linked	unlinked
prec-og-ni-tion	pre-cog-ni-tion
her-ba-ce-ous	her-ba-ceous
in-trave-nous-ly	in-tra-ve-nous-ly
fus-s-y	fuss-y
tel-e-s-cop-ic	tel-e-scop-ic
se-is-mic	seis-mic
hor-mo-n-al	hor-mo-nal
un-crea-tive	un-cre-a-tive
rank-le	ran-kle
prevue	pre-vue
rew-rit-a-ble	re-writ-a-ble
lan-gu-age	lan-guage
mi-crose-cond	mi-cro-sec-ond
patri-ar-chal	pa-tri-ar-chal
scented	scent-ed
stead-y-ing	steadying
hirel-ing	hire-ling
ar-ach-noid	a-rach-noid
di-m-in-u-en-do	di-min-u-en-do
in-hab-i-t-a-ble	in-hab-it-a-ble
mol-es-ta-tion	mo-les-ta-tion
mush-room-ing	mushrooming
sto-ve-pipe	stove-pipe
poul-t-ice	poul-tice
fescue	fes-cue
shelter	shel-ter
mar-gi-nal	mar-gin-al
ce-li-ba-cy	cel-i-ba-cy
sec-re-tive	se-cre-tive
in-ter-col-le-gi-ate	in-ter-col-le-giate
stripling	strip-ling
ho-m-o-pho-bi-a	ho-mo-pho-bi-a
var-i-e-tal	va-ri-e-tal
at-tack-ing	attacking
u-p-ro-ar-i-ous	up-roar-i-ous
fort-y	for-ty
flier	fli-er
pain-stak-ing-ly	pains-tak-ing-ly
tran-s-lu-cen-cy	trans-lu-cen-cy
de-r-ail-ment	de-rail-ment
phy-loge-ny	phy-log-e-ny
chris-t-en	chris-ten
aor-tic	a-or-tic
ro-c-o-co	ro-co-co
whodu-nit	who-dun-it
no-d-al	nod-al
un-her-oic	un-he-ro-ic
frees-tyle	free-style
rig-o-r-ous	rig-or-ous
fluid-i-ty	flu-id-i-ty
ge-o-gra-pher	ge-og-ra-pher
sun-burned	sunburned
gau-d-y	gaud-y
e-lec-tro-ne-ga-tive	e-lec-tro-neg-a-tive
ob-lig-ing-ly	o-blig-ing-ly
pup-pe-teer	pup-pet-eer
trans-fi-n-ite	trans-fi-nite
rav-en	ra-ven
mai-d-en	maid-en
cere-bel-lum	cer-e-bel-lum
mis-nom-er	mis-no-mer
clank-ing	clan-king
pals-y	pal-sy
pres-byter-y	pres-by-ter-y
me-temp-sy-cho-sis	me-tem-psy-cho-sis
tapes-try	tap-es-try
town-speo-ple	towns-peo-ple
voyeur-is-tic	voy-eur-is-tic
vel-veteen	vel-vet-een
bur-bling	burbling
fireguard	fire-guard
re-s-is-tor	re-sis-tor
han-dy-man	hand-y-man
lun-a-cy	lu-na-cy
ri-fled	rifled
ge-n-er-i-cal-ly	ge-ner-i-cal-ly
holl-er	hol-ler
i-des	ides
twent-y	twen-ty
wige-on	wig-eon
cand-les-tick	can-dle-stick
seam-an-ship	sea-man-ship
coauthor	co-au-thor
med-u-sa	me-du-sa
ven-o-mous	ven-om-ous
ro-oi-bos	roo-i-bos
pond-er	pon-der
wreck-ing	wrecking
proph-y-lac-tic	pro-phy-lac-tic
lany-ard	lan-yard
limp-ing	limping
dus-ter	dust-er
ditch-ing	ditching
pa-pule	pap-ule
in-ex-or-a-bly	in-ex-o-ra-bly
pro-blem	prob-lem
her-i-tage	her-it-age
sifted	sift-ed
her-e-in-af-t-er	here-in-af-ter
melee	me-lee
ele-ment	el-e-ment
li-g-and	li-gand
cudgel	cudg-el
her-bi-vo-r-ous	her-biv-o-rous
ne-verthe-less	nev-er-the-less
wrestling	wres-tling
askew	a-skew
o-le-and-er	o-le-an-der
grav-es-tone	grave-stone
smallish	small-ish
bi-en-nial	bi-en-ni-al
di-a-th-er-my	di-a-ther-my
o-ver-wint-er	o-ver-win-ter
naive-ly	na-ive-ly
for-mu-laic	for-mu-la-ic
co-ver-let	cov-er-let
sing-ly	sin-gly
baleen	ba-leen
bon-o-bo	bo-no-bo
sea-so-nal-i-ty	sea-son-al-i-ty
e-l-i-gi-ble	el-i-gi-ble
gaze-bo	ga-ze-bo
flim-s-y	flim-sy
trom-bonist	trom-bon-ist
re-in	rein
o-ven	ov-en
cir-cu-i-try	cir-cuit-ry
pro-po-si-tion-al	prop-o-si-tion-al
du-ke-dom	duke-dom
tend-er	ten-der
sacred	sa-cred
deba-cle	de-ba-cle
stif-fen-ing	stiff-en-ing
par-lia-m-en-tar-y	par-lia-men-ta-ry
con-des-cen-sion	con-de-scen-sion
gub-er-na-to-ri-al	gu-ber-na-to-ri-al
gud-geon	gudg-eon
teth-er-ing	tethering
ob-so-l-es-cent	ob-so-les-cent
re-newed	renewed
cata-pult	cat-a-pult
coag-u-late	co-ag-u-late
laz-i-ness	la-zi-ness
in-ter-pre-ter	in-ter-pret-er
ha-d-ron	had-ron
tran-s-lu-cent	trans-lu-cent
di-aphrag-mat-ic	di-a-phrag-mat-ic
war-rant-y	war-ran-ty
flan-ne-l-ette	flan-nel-ette
re-di-r-ect	re-di-rect
fo-ray	for-ay
par-ti-s-an-ship	par-ti-san-ship
ev-er-y-where	eve-ry-where
sub-po-e-na	sub-poe-na
par-a-bo-la	pa-rab-o-la
po-l-yur-e-thane	pol-y-u-re-thane
un-an-i-mous	u-nan-i-mous
glut-to-n-ous	glut-ton-ous
pho-to-elec-tric	pho-to-e-lec-tric
cau-d-al	cau-dal
decid-ing	de-cid-ing
mis-s-pend	mis-spend
buck-min-ster-ful-ler-e-n-e	buck-min-ster-ful-ler-ene
leger-de-main	leg-er-de-main
se-ni-or-i-ty	sen-ior-i-ty
poli-ce-wo-man	po-lice-wom-an
nin-e-ty	nine-ty
pro-ced-ur-al-ly	pro-ce-dur-al-ly
gir-der	gird-er
glam-o-rous	glam-or-ous
bir-die	bird-ie
pa-r-i-e-tal	pa-ri-e-tal
read-mis-sion	re-ad-mis-sion
in-du-bi-t-a-ble	in-du-bi-ta-ble
ma-c-ro-ec-o-nom-ic	mac-ro-ec-o-nom-ic
re-cei-ver-ship	re-ceiv-er-ship
mani-a-cal	ma-ni-a-cal
ir-re-con-ci-la-ble	ir-rec-on-cil-a-ble
gar-n-ish	gar-nish
po-ten-tiom-e-ter	po-ten-ti-om-e-ter
pa-p-il-la	pa-pil-la
con-stit-u-tive	con-sti-tu-tive
beav-er	bea-ver
om-ni-po-tence	om-nip-o-tence
evict	e-vict
stin-g-y	stin-gy
ven-geance	venge-ance
behe-moth	be-he-moth
livel-i-ness	live-li-ness
fan-d-an-go	fan-dan-go
te-t-ra	tet-ra
de-bonair	deb-o-nair
vin-yl	vi-nyl
er-ect	e-rect
pol-ys-tyrene	pol-y-sty-rene
car-ess-ing	ca-res-sing
in-ter-dis-cip-li-nar-y	in-ter-dis-ci-pli-nar-y
car-ri-age	car-riage
meth-y-lene	meth-yl-ene
ou-ter-most	out-er-most
banter	ban-ter
un-a-nim-i-ty	u-na-nim-i-ty
de-nim	den-im
cough-ing	coughing
hun-t-er	hunt-er
outs-mart	out-smart
so-ci-a-bil-i-ty	so-cia-bil-i-ty
smith-ereens	smith-er-eens
ce-d-il-la	ce-dil-la
mis-er-ly	mi-ser-ly
tail-or-ing	tai-lor-ing
pa-r-ole	pa-role
spa-n-i-el	span-iel
worth-y	wor-thy
cre-dul-i-ty	cre-du-li-ty
om-bud-s-man	om-buds-man
trus-t-y	trust-y
pa-tois	pat-ois
u-priv-er	up-riv-er
cow-l-ing	cowl-ing
dea-fen-ing	deaf-en-ing
wa-tershed	wa-ter-shed
u-ni-mag-ina-bly	un-im-ag-i-na-bly
tid-i-ness	ti-di-ness
boun-dar-y	bound-a-ry
based	based
eastern-most	east-ern-most
a-zal-e-a	a-zal-ea
wrong-doing	wrong-do-ing
dy-s-pep-tic	dys-pep-tic
western-most	west-ern-most
cere-al	ce-re-al
reader-ship	read-er-ship
ma-r-oon	ma-roon
jeo-pard-y	jeop-ard-y
dis-sonant	dis-so-nant
sa-t-is-fied	sat-is-fied
un-bo-som	un-bos-om
an-throp-ic	an-thro-pic
re-tiree	re-tir-ee
se-v-en-t-y	sev-en-ty
mil-lin-er-y	mil-li-ner-y
obel-isk	ob-e-lisk
be-fud-dling	befuddling
fo-re-arm	fore-arm
tun-ic	tu-nic
cour-troom	court-room
here-af-t-er	here-af-ter
bespeak	be-speak
bay-onet	bay-o-net
boat-s-wain	boat-swain
a-rum	ar-um
vig-i-lante	vig-i-lan-te
sneer-ing	sneering
ini-ti-a-tive	in-i-ti-a-tive
in-choate	in-cho-ate
fu-gue	fugue
co-r-o-na-tion	cor-o-na-tion
mas-ca-ra	mas-car-a
e-there-al	e-the-re-al
lul-la-by	lull-a-by
ar-cha-e-ol-o-gy	ar-chae-ol-o-gy
un-ex-amined	un-ex-am-ined
o-ver-writ-ing	overwriting
an-tiv-i-ral	an-ti-vi-ral
phi-lan-throp-ic	phil-an-throp-ic
mon-o-lin-gu-al	mon-o-lin-gual
grand-fa-th-er	grand-fa-ther
scoff-ing	scoffing
in-adeq-ua-cy	in-ad-e-qua-cy
in-stig-a-tor	in-sti-ga-tor
edgy	edg-y
ox-alate	ox-a-late
las-er	la-ser
bab-y-sit-ter	ba-by-sit-ter
nurser-y	nurs-er-y
bis-hop	bish-op
a-pho-r-ism	aph-o-rism
nur-ser-y-men	nurs-er-y-men
re-lat-i-vis-tic	rel-a-tiv-is-tic
pro-sec-u-to-ri-al	pros-e-cu-to-ri-al
ex-ploi-ta-tive	ex-ploit-a-tive
slumb-er	slum-ber
tes-ta-men-tar-y	tes-ta-men-ta-ry
rivet-ing	riv-et-ing
road-wor-th-y	road-wor-thy
by-pro-duct	by-prod-uct
rep-el	re-pel
ho-ver-craft	hov-er-craft
bount-y	boun-ty
crem-a-to-ri-um	cre-ma-to-ri-um
rave-nous	rav-en-ous
com-man-d-er	com-mand-er
ne-on-ate	ne-o-nate
bir-thright	birth-right
ca-val-ry	cav-al-ry
koa-la	ko-a-la
port-ent	por-tent
flood-ing	flooding
in-ter-ci-ty	in-ter-cit-y
scholar	schol-ar
pan-a-che	pa-nache
zigzag	zig-zag
en-crust-ed	encrusted
rem-it	re-mit
gnom-ic	gno-mic
pa-tro-ness	pa-tron-ess
es-ta-blish-ment	es-tab-lish-ment
op-por-tu-nis-tic	op-por-tun-is-tic
kais-er	kai-ser
de-ter-mi-nism	de-ter-min-ism
fool-hard-y	fool-har-dy
bas-i-cal-ly	ba-si-cal-ly
no-vel-ty	nov-el-ty
rant-ing	ranting
pimp-ing	pimping
rac-e-track	race-track
par-ent-ing	parenting
ma-nor	man-or
fev-er-ish	fe-ver-ish
vi-de-o	vid-e-o
cus-to-mar-i-ly	cus-tom-ar-i-ly
phar-mac-o-log-i-cal	phar-ma-co-log-i-cal
o-bei-s-ance	o-bei-sance
bri-d-al	brid-al
det-ri-tus	de-tri-tus
buzz-ing	buzzing
pro-fli-ga-cy	prof-li-ga-cy
jej-u-num	je-ju-num
pome-lo	pom-e-lo
col-os-sus	co-los-sus
ragged	rag-ged
co-p-y-ist	cop-y-ist
screw-ed	screwed
dim-i-n-u-tive	di-min-u-tive
ex-cru-ciat-ing	ex-cru-ci-at-ing
min-ce-meat	mince-meat
re-s-er-va-tion	res-er-va-tion
grie-vous	griev-ous
poi-so-nous	poi-son-ous
eer-ie	ee-rie
un-i-on-ist	un-ion-ist
gib-ber-ing	gibbering
ran-s-ack	ran-sack
wrink-le	wrin-kle
u-prise	up-rise
un-abridged	un-a-bridged
her-bal	herb-al
damper	damp-er
ide-al	i-de-al
re-im-ple-ment-ed	reimplemented
hib-is-cus	hi-bis-cus
as-su-age	as-suage
bodied	bod-ied
moist-en	mois-ten
poem	po-em
rat-e-pay-er	rate-pay-er
scra-pyard	scrap-yard
fril-ly	frill-y
hau-lier	haul-ier
pid-gin	pidg-in
demol-ish	de-mol-ish
war-drobe	ward-robe
roun-dup	round-up
vig-nette	vi-gnette
un-con-ge-ni-al	un-con-gen-ial
in-te-r-i-or	in-te-ri-or
celeb	ce-leb
an-noun-cer	an-nounc-er
per-is-cope	per-i-scope
hy-p-o-crit-i-cal	hyp-o-crit-i-cal
pul-lo-v-er	pull-o-ver
where-ver	wher-ev-er
i-t-in-er-ar-y	i-tin-er-ar-y
crull-er	crul-ler
sole-noid	so-le-noid
o-dys-sey	odyssey
phy-si-ol-o-gy	phys-i-ol-o-gy
vil-lai-ny	vil-lain-y
re-joind-er	re-join-der
foam-ing	foaming
puff-y	puf-fy
writer	writ-er
ca-n-ard	ca-nard
neu-ro-science	neu-ro-sci-ence
port-er	por-ter
bot-tled	bottled
pe-des-tal	ped-es-tal
in-vo-lun-tar-y	in-vol-un-tar-y
bestow	be-stow
sab-ot-age	sab-o-tage
erad-i-cat-ed	e-rad-i-cat-ed
buc-ca-ne-er	buc-ca-neer
mo-ral	mor-al
dim-pled	dimpled
boar-d-room	board-room
phy-si-og-no-my	phys-i-og-no-my
mi-n-ute-ly	mi-nute-ly
per-i-pher-y	pe-riph-er-y
hai-r-y	hair-y
firsthand	first-hand
in-fant-ry	in-fan-try
un-com-pli-men-tar-y	un-com-pli-men-ta-ry
sa-vage-ly	sav-age-ly
ar-ach-no-pho-bi-a	a-rach-no-pho-bi-a
the-o-c-ra-cy	the-oc-ra-cy
nove-l-ette	nov-el-ette
suic-i-dal	su-i-cid-al
vide-o-phone	vid-e-o-phone
ant-werp	antwerp
rhea	rhe-a
e-lec-tro-d-y-nam-ics	e-lec-tro-dy-nam-ics
poig-nant-ly	poign-ant-ly
deathbed	death-bed
ood-les	oo-dles
ci-ta-del	cit-a-del
ov-er-an-x-ious	o-ver-anx-ious
sen-hor	se-nhor
e-q-ua-tor	e-qua-tor
er-rone-ous-ly	er-ro-ne-ous-ly
tele-work-ing	teleworking
bases	ba-ses
dy-n-as-ty	dy-nas-ty
mas-termind	mas-ter-mind
od-dly	odd-ly
mo-t-el	mo-tel
de-ter-min-ed-ly	de-ter-mined-ly
sof-tie	soft-ie
ir-re-fut-a-ble	ir-ref-u-ta-ble
ex-pen-d-i-ture	ex-pend-i-ture
co-ronet	cor-o-net
leg-a-to	le-ga-to
slip-ping	slipping
offer	of-fer
fi-ef-dom	fief-dom
sa-lad	sal-ad
pro-tracted	pro-tract-ed
ye-o-man	yeo-man
ty-pe-script	type-script
fo-re-ign	for-eign
o-verspend	o-ver-spend
post-moder-nist	post-mod-ern-ist
pa-r-en-ter-al	par-en-ter-al
glas-ses	glass-es
re-ach	reach
ir-rev-oc-a-bly	ir-rev-o-ca-bly
rip-pling	rippling
in-di-ca-tive	in-dic-a-tive
wrink-ly	wrin-kly
mas-thead	mast-head
mishap	mis-hap
ar-om-a-ther-a-py	a-ro-ma-ther-a-py
ger-ry-man-d-er	ger-ry-man-der
be-drock	bed-rock
ideal-ist	i-de-al-ist
straitened	strait-ened
spi-rit-u-al-ly	spir-it-u-al-ly
gend-er	gen-der
ob-lig-ing	o-blig-ing
pap-er	pa-per
crea-tion	cre-a-tion
foothill	foot-hill
bawl-ing	baw-ling
con-tempti-ble	con-tempt-i-ble
dol-o-r-ous	dol-or-ous
squa-lor	squal-or
gent-ly	gen-tly
re-cru-it-er	re-cruit-er
chos-en	cho-sen
second-hand	sec-ond-hand
in-ves-ti-g-a-tive	in-ves-ti-ga-tive
ouster	oust-er
cen-tu-r-y	cen-tu-ry
mi-l-i-eu	mi-lieu
in-her-i-tance	in-her-it-ance
ta-proom	tap-room
sen-ti-n-el	sen-ti-nel
dim-in-ish	di-min-ish
hec-tor-ing	hectoring
ga-mut	gam-ut
sniff-ing	sniffing
prer-og-a-tive	pre-rog-a-tive
pa-r-en-the-sis	pa-ren-the-sis
stu-died	stud-ied
id-ly	i-dly
er-rone-ous	er-ro-ne-ous
bache-lor	bach-e-lor
glor-i-fi-ca-tion	glo-ri-fi-ca-tion
per-i-he-lion	per-i-he-li-on
in-ter-go-vern-men-tal	in-ter-gov-ern-men-tal
al-tog-e-ther	al-to-geth-er
per-sev-er-ance	per-se-ver-ance
an-ti-th-e-sis	an-tith-e-sis
aor-ta	a-or-ta
scato-log-i-cal	scat-o-log-i-cal
bleat-ing	bleating
prov-i-der	pro-vid-er
gra-phol-o-gy	graph-ol-o-gy
be-wildered	bewildered
mar-i-na	ma-ri-na
ha-giog-ra-phy	hag-i-og-ra-phy
un-pronounce-a-ble	un-pro-nounce-a-ble
im-pe-r-i-al-is-tic	im-pe-ri-al-is-tic
pet-ro-le-um	pe-tro-le-um
lo-c-o-mo-tion	lo-co-mo-tion
rep-ro-cess	re-proc-ess
el-vish	elv-ish
ver-bat-im	ver-ba-tim
sad-dlebag	sad-dle-bag
pe-n-um-bra	pe-num-bra
un-focused	un-fo-cused
priss-y	pris-sy
bor-ax	bo-rax
he-l-i-o-cen-tric	he-li-o-cen-tric
im-pressed	impressed
blasphe-mous	blas-phe-mous
bluster	blus-ter
un-com-prom-is-ing	un-com-pro-mis-ing
liber-ty	lib-er-ty
stew-ar-dess	stew-ard-ess
pileup	pile-up
whome-ver	whom-ev-er
un-lad-y-like	un-la-dy-like
qua-ter-nion	qua-ter-ni-on
awaken-ing	a-wak-en-ing
fal-len	fall-en
coastal	coast-al
mi-suse	mis-use
in-e-luc-t-a-ble	in-e-luc-ta-ble
thor-n-y	thorn-y
con-sor-tium	con-sor-ti-um
hot-el	ho-tel
in-vert-ed	inverted
dau-ber	daub-er
wor-th-i-ness	wor-thi-ness
mon-e-tar-ism	mon-e-ta-rism
re-in-vig-o-rate	re-in-vig-or-ate
frizz-y	friz-zy
a-l-oud	a-loud
un-sav-o-ry	un-sa-vor-y
tach-yon	tach-y-on
vehi-cle	ve-hi-cle
oft-en	of-ten
tra-der	trad-er
bon-an-za	bo-nan-za
cun-ei-form	cu-ne-i-form
hem-is-phere	hem-i-sphere
bristling	bris-tling
cys-teine	cys-te-ine
drop-s-y	drop-sy
ver-ita-ble	ver-i-ta-ble
slend-er	slen-der
ba-bes	babes
an-g-er	an-ger
el-e-venth	e-lev-enth
re-al-ign	re-a-lign
si-byl	sib-yl
pin-cushion	pin-cush-ion
e-ver-more	ev-er-more
ca-ta-l-ep-sy	cat-a-lep-sy
prop-el	pro-pel
wa-der	wad-er
ta-pi-o-ca	tap-i-o-ca
he-ron	her-on
in-dex-ing	indexing
conduct-ed	conducted
shand-y	shan-dy
se-is-mo-gram	seis-mo-gram
un-re-con-ciled	un-rec-on-ciled
tange-lo	tan-ge-lo
de-ter-mi-nis-tic	de-ter-min-is-tic
con-descend	con-de-scend
sta-ture	stat-ure
malle-a-ble	mal-le-a-ble
ca-sh-ier	cash-ier
preb-end-ar-y	preb-en-dar-y
lop-sided	lop-sid-ed
i-sosce-les	i-sos-ce-les
legend	leg-end
em-bass-y	em-bas-sy
a-t-a-vis-tic	at-a-vis-tic
gyra-tion	gy-ra-tion
fuse-lage	fu-se-lage
blasphe-my	blas-phe-my
re-sult-ing	resulting
mis-s-pell	mis-spell
sab-er	sa-ber
mam-ma-l-i-an	mam-ma-li-an
erec-tile	e-rec-tile
se-mide-tached	sem-i-de-tached
com-par-a-bil-i-ty	com-pa-ra-bil-i-ty
pro-gressed	progressed
knuck-le-dus-t-er	knuck-le-dust-er
pun-y	pu-ny
em-ployee	em-ploy-ee
trans-pire	tran-spire
lux-u-r-i-ous	lux-u-ri-ous
com-prom-is-ing	com-pro-mis-ing
grie-v-ous-ly	griev-ous-ly
rec-on-fig-u-ra-tion	re-con-fig-u-ra-tion
over-in-flat-ed	o-ver-in-flat-ed
e-phor	eph-or
em-o-tive	e-mo-tive
pivot	piv-ot
tech-no-pho-bi-a	tech-no-pho-bia
in-ge-ni-ous-ly	in-gen-ious-ly
pol-y-and-ry	pol-y-an-dry
ha-track	hat-rack
rapeseed	rape-seed
mol-ester	mo-lest-er
cham-pion-ship	cham-pi-on-ship
where-soev-er	where-so-ev-er
metro-nome	met-ro-nome
rare-fied	rar-e-fied
cya-nide	cy-a-nide
arc-ing	arcing
tran-s-a-tlan-tic	trans-at-lan-tic
va-gue-ness	vague-ness
e-s-o-ter-ic	es-o-ter-ic
bastard	bas-tard
wun-derkind	wun-der-kind
mul-tip-li-ca-tion	mul-ti-pli-ca-tion
clink-ing	clin-king
chamf-er	cham-fer
un-mot-i-vat-ed	un-mo-ti-vat-ed
kwa-ch-a	kwa-cha
sickbed	sick-bed
rubbing	rub-bing
cas-ter	cast-er
un-an-i-mous-ly	u-nan-i-mous-ly
sa-tur-day	sat-ur-day
au-r-ic	au-ric
in-ex-or-a-ble	in-ex-o-ra-ble
bab-y-sit-ting	babysitting
mis-conduct	mis-con-duct
non-ethe-less	none-the-less
con-su-m-er-ism	con-sum-er-ism
fran-gi-pa-ni	fran-gi-pan-i
gran-ar-y	gra-na-ry
scal-ar	sca-lar
but-tressed	buttressed
lieute-nant	lieu-ten-ant
stin-gray	sting-ray
blowf-ly	blow-fly
a-r-ound	a-round
has-s-le	has-sle
dis-yl-lab-ic	di-syl-lab-ic
sta-tute	stat-ute
gen-er-ic	ge-ner-ic
un-fru-it-ful	un-fruit-ful
quick-sil-v-er	quick-sil-ver
dais	da-is
ex-pe-r-i-en-tial	ex-pe-ri-en-tial
sheltered	shel-tered
level-head-ed	lev-el-head-ed
up-hea-val	up-heav-al
erad-i-cate	e-rad-i-cate
un-for-given	un-for-giv-en
pag-a-n-ism	pa-gan-ism
doc-trinaire	doc-tri-naire
con-val-es-cent	con-va-les-cent
u-ku-lele	u-ku-le-le
se-ren-dip-i-ty	ser-en-dip-i-ty
pho-toc-o-py	pho-to-cop-y
pleas-ura-ble	pleas-ur-a-ble
cove-nant	cov-e-nant
letharg-ic	le-thar-gic
pos-thu-mous	post-hu-mous
be-de-vil	be-dev-il
com-mis-sioned	commissioned
cuir-ass	cui-rass
in-ci-pient	in-cip-i-ent
of-fhand	off-hand
chau-vi-nis-tic	chau-vin-is-tic
ex-acting	ex-act-ing
rib-o-flav-in	ri-bo-fla-vin
tri-b-une	trib-une
clann-ish	clan-nish
en-treat-ing	entreating
so-lace	sol-ace
dis-ad-vant-age	dis-ad-van-tage
du-r-a-bil-i-ty	du-ra-bil-i-ty
char-wo-m-an	char-wom-an
sta-tue	stat-ue
meter	me-ter
shepherd-ess	shep-herd-ess
leng-th-en	length-en
con-sonant	con-so-nant
im-pro-per-ly	im-prop-er-ly
her-al-dry	her-ald-ry
e-th-os	e-thos
ex-pect-ed	expected
ta-bloid	tab-loid
an-throp-o-gen-ic	an-thro-po-gen-ic
ta-l-on	tal-on
wear-i-ness	wea-ri-ness
ni-hi-lis-tic	ni-hil-is-tic
bin-ar-y	bi-na-ry
feather-light	feath-er-light
junk-er	jun-ker
lam-plit	lamp-lit
stan-dard	stand-ard
measured	meas-ured
in-a-lien-a-ble	in-al-ien-a-ble
ar-mis-tice	ar-mi-stice
fi-n-al-i-ty	fi-nal-i-ty
meg-a-s-tar	meg-a-star
bluster-ing	blustering
sa-tel-lite	sat-el-lite
per-e-s-troika	pe-re-stroi-ka
toil-et	toi-let
in-dec-o-r-ous	in-dec-o-rous
leisured	lei-sured
trans-crip-tion	tran-scrip-tion
re-vival-ism	re-viv-al-ism
epis-tem-o-log-i-cal	e-pis-te-mo-log-i-cal
iso-th-er-mal	i-so-ther-mal
leo-tard	le-o-tard
kiw-i	ki-wi
se-ni-or	sen-ior
un-fa-thom-a-ble	un-fath-om-a-ble
mother-stobe	mo-ther-stobe
glor-i-fy	glo-ri-fy
grou-pie	group-ie
en-dang-er	en-dan-ger
cath-eter	cath-e-ter
per-u-sal	pe-rus-al
cloth-es	clothes
te-e-to-tal	tee-to-tal
plu-mage	plum-age
su-per-bly	su-perb-ly
tri-bal	trib-al
sa-l-ar-y	sal-a-ry
dumpling	dump-ling
bur-sa-r-y	bur-sa-ry
par-li-a-ment	par-lia-ment
iso-lat-ing	i-so-lat-ing
di-ag-on-al-ly	di-ag-o-nal-ly
in-tert-wine	in-ter-twine
in-sa-ti-a-ble	in-sa-tia-ble
gang-ly	gan-gly
man-i-cured	ma-ni-cured
pur-g-a-tive	pur-ga-tive
con-gealed	congealed
deca-pod	dec-a-pod
is-o-bar	i-so-bar
mar-in-er	mar-i-ner
mis-doing	mis-do-ing
gra-ter	grat-er
lu-n-ate	lu-nate
psy-ch-o-log-i-cal-ly	psy-cho-log-i-cal-ly
pri-mar-y	pri-ma-ry
con-struc-ti-vist	con-struc-tiv-ist
tas-te-ful-ly	taste-ful-ly
he-l-i-o-t-rope	he-li-o-trope
mo-noto-nous	mo-not-o-nous
ar-sen-ic	ar-se-nic
kook-ab-ur-ra	kook-a-bur-ra
bar-ge-pole	barge-pole
fish-mong-er	fish-mon-ger
en-gin-eer-ing	en-gi-neer-ing
legal-ly	le-gal-ly
me-tal	met-al
vi-tri-ol	vit-ri-ol
fluent-ly	flu-ent-ly
guan-a-co	gua-na-co
bould-er	boul-der
ou-trank	out-rank
pi-e-t-y	pi-e-ty
an-ter-oom	an-te-room
tur-fy	turf-y
quer-y	que-ry
du-gout	dug-out
grill-ing	grilling
year-l-ing	year-ling
blunder-ing	blundering
crin-k-le	crin-kle
shi-p-own-er	ship-own-er
in-fras-truc-tur-al	in-fra-struc-tur-al
ap-ril	a-pril
trans-cen-den-tal	tran-scen-den-tal
flick-er-ing	flickering
ar-m-rest	arm-rest
mim-i-cry	mim-ic-ry
ta-r-iff	tar-iff
bluster-y	blus-ter-y
heifer	heif-er
jester	jest-er
for-er-un-ner	fore-run-ner
de-ca-dent	dec-a-dent
su-g-ar-y	sug-ar-y
waster	wast-er
re-stive	res-tive
spi-cy	spic-y
in-ter-re-l-ate	in-ter-re-late
nestling	nest-ling
crotch-e-ty	crotch-et-y
id-eal-is-tic	i-de-al-is-tic
forest-er	for-est-er
ar-ith-met-ic	a-rith-me-tic
la-rynx	lar-ynx
un-co-v-er	un-cov-er
plann-ing	plan-ning
pro-n-ounce	pro-nounce
laun-dered	laundered
sur-vi-val	sur-viv-al
pleat-ed	pleated
sis-s-y	sis-sy
be-li-ev-a-bil-i-ty	be-liev-a-bil-i-ty
som-e-day	some-day
sa-l-i-ent	sa-li-ent
dis-par-ate	dis-pa-rate
re-th-ink	re-think
un-i-on-ism	un-ion-ism
diehard	die-hard
con-descend-ing	con-de-scend-ing
dal-liance	dal-li-ance
con-serv-a-toire	con-ser-va-toire
priv-a-cy	pri-va-cy
fev-er	fe-ver
temp-tress	tempt-ress
sur-rog-a-cy	sur-ro-ga-cy
ideal-ism	i-de-al-ism
panz-er	pan-zer
re-cord-ed	re-cor-ded
un-dis-tribut-ed	un-dis-trib-ut-ed
a-toll	at-oll
rat-tles-nake	rat-tle-snake
pie-ce-meal	piece-meal
sem-ester	se-mes-ter
ple-bei-an	ple-be-ian
in-spec-to-rate	in-spec-tor-ate
com-ba-tive	com-bat-ive
mal-ig-nant	ma-lig-nant
foreleg	fore-leg
per-en-nial-ly	per-en-ni-al-ly
pur-po-sive	pur-pos-ive
spi-rit-u-al-ism	spir-it-u-al-ism
sol-di-er-ly	sol-dier-ly
pretend-ed	pre-tend-ed
fer-o-cious-ly	fe-ro-cious-ly
surp-lus	sur-plus
un-der-a-chi-eve-ment	un-der-a-chieve-ment
ig-u-a-na	i-gua-na
coex-ist-ent	co-ex-ist-ent
new-s-reel	news-reel
tas-ter	tast-er
thir-te-enth	thir-teenth
how-l-er	howl-er
scan-ti-ly	scant-i-ly
hil-lock	hill-ock
hier-ar-ch-i-cal	hi-er-ar-chi-cal
in-sou-ciant	in-sou-ci-ant
au-tho-ress	au-thor-ess
i-n-ure	in-ure
painter	paint-er
cove-tous	cov-et-ous
diff-er	dif-fer
sci-en-ti-f-ic	sci-en-tif-ic
tempting	tempt-ing
dare-de-vil	dare-dev-il
mang-er	man-ger
modem	mo-dem
bo-ny	bon-y
embed	em-bed
body-work	bod-y-work
dizz-y	diz-zy
western-er	west-ern-er
glis-t-en	glis-ten
so-ci-al-ite	so-cial-ite
ex-plo-i-ta-tion	ex-ploi-ta-tion
rare-fac-tion	rar-e-fac-tion
pa-geant	pag-eant
reus-a-ble	re-us-a-ble
spil-lage	spill-age
bet-wixt	be-twixt
vel-o-drome	ve-lo-drome
lux-ur-y	lux-u-ry
lemming	lem-ming
ma-d-ras	mad-ras
dinghy	din-ghy
jux-tapo-si-tion	jux-ta-po-si-tion
em-it	e-mit
par-a-chutist	par-a-chut-ist
cut-tlef-ish	cut-tle-fish
stif-fly	stiff-ly
re-public	re-pub-lic
ta-lent	tal-ent
car-pent-ry	car-pen-try
sa-tire	sat-ire
star-ga-z-er	star-gaz-er
bit-ters-weet	bit-ter-sweet
e-g-o-ma-ni-a	e-go-ma-ni-a
bar-bar-ous	bar-ba-rous
an-tic-li-max	an-ti-cli-max
refer-ee	ref-er-ee
crea-tiv-i-ty	cre-a-tiv-i-ty
sphyg-mom-a-nom-e-ter	sphyg-mo-ma-nom-e-ter
sport-s-wear	sports-wear
chrom-a-tog-ra-phy	chro-ma-tog-ra-phy
gadget	gadg-et
u-ni-den-ti-fi-a-ble	un-i-den-ti-fi-a-ble
re-alm	realm
her-bal-ist	herb-al-ist
con-volut-ed	con-vo-lut-ed
beat-i-fi-ca-tion	be-at-i-fi-ca-tion
in-fect-ed	in-fec-ted
ca-r-ol	car-ol
fev-er-ish-ly	fe-ver-ish-ly
cub-oid	cu-boid
im-per-so-na-tion	im-per-son-a-tion
de-caf-fei-nate	de-caf-fein-ate
ne-phew	neph-ew
devel-op-ment	de-vel-op-ment
co-di-cil	cod-i-cil
clemen-cy	clem-en-cy
go-v-er-nance	gov-ern-ance
lac-teal	lac-te-al
pro-ject	proj-ect
blessed	bless-ed
bi-ogra-pher	bi-og-ra-pher
im-provised	im-pro-vised
sea-m-an	sea-man
venue	ven-ue
new-s-room	news-room
pro-duct	prod-uct
un-it	u-nit
daf-fod-il	daf-fo-dil
si-len-c-er	si-lenc-er
di-ver-sif-i-ca-tion	di-ver-si-fi-ca-tion
con-sti-t-u-en-cy	con-stit-u-en-cy
cate-chism	cat-e-chism
rei-fy	re-i-fy
drudger-y	drudg-er-y
mag-ni-lo-quent	mag-nil-o-quent
dis-con-ti-nue	dis-con-tin-ue
ep-is-tem-ic	ep-i-ste-mic
ba-r-oque	ba-roque
frau-du-lent	fraud-u-lent
kedger-ee	ked-ger-ee
com-ple-men-tar-y	com-ple-men-ta-ry
pro-n-oun	pro-noun
un-mis-sa-ble	un-miss-a-ble
tri-tium	trit-i-um
gen-ea-log-i-cal	ge-ne-a-log-i-cal
dis-pen-sa-r-y	dis-pen-sa-ry
pil-gri-mage	pil-grim-age
cha-mo-m-ile	cham-o-mile
shiv-er-ing	shivering
sus-ten-ance	sus-te-nance
tech-no-phob-ic	tech-no-pho-bic
prove-nance	prov-e-nance
u-ni-ni-tiat-ed	un-in-i-ti-at-ed
ves-ti-gial	ves-tig-i-al
cru-elt-y	cru-el-ty
doc-tor-ing	doctoring
prof-i-t-a-bly	prof-it-a-bly
des-pise	de-spise
a-n-o-int	a-noint
u-ni-mag-i-na-ble	un-im-ag-i-na-ble
ri-o-tous	ri-ot-ous
in-cor-ri-g-i-ble	in-cor-ri-gi-ble
rec-i-tal	re-cit-al
edict	e-dict
un-scheduled	un-sched-uled
sun-tanned	suntanned
re-hear-sal	re-hears-al
ou-t-re-ach	out-reach
ca-gey	cag-ey
re-mar-ri-age	re-mar-riage
sau-s-age	sau-sage
cin-ema-tog-ra-pher	cin-e-ma-tog-ra-pher
law-su-it	law-suit
un-ack-nowledged	un-ac-knowl-edged
what-e-v-er	what-ev-er
ber-ate	be-rate
mogul	mo-gul
tran-s-verse	trans-verse
de-co	dec-o
prair-ie	prai-rie
me-tal-lur-gy	met-al-lur-gy
foun-d-ry	found-ry
rec-ti-li-near	rec-ti-lin-e-ar
num-b-er	num-ber
Words with errors: 1177
Words with incorrect number of syllables: 658
Total evluated: 6500
Perfect accuracy: 0.82
Number of syllables accuracy: 0.90
Average Levenshtein Distance(across incorrect words): 1.14
