Attempt	Real
whif-f	whiff
billing	bil-ling
crazi-ness	cra-zi-ness
in-es-timable	in-es-ti-ma-ble
s-tim-u-la-tor	stim-u-la-tor
nobly	no-bly
s-cor-pi-on	scor-pi-on
fly-over	fly-o-ver
syl-labus	syl-la-bus
aphe-lion	a-phe-li-on
poly-crys-talline	pol-y-crys-tal-line
nonen-ti-ty	non-en-ti-ty
mac-a-roni	mac-a-ro-ni
politic	pol-i-tic
im-pro-pri-ety	im-pro-pri-e-ty
bawdy	bawd-y
un-set-tling	unsettling
in-fre-quen-t	in-fre-quent
get-away	get-a-way
s-tub	stub
e-q-ui-tably	eq-ui-ta-bly
co-conut	co-co-nut
er-bium	er-bi-um
taskmas-ter	task-mas-ter
mesca-line	mes-ca-line
debtor	debt-or
ro-tary	ro-ta-ry
s-phyg-mo-manome-ter	sphyg-mo-ma-nom-e-ter
pira-cy	pi-ra-cy
over-shot	o-ver-shot
con-vivi-al-i-ty	con-viv-i-al-i-ty
re-mov-able	re-mov-a-ble
pro-ject-ed	projected
ex-ocrine	ex-o-crine
sus-pender-s	sus-pend-ers
hang-glid-ed	hang-gli-ded
sauna	sau-na
aver-sion	a-ver-sion
archetype	ar-che-type
trick-ery	trick-er-y
lu-mi-nary	lu-mi-nar-y
coau-thor	co-au-thor
elfin	elf-in
mil-lenar-i-an-is-m	mil-le-nar-i-an-ism
mag-netism	mag-net-ism
com-po-nen-t	com-po-nent
colos-sus	co-los-sus
sedi-tious	se-di-tious
far-m	farm
stripy	strip-y
s-lide	slide
ver-dic-t	ver-dict
pal-isade	pal-i-sade
reti-na	ret-i-na
declar-a-tive	de-clar-a-tive
y-achts-man	yachts-man
teardrop	tear-drop
anonymi-ty	an-o-nym-i-ty
crozi-er	cro-zier
omi-nous-ly	om-i-nous-ly
do-lor-ous	dol-or-ous
lethal	le-thal
p-re-sen-ta-tion	pres-en-ta-tion
mag-netron	mag-ne-tron
s-train	strain
monochro-mat-ic	mon-o-chro-mat-ic
roughage	rough-age
c-om-men-da-tion	com-men-da-tion
se-ca-teurs	sec-a-teurs
pro-boscis	pro-bos-cis
take-away	take-a-way
jiffy	jif-fy
over-rid-ing	o-ver-rid-ing
haver-sack	hav-er-sack
in-deco-rous	in-dec-o-rous
nitwit	nit-wit
pub-lished	published
in-flat-able	in-flat-a-ble
epis-tle	e-pis-tle
trans-fer-able	trans-fer-a-ble
un-in-ter-pretable	un-in-ter-pret-a-ble
chemise	che-mise
de-fec-t	de-fect
good-s	goods
n-u-mis-mat-ic	nu-mis-mat-ic
ure-thane	u-re-thane
gallery	gal-ler-y
u-n-ac-com-mo-dat-ing	un-ac-com-mo-dat-ing
en-comi-um	en-co-mi-um
corky	cork-y
liv-ery	liv-er-y
con-ver-gen-t	con-ver-gent
cashier	cash-ier
es-capis-m	es-cap-ism
carmine	car-mine
naive	na-ive
timid-i-ty	ti-mid-i-ty
struc-tural-ly	struc-tur-al-ly
rigid-i-ty	ri-gid-i-ty
s-tu-pe-fy	stu-pe-fy
par-lia-men-t	par-lia-ment
g-lut-ton	glut-ton
rafter	raft-er
an-niver-sary	an-ni-ver-sa-ry
preda-to-ry	pred-a-to-ry
sus-tain-abil-i-ty	sus-tain-a-bil-i-ty
e-ques-tri-an-is-m	e-ques-tri-an-ism
va-sec-to-my	vas-ec-to-my
walkover	walk-o-ver
dispir-it-ed	dis-pir-it-ed
hypochon-dri-a-cal	hy-po-chon-dri-a-cal
s-word	sword
over-heat-ed	overheated
s-plut-ter-ing	spluttering
at-tribu-tive	at-trib-u-tive
gigo-lo	gig-o-lo
ileum	il-e-um
de-con-struc-t	de-con-struct
in-erad-i-ca-ble	in-e-rad-i-ca-ble
tragedy	trag-e-dy
mar-quetry	mar-que-try
choco-late	choc-o-late
nadir	na-dir
s-tair-way	stair-way
an-throp-ic	an-thro-pic
mer-ri-men-t	mer-ri-ment
castof-f	cast-off
un-vary-ing	un-var-y-ing
co-ex-is-ten-t	co-ex-ist-ent
pro-pri-etor-ship	pro-pri-e-tor-ship
arachno-pho-bi-a	a-rach-no-pho-bi-a
over-sized	o-ver-sized
re-al-is-m	re-al-ism
iris	i-ris
regime	re-gime
clien-t	cli-ent
tel-l	tell
pli-able	pli-a-ble
hero-in	her-o-in
con-trac-t	con-tract
unlove-ly	un-love-ly
s-traw	straw
e-s-planade	es-pla-nade
speechi-fy-ing	speechifying
bene-fac-tor	ben-e-fac-tor
ir-ra-tional-ly	ir-ra-tion-al-ly
wind-surfer	wind-surf-er
pul-l	pull
guardian	guard-i-an
sub-servien-t	sub-ser-vi-ent
black-bal-l	black-ball
postlude	post-lude
thiev-ery	thiev-er-y
im-ple-menter	im-ple-ment-er
me-te-o-ro-log-i-cal	me-te-or-o-log-i-cal
thorny	thorn-y
i-n-ad-e-quate-ly	in-ad-e-quate-ly
s-tormy	storm-y
in-ces-t	in-cest
legate	leg-ate
hy-per-boloid	hy-per-bo-loid
ion-ic	i-on-ic
sober-ly	so-ber-ly
geni-i	ge-ni-i
specif-i-cal-ly	spe-cif-i-cal-ly
vol-ley-bal-l	vol-ley-ball
s-core-card	score-card
bac-carat	bac-ca-rat
u-n-ac-knowl-edged	un-ac-knowl-edged
s-melly	smell-y
hack-able	hack-a-ble
clavi-chord	clav-i-chord
over-due	o-ver-due
s-ti-fle	sti-fle
anger	an-ger
de-scen-t	de-scent
biom-e-try	bi-om-e-try
qui-es-cen-t	qui-es-cent
p-res-ence	pres-ence
buf-f	buff
im-pres-sion-able	im-pres-sion-a-ble
s-ports-man	sports-man
vil-lainy	vil-lain-y
gad-getry	gadg-et-ry
dis-ori-en-t	dis-o-ri-ent
in-ter-locu-to-ry	in-ter-loc-u-to-ry
piercer	pierc-er
im-moral-i-ty	im-mo-ral-i-ty
stere-o	ster-e-o
fundrais-ing	fund-rais-ing
lin-i-men-t	lin-i-ment
undis-cern-ing	un-dis-cern-ing
blither-ing	blith-er-ing
rent-ed	rented
taunt-ing	taunting
re-moval	re-mov-al
metempsy-chosis	me-tem-psy-cho-sis
onyx	on-yx
bari-tone	bar-i-tone
pro-tea	pro-te-a
con-dem-n	con-demn
cyn-i-cis-m	cyn-i-cism
san-i-tary	san-i-tar-y
lega-to	le-ga-to
dairy	dair-y
s-to-ical-ly	sto-i-cal-ly
es-capist	es-cap-ist
s-tran-gle-hold	stran-gle-hold
pro-pri-eto-ri-al	pro-pri-e-to-ri-al
dim-pled	dimpled
di-etet-ic	di-e-tet-ic
s-teel	steel
bloomer	bloom-er
lega-tor	le-ga-tor
tri-tium	trit-i-um
humbly	hum-bly
s-pade	spade
dance-able	dance-a-ble
u-nadul-ter-at-ed	un-a-dul-ter-at-ed
rock-ery	rock-er-y
mater	ma-ter
knick-er-s	knick-ers
totem	to-tem
farewell	fare-well
ob-serv-able	ob-serv-a-ble
dis-ar-m	dis-arm
gooey	goo-ey
baron-age	bar-on-age
re-cessed	recessed
lousy	lous-y
bevy	bev-y
meta-mor-phosed	metamorphosed
ex-pect-ed	expected
retry	re-try
deriva-tion	der-i-va-tion
forcible	for-ci-ble
cen-tau-r	cen-taur
ten-an-t	ten-ant
schemat-ic	sche-mat-ic
ex-e-cutable	ex-e-cut-a-ble
bug-gered	buggered
necrophil-i-a	nec-ro-phil-i-a
tractable	trac-ta-ble
satchel	satch-el
plebiscite	pleb-i-scite
dumb-bel-l	dumb-bell
gatepost	gate-post
aquar-i-um	a-quar-i-um
ease-men-t	ease-ment
brasserie	bras-se-rie
apoc-ryphal	a-poc-ry-phal
peremp-to-ry	per-emp-to-ry
monog-a-mous	mo-nog-a-mous
untest-ed	un-test-ed
cel-ery	cel-er-y
stew-ardess	stew-ard-ess
epi-gram	ep-i-gram
ir-rec-on-cil-able	ir-rec-on-cil-a-ble
para-psy-chol-o-gy	par-a-psy-chol-o-gy
coxswain	cox-swain
prece-dence	prec-e-dence
nec-es-sary	nec-es-sar-y
both-ered	bothered
damsel	dam-sel
s-tok-er	stok-er
ex-pand-able	ex-pand-a-ble
pout-ing	pouting
p-saltery	psal-ter-y
anony-mous	a-non-y-mous
run-t	runt
con-stituen-t	con-stit-u-ent
s-lip-way	slip-way
out-per-for-m	out-per-form
cre-ativ-i-ty	cre-a-tiv-i-ty
bracelet	brace-let
min-der	mind-er
pre-his-toric	pre-his-tor-ic
cheery	cheer-y
cam-panol-o-gy	cam-pa-nol-o-gy
con-veyanc-ing	con-vey-anc-ing
re-con-struc-t	re-con-struct
tourist	tour-ist
fid-gety	fidg-et-y
swasti-ka	swas-ti-ka
gelatin	gel-a-tin
seabed	sea-bed
un-equiv-o-cal	un-e-quiv-o-cal
de-tainee	de-tain-ee
avenge	a-venge
s-trand	strand
fun-da-men-tal-is-m	fun-da-men-tal-ism
gig-gling	giggling
melan-cholic	mel-an-chol-ic
k-ing-fish-er	king-fish-er
nympho-ma-ni-a	nym-pho-ma-ni-a
minu-ti-ae	mi-nu-ti-ae
de-cay-ing	decaying
jus-ti-fi-able	jus-ti-fi-a-ble
lib-er-al-is-m	lib-er-al-ism
elec-tron-ic	e-lec-tron-ic
un-suit-able	un-suit-a-ble
quirky	quirk-y
co-mestible	co-mes-ti-ble
s-light	slight
el-e-men-tary	el-e-men-ta-ry
pro-fes-sion-al-is-m	pro-fes-sion-al-ism
re-deemable	re-deem-a-ble
s-tor-age	stor-age
par-a-sitism	par-a-sit-ism
col-lapsi-ble	col-laps-i-ble
pres-tidig-i-ta-tion	pres-ti-dig-i-ta-tion
ex-tra-or-di-nary	ex-traor-di-nar-y
ap-petite	ap-pe-tite
skater	skat-er
s-ta-tion-mas-ter	sta-tion-mas-ter
teleprint-er	tel-e-print-er
lap-idary	lap-i-dar-y
viaduc-t	vi-a-duct
ma-tri-archy	ma-tri-ar-chy
whistler	whis-tler
potas-si-um	po-tas-si-um
salien-t	sa-li-ent
sergean-t	ser-geant
ban-knote	bank-note
c-on-cil-ia-to-ry	con-cil-i-a-to-ry
s-courge	scourge
worsted	wor-sted
tanker	tank-er
avun-cu-lar	a-vun-cu-lar
s-tate-less	state-less
aque-duc-t	aq-ue-duct
regress	re-gress
florin	flor-in
gud-geon	gudg-eon
translit-er-ate	trans-lit-er-ate
re-ver-ber-an-t	re-ver-ber-ant
im-mov-able	im-mov-a-ble
s-marten	smart-en
s-played	splayed
yel-lowed	yellowed
el-dest	eld-est
k-i-na	ki-na
as-sign-men-t	as-sign-ment
in-nu-mer-able	in-nu-mer-a-ble
frothy	froth-y
detox-i-fy	de-tox-i-fy
s-tran-gled	strangled
e-mol-u-men-t	e-mol-u-ment
frailty	frail-ty
pyra-can-tha	py-ra-can-tha
fur-rowed	furrowed
un-beat-able	un-beat-a-ble
em-bank-men-t	em-bank-ment
s-nug-gle	snug-gle
beamy	beam-y
unin-su-lat-ed	un-in-su-lat-ed
speci-fici-ty	spec-i-fic-i-ty
dol-l	doll
blos-som-ing	blossoming
an-tic-s	an-tics
pat-terned	patterned
lyrist	lyr-ist
s-tim-u-la-tion	stim-u-la-tion
sun-tanned	suntanned
lurid	lu-rid
con-sulate	con-su-late
antacid	ant-ac-id
schis-m	schism
comi-ty	com-i-ty
zany	za-ny
d-e-duce	de-duce
peachy	peach-y
relic-t	rel-ict
chameleon	cha-me-le-on
beanstalk	bean-stalk
the-saurus	the-sau-rus
un-hope-d	un-hoped
fal-ter-ing	fal-te-ring
hunter	hunt-er
lega-tion	le-ga-tion
be-fud-dling	befuddling
downy	down-y
saline	sa-line
apo-lit-i-cal	a-po-lit-i-cal
s-cold	scold
fil-i-buster	fil-i-bus-ter
man-telshelf	man-tel-shelf
readi-ness	read-i-ness
melod-ic	me-lod-ic
het-ero-dox	het-er-o-dox
pol-lard-ed	pollarded
rack-e-teer-ing	rack-et-eer-ing
avi-ate	a-vi-ate
lop-per-s	lop-pers
es-capade	es-ca-pade
in-flec-t	in-flect
reg-i-men-t	reg-i-ment
racial	ra-cial
ni-troge-nous	ni-trog-e-nous
cir-cum-ven-t	cir-cum-vent
em-place-men-t	em-place-ment
provider	pro-vid-er
brandy	bran-dy
premis-es	prem-is-es
mati-nee	mat-i-nee
stag-ger-ing	staggering
semide-tached	sem-i-de-tached
her-i-tabil-i-ty	her-it-a-bil-i-ty
u-nassertive	un-as-ser-tive
un-taugh-t	un-taught
buz-z	buzz
lofty	loft-y
in-trauter-ine	in-tra-u-ter-ine
dis-ar-ma-men-t	dis-ar-ma-ment
medic	med-ic
xeno-pho-bic	xen-o-pho-bic
s-ta-tus	sta-tus
ar-ma-men-t	ar-ma-ment
di-lata-tion	dil-a-ta-tion
rigid-ly	rig-id-ly
arthro-pod	ar-thro-pod
gam-bling	gam-bling
ful-l	full
aster-n	a-stern
acid	ac-id
de-ify	de-i-fy
lovesick	love-sick
shandy	shan-dy
per-me-abil-i-ty	per-me-a-bil-i-ty
steplad-der	step-lad-der
ide-al	i-de-al
fevered	fe-vered
d-e-ductible	de-duct-i-ble
grass-root-s	grass-roots
rock-fal-l	rock-fall
tribu-la-tion	trib-u-la-tion
hexagon	hex-a-gon
an-tithe-sis	an-tith-e-sis
so-ci-ety	so-ci-e-ty
prov-ably	prov-a-bly
temer-i-ty	te-mer-i-ty
big-otry	big-ot-ry
un-nerv-ing	unnerving
sev-ered	severed
deli	del-i
limpet	lim-pet
dairy-ing	dair-y-ing
ex-ploita-tive	ex-ploit-a-tive
be-wil-dered	bewildered
ax-iomat-ic	ax-i-o-mat-ic
re-dun-dan-t	re-dun-dant
pan-das	pan-das
pro-mul-gate	prom-ul-gate
poly-graph	pol-y-graph
tiller	till-er
vi-bran-t	vi-brant
emit	e-mit
brand-ing	branding
par-tici-ple	par-ti-ci-ple
s-teer-age	steer-age
en-joy-ably	en-joy-a-bly
us-abil-i-ty	us-a-bil-i-ty
manes	ma-nes
un-rea-son-ably	un-rea-son-a-bly
timer	tim-er
spec-troscopy	spec-tros-co-py
usu-ri-ous	u-su-ri-ous
ve-nial	ve-ni-al
dredger	dredg-er
en-vi-ron-men-tal-is-m	en-vi-ron-men-tal-ism
com-mon-s	com-mons
in-hab-i-tan-t	in-hab-it-ant
s-tar-lit	star-lit
grasshop-per	grass-hop-per
trans-ac-t	trans-act
ar-ran-t	ar-rant
neu-ro-science	neu-ro-sci-ence
s-teed	steed
patho-log-i-cal	path-o-log-i-cal
cleaver-s	cleav-ers
s-pank	spank
gra-tu-itous	gra-tu-i-tous
un-easi-ly	un-eas-i-ly
cliquey	cli-quey
springy	spring-y
pho-to-copi-er	pho-to-cop-i-er
rudi-men-ta-ry	ru-di-men-ta-ry
s-tiff	stiff
punch-line	punchline
wom-b	womb
over-al-l	o-ver-all
es-pi-onage	es-pi-o-nage
e-d-u-ca-tion	ed-u-ca-tion
wiper	wip-er
stron-groom	strong-room
s-trait-ened	strait-ened
un-stop-pable	un-stop-pa-ble
fiery	fier-y
racial-is-m	ra-cial-ism
re-for-esta-tion	re-for-est-a-tion
se-quoia	se-quoi-a
rein-sur-ance	re-in-sur-ance
soror-i-ty	so-ror-i-ty
un-change-able	un-change-a-ble
wiz-ardry	wiz-ard-ry
pectin	pec-tin
frosty	frost-y
avow	a-vow
s-nick	snick
seg-men-t	seg-ment
mis-s	miss
cud-gel	cudg-el
reprise	re-prise
oint-men-t	oint-ment
chamois	cham-ois
d-is-fig-ure	dis-fig-ure
palat-able	pal-at-a-ble
com-pe-ten-t	com-pe-tent
oc-cu-pan-t	oc-cu-pant
homage	hom-age
crys-talline	crys-tal-line
over-leaf	o-ver-leaf
doyen	doy-en
pot-tery	pot-ter-y
tu-ition	tu-i-tion
mis-judg-men-t	mis-judg-ment
no-body	no-bod-y
un-spen-t	un-spent
suit-abil-i-ty	suit-a-bil-i-ty
dis-con-nec-t	dis-con-nect
babysit-ting	babysitting
s-melt	smelt
aqualung	aq-ua-lung
in-tra-venous-ly	in-tra-ve-nous-ly
un-re-pairable	un-re-pair-a-ble
sexy	sex-y
athe-is-m	a-the-ism
nether	neth-er
af-fec-t	af-fect
sub-se-quen-t	sub-se-quent
dark-ened	dar-kened
scrolling	scroll-ing
g-lyph	glyph
jumper	jump-er
breathy	breath-y
un-en-durable	un-en-dur-a-ble
para-met-ric	par-a-met-ric
motet	mo-tet
u-n-ac-count-able	un-ac-count-a-ble
gas-work-s	gas-works
drea-ry	drear-y
ra-tio-nal-ly	ra-tion-al-ly
lapel	la-pel
un-ob-tain-able	un-ob-tain-a-ble
hon-esty	hon-es-ty
g-narled	gnarled
re-mark-able	re-mark-a-ble
pity	pit-y
podi-um	po-di-um
plea-sur-able	pleas-ur-a-ble
g-lycine	gly-cine
elec-tro-dy-nam-ic-s	e-lec-tro-dy-nam-ics
seizure	sei-zure
ap-praisal	ap-prais-al
colo-nial	co-lo-ni-al
drafty	draft-y
macroe-co-nom-ic	mac-ro-ec-o-nom-ic
o-vary	o-va-ry
over-view	o-ver-view
catch-men-t	catch-ment
s-low-ly	slow-ly
chop-s	chops
capri-ole	cap-ri-ole
lun-cheon	lunch-eon
semi-cir-cle	sem-i-cir-cle
gym-nas-tic-s	gym-nas-tics
suit-ably	suit-a-bly
charge-able	charge-a-ble
hege-mon-ic	heg-e-mon-ic
tes-ta-men-tary	tes-ta-men-ta-ry
ra-dio	ra-di-o
at-trac-t	at-tract
as-bestos	as-bes-tos
per-fec-tion-is-m	per-fec-tion-ism
bushy	bush-y
mono-syl-lab-ic	mon-o-syl-lab-ic
lender	lend-er
limekil-n	lime-kiln
coac-tion	co-ac-tion
flick-er-ing	flickering
eater	eat-er
deben-ture	de-ben-ture
drudgery	drudg-er-y
over-whelm	o-ver-whelm
k-ilo-byte	kil-o-byte
naughty	naugh-ty
in-dis-pens-able	in-dis-pen-sa-ble
mega-lith	meg-a-lith
satyr	sa-tyr
pro-fi-cien-t	pro-fi-cient
sandy	sand-y
wat-t	watt
i-n-ac-tive	in-ac-tive
chronome-ter	chro-nom-e-ter
monog-a-mous-ly	mo-nog-a-mous-ly
psy-chopathol-o-gy	psy-cho-pa-thol-o-gy
i-n-ac-ti-va-tion	in-ac-ti-va-tion
fetishis-tic	fet-ish-is-tic
over-dose	o-ver-dose
punter	punt-er
phrenol-o-gy	phre-nol-o-gy
trea-sonous	trea-son-ous
im-pe-cu-nious	im-pe-cu-ni-ous
ca-su-istry	cas-u-ist-ry
ir-rev-er-en-t	ir-rev-er-ent
s-tran-gles	stran-gles
un-read-able	un-read-a-ble
bindweed	bind-weed
hec-tor-ing	hectoring
testos-terone	tes-tos-ter-one
alone	a-lone
epi-demi-ol-o-gy	ep-i-de-mi-ol-o-gy
elec-trol-y-sis	e-lec-trol-y-sis
dis-cov-ery	dis-cov-er-y
g-lan-du-lar	glan-du-lar
stroller	stroll-er
s-tra-tum	stra-tum
gneis-s	gneiss
e-vic-t	e-vict
un-car-ed	un-cared
re-sis-tance	re-sist-ance
adult	a-dult
dis-com-fort-ing	discomforting
wastage	wast-age
in-di-vid-u-al-is-m	in-di-vid-u-al-ism
d-if-fer-ent-ly	dif-fer-ent-ly
en-doge-nous	en-dog-e-nous
s-car-i-ly	scar-i-ly
greasy	greas-y
p-light	plight
undis-turbed	un-dis-turbed
ex-cite-men-t	ex-cite-ment
graphite	graph-ite
legume	leg-ume
conifer	co-ni-fer
em-bit-tered	embittered
pre-dictably	pre-dict-a-bly
chee-ri-o	cheer-i-o
ex-huma-tion	ex-hu-ma-tion
un-palat-able	un-pal-at-a-ble
timetable	time-ta-ble
i-n-ac-cu-ra-cy	in-ac-cu-ra-cy
molyb-de-num	mo-lyb-de-num
weed-s	weeds
polypep-tide	pol-y-pep-tide
emit-ter	e-mit-ter
busk-ing	busking
so-porif-ic	sop-o-rif-ic
fatu-ous	fat-u-ous
spinach	spin-ach
gourmet	gour-met
overnight	o-ver-night
ureter	u-re-ter
climber	climb-er
land-fal-l	land-fall
ho-minid	hom-i-nid
tetrox-ide	te-trox-ide
provin-cial-is-m	pro-vin-cial-ism
stylist	styl-ist
castel-lat-ed	cas-tel-lat-ed
par-a-sitic	par-a-sit-ic
case-men-t	case-ment
u-n-am-bi-tious	un-am-bi-tious
tar-if-f	tar-iff
sor-cery	sor-cer-y
s-plat	splat
ar-rival	ar-ri-val
s-mock	smock
ev-ery-day	eve-ry-day
in-de-fin-able	in-de-fin-a-ble
s-coff-in-g	scoffing
wealthy	wealth-y
c-it-rus	cit-rus
cack-ling	cackling
s-pa-tial	spa-tial
crier	cri-er
delu-sive	de-lu-sive
oblo-quy	ob-lo-quy
spir-i-tu-al	spir-it-u-al
detri-men-tal	det-ri-men-tal
s-lop	slop
re-assess-men-t	re-as-sess-ment
hooky	hook-y
scrol-l	scroll
laud-s	lauds
loft-ed	lofted
post-mistress	post-mis-tress
warpath	war-path
ridicule	rid-i-cule
s-culp-tress	sculp-tress
tele-ol-o-gy	tel-e-ol-o-gy
tom-fool-ery	tom-fool-er-y
fizzy	fizz-y
erot-ic	e-rot-ic
katy-did	ka-ty-did
di-ana	di-an-a
homonym	hom-o-nym
copy-right	cop-y-right
fuz-z	fuzz
hail-stor-m	hail-storm
preterite	pret-er-ite
un-pre-dictably	un-pre-dict-a-bly
bio-chem-i-cal	bi-o-chem-i-cal
tur-f	turf
char-cu-terie	char-cu-te-rie
semi-con-duct-ing	sem-i-con-duct-ing
con-stan-t	con-stant
hawthorn	haw-thorn
iso-topic	i-so-top-ic
lazy-bones	la-zy-bones
sinewy	sin-ew-y
im-preg-nable	im-preg-na-ble
sem-i-nary	sem-i-nar-y
ego	e-go
florid	flor-id
parish	par-ish
glam-orous	glam-or-ous
as-cen-dan-t	as-cend-ant
cuprous	cu-prous
s-neer	sneer
heresy	her-e-sy
s-paced	spaced
re-in-state-men-t	re-in-state-ment
incog-ni-to	in-cog-ni-to
bas-ketry	bas-ket-ry
pen-i-ten-tiary	pen-i-ten-tia-ry
ri-ot-ing	ri-o-ting
warhorse	war-horse
avail	a-vail
re-fresh-men-t	re-fresh-ment
s-plin-t	splint
re-flec-t	re-flect
bizarre	bi-zarre
spon-ta-neous-ly	spon-ta-ne-ous-ly
ef-fron-tery	ef-fron-ter-y
feu-dal-is-m	feu-dal-ism
ex-pec-t	ex-pect
inkwell	ink-well
in-fec-t	in-fect
dis-able	dis-a-ble
antwer-p	antwerp
bub-blegum	bub-ble-gum
re-versible	re-vers-i-ble
un-der-cur-ren-t	un-der-cur-rent
pro-tease	pro-te-ase
de-liv-er-able	de-liv-er-a-ble
k-it	kit
chlo-ro-for-m	chlo-ro-form
mul-ti-lat-er-al-is-m	mul-ti-lat-er-al-ism
metro	met-ro
pre-dict-ed	predicted
catal-y-sis	ca-tal-y-sis
kril-l	krill
in-domitable	in-dom-i-ta-ble
obei-sance	o-bei-sance
in-hos-pitable	in-hos-pi-ta-ble
bil-liard-s	bil-liards
mil-lisec-ond	mil-li-sec-ond
zigza-g	zig-zag
trib-u-tary	trib-u-tar-y
vista	vis-ta
un-rea-son-able	un-rea-son-a-ble
para-nor-mal	par-a-nor-mal
in-de-clin-able	in-de-clin-a-ble
for-syth-ia	for-syth-i-a
ped-a-gogy	ped-a-go-gy
k-ing-dom	king-dom
dis-pos-able	dis-pos-a-ble
over-state	o-ver-state
pic-turesque	pic-tur-esque
sier-ra	si-er-ra
con-jec-tural	con-jec-tur-al
drink-able	drink-a-ble
v-ole	vole
sonorous	so-no-rous
in-gre-di-en-t	in-gre-di-ent
soft-bal-l	soft-ball
s-neaky	sneak-y
siren	si-ren
syn-ony-mous	syn-on-y-mous
scholas-ti-cis-m	scho-las-ti-cism
de-for-m	de-form
dessert	des-sert
s-ten-tor	sten-tor
the-atri-cal	the-at-ri-cal
io-dine	i-o-dine
un-de-ni-ably	un-de-ni-a-bly
catarrh	ca-tarrh
ap-proach-ing	approaching
s-trat-i-fi-ca-tion	strat-i-fi-ca-tion
tape-wor-m	tape-worm
ma-hogany	ma-hog-a-ny
bar-rack-s	bar-racks
capy-bara	cap-y-ba-ra
an-tipa-thet-ic	an-ti-pa-thet-ic
avari-cious	av-a-ri-cious
re-trench-men-t	re-trench-ment
hon-orif-ic	hon-or-if-ic
unso-cia-ble	un-so-cia-ble
bonus	bo-nus
tick-et-ed	ticketed
promp-t	prompt
pom-padour	pom-pa-dour
poster	post-er
cy-ber-net-ic-s	cy-ber-net-ics
tru-is-m	tru-ism
teth-er-ing	tethering
re-deemer	re-deem-er
un-sur-pass-able	un-sur-pass-a-ble
ex-plo-ration	ex-plo-ra-tion
tawny	taw-ny
area	ar-e-a
rein-ter-pre-ta-tion	re-in-ter-pre-ta-tion
duster	dust-er
s-mut	smut
un-shak-able	un-shak-a-ble
arise	a-rise
poly-chrome	pol-y-chrome
be-liev-able	be-liev-a-ble
re-trac-t	re-tract
dy-nasty	dy-nas-ty
ram-shackle	ram-shack-le
voyeuris-m	vo-yeur-ism
periglacial	per-i-gla-cial
saunter	saun-ter
pro-to-plas-m	pro-to-plasm
bion-ic	bi-on-ic
pharao-h	phar-aoh
aqua	aq-ua
herbage	herb-age
apery	ap-er-y
in-sou-ciance	in-sou-ci-ance
won-t	wont
sinker	sink-er
grainy	grain-y
over-re-ac-t	o-ver-re-act
can-ni-bal-is-m	can-ni-bal-ism
s-in-ful	sin-ful
se-nior-i-ty	sen-ior-i-ty
archer	arch-er
cop-pery	cop-per-y
s-car-f	scarf
v-enue	ven-ue
bleary	blear-y
polypho-ny	po-lyph-o-ny
u-p-lift-ed	uplifted
chuf-f	chuff
debu-tante	deb-u-tante
turnip	tur-nip
u-nimag-i-na-tive	un-im-ag-i-na-tive
rene-gade	ren-e-gade
timid-ly	tim-id-ly
ac-t	act
im-mutable	im-mu-ta-ble
en-fran-chise-men-t	en-fran-chise-ment
fri-ary	fri-ar-y
over-flow	o-ver-flow
haz-ardous	haz-ard-ous
s-tar-dom	star-dom
reac-cep-t	re-ac-cept
fo-lio	fo-li-o
sen-sa-tion-al-is-m	sen-sa-tion-al-ism
sep-a-ratism	sep-a-ra-tism
di-atom	di-a-tom
en-chant-men-t	en-chant-ment
shaven	shav-en
naugh-t	naught
s-pat-ter	spat-ter
de-flec-t	de-flect
harshen	harsh-en
d-i-nar	di-nar
clever	clev-er
crum-bling	crumbling
shaman-ic	sha-man-ic
vari-abil-i-ty	var-i-a-bil-i-ty
s-cup-per	scup-per
in-tu-itive-ly	in-tu-i-tive-ly
epiphe-nomenon	ep-i-phe-nom-e-non
in-di-can-t	in-di-cant
domi-no	dom-i-no
trea-sure	treas-ure
em-ploy-able	em-ploy-a-ble
vam-p	vamp
ir-ra-tional-i-ty	ir-ra-tion-al-i-ty
fem-i-nis-m	fem-i-nism
el-e-gan-t	el-e-gant
over-ac-tive	o-ver-ac-tive
ide-al-i-ty	i-de-al-i-ty
oop-s	oops
sewage	sew-age
y-owl	yowl
in-vest-men-t	in-vest-ment
windswep-t	wind-swept
s-tovepipe	stove-pipe
ex-tra-galac-tic	ex-tra-ga-lac-tic
in-tol-er-an-t	in-tol-er-ant
arable	ar-a-ble
propen-si-ty	pro-pen-si-ty
glassy	glass-y
pupil	pu-pil
ex-tra-ditable	ex-tra-dit-a-ble
un-treat-able	un-treat-a-ble
baguette	ba-guette
out-sel-l	out-sell
ax-e-man	axe-man
so-cio-bi-ol-o-gy	so-ci-o-bi-ol-o-gy
skul-l	skull
ashamed	a-shamed
place-bo	pla-ce-bo
nurs-ery-men	nurs-er-y-men
sand-piper	sand-pi-per
apolo-get-ic	a-pol-o-get-ic
any-thing	an-y-thing
repli-ca-ble	rep-li-ca-ble
ar-rester	ar-rest-er
in-frared	in-fra-red
bar-tender	bar-tend-er
re-pro-ducible	re-pro-duc-i-ble
apoplec-tic	ap-o-plec-tic
tetra-he-dron	tet-ra-he-dron
un-shaven	un-shav-en
freely	free-ly
heron-ry	her-on-ry
ques-tion-able	ques-tion-a-ble
saga-cious	sa-ga-cious
redac-tion	re-dac-tion
p-salmist	psalm-ist
es-sen-tial-is-m	es-sen-tial-ism
sud-s	suds
di-aphanous	di-aph-a-nous
epis-to-lary	e-pis-to-lar-y
in-ter-ac-t	in-ter-act
wether	weth-er
parachutist	par-a-chut-ist
rum-pled	rumpled
chary	char-y
an-nul-men-t	an-nul-ment
ex-tin-guish-men-t	ex-tin-guish-ment
pre-cau-tion-ary	pre-cau-tion-ar-y
mod-ernist	mod-ern-ist
fanci-er	fan-ci-er
prag-mat-ic-s	prag-mat-ics
laven-der	lav-en-der
ob-jec-t	ob-ject
s-cant	scant
s-peak	speak
liftof-f	lift-off
nor-m	norm
lodestar	lode-star
l-ynx	lynx
un-frozen	un-fro-zen
raven-ing	rav-en-ing
reac-qui-si-tion	re-ac-qui-si-tion
un-remit-ting	un-re-mit-ting
salience	sa-li-ence
con-strict-ed	constricted
daf-fodil	daf-fo-dil
clash-ing	clashing
com-modor-e	com-mo-dore
vis-ual	vis-u-al
cus-tody	cus-to-dy
patis-serie	pa-tis-se-rie
whizkid-s	whizkids
basin	ba-sin
glas-nos-t	glas-nost
ten-able	ten-a-ble
over-sim-pli-fy	o-ver-sim-pli-fy
pe-tit	pet-it
s-i-nu-soidal	si-nus-oi-dal
despo-tism	des-pot-ism
painter	paint-er
benefice	ben-e-fice
cladding	clad-ding
ep-ithe-li-um	ep-i-the-li-um
melee	me-lee
tarsal	tar-sal
arid	ar-id
sub-stan-dard	sub-stand-ard
napoleon	na-po-le-on
u-n-aid-ed	un-aid-ed
s-pa	spa
ra-bid	rab-id
gleam-ing	gleaming
lyri-cist	lyr-i-cist
d-e-fi-cien-cy	de-fi-cien-cy
un-pre-dictabil-i-ty	un-pre-dict-a-bil-i-ty
platy-pus	plat-y-pus
o-ver-seer	o-ver-se-er
un-trans-lat-able	un-trans-lat-a-ble
as-sess-men-t	as-sess-ment
fre-quen-t	fre-quent
wrestler	wres-tler
s-tore-room	store-room
mar-ketable	mar-ket-a-ble
tri-den-t	tri-dent
col-um-n	co-lumn
e-u-pho-ny	eu-pho-ny
pedol-o-gy	pe-dol-o-gy
s-tat-u-ary	stat-u-ar-y
bougainvil-lea	bou-gain-vil-le-a
woofer	woof-er
s-mug-gler	smug-gler
hand-cuf-f	hand-cuff
s-tran-gle	stran-gle
ma-joli-ca	ma-jol-i-ca
dis-cern-men-t	dis-cern-ment
fraud-u-len-t	fraud-u-lent
s-lay-ing	slay-ing
dis-agree	dis-a-gree
parochial	pa-ro-chi-al
doubter	doubt-er
con-sul-tan-t	con-sult-ant
be-fud-dled	befuddled
vir-ginal	vir-gin-al
in-de-cen-t	in-de-cent
p-re-sentable	pre-sent-a-ble
un-charis-mat-ic	un-char-is-mat-ic
warthog	wart-hog
cur-able	cur-a-ble
in-tox-i-can-t	in-tox-i-cant
dick-en-s	dick-ens
heron	her-on
s-tump	stump
u-n-avail-abil-i-ty	un-a-vail-a-bil-i-ty
e-quable	eq-ua-ble
meringue	me-ringue
bud-getary	budg-et-ar-y
respire	re-spire
skua	sku-a
leg-endary	leg-end-ar-y
de-viant	de-vi-ant
quain-t	quaint
re-tini-tis	ret-i-ni-tis
over-bear-ing	o-ver-bear-ing
astride	a-stride
s-corcher	scorch-er
war-ran-t	war-rant
polemic	po-lem-ic
ex-porter	ex-port-er
bedrock	bed-rock
phrase-ol-o-gy	phra-se-ol-o-gy
on-slaugh-t	on-slaught
baron	bar-on
colo-nial-ist	co-lo-ni-al-ist
achieve-men-t	a-chieve-ment
ob-scu-ran-tism	ob-scu-rant-ism
up-hol-stery	up-hol-ster-y
un-quench-able	un-quench-a-ble
pineal	pin-e-al
oblit-er-a-tion	ob-lit-er-a-tion
erad-i-cat-ed	e-rad-i-cat-ed
phys-io-ther-a-py	phys-i-o-ther-a-py
ir-rel-e-van-t	ir-rel-e-vant
s-tudy	stud-y
usurer	u-su-rer
au-dio	au-di-o
sub-trac-t	sub-tract
re-spon-den-t	re-spond-ent
renown	re-nown
mono-lay-er	mon-o-lay-er
over-crowd	o-ver-crowd
motile	mo-tile
meta-mor-phis-m	met-a-mor-phism
rhodo-den-dron	rho-do-den-dron
record-ed	re-cor-ded
polo-ni-um	po-lo-ni-um
er-r	err
iono-sphere	i-on-o-sphere
geo-phys-i-cal	ge-o-phys-i-cal
cordage	cord-age
treat-able	treat-a-ble
ei-de-t-ic	ei-det-ic
palmy	palm-y
nowhere	no-where
col-lec-tivist	col-lec-tiv-ist
doorstep	door-step
more-over	more-o-ver
reshow	re-show
re-tain-ing	retaining
bathrobe	bath-robe
s-traight-en	straight-en
trigonom-e-try	trig-o-nom-e-try
gavotte	ga-votte
dimer	di-mer
arm-s	arms
lazy	la-zy
dosage	dos-age
dev-il-men-t	dev-il-ment
syl-labary	syl-la-bar-y
prompter	prompt-er
skele-ton	skel-e-ton
mari-nade	mar-i-nade
table-cloth	ta-ble-cloth
de-lin-eate	de-lin-e-ate
reroute	re-route
bury	bur-y
rekin-dle	re-kin-dle
rooftop	roof-top
stylish-ly	styl-ish-ly
omen	o-men
wicked-ness	wick-ed-ness
wapi-ti	wap-i-ti
over-ca-pac-i-ty	o-ver-ca-pac-i-ty
deca-dence	dec-a-dence
break-able	break-a-ble
spir-i-tu-al-i-ty	spir-it-u-al-i-ty
re-sult-ing	resulting
s-linky	slink-y
un-so-licit-ed	un-so-lic-it-ed
de-sir-abil-i-ty	de-sir-a-bil-i-ty
elec-tro-stat-ic	e-lec-tro-stat-ic
tex-t	text
over-re-ac-tion	o-ver-re-ac-tion
c-om-mend-able	com-mend-a-ble
s-tark	stark
foren-sic	fo-ren-sic
heat-wave	heatwave
enor-mi-ty	e-nor-mi-ty
in-sulin	in-su-lin
ori-en-tal-is-m	o-ri-en-tal-ism
pilchard	pil-chard
dis-traugh-t	dis-traught
oafish	oaf-ish
mi-cro-bial	mi-cro-bi-al
de-mo-graph-ic-s	dem-o-graph-ics
sim-plis-m	sim-plism
sol-ven-t	sol-vent
tepid	tep-id
over-ly	o-ver-ly
api-ary	a-pi-ar-y
trace-abil-i-ty	trace-a-bil-i-ty
moldy	mold-y
join-ery	join-er-y
ine-bri-ate	in-e-bri-ate
un-abashed	un-a-bashed
di-achron-ic	di-a-chron-ic
vivid	viv-id
im-pru-den-t	im-pru-dent
unchris-tian	un-chris-tian
famine	fam-ine
in-tel-li-gen-t	in-tel-li-gent
think-able	think-a-ble
elec-tive	e-lec-tive
spir-i-tu-al-ist	spir-it-u-al-ist
suc-cinc-t	suc-cinct
con-ve-nient-ly	con-ven-ient-ly
yokel	yo-kel
en-joy-able	en-joy-a-ble
per-cip-i-en-t	per-cip-i-ent
c-og-nizan-t	cog-ni-zant
un-in-for-ma-tive	un-in-form-a-tive
ori-en-t	o-ri-ent
weari-ly	wea-ri-ly
marten	mar-ten
meta-mor-pho-sis	met-a-mor-pho-sis
b-otany	bot-a-ny
chival-rous	chiv-al-rous
poly-mor-phous	pol-y-mor-phous
l-o-gis-tic	lo-gis-tic
i-den-ti-fi-able	i-den-ti-fi-a-ble
op-er-cu-lum	o-per-cu-lum
pro-pri-etor	pro-pri-e-tor
omega	o-me-ga
silent-ly	si-lent-ly
pick-ax-e	pick-axe
aug-men-t	aug-ment
gassy	gas-sy
s-tar-board	star-board
dili-gen-t	dil-i-gent
s-nook-er	snook-er
mit-t	mitt
trea-sury	treas-ur-y
ro-den-t	ro-dent
makeweight	make-weight
s-taunch-ly	staunch-ly
sander	sand-er
muslin	mus-lin
recre-ation	rec-re-a-tion
psy-cho-me-t-ric	psy-cho-met-ric
su-per-posed	superposed
ev-ery-body	eve-ry-bod-y
in-abil-i-ty	in-a-bil-i-ty
loca-tive	loc-a-tive
in-ter-me-di-ary	in-ter-me-di-ar-y
cre-osote	cre-o-sote
sul-tana	sul-tan-a
monarch	mon-arch
dero-ga-tion	der-o-ga-tion
body	bod-y
horny	horn-y
pi-ran-ha	pi-ra-nha
s-meg-ma	smeg-ma
roller	roll-er
s-neak	sneak
prophe-cy	proph-e-cy
har-mo-nious-ly	har-mo-ni-ous-ly
method	meth-od
rap-proche-men-t	rap-proche-ment
para-graph	par-a-graph
e-quer-ry	eq-uer-ry
e-t-y-mo-log-i-cal	et-y-mo-log-i-cal
chanter	chant-er
taboo	ta-boo
menagerie	me-nag-er-ie
s-po-rad-i-cal-ly	spo-rad-i-cal-ly
lul-l	lull
re-in-stal-l	re-in-stall
re-cur-ren-t	re-cur-rent
whomev-er	whom-ev-er
h-es-i-tan-cy	hes-i-tan-cy
eu-kary-ote	eu-kar-y-ote
vo-cab-u-lary	vo-cab-u-lar-y
prosce-ni-um	pro-sce-ni-um
turntable	turn-ta-ble
lanky	lank-y
n-odal	nod-al
over-state-men-t	o-ver-state-ment
tapi-o-ca	tap-i-o-ca
man-darin	man-da-rin
in-com-men-su-rable	in-com-men-su-ra-ble
en-trench-men-t	en-trench-ment
huf-f	huff
i-n-alien-able	in-al-ien-a-ble
reper-toire	rep-er-toire
lovelorn	love-lorn
dizzi-ness	diz-zi-ness
cervix	cer-vix
bio-med-i-cal	bi-o-med-i-cal
premise	prem-ise
penance	pen-ance
mor-dan-t	mor-dant
over-print	o-ver-print
chronol-o-gy	chro-nol-o-gy
delin-quen-t	de-lin-quent
dahli-a	dahl-ia
evo-lute	ev-o-lute
min-istry	min-is-try
pro-ject-ing	projecting
n-erd	nerd
over-come	o-ver-come
hos-pitable	hos-pi-ta-ble
pastis	pas-tis
ir-re-versibly	ir-re-vers-i-bly
in-nard-s	in-nards
queru-lous	quer-u-lous
stinky	stink-y
in-dict-men-t	in-dict-ment
sever-i-ty	se-ver-i-ty
per-son-a	per-so-na
white-washed	whitewashed
fa-nati-cis-m	fa-nat-i-cism
s-light-ly	slight-ly
over-dra-mat-ic	o-ver-dra-mat-ic
an-tibi-ot-ic	an-ti-bi-ot-ic
savvy	sav-vy
sched-uler	sched-ul-er
m-nemon-ic-s	mne-mon-ics
re-volver	re-volv-er
con-stab-u-lary	con-stab-u-lar-y
height-ened	heightened
tri-umvi-rate	tri-um-vi-rate
lazuli	laz-u-li
crumbly	crum-bly
sewing	sew-ing
per-i	pe-ri
lazi-ly	la-zi-ly
glan-s	glans
ar-chi-tec-t	ar-chi-tect
click-ing	clicking
mi-cro-elec-tron-ic-s	mi-cro-e-lec-tron-ics
ar-ro-gan-t	ar-ro-gant
archdea-con	arch-dea-con
bom-bard-men-t	bom-bard-ment
su-per-fluity	su-per-flu-i-ty
um-bili-cus	um-bil-i-cus
l-iti-gious	li-ti-gious
joyride	joy-ride
erot-i-ca	e-rot-i-ca
ir-re-mov-able	ir-re-mov-a-ble
em-ployed	employed
in-vig-o-rat-ing	in-vig-or-at-ing
in-signif-i-can-t	in-sig-nif-i-cant
cat-a-com-b	cat-a-comb
con-vivial	con-viv-i-al
chill-ing	chilling
ap-pease-men-t	ap-pease-ment
her-b	herb
by-stander	by-stand-er
liar	li-ar
lugubri-ous	lu-gu-bri-ous
shim-mer-ing	shimmering
geisha	gei-sha
apolo-gia	ap-o-lo-gi-a
pulpy	pulp-y
s-can-ner	scan-ner
or-na-men-t	or-na-ment
leg-isla-tive	leg-is-la-tive
dogged-ly	dog-ged-ly
crevasse	cre-vasse
roundel	roun-del
dis-obe-di-en-t	dis-o-be-di-ent
spin-naker	spin-na-ker
sacra-men-t	sac-ra-ment
stinger	sting-er
back-wood-s	back-woods
ha-cien-da	ha-ci-en-da
clas-si-cis-m	clas-si-cism
s-trait-jack-et	strait-jack-et
rever-ie	rev-er-ie
m-is-for-tune	mis-for-tune
s-lap-stick	slap-stick
as-so-cia-tive	as-so-ci-a-tive
en-abled	e-na-bled
tat-ter-s	tat-ters
negate	ne-gate
grid-ded	gridded
in-ge-nious-ly	in-gen-ious-ly
apish	ap-ish
s-lushy	slush-y
sub-jec-tivis-m	sub-jec-tiv-ism
lisp-ing	lis-ping
reser-va-tion	res-er-va-tion
cater-er	ca-ter-er
for-get-table	for-get-ta-ble
wispy	wisp-y
recital	re-cit-al
postal	post-al
s-port-ing-ly	sport-ing-ly
fusil-lade	fu-sil-lade
thruster	thrust-er
need-s	needs
galleon	gal-le-on
cir-cum-lo-cu-to-ry	cir-cum-loc-u-to-ry
lu-bri-can-t	lu-bri-cant
wheezy	wheez-y
ap-point-men-t	ap-point-ment
any	an-y
ave	a-ve
apho-ris-m	aph-o-rism
midair	mid-air
so-bri-ety	so-bri-e-ty
gos-sipy	gos-sip-y
s-mog-gy	smog-gy
vari-cose	var-i-cose
va-porous	va-por-ous
cus-tom-ary	cus-tom-ar-y
over-play	o-ver-play
s-mooth-ness	smooth-ness
dis-mal-l-y	dis-mal-ly
coro-n-a	co-ro-na
wolfish	wolf-ish
i-nat-ten-tive	in-at-ten-tive
re-lax-ation	re-lax-a-tion
e-q-ui-table	eq-ui-ta-ble
prodi-gal	prod-i-gal
dili-gence	dil-i-gence
taffe-ta	taf-fe-ta
mishap	mis-hap
ex-oge-nous	ex-og-e-nous
stringer	string-er
b-land-ness	bland-ness
in-ter-po-lat-able	in-ter-po-la-ta-ble
crum-b	crumb
phys-iog-no-my	phys-i-og-no-my
chrono-graph	chron-o-graph
in-cip-i-en-t	in-cip-i-ent
bindery	bind-er-y
restart	re-start
dele-te-ri-ous	del-e-te-ri-ous
para-chute	par-a-chute
un-ordered	un-or-dered
s-lid-er	slid-er
re-pen-tan-t	re-pent-ant
squally	squal-ly
frica-tive	fric-a-tive
bi-sec-t	bi-sect
dyestuff	dye-stuff
unswerv-ing	un-swerv-ing
hazel-nut	ha-zel-nut
s-pace-ship	space-ship
vex-ing	vexing
den-tistry	den-tis-try
pol-luter	pol-lut-er
saucepan	sauce-pan
om-nipres-ence	om-ni-pres-ence
con-cate-nate	con-cat-e-nate
teenag-er	teen-ag-er
fit-men-t	fit-ment
drowsi-ness	drow-si-ness
con-ser-va-tive	con-serv-a-tive
s-pas-m	spasm
rapid	rap-id
vacu-ity	va-cu-i-ty
rainy	rain-y
bomb-shel-l	bomb-shell
aris-to-crat	a-ris-to-crat
presto	pres-to
rani	ra-ni
per-ma-nen-t	per-ma-nent
pream-pli-fi-er	pre-am-pli-fi-er
erased	e-rased
l-la-ma	lla-ma
tol-er-an-t	tol-er-ant
stapes	sta-pes
firmware	firm-ware
ripen	rip-en
ori-en-ta-tion	o-ri-en-ta-tion
com-plainan-t	com-plain-ant
cliffhang-er	cliff-hang-er
clink-ing	clin-king
eye-d	eyed
s-pas-mod-ic	spas-mod-ic
e-quip-men-t	e-quip-ment
baoba-b	ba-o-bab
car-roty	car-rot-y
reload	re-load
whim-per-ing	whimpering
chrono-log-i-cal	chron-o-log-i-cal
in-ter-de-pen-den-t	in-ter-de-pend-ent
pro-to-zoan	pro-to-zo-an
hul-l	hull
bullish	bull-ish
lam-plit	lamp-lit
con-se-quen-t	con-se-quent
wreck-ing	wrecking
shifter	shift-er
fes-ter-ing	festering
cheeky	cheek-y
in-con-gruity	in-con-gru-i-ty
mon-u-men-t	mon-u-ment
salty	salt-y
clank-ing	clan-king
ex-ploita-tion	ex-ploi-ta-tion
mimet-ic	mi-met-ic
uten-sil	u-ten-sil
porter	por-ter
ir-ra-tional	ir-ra-tion-al
dra-mat-ic-s	dra-mat-ics
res-onator	res-o-na-tor
longish	long-ish
mimicry	mim-ic-ry
spillage	spill-age
op-er-a-tional	op-er-a-tion-al
bereft	be-reft
atyp-i-cal	a-typ-i-cal
numb-skul-l	numb-skull
school-teacher	school-teach-er
sub-ur-b	sub-urb
driver-less	driv-er-less
avion-ic-s	a-vi-on-ics
triglyc-eride	tri-glyc-er-ide
retic-ule	ret-i-cule
pruri-en-t	pru-ri-ent
s-tand-by	stand-by
s-tate-hood	state-hood
voodoo	voo-doo
dis-parate	dis-pa-rate
dumb-found-ed	dumbfounded
based	based
trac-t	tract
retro-fit	ret-ro-fit
odd-s	odds
i-nani-ty	in-an-i-ty
un-ques-tion-ably	un-ques-tion-a-bly
edi-tion	e-di-tion
frat-ri-ci-dal	frat-ri-cid-al
triathlon	tri-ath-lon
army	ar-my
mys-tery	mys-ter-y
grad-u-al-is-m	grad-u-al-ism
legu-mi-nous	le-gu-mi-nous
fidu-cia-ry	fi-du-ci-ar-y
in-quisi-to-ri-al	in-quis-i-to-ri-al
s-park	spark
lazi-ness	la-zi-ness
fin-ery	fin-er-y
poly-no-mi-al	pol-y-no-mi-al
bio-sphere	bi-o-sphere
chore-o-graph-ic	cho-re-o-graph-ic
howler	howl-er
sub-scrip-t	sub-script
flus-tered	flustered
o-rang-utan	o-rang-u-tan
s-nooze	snooze
crusty	crust-y
s-mashed	smashed
az-imuth	az-i-muth
waspish	wasp-ish
polyun-sat-u-rat-ed	pol-y-un-sat-u-rat-ed
re-gret-table	re-gret-ta-ble
roof-in-g	roof-ing
s-tu-por	stu-por
l-itany	lit-a-ny
car-diac	car-di-ac
ex-cep-t	ex-cept
soli-tary	sol-i-tar-y
ar-ti-fi-cial-i-ty	ar-ti-fi-ci-al-i-ty
ragout	ra-gout
l-it-i-gan-t	lit-i-gant
re-uni-fi-ca-tion	re-u-ni-fi-ca-tion
tenor	ten-or
c-og-nizance	cog-ni-zance
or-ga-nize	or-gan-ize
s-caled	scaled
s-lan-der-ous	slan-der-ous
per-for-m	per-form
un-de-tectable	un-de-tect-a-ble
em-bar-rass-men-t	em-bar-rass-ment
in-her-i-ta-ble	in-her-it-a-ble
erec-t	e-rect
mu-nif-i-cen-t	mu-nif-i-cent
graphol-o-gy	graph-ol-o-gy
pe-ri-as-tron	per-i-as-tron
en-riched	enriched
patel-la	pa-tel-la
in-fir-mary	in-fir-ma-ry
cal-care-ous	cal-car-e-ous
hy-drome-chan-ic-s	hy-dro-me-chan-ics
jaz-z	jazz
s-lop-pi-ness	slop-pi-ness
bar-bel-l	bar-bell
crafty	craft-y
platelet	plate-let
evince	e-vince
pinkie	pink-ie
paean	pae-an
over-whelm-ing-ly	o-ver-whelm-ing-ly
pekan	pek-an
panoply	pan-o-ply
s-tark-ly	stark-ly
syn-chrony	syn-chro-ny
o-r-a-to-ri-o	or-a-to-ri-o
con-trivance	con-triv-ance
con-ti-nen-t	con-ti-nent
vi-o-len-t	vi-o-lent
prefer-men-t	pre-fer-ment
un-easi-ness	un-eas-i-ness
metas-ta-sis	me-tas-ta-sis
erad-i-ca-tion	e-rad-i-ca-tion
oa-sis	o-a-sis
frivol	friv-ol
even-tu-al	e-ven-tu-al
em-bo-som	em-bos-om
table-land	ta-ble-land
ter-ror-is-m	ter-ror-ism
tour-na-men-t	tour-na-ment
tremor	trem-or
rigid-i-fy	ri-gid-i-fy
s-trate-gic	stra-te-gic
tox-i-c	tox-ic
s-teer	steer
seclu-sion	se-clu-sion
over-draw	o-ver-draw
polyurethane	pol-y-u-re-thane
s-pam	spam
evil-do-er	e-vil-do-er
ex-per-i-menter	ex-per-i-ment-er
dimwit	dim-wit
un-clas-si-fi-able	un-clas-si-fi-a-ble
con-duc-tance	con-duct-ance
prof-itable	prof-it-a-ble
w-hole-heart-ed	whole-heart-ed
dipole	di-pole
psy-chopath	psy-cho-path
d-war-f	dwarf
rein-te-gra-tion	re-in-te-gra-tion
poly-atom-ic	pol-y-a-tom-ic
dis-agree-men-t	dis-a-gree-ment
syl-lo-gis-m	syl-lo-gism
spoilage	spoil-age
in-ho-mo-ge-neous	in-ho-mo-ge-ne-ous
shunter	shunt-er
undis-tin-guished	un-dis-tin-guished
pri-apic	pri-ap-ic
earplug	ear-plug
pave-men-t	pave-ment
dor-man-t	dor-mant
leviathan	le-vi-a-than
at-ten-dance	at-tend-ance
im-munol-o-gy	im-mu-nol-o-gy
lega-cy	leg-a-cy
id-io-cy	id-i-o-cy
encage	en-cage
s-tim-u-lat-ing	stim-u-lat-ing
triv-ial	triv-i-al
cat-tery	cat-te-ry
malaise	ma-laise
in-con-ve-nien-t	in-con-ven-ient
vi-o-l	vi-ol
sax-ony	sax-o-ny
s-later	slat-er
cycli-cal	cy-cli-cal
e-d-uca-tive	ed-u-ca-tive
iron-ic	i-ron-ic
scrib-bling	scribbling
in-sur-mount-able	in-sur-mount-a-ble
at-tack-ing	attacking
coloured	co-loured
rein-vest	re-in-vest
bat-ter-ing	battering
an-tipa-thy	an-tip-a-thy
cli-toris	clit-o-ris
in-her-i-tance	in-her-it-ance
an-thro-pocen-tric	an-thro-po-cen-tric
fever	fe-ver
s-ki	ski
over-grown	o-ver-grown
catas-tro-phe	ca-tas-tro-phe
awak-en	a-wak-en
undis-closed	un-dis-closed
iso-la-tion-is-m	i-so-la-tion-ism
sen-t	sent
rosy	ros-y
asleep	a-sleep
su-perbly	su-perb-ly
felo-nious	fe-lo-ni-ous
over-pow-er	o-ver-pow-er
de-nier	de-ni-er
renum-ber	re-num-ber
s-tair-head	stair-head
veni-son	ven-i-son
s-to-chas-tic	sto-chas-tic
petu-lance	pet-u-lance
ga-mete	gam-ete
seedy	seed-y
s-tay	stay
hep-tagon	hep-ta-gon
sub-servience	sub-ser-vi-ence
vir-u-len-t	vir-u-lent
ex-pe-di-en-t	ex-pe-di-ent
s-nide	snide
re-ceiv-able	re-ceiv-a-ble
cred-itable	cred-it-a-ble
retel-l	re-tell
grotesque	gro-tesque
crim-p	crimp
hookah	hook-ah
sur-viv-able	sur-viv-a-ble
maudlin	maud-lin
e-m-a-na-tion	em-a-na-tion
un-sol-d	un-sold
f-rigid	frig-id
re-state-men-t	re-state-ment
dis-tillery	dis-till-er-y
mist-imed	mis-timed
struc-tural	struc-tur-al
libero	li-be-ro
poros-i-ty	po-ros-i-ty
cougar	cou-gar
an-nu-ity	an-nu-i-ty
lam-ben-t	lam-bent
overop-ti-mistic	o-ver-op-ti-mis-tic
in-deli-ble	in-del-i-ble
penal-ty	pen-al-ty
ex-or-cis-m	ex-or-cism
table-ware	ta-ble-ware
over-worked	overworked
tele-gram	tel-e-gram
poly-mor-phis-m	pol-y-mor-phism
trans-portable	trans-port-a-ble
a-gen-t	a-gent
tightrope	tight-rope
needy	need-y
hor-mon-al	hor-mo-nal
di-eti-tian	di-e-ti-tian
s-ling	sling
kudu	ku-du
me-chan-ic-s	me-chan-ics
s-todgy	stodg-y
con-cor-dance	con-cord-ance
lin-eage	lin-e-age
painstak-ing-ly	pains-tak-ing-ly
mem-o-rable	mem-o-ra-ble
overt-ly	o-vert-ly
totemic	to-tem-ic
eon	e-on
despot-ic	des-pot-ic
en-rol-l	en-roll
radar	ra-dar
taster	tast-er
eleventh	e-lev-enth
pit-fal-l	pit-fall
hy-drangea	hy-dran-gea
verisimil-i-tude	ver-i-si-mil-i-tude
ephor	eph-or
s-tupid	stu-pid
fig-u-ra-tive-ly	fig-ur-a-tive-ly
erup-tion	e-rup-tion
rhetoric	rhet-o-ric
grassy	grass-y
serendip-i-tous	ser-en-dip-i-tous
py-rotech-nic	py-ro-tech-nic
cool-ing	cooling
re-pen-tance	re-pent-ance
s-tar	star
derelic-t	der-e-lict
in-audi-ble	in-au-di-ble
re-stric-t	re-strict
laud-able	laud-a-ble
oblate	ob-late
bul-letin	bul-le-tin
il-lu-mi-nan-t	il-lu-mi-nant
biomass	bi-o-mass
un-nec-es-sary	un-nec-es-sar-y
cob-we-b	cob-web
po-litesse	pol-i-tesse
v-in-tage	vin-tage
protest-ing	protesting
hero-ical-ly	he-ro-i-cal-ly
an-cien-t	an-cient
mis-in-for-m	mis-in-form
bil-l	bill
axle	ax-le
peanut	pea-nut
gan-g-ly	gan-gly
py-rotech-nic-s	py-ro-tech-nics
groovy	groov-y
sitar	si-tar
prof-itabil-i-ty	prof-it-a-bil-i-ty
re-liant	re-li-ant
o-nion	on-ion
quan-tifi-able	quan-ti-fi-a-ble
mono-ma-ni-a	mon-o-ma-ni-a
s-nowy	snow-y
in-vol-un-tary	in-vol-un-tar-y
weari-ness	wea-ri-ness
mod-ernism	mod-ern-ism
grand-par-en-t	grand-par-ent
largo	lar-go
enu-mer-a-tion	e-nu-mer-a-tion
sub-mersible	sub-mers-i-ble
lyri-cis-m	lyr-i-cism
suf-fragette	suf-fra-gette
viril-i-ty	vi-ril-i-ty
psy-chi-atric	psy-chi-at-ric
oblique	o-blique
piti-ful	pit-i-ful
wind-fal-l	wind-fall
m-i-lieu	mi-lieu
en-ter-tain-men-t	en-ter-tain-ment
slav-ery	slav-er-y
in-ter-ci-ty	in-ter-cit-y
may-oral-ty	may-or-al-ty
in-jury	in-ju-ry
beget	be-get
s-pore	spore
un-men-tion-able	un-men-tion-a-ble
her-itage	her-it-age
be-trothal	be-troth-al
im-per-fec-t	im-per-fect
lama	la-ma
di-a-betes	di-a-be-tes
scrupu-lous-ly	scru-pu-lous-ly
re-seller	re-sell-er
pro-tec-tion-is-m	pro-tec-tion-ism
pota-to	po-ta-to
dry-s-tone	dry-stone
there-about-s	there-a-bouts
or-nithol-o-gist	or-ni-thol-o-gist
e-u-phemisti-cal-ly	eu-phe-mis-ti-cal-ly
fri-able	fri-a-ble
dis-join-t	dis-joint
bound-ary	bound-a-ry
moun-taineer	moun-tain-eer
s-tud-ded	stud-ded
mea-sure-less	meas-ure-less
char-i-o-teer	char-i-ot-eer
crofter	croft-er
electable	e-lect-a-ble
repli-cate	rep-li-cate
nurs-ery-man	nurs-er-y-man
sleepi-ness	sleep-i-ness
spokesper-son	spokes-per-son
reify	re-i-fy
poly-cyclic	pol-y-cy-clic
teenaged	teen-aged
pam-phle-teer	pam-phlet-eer
minibus	min-i-bus
s-tac-ca-to	stac-ca-to
seedbed	seed-bed
bio-chemist	bi-o-chem-ist
hefty	heft-y
s-word-fish	sword-fish
carouse	ca-rouse
guano	gua-no
s-ports-wear	sports-wear
wari-ness	war-i-ness
facet	fac-et
un-drink-able	un-drink-a-ble
maser	ma-ser
curvi-lin-ear	cur-vi-lin-e-ar
lifebelt	life-belt
tran-scrip-t	tran-script
in-ter-cep-t	in-ter-cept
s-tand-stil-l	stand-still
founder	found-er
som-no-len-t	som-no-lent
lyric	lyr-ic
out-skirt-s	out-skirts
heraldic	he-ral-dic
hearthrug	hearth-rug
ob-struc-tion-is-m	ob-struc-tion-ism
post-mortem	post-mor-tem
s-melt-ing	smelting
s-corn-ful	scorn-ful
unchecked	un-checked
peas-antry	peas-ant-ry
piv-otal	piv-ot-al
cen-trifuge	cen-tri-fuge
er-ro-neous-ly	er-ro-ne-ous-ly
ge-nial	ge-ni-al
hilly	hill-y
k-in-folk	kin-folk
chester-field	ches-ter-field
beau-teous	beau-te-ous
drainage	drain-age
en-hancer	en-hanc-er
s-lick-er	slick-er
calami-ty	ca-lam-i-ty
or-biter	or-bit-er
in-spi-ra-tional	in-spi-ra-tion-al
palate	pal-ate
s-ly-ly	sly-ly
re-open	re-o-pen
kedgeree	ked-ger-ee
book-wor-m	book-worm
in-com-press-ible	in-com-press-i-ble
defuse	de-fuse
far-away	far-a-way
dis-mem-bered	dismembered
s-lash-er	slash-er
ra-j	raj
trouser-s	trou-sers
sen-ti-men-tal-is-m	sen-ti-men-tal-ism
babysit-ter	ba-by-sit-ter
unin-spir-ing	un-in-spir-ing
positron	pos-i-tron
dodgem	dodg-em
s-toa	sto-a
s-caly	scal-y
s-carce-ly	scarce-ly
in-ter-roga-to-ry	in-ter-rog-a-to-ry
de-ca-pod	dec-a-pod
s-now-drift	snow-drift
s-mog	smog
feb-ru-ary	feb-ru-ar-y
vanil-la	va-nil-la
pro-ceed-s	pro-ceeds
bond-ing	bonding
foot-balling	foot-ball-ing
solem-ni-ty	so-lem-ni-ty
odi-um	o-di-um
elec-tro-cu-tion	e-lec-tro-cu-tion
en-chan-t	en-chant
sacral	sa-cral
tele-graph	tel-e-graph
apol-o-gist	a-pol-o-gist
ion	i-on
brassy	brass-y
herbal-ist	herb-al-ist
mono-graph-ic	mon-o-graph-ic
avalanche	av-a-lanche
i-n-ad-mis-si-ble	in-ad-mis-si-ble
con-ducive	con-du-cive
donor	do-nor
ap-proval	ap-prov-al
un-gentle-man-ly	un-gen-tle-man-ly
lawyer	law-yer
high-t	hight
cres-cen-t	cres-cent
demo-crat-ic	dem-o-crat-ic
link-able	link-a-ble
re-formist	re-form-ist
night-fal-l	night-fall
brew-ery	brew-er-y
doyenne	doy-enne
tachy-on	tach-y-on
cari-bou	car-i-bou
lever	lev-er
sur-f	surf
us-able	us-a-ble
d-e-duc-tion	de-duc-tion
s-worn	sworn
psy-chother-a-py	psy-cho-ther-a-py
even	e-ven
con-ge-nial	con-gen-ial
painful	pain-ful
over-run	o-ver-run
ru-ined	ruined
s-ta-tis-tics	sta-tis-tics
in-con-ti-nen-t	in-con-ti-nent
pesti-len-tial	pes-ti-len-tial
payable	pay-a-ble
purga-tive	pur-ga-tive
decade	dec-ade
gree-nie	green-ie
lol-lipop	lol-li-pop
flautist	flau-tist
en-vi-able	en-vi-a-ble
seis-mome-ter	seis-mom-e-ter
demise	de-mise
sur-vival	sur-viv-al
se-quen-t	se-quent
moun-taineer-ing	moun-tain-eer-ing
galling	gall-ing
mist-ime	mis-time
refugee	ref-u-gee
cele-b	ce-leb
retroac-tive	ret-ro-ac-tive
trusty	trust-y
sober-ing	sobering
biorhyth-m	bi-o-rhythm
sycamore	syc-a-more
na-tion-al-is-m	na-tion-al-ism
lumpy	lump-y
mul-ti-pro-ces-sor	mul-ti-proc-es-sor
nico-tine	nic-o-tine
dyad	dy-ad
un-electable	un-e-lect-a-ble
het-erol-o-gous	het-er-ol-o-gous
hexag-o-nal	hex-ag-o-nal
y-outh	youth
er-ran-t	er-rant
rangy	rang-y
dy-namo	dy-na-mo
mis-sion-ary	mis-sion-ar-y
telling-ly	tell-ing-ly
shekel	shek-el
bap-tismal	bap-tis-mal
canopy	can-o-py
u-nar-guable	un-ar-gu-a-ble
mega	meg-a
ho-mo-mor-phis-m	ho-mo-mor-phism
im-peach-men-t	im-peach-ment
pedestal	ped-es-tal
en-able	en-a-ble
neo-prene	ne-o-prene
s-lant-wise	slant-wise
sec-ondary	sec-ond-ar-y
dy-namis-m	dy-na-mism
dauber	daub-er
mis-nomer	mis-no-mer
noisy	nois-y
li-brary	li-brar-y
pael-la	pa-el-la
stilet-to	sti-let-to
n-ev-er	nev-er
decla-ma-tion	dec-la-ma-tion
ca-su-al-ty	cas-u-al-ty
hermeneu-tic	her-me-neu-tic
aquiline	aq-ui-line
com-man-der	com-mand-er
longevi-ty	lon-gev-i-ty
po-ten-tial-i-ty	po-ten-ti-al-i-ty
broc-col-i	broc-co-li
in-con-tro-vert-ible	in-con-tro-vert-i-ble
charis-ma	cha-ris-ma
id-iot	id-i-ot
necro-mancer	nec-ro-man-cer
taxi-der-mist	tax-i-der-mist
se-mi	sem-i
s-cant-i-ly	scant-i-ly
s-cullery	scul-ler-y
s-cu-ba	scu-ba
blud-geon	bludg-eon
ini-tia-tive	in-i-ti-a-tive
lethar-gy	leth-ar-gy
tourni-quet	tour-ni-quet
chantry	chan-try
buri-al	bur-i-al
pep-pery	pep-per-y
cam-era-man	cam-er-a-man
synap-tic	syn-ap-tic
mildewy	mil-dew-y
turpi-tude	tur-pi-tude
para-sol	par-a-sol
medi-ocre	me-di-o-cre
foam-ing	foaming
treat-men-t	treat-ment
oblige	o-blige
cat-e-chis-m	cat-e-chism
squashy	squash-y
chemist	chem-ist
un-steady	un-stead-y
sunspot	sun-spot
g-nom-ic	gno-mic
apol-o-gize	a-pol-o-gize
s-ab-bath	sab-bath
ap-pli-can-t	ap-pli-cant
fein-t	feint
laud-ed	lauded
caviar	cav-i-ar
gantry	gan-try
re-stroom	rest-room
s-traight	straight
de-posi-tary	de-pos-i-tar-y
epic	ep-ic
con-fronta-tion-al	con-fron-ta-tion-al
s-porran	spor-ran
s-tranger	stran-ger
o-live	ol-ive
sig-nif-i-can-t	sig-nif-i-cant
prodi-gy	prod-i-gy
ri-boflavin	ri-bo-fla-vin
pla-gia-ris-m	pla-gia-rism
s-tur-geon	stur-geon
uri-nary	u-ri-nar-y
per-former	per-form-er
marzi-pan	mar-zi-pan
bearskin	bear-skin
turnout	turn-out
teenage	teen-age
coro-na-tion	cor-o-na-tion
heifer	heif-er
naive-ly	na-ive-ly
tenac-i-ty	te-nac-i-ty
as-sen-t	as-sent
delete	de-lete
mar-itime	mar-i-time
flip-pan-t	flip-pant
stealth-ily	stealth-i-ly
c-itadel	cit-a-del
ve-he-men-t	ve-he-ment
dis-burse-men-t	dis-burse-ment
un-solv-able	un-solv-a-ble
en-gi-neered	engineered
pro-cure-men-t	pro-cure-ment
broody	brood-y
de-con-struc-tive	deconstructive
re-vam-p	re-vamp
s-mite	smite
kerosene	ker-o-sene
ini-tia-tor	in-i-ti-a-tor
chro-mo-so-ma-l	chro-mo-so-mal
pan-golin	pan-go-lin
pirou-ette	pir-ou-ette
s-low-down	slow-down
cagey	cag-ey
re-searcher	re-search-er
por-phyry	por-phy-ry
con-tretemp-s	con-tre-temps
rata-touille	ra-ta-touille
s-nob	snob
s-trat-e-gy	strat-e-gy
roulette	rou-lette
in-cum-ben-t	in-cum-bent
elec-trode	e-lec-trode
torus	to-rus
d-if-fer-en-tial-ly	dif-fer-en-tial-ly
guilty	guilt-y
mistype	mis-type
origa-mi	o-ri-ga-mi
bur-nished	burnished
con-tender	con-tend-er
mul-ti-pro-cess-ing	mul-ti-proc-ess-ing
quotable	quot-a-ble
per-jury	per-ju-ry
rhap-sody	rhap-so-dy
can-tilever	can-ti-le-ver
con-sis-ten-t	con-sist-ent
mariner	mar-i-ner
cos-mopoli-tan	cos-mo-pol-i-tan
grenade	gre-nade
pro-tean	pro-te-an
meta-bol-ic	met-a-bol-ic
gullible	gul-li-ble
in-ter-vie-wee	in-ter-view-ee
comet	com-et
syn-di-cal-is-m	syn-di-cal-ism
defam-a-to-ry	de-fam-a-to-ry
de-nial	de-ni-al
quartzite	quartz-ite
un-abashed-ly	un-a-bash-ed-ly
necro-man-cy	nec-ro-man-cy
ro-mancer	ro-manc-er
p-re-s-e-lec-t	pre-se-lect
prophet-ic	pro-phet-ic
s-tud-ied	stud-ied
y-ours	yours
vol-can-is-m	vol-can-ism
deca-den-t	dec-a-dent
in-ter-preter	in-ter-pret-er
re-pairable	re-pair-a-ble
ter-rapin	ter-ra-pin
flesh-ing	fleshing
suprema-cy	su-prem-a-cy
in-fir-m	in-firm
s-ta-tis-ti-cal	sta-tis-ti-cal
per-fidy	per-fi-dy
te-dious	te-di-ous
eru-dite	er-u-dite
s-ca-lene	sca-lene
bonobo	bo-no-bo
open-er	o-pen-er
d-u-al-is-m	du-al-ism
o-cean-ic	o-ce-an-ic
blitzkrieg	blitz-krieg
mae-stro	maes-tro
u-nattrac-tive	un-at-trac-tive
unsweet-ened	un-sweet-ened
ari-a	a-ri-a
cam-panile	cam-pa-ni-le
prover-bial	pro-ver-bi-al
over-sleep	o-ver-sleep
fer-n	fern
gen-i-tali-a	gen-i-ta-li-a
dis-coun-t	dis-count
un-de-ni-able	un-de-ni-a-ble
aslan-t	a-slant
celi-bate	cel-i-bate
chromi-um	chro-mi-um
fruit-ing	fruiting
deci-bel	dec-i-bel
s-cabbed	scabbed
s-e-lec-tive-ly	se-lec-tive-ly
bad-ger	badg-er
ni-hilis-m	ni-hil-ism
he-do-nis-m	he-don-ism
tillage	till-age
he-li-copter	hel-i-cop-ter
break-away	break-a-way
s-ta-di-um	sta-di-um
fig-u-ra-tive	fig-ur-a-tive
papule	pap-ule
de-fer-men-t	de-fer-ment
carousel	car-ou-sel
wilder-ness	wil-der-ness
t-wo-some	two-some
misty	mist-y
vel-veteen	vel-vet-een
dirty	dirt-y
afraid	a-fraid
poly-merase	pol-y-mer-ase
pi-o-n	pi-on
s-core-board	score-board
yippee	yip-pee
elvish	elv-ish
hero-ine	her-o-ine
laun-derette	laun-der-ette
aster	as-ter
cochlea	coch-le-a
lava-to-ri-al	lav-a-to-ri-al
cloven	clo-ven
vivid-ly	viv-id-ly
duo-logue	du-o-logue
trade-marked	trademarked
para-noid	par-a-noid
re-mis-s	re-miss
b-e-fit	be-fit
hostel-ry	hos-tel-ry
vol-cano	vol-ca-no
record-ing	re-cord-ing
rein-vest-men-t	re-in-vest-ment
shoplift-ing	shop-lift-ing
med-dling	meddling
spinal	spi-nal
het-ero-sex-u-al	het-er-o-sex-u-al
blowfly	blow-fly
in-do-len-t	in-do-lent
k-lick	klick
jugu-lar	jug-u-lar
s-tair-well	stair-well
fold-ing	folding
diox-ide	di-ox-ide
s-low-poke	slow-poke
sec-toral	sec-tor-al
over	o-ver
s-cal-lop	scal-lop
cowslip	cow-slip
in-vari-able	in-var-i-a-ble
dea-coness	dea-con-ess
condi-men-t	con-di-ment
prodi-gious	pro-di-gious
pho-to-elec-tric	pho-to-e-lec-tric
bouf-fan-t	bouf-fant
in-ca-pable	in-ca-pa-ble
so-ci-etal	so-ci-e-tal
plover	plov-er
paci-fis-m	pac-i-fism
cashew	cash-ew
plan-e-tary	plan-e-tar-y
awry	a-wry
gable	ga-ble
paving	pav-ing
deroga-to-ry	de-rog-a-to-ry
com-man-dan-t	com-man-dant
s-low	slow
s-cud	scud
tasty	tast-y
u-niden-ti-fi-able	un-i-den-ti-fi-a-ble
un-al-ter-able	un-al-ter-a-ble
archival	ar-chi-val
s-norkel	snor-kel
ir-re-triev-able	ir-re-triev-a-ble
rock-et-ing	rocketing
pornog-ra-phy	por-nog-ra-phy
poly-he-dron	pol-y-he-dron
cupo-la	cu-po-la
s-parkler	spar-kler
de-jec-t	de-ject
gerund	ger-und
bla-tan-t	bla-tant
chaffinch	chaf-finch
burn-t	burnt
s-trate-gi-cal-ly	stra-te-gi-cal-ly
puma	pu-ma
hauli-er	haul-ier
any-way	an-y-way
bazooka	ba-zoo-ka
y-oung	young
epicy-cloid	ep-i-cy-cloid
lol-l	loll
al-ready	al-read-y
pa-tien-t	pa-tient
dom-i-nan-t	dom-i-nant
cu-rios-i-ty	cu-ri-os-i-ty
tawdry	taw-dry
frilly	frill-y
sisal	si-sal
neuter	neu-ter
defe-cate	def-e-cate
im-politic	im-pol-i-tic
trea-sur-er	treas-ur-er
vale-dic-tion	val-e-dic-tion
s-i-nus	si-nus
r-eread	re-read
repar-tee	rep-ar-tee
ex-trav-a-gan-t	ex-trav-a-gant
ephemer-a	e-phem-er-a
con-tour-ing	con-touring
con-tention	con-ten-tion
o-r-ange	or-ange
epi-dem-ic	ep-i-dem-ic
s-cathing	scath-ing
chiefly	chief-ly
friendlily	friend-li-ly
mis-aligned	mis-a-ligned
ho-muncu-lus	ho-mun-cu-lus
api-an	a-pi-an
in-ex-ac-t	in-ex-act
steadi-ness	stead-i-ness
sub-si-dence	sub-sid-ence
c-on-cil-i-ate	con-cil-i-ate
pho-tore-cep-tor	pho-to-re-cep-tor
hearti-ly	heart-i-ly
vicarage	vic-ar-age
beach-comber	beach-comb-er
in-valu-able	in-val-u-a-ble
mata-dor	mat-a-dor
je-junum	je-ju-num
dis-uni-ty	dis-u-ni-ty
fool-hardy	fool-har-dy
codling	cod-ling
ori-en-tal	o-ri-en-tal
elec-torate	e-lec-tor-ate
mauler	maul-er
quintessen-tial-ly	quin-tes-sen-tial-ly
spiky	spik-y
wis-p	wisp
s-mug-ness	smug-ness
Words with errors: 2270
Words with incorrect number of syllables: 2073
Total evluated: 6500
Perfect accuracy: 0.65
Number of syllables accuracy: 0.68
Average Levenshtein Distance(across incorrect words): 1.21
