Attempt	Real
un-afraid	un-a-fraid
mushy	mush-y
uni-formed	u-ni-formed
is-suer	is-su-er
book-able	book-a-ble
undi-min-ished	un-di-min-ished
again	a-gain
tem-pera-ment	tem-per-a-ment
penu-ri-ous	pe-nu-ri-ous
resur-face	re-sur-face
precinct	pre-cinct
cobalt	co-balt
epic	ep-ic
em-broi-dered	embroidered
provoca-tive-ly	pro-voc-a-tive-ly
lawyer	law-yer
singsong	sing-song
bather	bath-er
un-ten-able	un-ten-a-ble
satir-ic	sa-tir-ic
rar-efied	rar-e-fied
uni-lat-er-al-ism	u-ni-lat-er-al-ism
bes-tiary	bes-ti-ar-y
habi-ta-tion	hab-i-ta-tion
in-ge-nious-ly	in-gen-ious-ly
hi-jack-ing	hi-jac-king
remix	re-mix
print-able	print-a-ble
re-tiree	re-tir-ee
or-thorhom-bic	or-tho-rhom-bic
rel-a-tivism	rel-a-tiv-ism
sub-lu-nary	sub-lu-nar-y
coali-tion	co-a-li-tion
sys-temic	sys-tem-ic
pigsty	pig-sty
tem-po-rary	tem-po-rar-y
archdea-con	arch-dea-con
tillage	till-age
mica	mi-ca
misog-y-ny	mi-sog-y-ny
ridicu-lous-ness	ri-dic-u-lous-ness
irid-i-um	i-rid-i-um
rum-pled	rumpled
enig-ma	e-nig-ma
lever	lev-er
bushel	bush-el
pathogen	path-o-gen
playfel-low	play-fel-low
dreamy	dream-y
con-vert-ible	con-vert-i-ble
cologne	co-logne
en-er-getic	en-er-get-ic
con-toured	contoured
tuner	tun-er
he-do-nism	he-don-ism
any	an-y
foundry	found-ry
dado	da-do
opin-ion-at-ed	o-pin-ion-at-ed
un-ac-cept-ably	un-ac-cept-a-bly
re-pairable	re-pair-a-ble
con-sid-er-ably	con-sid-er-a-bly
re-porter	re-port-er
changeling	change-ling
recheck	re-check
an-tecedent	an-te-ced-ent
onion	on-ion
spher-oid	sphe-roid
seafood	sea-food
de-po-si-tion	dep-o-si-tion
ar-guably	ar-gu-a-bly
mas-cara	mas-car-a
brio	bri-o
ex-huma-tion	ex-hu-ma-tion
seis-mome-ter	seis-mom-e-ter
inat-ten-tion	in-at-ten-tion
valet	val-et
lazi-ness	la-zi-ness
uvu-lar	u-vu-lar
moun-taineer	moun-tain-eer
sportive	spor-tive
as-sured-ly	as-sur-ed-ly
in-ter-nu-clear	in-ter-nu-cle-ar
quiet-ness	qui-et-ness
uni-lat-er-al-ly	u-ni-lat-er-al-ly
vari-abil-i-ty	var-i-a-bil-i-ty
over-seas	o-ver-seas
sto-ical-ly	sto-i-cal-ly
laden	lad-en
cu-rat-ed	curated
mam-malian	mam-ma-li-an
deeply	deep-ly
mov-able	mov-a-ble
gillie	gil-lie
ex-oskele-ton	ex-o-skel-e-ton
tetra-he-dron	tet-ra-he-dron
sawmill	saw-mill
mis-er-able	mis-er-a-ble
tureen	tu-reen
radon	ra-don
lega-cy	leg-a-cy
muti-nous	mu-ti-nous
for-tu-itous-ly	for-tu-i-tous-ly
joyrid-ing	joy-rid-ing
masochist	mas-och-ist
econ-o-mist	e-con-o-mist
hexa-ne	hex-ane
foren-sic	fo-ren-sic
lyrist	lyr-ist
hy-drazine	hy-dra-zine
heron	her-on
scathing	scath-ing
un-frozen	un-fro-zen
leviathan	le-vi-a-than
vel-veteen	vel-vet-een
pauci-ty	pau-ci-ty
baby-ish	ba-by-ish
hubris	hu-bris
con-nect-ing	connecting
covert-ly	cov-ert-ly
lyri-cal	lyr-i-cal
reusable	re-us-a-ble
sou-venir	sou-ve-nir
canopy	can-o-py
mayflower	may-flow-er
spon-tane-ity	spon-ta-ne-i-ty
cam-panile	cam-pa-ni-le
stratos-pher-ic	strat-o-spher-ic
scrumhalf	scrum-half
coven	cov-en
ethol-o-gy	e-thol-o-gy
chid-ing	chiding
ca-su-istry	cas-u-ist-ry
pen-sion-able	pen-sion-a-ble
in-quiry	in-quir-y
meri-no	me-ri-no
scalar	sca-lar
iso-ton-ic	i-so-ton-ic
vi-t-a-min	vi-ta-min
falset-to	fal-set-to
abaft	a-baft
vil-lager	vil-lag-er
propen-si-ty	pro-pen-si-ty
sali-vate	sal-i-vate
dri-ve-way	drive-way
teenage	teen-age
ge-nom-ic	ge-no-mic
seal-ing	sealing
sunspot	sun-spot
sus-tain-ably	sus-tain-a-bly
heavy-weight	heav-y-weight
con-sulate	con-su-late
disin-gen-u-ous	dis-in-gen-u-ous
dairy-man	dair-y-man
un-du-lat-ing	undulating
baby	ba-by
pro-ce-du-ral-ly	pro-ce-dur-al-ly
im-pon-der-able	im-pon-der-a-ble
in-vol-un-tary	in-vol-un-tar-y
in-de-pen-dent	in-de-pend-ent
an-throp-ic	anthropic
kern-ing	kerning
bud-get	budg-et
tro-pos-phere	trop-o-sphere
duo	du-o
cognoscen-ti	co-gno-scen-ti
cus-tom-ary	cus-tom-ar-y
iron	i-ron
ora-tion	o-ra-tion
over	o-ver
climber	climb-er
re-align-ment	re-a-lign-ment
rata-touille	ra-ta-touille
askance	a-skance
islet	is-let
teleprint-er	tel-e-print-er
di-a-conal	di-ac-o-nal
un-vary-ing	un-var-y-ing
satrap	sa-trap
billing	bill-ing
poly-chrome	pol-y-chrome
the-atri-cals	the-at-ri-cals
un-re-li-able	un-re-li-a-ble
cas-tanets	cas-ta-nets
sophistry	soph-ist-ry
over-joyed	o-ver-joyed
pre-dictabil-i-ty	pre-dict-a-bil-i-ty
em-bed-d-a-ble	em-bed-da-ble
monar-chi-cal	mo-nar-chi-cal
pael-la	pa-el-la
autarchy	au-tar-chy
marzi-pan	mar-zi-pan
domi-cil-iary	dom-i-cil-i-ar-y
bud-getary	budg-et-ar-y
beachy	beach-y
dunghill	dung-hill
pu-rifi-ca-tion	pu-ri-fi-ca-tion
heady	head-y
aura	au-ra
thumbprint	thumb-print
iso-met-ric	i-so-met-ric
gazelle	ga-zelle
haver-ing	havering
idem	i-dem
windy	wind-y
aver-sion	a-ver-sion
paragon	par-a-gon
elastin	e-las-tin
in-ter-op-er-abil-i-ty	in-ter-op-er-a-bil-i-ty
nugget	nug-get
em-ployed	employed
rec-i-p-ro-cal	re-cip-ro-cal
pen-tame-ter	pen-tam-e-ter
shiv-ery	shiv-er-y
cre-ator	cre-a-tor
dis-claimer	dis-claim-er
peri-na-tal	per-i-na-tal
in-fi-deli-ty	in-fi-del-i-ty
chaos	cha-os
over-turn	o-ver-turn
duly	du-ly
poly-ester	pol-y-es-ter
rigid-i-fy	ri-gid-i-fy
quirky	quirk-y
sloven-ly	slov-en-ly
mul-ti-proces-sor	mul-ti-proc-es-sor
egre-gious	e-gre-gious
erad-i-cat-ed	e-rad-i-cat-ed
gra-tu-itous-ly	gra-tu-i-tous-ly
util-i-tar-i-an-ism	u-til-i-tar-i-an-ism
over-shoot	o-ver-shoot
over-cast	o-ver-cast
redi-rec-tion	re-di-rec-tion
ool-o-gy	o-ol-o-gy
haz-ardous	haz-ard-ous
im-pass-able	im-pass-a-ble
nonen-ti-ty	non-en-ti-ty
pro-tea	pro-te-a
halo	ha-lo
bo-som	bos-om
humbly	hum-bly
viceroy	vice-roy
bracelet	brace-let
mili-tia-man	mi-li-tia-man
re-ceiver-ship	re-ceiv-er-ship
sand-piper	sand-pi-per
gelig-nite	gel-ig-nite
para-dox-i-cal-ly	par-a-dox-i-cal-ly
over-fill	o-ver-fill
gut-sy	guts-y
grass-roots	grassroots
sewage	sew-age
rekin-dle	re-kin-dle
so-cio-bi-ol-o-gy	so-ci-o-bi-ol-o-gy
deu-teri-um	deu-te-ri-um
homonym	hom-o-nym
gherkin	gher-kin
bristly	bris-tly
fi-deli-ty	fi-del-i-ty
de-sir-abil-i-ty	de-sir-a-bil-i-ty
unin-spir-ing	un-in-spir-ing
labi-al	la-bi-al
wun-derkind	wun-der-kind
moder-ni-ty	mo-der-ni-ty
pesti-lent	pes-ti-lent
en-hancer	en-hanc-er
aster	as-ter
imag-i-nary	im-ag-i-nar-y
over-dose	o-ver-dose
tra-verse	trav-erse
cryp-tol-ogy	cryp-tol-o-gy
phonol-o-gy	pho-nol-o-gy
hori-zon	ho-ri-zon
con-vivial	con-viv-i-al
pre-his-toric	pre-his-tor-ic
im-pre-sario	im-pre-sa-ri-o
midair	mid-air
arranger	ar-rang-er
in-ca-pable	in-ca-pa-ble
telepa-thy	te-lep-a-thy
flow-ery	flow-er-y
anteater	ant-eat-er
panties	pant-ies
quencher	quench-er
wacky	wack-y
glaciat-ed	gla-ci-at-ed
drom-e-dary	drom-e-dar-y
catalep-sy	cat-a-lep-sy
yoga	yo-ga
playable	play-a-ble
taxi	tax-i
tai-lorable	tai-lor-a-ble
gad-get	gadg-et
rugged	rug-ged
un-awak-ened	un-a-wak-ened
chill-ing	chilling
imag-i-na-tion	im-ag-i-na-tion
heater	heat-er
on-toge-ny	on-tog-e-ny
builder	build-er
vig-i-lante	vig-i-lan-te
hexa-gon	hex-a-gon
herbal	herb-al
ty-pog-ra-phers	ty-po-gra-phers
her-i-ta-ble	her-it-a-ble
porno	por-no
ni-hilis-tic	ni-hil-is-tic
dan-de-lion	dan-de-li-on
plenum	ple-num
turmer-ic	tur-mer-ic
pes-simism	pes-si-mism
hy-drangea	hy-dran-gea
equi-lib-ri-um	e-qui-lib-ri-um
eeri-ly	ee-ri-ly
para-psy-chol-o-gy	par-a-psy-chol-o-gy
lyri-cist	lyr-i-cist
ego-tist	e-go-tist
nar-ra-tol-ogy	nar-ra-tol-o-gy
cine	cin-e
ca-reerist	ca-reer-ist
oldie	old-ie
mirac-u-lous	mi-rac-u-lous
flaky	flak-y
brava-do	bra-va-do
struc-tural-ism	struc-tur-al-ism
awry	a-wry
con-sis-ten-cy	con-sist-en-cy
my-opic	my-op-ic
de-posit	de-pos-it
rant-i-ng	ranting
odor-ous	o-dor-ous
labyrinth	lab-y-rinth
sickbed	sick-bed
classy	class-y
hauli-er	haul-ier
ju-bilee	ju-bi-lee
or-ga-nize	or-gan-ize
frip-pery	frip-per-y
radar	ra-dar
star-tled	startled
catheter	cath-e-ter
demigod	dem-i-god
dis-qui-etude	dis-qui-e-tude
bluesy	blues-y
in-ho-mo-ge-neous	in-ho-mo-ge-ne-ous
ref-er-ee-ing	refereeing
im-per-turbable	im-per-turb-a-ble
alone	a-lone
damni-fy	dam-ni-fy
athe-ism	a-the-ism
nega-tion	ne-ga-tion
in-ge-nu-ity	in-ge-nu-i-ty
res-cuer	res-cu-er
piezo-elec-tric	pi-e-zo-e-lec-tric
serendip-i-ty	ser-en-dip-i-ty
ni-hilist	ni-hil-ist
spo-radic	spo-rad-ic
lilac	li-lac
man-dolin	man-do-lin
elec-torate	e-lec-tor-ate
whirlpool	whirl-pool
vet-eri-nary	vet-er-i-nar-y
baldy	bald-y
macrophage	mac-ro-phage
lucky	luck-y
squashy	squash-y
shep-herd-ing	shepherding
whoso-ev-er	who-so-ev-er
evac-u-a-tion	e-vac-u-a-tion
en-thralling	en-thral-ling
lantern	lan-tern
frozen	fro-zen
in-ves-tiga-tive	in-ves-ti-ga-tive
taskmas-ter	task-mas-ter
steady	stead-y
per-pe-tu-ity	per-pe-tu-i-ty
defy	de-fy
spir-i-tu-al-i-ty	spir-it-u-al-i-ty
pipeline	pipe-line
mari-nade	mar-i-nade
horsey	hors-ey
wordy	word-y
bad-minton	bad-min-ton
hys-te-ria	hys-te-ri-a
pro-tease	pro-te-ase
inca	in-ca
beamy	beam-y
metonymy	me-ton-y-my
ir-recov-er-able	ir-re-cov-er-a-ble
as-cen-dant	as-cend-ant
echid-na	e-chid-na
verdi-gris	ver-di-gris
peri-toneum	per-i-to-ne-um
blender	blend-er
poet	po-et
mimet-ic	mi-met-ic
im-ple-menter	im-ple-ment-er
lancet	lan-cet
pig-ment-ed	pigmented
com-man-der	com-mand-er
reawak-en	re-a-wak-en
poundage	pound-age
in-signif-i-cance	in-sig-nif-i-cance
vestry	ves-try
po-litesse	pol-i-tesse
petu-lance	pet-u-lance
vale-dic-tion	val-e-dic-tion
dele-te-ri-ous	del-e-te-ri-ous
gan-glion	gan-gli-on
at-trib-ut-able	at-trib-ut-a-ble
guano	gua-no
study	stud-y
polemi-cist	po-lem-i-cist
avenger	a-veng-er
beaver	bea-ver
un-ap-pre-cia-tive	un-ap-pre-ci-a-tive
in-ad-vis-able	in-ad-vis-a-ble
undis-tort-ed	un-dis-tort-ed
chrono-log-i-cal-ly	chron-o-log-i-cal-ly
stereo-typ-i-cal	ster-e-o-typ-i-cal
re-tal-ia-to-ry	re-tal-i-a-to-ry
sus-pend-ed	suspended
supra-na-tion-al	su-pra-na-tion-al
iden-ti-fi-able	i-den-ti-fi-a-ble
un-equiv-o-cal-ly	un-e-quiv-o-cal-ly
cele-ri-ac	ce-ler-i-ac
spokesper-son	spokes-per-son
stagfla-tion	stag-fla-tion
here-inafter	here-in-af-ter
pic-to-r-i-al	pic-to-ri-al
at-tribu-tive	at-trib-u-tive
lady	la-dy
amused	a-mused
unau-dit-ed	un-au-dit-ed
lancer	lanc-er
epi-demi-ol-o-gy	ep-i-de-mi-ol-o-gy
un-solv-able	un-solv-a-ble
perime-ter	pe-rim-e-ter
pastille	pas-tille
chimera	chi-me-ra
memo-r-i-al	me-mo-ri-al
raster	ras-ter
tanker	tank-er
downy	down-y
prece-dence	prec-e-dence
blither-ing	blith-er-ing
judo	ju-do
thievish	thiev-ish
legume	leg-ume
labur-num	la-bur-num
halo-gen	hal-o-gen
macro-eco-nom-ic	mac-ro-ec-o-nom-ic
pur-port-ed	purported
cheva-lier	chev-a-lier
sala-cious	sa-la-cious
su-per-nu-mer-ary	su-per-nu-mer-ar-y
mi-crowave	mi-cro-wave
taxi-der-mist	tax-i-der-mist
darter	dart-er
bul-gy	bulg-y
over-full	o-ver-full
pick-pock-et-ing	pickpocketing
rock-etry	rock-et-ry
doc-u-men-tary	doc-u-men-ta-ry
doorstop	door-stop
prison	pris-on
prophet-ic	pro-phet-ic
mis-aligned	mis-a-ligned
chamois	cham-ois
mal-adap-tive	mal-a-dap-tive
sub-unit	sub-u-nit
barom-e-ter	ba-rom-e-ter
coral	cor-al
suet	su-et
roomy	room-y
abil-i-ty	a-bil-i-ty
helpline	help-line
in-creduli-ty	in-cre-du-li-ty
patho-log-i-cal	path-o-log-i-cal
crisper	crisp-er
crys-talline	crys-tal-line
karate	ka-ra-te
ledger	ledg-er
bath-wa-ter	bathwater
chore-o-g-ra-ph-er	cho-re-og-ra-pher
gymkhana	gym-kha-na
tonal	ton-al
felon	fel-on
saki	sa-ki
drowsy	drow-sy
read-mis-sion	re-ad-mis-sion
so-cio-cul-tur-al	so-ci-o-cul-tur-al
fuzzy	fuzz-y
dis-penser	dis-pens-er
synapse	syn-apse
cor-re-spon-dence	cor-re-spond-ence
cur-able	cur-a-ble
galleon	gal-le-on
lounger	loung-er
turquoise	tur-quoise
bondage	bond-age
rick-ety	rick-et-y
steeply	steep-ly
mariner	mar-i-ner
basil-i-ca	ba-sil-i-ca
evan-gel-i-cal	e-van-gel-i-cal
propul-sion	pro-pul-sion
podgy	podg-y
virtue	vir-tue
peri	pe-ri
im-per-me-able	im-per-me-a-ble
over-dra-mat-ic	o-ver-dra-mat-ic
crock-ery	crock-er-y
li-oness	li-on-ess
song-writer	song-writ-er
horny	horn-y
in-signia	in-sig-ni-a
tribu-la-tion	trib-u-la-tion
macro	mac-ro
mi-cro-surgery	mi-cro-sur-ger-y
meta-mor-phic	met-a-mor-phic
equal-ly	e-qual-ly
in-con-ceiv-able	in-con-ceiv-a-ble
io-dine	i-o-dine
smithy	smith-y
shrub-bery	shrub-ber-y
rein-vent	re-in-vent
tiling	til-ing
there-upon	there-up-on
catal-y-sis	ca-tal-y-sis
cough-ing	coughing
bad-ger	badg-er
repro-bate	rep-ro-bate
li-censee	li-cen-see
ra-dio-car-bon	ra-di-o-car-bon
holis-ti-cal-ly	ho-lis-ti-cal-ly
cog-nizance	cog-ni-zance
re-vo-ca-tion	rev-o-ca-tion
pedi-gree	ped-i-gree
evade	e-vade
around	a-round
ig-neous	ig-ne-ous
junkie	junk-ie
pion	pi-on
sado-masochis-tic	sa-do-mas-o-chis-tic
di-etet-ic	di-e-tet-ic
yel-lowed	yellowed
leucine	leu-cine
pen-tathlon	pen-tath-lon
un-abashed	un-a-bashed
me-te-oric	me-te-or-ic
soloist	so-lo-ist
weightlift-ing	weight-lift-ing
pogrom	po-grom
overindul-gence	o-ver-in-dul-gence
hy-dropho-bic	hy-dro-pho-bic
crinkly	crin-kly
semi-cir-cle	sem-i-cir-cle
bradawl	brad-awl
busi-ly	bus-i-ly
sauer-kraut	sau-er-kraut
eti-quette	et-i-quette
saline	sa-line
col-liery	col-lier-y
teller	tell-er
nau-tilus	nau-ti-lus
linoleum	li-no-le-um
geo-chem-istry	ge-o-chem-is-try
rewrite	re-write
geo-syn-chro-nous	ge-o-syn-chro-nous
rephrase	re-phrase
timer	tim-er
im-mea-sur-able	im-meas-ur-a-ble
rep-til-ian	rep-til-i-an
diox-ide	di-ox-ide
aqua-ma-rine	aq-ua-ma-rine
measly	mea-sly
promis-cu-ous	pro-mis-cu-ous
bitmap	bit-map
man-i-cured	manicured
re-versible	re-vers-i-ble
icosa-he-dron	i-co-sa-he-dron
eu-pho-nious	eu-pho-ni-ous
faulty	fault-y
reac-cept	re-ac-cept
in-dis-putably	in-dis-put-a-bly
wildlife	wild-life
smirk-ing	smirking
man-darin	man-da-rin
florist	flo-rist
pseu-do-ny-mous	pseu-don-y-mous
un-sea-son-able	un-sea-son-a-ble
gooey	goo-ey
creaky	creak-y
jerky	jerk-y
tawdry	taw-dry
con-cor-dance	con-cord-ance
asun-der	a-sun-der
curvi-lin-ear	cur-vi-lin-e-ar
award	a-ward
catgut	cat-gut
trouser	trou-ser
ringer	ring-er
porta-bil-i-ty	port-a-bil-i-ty
swinger	swing-er
facet	fac-et
specif-i-cal-ly	spe-cif-i-cal-ly
en-durable	en-dur-a-ble
medul-la	me-dul-la
beta	be-ta
poly-the-is-tic	pol-y-the-is-tic
gaiter	gait-er
pleas-antry	pleas-ant-ry
java	ja-va
pony	po-ny
scrib-bled	scribbled
ir-re-solv-able	ir-re-solv-a-ble
en-treaty	en-treat-y
artiste	ar-tiste
mighty	might-y
un-easi-ness	un-eas-i-ness
licorice	lic-o-rice
rev-erend	rev-er-end
boast-ing	boasting
prove-nance	prov-e-nance
crazi-ly	cra-zi-ly
quizzi-cal	quiz-zi-cal
greensward	green-sward
elec-tro-mag-net-ic	e-lec-tro-mag-net-ic
eigh-teenth	eight-eenth
nice-ty	ni-ce-ty
lega-tion	le-ga-tion
ravi-o-li	ra-vi-o-li
deco-rous	dec-o-rous
glut-to-nous	glut-ton-ous
pyra-mid	pyr-a-mid
mac-a-roni	mac-a-ro-ni
steely	steel-y
mono-phon-ic	mon-o-phon-ic
unan-swer-able	un-an-swer-a-ble
cygnet	cyg-net
erup-tion	e-rup-tion
damna-tion	dam-na-tion
biosyn-the-sis	bi-o-syn-the-sis
lemur	le-mur
rhap-sody	rhap-so-dy
chorale	cho-rale
chromite	chro-mite
busy	bus-y
per-fumery	per-fum-er-y
unlove-ly	un-love-ly
in-audi-ble	in-au-di-ble
mendele-vi-um	men-de-le-vi-um
metaphor	met-a-phor
stran-gled	strangled
malev-o-lence	ma-lev-o-lence
wel-com-ing	welcoming
hefty	heft-y
con-sum-able	con-sum-a-ble
over-step	o-ver-step
searcher	search-er
dig-ni-tary	dig-ni-tar-y
fron-tispiece	fron-tis-piece
forepaw	fore-paw
spir-i-tu-al-ist	spir-it-u-al-ist
car-bonyl	car-bon-yl
pizzi-ca-to	piz-zi-ca-to
pompous	pomp-ous
trick-ery	trick-er-y
con-for-mi-ty	con-form-i-ty
telekine-sis	tel-e-ki-ne-sis
post-mistress	post-mis-tress
maybe	may-be
mar-malade	mar-ma-lade
motet	mo-tet
top-sy-turvy	top-sy-tur-vy
scrolling	scroll-ing
smarten	smart-en
ex-trater-ri-to-r-i-al	ex-tra-ter-ri-to-ri-al
un-avail-able	un-a-vail-a-ble
dul-cimer	dul-ci-mer
amaz-ing	a-maz-ing
en-tropy	en-tro-py
courtship	court-ship
portage	por-tage
chameleon	cha-me-le-on
min-der	mind-er
rigid	rig-id
cowslip	cow-slip
suf-frag-ist	suf-fra-gist
valiant	val-iant
ga-lop	gal-op
sundry	sun-dry
brochure	bro-chure
opac-i-ty	o-pac-i-ty
gnom-ic	gno-mic
holy	ho-ly
whichev-er	which-ev-er
syn-chrony	syn-chro-ny
gaseous	gas-e-ous
nervy	nerv-y
elec-troen-cephalo-gram	e-lec-tro-en-ceph-a-lo-gram
stodgy	stodg-y
clemen-cy	clem-en-cy
ra-di-ogram	ra-di-o-gram
psalmist	psalm-ist
iron-work	i-ron-work
con-fronta-tion-al	con-fron-ta-tion-al
there-after	there-af-ter
largo	lar-go
decre-ment	dec-re-ment
palm-istry	palm-is-try
he-li-copter	hel-i-cop-ter
mono-chro-mat-ic	mon-o-chro-mat-ic
medusa	me-du-sa
roughage	rough-age
ra-dioac-tiv-i-ty	ra-di-o-ac-tiv-i-ty
ecol-o-gist	e-col-o-gist
pi-rat-ed	pirated
sec-re-tari-at	sec-re-tar-i-at
omis-sion	o-mis-sion
mono-lin-gual	mon-o-lin-gual
testos-terone	tes-tos-ter-one
wiring	wir-ing
en-dother-mic	en-do-ther-mic
masseur	mas-seur
de-pen-dent	de-pend-ent
apoc-a-lyp-tic	a-poc-a-lyp-tic
in-her-i-ta-ble	in-her-it-a-ble
eclec-tic	ec-lec-tic
tetra	tet-ra
peafowl	pea-fowl
con-cil-iar	con-cil-i-ar
rein-vig-o-rate	re-in-vig-or-ate
par-al-lelepiped	par-al-lel-e-pi-ped
di-lata-tion	dil-a-ta-tion
bel-liger-ent	bel-lig-er-ent
trum-peter	trum-pet-er
fuse-lage	fu-se-lage
salience	sa-li-ence
soda	so-da
ap-petite	ap-pe-tite
rein-ven-tion	re-in-ven-tion
empti-ness	emp-ti-ness
sub-ter-ranean	sub-ter-ra-ne-an
in-de-scrib-able	in-de-scrib-a-ble
along-side	a-long-side
minute-ly	mi-nute-ly
unre-deemed	un-re-deemed
iden-ti-ty	i-den-ti-ty
os-tracism	os-tra-cism
coupon	cou-pon
screen-writer	screen-writ-er
gu-ber-na-to-r-i-al	gu-ber-na-to-ri-al
prodi-gious	pro-di-gious
tele-graph-ic	tel-e-graph-ic
semi-fi-nal-ist	sem-i-fi-nal-ist
xeno-phobe	xen-o-phobe
ot-toman	ot-to-man
ex-clu-sion-ary	ex-clu-sion-ar-y
colony	col-o-ny
diskette	disk-ette
eman-ci-pa-tion	e-man-ci-pa-tion
qua-drat-ic	quad-rat-ic
teatime	tea-time
racial	ra-cial
un-re-mark-able	un-re-mark-a-ble
erec-tile	e-rec-tile
nephri-tis	ne-phri-tis
un-learned	un-learn-ed
elit-ist	e-lit-ist
polyandry	pol-y-an-dry
mod-ernism	mod-ern-ism
heron-ry	her-on-ry
atone	a-tone
se-nior-i-ty	sen-ior-i-ty
curly	curl-y
dis-heart-en-ing	disheartening
ra-di-og-ra-ph-er	ra-di-og-ra-pher
adapt	a-dapt
record-ed	recorded
chesty	chest-y
across	a-cross
brand-ed	branded
morale	mo-rale
de-odor-ant	de-o-dor-ant
warpath	war-path
un-sur-pass-able	un-sur-pass-a-ble
un-sa-vory	un-sa-vor-y
kook-abur-ra	kook-a-bur-ra
salmon	salm-on
fundrais-ing	fund-rais-ing
sepul-chral	se-pul-chral
molyb-de-num	mo-lyb-de-num
dis-plea-sure	dis-pleas-ure
electro-mechan-i-cal	e-lec-tro-me-chan-i-cal
ar-bi-trari-ness	ar-bi-trar-i-ness
puffy	puff-y
in-ter-vie-wee	in-ter-view-ee
trapeze	tra-peze
strate-gist	strat-e-gist
necrop-sy	nec-rop-sy
melan-choly	mel-an-chol-y
lim-iter	lim-it-er
re-pro-ducible	re-pro-duc-i-ble
gecko	geck-o
oval	o-val
prog-es-terone	pro-ges-ter-one
pur-veyance	pur-vey-ance
cladding	clad-ding
aor-tic	a-or-tic
re-versed	reversed
lily	lil-y
archer	arch-er
slimy	slim-y
pa-tois	pat-ois
backgam-mon	back-gam-mon
in-ter-lock-ing	interlocking
ni-hilism	ni-hil-ism
anom-aly	a-nom-a-ly
struc-tural-ly	struc-tur-al-ly
tingly	tin-gly
caramel	car-a-mel
zealotry	zeal-ot-ry
rob-bery	rob-ber-y
ringlet	ring-let
mazy	ma-zy
defam-a-to-ry	de-fam-a-to-ry
mio-sis	mi-o-sis
aplen-ty	a-plen-ty
scenic	sce-nic
trea-sury	treas-ur-y
rhetor-i-cal	rhe-tor-i-cal
hayloft	hay-loft
frigid	frig-id
over-board	o-ver-board
octet	oc-tet
ir-ra-tional-i-ty	ir-ra-tion-al-i-ty
ini-ti-a-tion	in-i-ti-a-tion
dosage	dos-age
over-coat	o-ver-coat
monarch	mon-arch
con-cil-ia-tor	con-cil-i-a-tor
war-rior	war-ri-or
boater	boat-er
bathrobe	bath-robe
si-nu-soid	si-nus-oid
head-mistress	head-mis-tress
styl-is-tics	sty-lis-tics
grassy	grass-y
pago-da	pa-go-da
upon	up-on
un-re-peat-able	un-re-peat-a-ble
naughty	naugh-ty
coinage	coin-age
cre-ation	cre-a-tion
sullen	sul-len
wether	weth-er
gal-lantry	gal-lant-ry
apoth-e-o-sis	a-poth-e-o-sis
beanstalks	bean-stalks
atri-um	a-tri-um
de-fines	def-ines
gad-getry	gadg-et-ry
fifty	fif-ty
di-ary	di-a-ry
scal-able	scal-a-ble
gelatin	gel-a-tin
blocky	block-y
psy-chopathol-o-gy	psy-cho-pa-thol-o-gy
be-wil-der-ing	bewildering
rever-ie	rev-er-ie
crino-line	crin-o-line
cleaver	cleav-er
im-porter	im-port-er
colo-nial	co-lo-ni-al
tur-bocharg-er	tur-bo-charg-er
sacra-men-tal	sac-ra-men-tal
wimpy	wimp-y
lacy	lac-y
bases	ba-ses
com-bi-na-to-r-i-al	com-bi-na-to-ri-al
ob-jec-tion-able	ob-jec-tion-a-ble
maul-ing	mauling
dairy-ing	dair-y-ing
en-force-able	en-force-a-ble
un-ortho-dox	un-or-tho-dox
scrapie	scrap-ie
mono-mi-al	mo-no-mi-al
evil-do-er	e-vil-do-er
toupee	tou-pee
ragged	rag-ged
gulli-bil-i-ty	gul-li-bil-i-ty
calorif-ic	cal-o-rif-ic
butch-ery	butch-er-y
fil-ial	fil-i-al
gelati-nous	ge-lat-i-nous
fruiter	fruit-er
cider	ci-der
bologna	bo-lo-gna
avens	av-ens
in-tractable	in-trac-ta-ble
here-upon	here-up-on
in-fir-mary	in-fir-ma-ry
colour	co-lour
galaxy	gal-ax-y
foolscap	fools-cap
un-con-tain-able	un-con-tain-a-ble
botanist	bot-a-nist
rapid-ly	rap-id-ly
malaise	ma-laise
seamy	seam-y
odor-if-er-ous	o-dor-if-er-ous
seaborne	sea-borne
penal-ty	pen-al-ty
re-tain-ing	retaining
thriller	thrill-er
delu-sion-al	de-lu-sion-al
bound-ary	bound-a-ry
ban-knote	bank-note
of-fend-ing	offending
the-atri-cal-ly	the-at-ri-cal-ly
chamomile	cham-o-mile
unim-paired	un-im-paired
fran-coph-o-ne	fran-co-phone
pe-trel	pet-rel
over-seer	o-ver-se-er
yeti	yet-i
bre-viary	bre-vi-ar-y
flut-tery	flut-ter-y
neo-phyte	ne-o-phyte
twisty	twist-y
mileage	mile-age
ten-antry	ten-ant-ry
caviar	cav-i-ar
re-assem-ble	re-as-sem-ble
imag-in-able	im-ag-i-na-ble
out-landish	out-land-ish
worka-day	work-a-day
whacko	whack-o
ovoid	o-void
genii	ge-ni-i
ridicule	rid-i-cule
equiv-o-ca-tion	e-quiv-o-ca-tion
fish-ery	fish-er-y
monog-a-mous	mo-nog-a-mous
methanol	meth-a-nol
sub-servient	sub-ser-vi-ent
idol-a-try	i-dol-a-try
fleshy	flesh-y
hedgerow	hedge-row
ghana	ghana
ten-able	ten-a-ble
atone-ment	a-tone-ment
cruller	crul-ler
showy	show-y
lega-to	le-ga-to
abalone	ab-a-lo-ne
isosce-les	i-sos-ce-les
bushy	bush-y
over-pow-er-ing	o-ver-pow-er-ing
jan-u-ary	jan-u-ar-y
ge-nial	ge-ni-al
breathy	breath-y
shipown-er	ship-own-er
shep-herdess	shep-herd-ess
teething	teeth-ing
overem-pha-sis	o-ver-em-pha-sis
melee	me-lee
grenadier	gren-a-dier
stu-dious-ly	stu-di-ous-ly
man-ager-ess	man-ag-er-ess
pineap-ple	pine-ap-ple
nobly	no-bly
phrase-ol-o-gy	phra-se-ol-o-gy
rewire	re-wire
sac-risty	sac-ris-ty
iso-mer	i-so-mer
lichen	li-chen
diminu-tion	dim-i-nu-tion
apart-ness	a-part-ness
open-ing	o-pen-ing
mi-croc-ode	mi-cro-code
joey	jo-ey
mem-o-rable	mem-o-ra-ble
laun-derette	laun-der-ette
hosan-na	ho-san-na
rip-pling	rippling
re-pro-ducibly	re-pro-duc-i-bly
an-tipodes	an-tip-o-des
us-abil-i-ty	us-a-bil-i-ty
ini-tia-tor	in-i-ti-a-tor
clin-i-cian	cli-ni-cian
de-tectably	de-tect-a-bly
sapi-ent	sa-pi-ent
cor-ti-cos-teroid	cor-ti-co-ster-oid
heart-en-ing	heartening
bilin-gual	bi-lin-gual
dis-may-ing	dismaying
im-pro-vi-sa-tion-al	im-prov-i-sa-tion-al
over-rate	o-ver-rate
silt-ing	silting
ide-ol-o-gy	i-de-ol-o-gy
ir-refutable	ir-ref-u-ta-ble
opin-ion	o-pin-ion
as-phyx-ia	as-phyx-i-a
bedrid-den	bed-rid-den
elon-gat-ed	e-lon-gat-ed
drifter	drift-er
lachry-mal	lach-ry-mal
pekan	pek-an
febrile	fe-brile
over-come	o-ver-come
beefeater	beef-eat-er
lessee	les-see
emit	e-mit
kudu	ku-du
ho-mo-pho-bia	ho-mo-pho-bi-a
ergo	er-go
wadding	wad-ding
castel-lat-ed	cas-tel-lat-ed
mu-cosa	mu-co-sa
racial-ism	ra-cial-ism
rubric	ru-bric
bleat-ing	bleating
cheery	cheer-y
ethno-graph-ic	eth-no-graph-ic
iso-la-tion	i-so-la-tion
id-iomat-ic	id-i-o-mat-ic
menu	men-u
pullover	pull-o-ver
rooi-bos	roo-i-bos
link-able	link-a-ble
emet-ic	e-met-ic
fontanel	fon-ta-nel
delir-i-um	de-lir-i-um
en-tourage	en-tou-rage
crater	cra-ter
desul-to-ry	des-ul-to-ry
epi-dem-ic	ep-i-dem-ic
phonon	pho-non
work-able	work-a-ble
ante	an-te
prairie	prai-rie
litur-gi-cal	li-tur-gi-cal
leapfrog	leap-frog
dri-vable	driv-a-ble
de-scen-dant	de-scend-ant
stingray	sting-ray
duet	du-et
glo-be-trot-ting	globe-trot-ting
pizze-ria	piz-ze-ri-a
hideous	hid-e-ous
co-eval	co-e-val
mea-sured	meas-ured
bedrag-gled	be-drag-gled
gratic-ule	grat-i-cule
grenade	gre-nade
con-tin-gency	con-tin-gen-cy
even-tide	e-ven-tide
retsi-na	ret-si-na
con-juror	con-ju-ror
elec-tro-car-dio-gram	e-lec-tro-car-di-o-gram
speechi-fy-ing	speechifying
ovary	o-va-ry
re-trieval	re-triev-al
de-gauss-ing	degaussing
pectin	pec-tin
facile	fac-ile
ine-bri-a-tion	in-e-bri-a-tion
cat-alyt-ic	cat-a-lyt-ic
tetrox-ide	te-trox-ide
user	us-er
ur-ticaria	ur-ti-car-i-a
ta-pes-try	tap-es-try
wretched	wretch-ed
postage	post-age
glia	gli-a
moral-ist	mor-al-ist
dis-pen-sary	dis-pen-sa-ry
oven	ov-en
grid-iron	grid-i-ron
dodger	dodg-er
dauphin	dau-phin
satirist	sat-i-rist
residue	res-i-due
whether	wheth-er
un-mis-tak-ably	un-mis-tak-a-bly
brainy	brain-y
dozen	doz-en
com-men-tary	com-men-tar-y
politic	pol-i-tic
gos-samer	gos-sa-mer
palati-nate	pa-lat-i-nate
delta	del-ta
va-pid	vap-id
babes	babes
layabout	lay-a-bout
dactyl	dac-tyl
anvil	an-vil
di-nosaur	di-no-saur
hyp-nother-a-py	hyp-no-ther-a-py
an-tithe-sis	an-tith-e-sis
stingy	stin-gy
deputy	dep-u-ty
erup-tive	e-rup-tive
di-arist	di-a-rist
atop	a-top
eva-sive	e-va-sive
asyn-chro-nous	a-syn-chro-nous
over-state-ment	o-ver-state-ment
hero-ical-ly	he-ro-i-cal-ly
aro-matic-i-ty	ar-o-ma-tic-i-ty
out-stretched	outstretched
read-just-ment	re-ad-just-ment
benef-i-cent	be-nef-i-cent
schoolmistress	school-mis-tress
springer	spring-er
ex-e-cutable	ex-e-cut-a-ble
bi-l-abi-al	bi-la-bi-al
mega-hertz	meg-a-hertz
mar-ketable	mar-ket-a-ble
florin	flor-in
over-ex-po-sure	o-ver-ex-po-sure
parish	par-ish
sniper	snip-er
de-nial	de-ni-al
pro-lapsed	prolapsed
erot-ic	e-rot-ic
aware-ness	a-ware-ness
prefa-to-ry	pref-a-to-ry
ur-gency	ur-gen-cy
bio-morph	bi-o-morph
semi-con-duct-ing	sem-i-con-duct-ing
foghorn	fog-horn
watch-able	watch-a-ble
epis-co-pate	e-pis-co-pate
ivy	i-vy
re-design	re-de-sign
burly	bur-ly
equal	e-qual
bur-ial	bur-i-al
suit-able	suit-a-ble
undig-ni-fied	un-dig-ni-fied
punky	punk-y
con-fus-able	con-fus-a-ble
un-be-liev-able	un-be-liev-a-ble
fever	fe-ver
dither	dith-er
biop-sy	bi-op-sy
im-per-son-ation	im-per-son-a-tion
hypocrisy	hy-poc-ri-sy
burn-ings	bur-nings
elec-tri-cal	e-lec-tri-cal
musty	mus-ty
ban-tamweight	ban-tam-weight
su-perla-tive	su-per-la-tive
saucer	sau-cer
copi-lot	co-pi-lot
mil-lenar-i-an	mil-le-nar-i-an
fussy	fuss-y
un-change-able	un-change-a-ble
maudlin	maud-lin
fever-ish-ly	fe-ver-ish-ly
friv-o-li-ty	fri-vol-i-ty
idler	i-dler
teeter	tee-ter
causal	caus-al
spir-i-tu-al-ly	spir-it-u-al-ly
stiffly	stiff-ly
un-shak-able	un-shak-a-ble
an-tifreeze	an-ti-freeze
pant-i-ng	pant-ing
med-icate	med-i-cate
crin-kled	crinkled
mati-nee	mat-i-nee
capri-ole	cap-ri-ole
sparkling	spar-kling
draftee	draft-ee
buildup	build-up
shoplift-ing	shop-lift-ing
mil-i-tarist	mil-i-ta-rist
junker	jun-ker
ex-tend-ing	extending
scoundrel	scoun-drel
flower	flow-er
plumba-go	plum-ba-go
desider-a-tum	de-sid-er-a-tum
may-oral-ty	may-or-al-ty
bridal	brid-al
ma-nia	ma-ni-a
ir-re-proach-able	ir-re-proach-a-ble
ape-ri-od-ic	a-pe-ri-od-ic
ide-o-logue	i-de-o-logue
foot-baller	foot-ball-er
reti-nal	ret-i-nal
ap-pari-tion	ap-pa-ri-tion
over-run	o-ver-run
dingy	din-gy
inat-ten-tive	in-at-ten-tive
lo-goff	log-off
both-ered	bothered
piety	pi-e-ty
banger	bang-er
mus-cu-loskele-tal	mus-cu-lo-skel-e-tal
delu-sion	de-lu-sion
com-forter	com-fort-er
peremp-to-ry	per-emp-to-ry
deci-bel	dec-i-bel
surfer	surf-er
re-cessed	recessed
unimag-in-able	un-im-ag-i-na-ble
over-e-mo-tion-al	o-ver-e-mo-tion-al
sepia	se-pi-a
frosty	frost-y
crispy	crisp-y
un-avail-abil-i-ty	un-a-vail-a-bil-i-ty
wardrobe	ward-robe
peren-ni-al-ly	per-en-ni-al-ly
aris-toc-ra-cy	ar-is-toc-ra-cy
monar-chy	mon-ar-chy
can-nery	can-ner-y
killer	kill-er
minke	min-ke
mor-phia	mor-phi-a
snif-fer	sniff-er
con-tigu-ous	con-tig-u-ous
mar-moset	mar-mo-set
place-bo	pla-ce-bo
re-cruiter	re-cruit-er
mela-tonin	mel-a-to-nin
hooray	hoo-ray
pa-pery	pa-per-y
sinewy	sin-ew-y
rur-al	ru-ral
physique	phy-sique
un-re-solv-able	un-re-solv-a-ble
sol-diery	sol-dier-y
con-gealed	congealed
sabo-teur	sab-o-teur
callable	call-a-ble
payable	pay-a-ble
over-sub-scribed	o-ver-sub-scribed
unedit-ed	un-ed-it-ed
oviduct	o-vi-duct
claus-tro-pho-bia	claus-tro-pho-bi-a
over-in-flat-ed	o-ver-in-flat-ed
ob-streper-ous	ob-strep-er-ous
jus-ti-fi-able	jus-ti-fi-a-ble
episod-ic	ep-i-sod-ic
cos-set-ed	cosseted
paraquat	par-a-quat
surgery	sur-ger-y
lament	la-ment
monomol-e-c-u-lar	mon-o-mo-lec-u-lar
in-ter-roga-to-ry	in-ter-rog-a-to-ry
taunt-ing	taunting
clat-ter-ing	cla-tter-ing
lu-mi-nary	lu-mi-nar-y
ex-plic-a-ble	ex-pli-ca-ble
de-pen-dence	de-pend-ence
july	ju-ly
vivid-ly	viv-id-ly
evan-ge-lism	e-van-ge-lism
ahead	a-head
dis-avow	dis-a-vow
ban-ter-ing	bantering
paren-the-sis	pa-ren-the-sis
vit-ri-olic	vit-ri-ol-ic
sta-tion-ary	sta-tion-ar-y
longish	long-ish
cast-away	cast-a-way
un-fa-mil-iar-i-ty	un-fa-mil-i-ar-i-ty
in-stan-ta-neous-ly	in-stan-ta-ne-ous-ly
body-build-ing	bod-y-build-ing
coac-tion	co-ac-tion
porter-age	por-ter-age
caliper	cal-i-per
reat-tempt	re-at-tempt
crooked	crook-ed
anorex-ic	an-o-rex-ic
bal-moral	bal-mor-al
epit-o-me	e-pit-o-me
to-bac-conist	to-bac-co-nist
baleen	ba-leen
break-away	break-a-way
hearty	heart-y
cedil-la	ce-dil-la
furtive-ly	fur-tive-ly
un-de-mo-c-ra-t-ic	un-dem-o-crat-ic
obelisk	ob-e-lisk
over-act-ing	overacting
wealthy	wealth-y
over-stretch	o-ver-stretch
duchess	duch-ess
sun-tanned	suntanned
sub-terfuge	sub-ter-fuge
re-cidi-vist	re-cid-i-vist
over-pay	o-ver-pay
dis-pens-able	dis-pen-sa-ble
ves-ti-gial	ves-tig-i-al
cochlea	coch-le-a
di-rec-to-r-i-al	di-rec-to-ri-al
dis-obey	dis-o-bey
mis-an-thropy	mis-an-thro-py
fetishism	fet-ish-ism
im-memo-r-i-al	im-me-mo-ri-al
sup-ple-men-tary	sup-ple-men-ta-ry
chiefly	chief-ly
bromine	bro-mine
mega-lo-ma-nia	meg-a-lo-ma-ni-a
im-pe-cu-nious	im-pe-cu-ni-ous
un-easi-ly	un-eas-i-ly
in-de-ter-minable	in-de-ter-mi-na-ble
crick-eter	crick-et-er
op-er-a-tional-ly	op-er-a-tion-al-ly
mil-i-taris-tic	mil-i-ta-ris-tic
torus	to-rus
geri-atrics	ger-i-at-rics
smelly	smell-y
tele-vise	tel-e-vise
sto-icism	sto-i-cism
cos-mopoli-tan	cos-mo-pol-i-tan
welling-ton	wel-ling-ton
over-spill	o-ver-spill
vol-cano	vol-ca-no
topo-graph-i-cal	top-o-graph-i-cal
palatal	pal-a-tal
carotid	ca-rot-id
imam	i-mam
ra-tio-nal-ly	ra-tion-al-ly
ra-tio-nal-ism	ra-tion-al-ism
hec-tor-ing	hectoring
rhubarb	rhu-barb
het-erol-o-gous	het-er-ol-o-gous
per-e-stroi-ka	pe-re-stroi-ka
etui	e-tui
ar-senic	ar-se-nic
ca-ress-ing	caressing
over-writ-ing	overwriting
oblig-a-tion	ob-li-ga-tion
zebu	ze-bu
or-biter	or-bit-er
volatil-i-ty	vol-a-til-i-ty
sycamore	syc-a-more
hardy	har-dy
dizzy	diz-zy
pan-icky	pan-ick-y
geron-toc-ra-cy	ger-on-toc-ra-cy
area	ar-e-a
over-haul	o-ver-haul
har-mo-nious-ly	har-mo-ni-ous-ly
video-con-fer-enc-ing	vid-e-o-con-fer-enc-ing
evis-cer-ate	e-vis-cer-ate
but-tery	but-ter-y
arachno-pho-bia	a-rach-no-pho-bi-a
translu-cen-cy	trans-lu-cen-cy
think-able	think-a-ble
un-wieldy	un-wield-y
telecom-mut-ing	telecommuting
mytho-log-i-cal	myth-o-log-i-cal
chary	char-y
briefer	brief-er
needy	need-y
pi-anola	pi-a-no-la
hawser	haw-ser
filet	fi-let
lisp-ing	lisping
re-vival-ism	re-viv-al-ism
dotage	dot-age
stipend	sti-pend
bio-chemist	bi-o-chem-ist
re-cov-er-able	re-cov-er-a-ble
re-assess-ment	re-as-sess-ment
rheuma-tism	rheu-ma-tism
brutish	brut-ish
spoilage	spoil-age
bac-carat	bac-ca-rat
un-de-cid-able	un-de-cid-a-ble
su-prema-cist	su-prem-a-cist
bul-letin	bul-le-tin
eval-u-a-tion	e-val-u-a-tion
er-ro-neous-ly	er-ro-ne-ous-ly
com-fort-ably	com-fort-a-bly
solemn	sol-emn
pantry	pan-try
enig-mat-ic	en-ig-mat-ic
rudi-men-ta-ry	ru-di-men-ta-ry
daisy	dai-sy
thiev-ery	thiev-er-y
quadru-ple	quad-ru-ple
min-istry	min-is-try
gerund	ger-und
pho-to-copy	pho-to-cop-y
avi-ate	a-vi-ate
trans-portable	trans-port-a-ble
poky	pok-y
pold-er	pol-der
reap-pear	re-ap-pear
para-troops	par-a-troops
ax-olotl	ax-o-lotl
oily	oil-y
dumpy	dump-y
poly-car-bon-ate	pol-y-car-bon-ate
sexy	sex-y
mer-curic	mer-cu-ric
lever-age	lev-er-age
stoma	sto-ma
gen-er-a-tional	gen-er-a-tion-al
elon-ga-tion	e-lon-ga-tion
hexa-gram	hex-a-gram
me-dieval	me-di-e-val
banker	bank-er
furtive	fur-tive
perky	perk-y
het-ero-sex-u-al-i-ty	het-er-o-sex-u-al-i-ty
unin-sured	un-in-sured
unas-sail-able	un-as-sail-a-ble
oxy-moron	ox-y-mo-ron
rasper	rasp-er
plucky	pluck-y
handrail	hand-rail
mo-men-tary	mo-men-tar-y
afraid	a-fraid
respire	re-spire
slinky	slink-y
iris	i-ris
breakup	break-up
di-uret-ic	di-u-ret-ic
poli-ty	pol-i-ty
mys-tery	mys-ter-y
de-posi-tary	de-pos-i-tar-y
em-broi-dery	em-broi-der-y
dud-geon	dudg-eon
non-con-for-mi-ty	non-con-form-i-ty
unassertive	un-as-ser-tive
avoid-ance	a-void-ance
mag-netron	mag-ne-tron
stargaz-er	star-gaz-er
re-cidi-vism	re-cid-i-vism
lad-dered	laddered
squeegee	squee-gee
cathar-tic	ca-thar-tic
in-ad-ver-tent-ly	in-ad-vert-ent-ly
hermeneu-tics	her-me-neu-tics
ha-track	hat-rack
earplug	ear-plug
dri-ving	driv-ing
es-pousal	es-pous-al
unau-then-ti-cat-ed	un-au-then-ti-cat-ed
cougar	cou-gar
ri-ot-ing	rioting
par-venu	par-ve-nu
who-dunit	who-dun-it
arabesque	ar-a-besque
trea-so-nous	trea-son-ous
mesca-line	mes-ca-line
lam-plit	lamp-lit
clam-p-down	clamp-down
bawl-ing	bawling
in-ter-galac-tic	in-ter-ga-lac-tic
cal-care-ous	cal-car-e-ous
cupo-la	cu-po-la
nascent	nas-cent
pan-theon	pan-the-on
even-tu-al-ly	e-ven-tu-al-ly
every-day	eve-ry-day
es-cha-tol-ogy	es-cha-tol-o-gy
posthu-mous-ly	post-hu-mous-ly
auburn	au-burn
aright	a-right
co-pro-lite	cop-ro-lite
reprise	re-prise
voodoo	voo-doo
privy	priv-y
di-aphragm	di-a-phragm
un-break-able	un-break-a-ble
im-peri-um	im-pe-ri-um
en-forcer	en-forc-er
in-con-gruity	in-con-gru-i-ty
conur-ba-tion	con-ur-ba-tion
high-lander	high-lan-der
kaolin	ka-o-lin
foible	foi-ble
aro-mather-a-py	a-ro-ma-ther-a-py
shad-owy	shad-ow-y
mar-riage-able	mar-riage-a-ble
uni-cel-lu-lar	u-ni-cel-lu-lar
in-ex-press-ible	in-ex-press-i-ble
diox-in	di-ox-in
di-choto-my	di-chot-o-my
dis-rep-utable	dis-rep-u-ta-ble
el-dest	eld-est
elec-table	e-lect-a-ble
unswerv-ing	un-swerv-ing
dis-heart-ened	disheartened
mossy	moss-y
dyer	dy-er
spaghet-ti	spa-ghet-ti
cylin-der	cyl-in-der
more-over	more-o-ver
union-ism	un-ion-ism
hu-manoid	hu-man-oid
shiny	shin-y
bigamy	big-a-my
easel	ea-sel
fo-liage	fo-li-age
squirearchy	squire-ar-chy
my-ocar-dial	my-o-car-di-al
man-nequin	man-ne-quin
foothill	foot-hill
lender	lend-er
con-cor-dant	con-cord-ant
pornog-ra-ph-er	por-nog-ra-pher
prowler	prowl-er
ini-ti-ate	in-i-ti-ate
dis-turbing-ly	dis-turb-ing-ly
meta-mor-phism	met-a-mor-phism
legroom	leg-room
overeat	o-ver-eat
briskly	brisk-ly
no-to-ri-ety	no-to-ri-e-ty
viril-i-ty	vi-ril-i-ty
mono-lith-ic	mon-o-lith-ic
rusty	rust-y
iden-ti-fy	i-den-ti-fy
repli-ca-tor	rep-li-ca-tor
inkwell	ink-well
colobus	col-o-bus
imag-ine	im-ag-ine
dili-gent	dil-i-gent
monogamy	mo-nog-a-my
fury	fu-ry
hero	he-ro
pyrite	py-rite
coxswain	cox-swain
share-able	share-a-ble
man-i-festo	man-i-fes-to
cas-sowary	cas-so-war-y
heretic	her-e-tic
de-lin-eate	de-lin-e-ate
in-vig-o-rate	in-vig-or-ate
obe-di-ent	o-be-di-ent
mega-phone	meg-a-phone
con-sor-tium	con-sor-ti-um
tricky	trick-y
pedant	ped-ant
broody	brood-y
maisonette	mai-son-ette
emen-da-tion	e-men-da-tion
boun-teous	boun-te-ous
restart	re-start
preter-nat-ur-al	pre-ter-nat-u-ral
di-achron-ic	di-a-chron-ic
hooli-gan	hoo-li-gan
beanstalk	bean-stalk
lessen	less-en
totem	to-tem
wil-lowy	wil-low-y
au-tonomous	au-ton-o-mous
flinch-ing	flinching
uvu-la	u-vu-la
iras-ci-ble	i-ras-ci-ble
para-dox	par-a-dox
eques-tri-an	e-ques-tri-an
tyran-ni-cal	ty-ran-ni-cal
voyeurism	vo-yeur-ism
dis-tri-b-u-tion	dis-tri-bu-tion
en-abled	enabled
bloomer	bloom-er
gigo-lo	gig-o-lo
blitzkrieg	blitz-krieg
sprayer	spray-er
orig-i-na-tor	o-rig-i-na-tor
whomev-er	whom-ev-er
touris-tic	tour-is-tic
prepar-a-tive	pre-par-a-tive
my-opia	my-o-pi-a
ex-em-plary	ex-em-pla-ry
re-strain-ing	restraining
repet-i-tive	re-pet-i-tive
pupa	pu-pa
over-rule	o-ver-rule
elec-tron-i-cal-ly	e-lec-tron-i-cal-ly
me-dia	me-di-a
oakum	oa-kum
celiba-cy	cel-i-ba-cy
nasty	nas-ty
dis-senter	dis-sent-er
ex-plo-ration	ex-plo-ra-tion
dila-tor	di-la-tor
de-mo-c-rat	dem-o-crat
heiress	heir-ess
paschal	pas-chal
wash-er-woman	wash-er-wom-an
postal	post-al
swelling	swell-ing
idio-syn-crasy	id-i-o-syn-cra-sy
redi-rect	re-di-rect
millpond	mill-pond
coastal	coast-al
for-syth-ia	for-syth-i-a
un-scrupu-lous	un-scru-pu-lous
de-tectable	de-tect-a-ble
plaza	pla-za
tremu-lous	trem-u-lous
tru-cu-lent	truc-u-lent
de-served-ly	de-serv-ed-ly
genome	ge-nome
tropopause	trop-o-pause
em-ploy-able	em-ploy-a-ble
dyestuff	dye-stuff
any-way	an-y-way
shaven	shav-en
morass	mo-rass
celandine	cel-an-dine
co-pra	cop-ra
equip-ment	e-quip-ment
crevasse	cre-vasse
laud-able	laud-a-ble
nowa-days	now-a-days
pedes-tri-an	pe-des-tri-an
uri-nary	u-ri-nar-y
iden-ti-fi-er	i-den-ti-fi-er
bun-gled	bungled
steve-dore	ste-ve-dore
gar-bled	garbled
avian	a-vi-an
glis-ten-ing	glistening
im-moral	im-mor-al
pas-toral	pas-to-ral
re-cy-clable	re-cy-cla-ble
mar-ketabil-i-ty	mar-ket-a-bil-i-ty
aso-cial	a-so-cial
testable	test-a-ble
bib-lio-phile	bib-li-o-phile
over-flow-ing	overflowing
cyan	cy-an
yeasty	yeast-y
beeswax	bees-wax
curie	cu-rie
bil-iary	bil-i-ar-y
un-treat-able	un-treat-a-ble
cousin	cous-in
seizure	sei-zure
revenant	rev-e-nant
tightrope	tight-rope
comi-ty	com-i-ty
mon-e-tarism	mon-e-ta-rism
fri-ary	fri-ar-y
anti-gen	an-ti-gen
dis-ori-en-ta-tion	dis-o-ri-en-ta-tion
trans-porta-tion	trans-por-ta-tion
record-ing	re-cord-ing
re-arrange-ment	re-ar-range-ment
stron-groom	strong-room
an-ti-quary	an-ti-quar-y
opi-ate	o-pi-ate
firmware	firm-ware
un-cre-ative	un-cre-a-tive
ingress	in-gress
un-de-ni-able	un-de-ni-a-ble
aban-don-ment	a-ban-don-ment
racist	rac-ist
trea-sur-er	treas-ur-er
firkin	fir-kin
dip-so-ma-nia	dip-so-ma-ni-a
irate	i-rate
aba-cus	ab-a-cus
misog-y-nis-tic	mi-sog-y-nis-tic
awhile	a-while
naked	na-ked
ju-nior	jun-ior
leg-endary	leg-end-ar-y
dance-able	dance-a-ble
so-ci-etal	so-ci-e-tal
rewritable	re-writ-a-ble
into	in-to
piercer	pierc-er
velour	ve-lour
gaga	ga-ga
cre-ative	cre-a-tive
de-nier	de-ni-er
mi-cro-com-put-er	mi-cro-com-pu-ter
damnable	dam-na-ble
refu-ta-tion	ref-u-ta-tion
clash-ing	clashing
touchy	touch-y
aubergine	au-ber-gine
rein-te-gra-tion	re-in-te-gra-tion
piebald	pie-bald
penul-ti-mate	pe-nul-ti-mate
telethon	tel-e-thon
monoc-u-lar	mo-noc-u-lar
to-kenism	to-ken-ism
dis-obe-di-ence	dis-o-be-di-ence
monomer	mon-o-mer
whiten	whit-en
moraine	mo-raine
very	ver-y
brouha-ha	brou-ha-ha
syco-phant	syc-o-phant
re-seller	re-sell-er
re-port-ed	reported
romper	romp-er
inar-tic-u-late	in-ar-tic-u-late
es-teemed	esteemed
mar-que	marque
oph-thalmic	oph-thal-mic
elic-it	e-lic-it
emo-tive	e-mo-tive
re-vival	re-viv-al
tourist	tour-ist
spokesman	spokes-man
aver	a-ver
sen-a-to-r-i-al	sen-a-to-ri-al
ex-pec-tant-ly	ex-pect-ant-ly
an-niver-sary	an-ni-ver-sa-ry
en-durance	en-dur-ance
ketchup	ketch-up
emo-tion-al-ly	e-mo-tion-al-ly
parental	pa-ren-tal
gumshoe	gum-shoe
cream-ery	cream-er-y
un-bear-able	un-bear-a-ble
schooner	schoon-er
uni-ver-sal-ism	u-ni-ver-sal-ism
lemon-ade	lem-on-ade
frailty	frail-ty
her-i-tabil-i-ty	her-it-a-bil-i-ty
salary	sal-a-ry
elec-trode	e-lec-trode
un-count-able	un-count-a-ble
dy-namo	dy-na-mo
ego-cen-tric	e-go-cen-tric
botan-i-cal	bo-tan-i-cal
katy-did	ka-ty-did
in-hala-tion	in-ha-la-tion
trainee	train-ee
mo-not-o-ne	mon-o-tone
creak-ing	creaking
aslant	a-slant
bidi-rec-tion-al	bi-di-rec-tion-al
baloney	ba-lo-ney
bene-dic-tion	ben-e-dic-tion
diva	di-va
sniff-ing	sniffing
pho-to-s-phere	pho-to-sphere
lament-ed	la-ment-ed
heraldic	he-ral-dic
liquor	liq-uor
dum-found-ing	dumf-ound-ing
ra-di-ograph-ic	ra-di-o-graph-ic
meta-phys-i-cal	met-a-phys-i-cal
species	spe-cies
waspish	wasp-ish
hexa-dec-i-mal	hex-a-dec-i-mal
pre-s-e-lect	pre-se-lect
con-sis-tent	con-sist-ent
un-processed	un-proc-essed
agent	a-gent
dis-in-fec-tant	dis-in-fect-ant
kamikaze	ka-mi-ka-ze
fal-ter-ing	faltering
harpists	har-pists
refugee	ref-u-gee
readapt	re-a-dapt
genre	gen-re
be-liev-abil-i-ty	be-liev-a-bil-i-ty
handy-man	hand-y-man
drift-ing	drifting
viva	vi-va
es-capade	es-ca-pade
rea-son-able	rea-son-a-ble
iron-i-cal-ly	i-ron-i-cal-ly
sphyg-mo-manome-ter	sphyg-mo-ma-nom-e-ter
mind-set	mindset
grotesque-ly	gro-tesque-ly
in-fect-ed	infected
glaciol-o-gy	gla-ci-ol-o-gy
lumpen	lum-pen
dark-ened	darkened
ta-per-ing	tapering
per-mafrost	per-ma-frost
bom-bardier	bom-bar-dier
li-bido	li-bi-do
ex-pan-sion-ary	ex-pan-sion-ar-y
tram-polin-ing	trampolining
mim-ic-k-er	mim-ick-er
plumy	plum-y
aris-to-crat-ic	a-ris-to-crat-ic
monothe-ism	mon-o-the-ism
flat-tery	flat-ter-y
avun-cu-lar	a-vun-cu-lar
ap-proval	ap-prov-al
manda-to-ry	man-da-to-ry
par-a-sitism	par-a-sit-ism
clever	clev-er
he-li-pad	hel-i-pad
domi-cile	dom-i-cile
waster	wast-er
cer-ti-fi-able	cer-ti-fi-a-ble
cleanup	clean-up
primeval	pri-me-val
turntable	turn-ta-ble
de-sir-able	de-sir-a-ble
fo-lio	fo-li-o
beefy	beef-y
over-crowd-ed	overcrowded
over-draw	o-ver-draw
holdup	hold-up
clank-ing	clanking
ox-alate	ox-a-late
graphite	graph-ite
un-read-able	un-read-a-ble
damsel	dam-sel
trackbed	track-bed
Words with errors: 1817
Words with incorrect number of syllables: 1719
Total evluated: 6500
Perfect accuracy: 0.72
Number of syllables accuracy: 0.74
Average Levenshtein Distance(across incorrect words): 1.20
