Attempt	Real
con-stab-u-lary	con-stab-u-lar-y
in-audi-ble	in-au-di-ble
vestibu-lar	ves-tib-u-lar
caldera	cal-de-ra
poly-mor-phism	pol-y-mor-phism
buoy	bu-oy
lager	la-ger
epi-demi-o-log-i-cal	ep-i-de-mi-o-log-i-cal
bevy	bev-y
over-weight	o-ver-weight
cycli-cal	cy-cli-cal
im-puni-ty	im-pu-ni-ty
shipown-er	ship-own-er
lacteal	lac-te-al
ap-pari-tion	ap-pa-ri-tion
cir-cling	circling
centi-grade	cen-ti-grade
au-tomat	au-to-mat
garter	gar-ter
dis-claimer	dis-claim-er
golfer	golf-er
coupon	cou-pon
share-able	share-a-ble
or-ga-nized	or-gan-ized
het-ero-sex-u-al-i-ty	het-er-o-sex-u-al-i-ty
di-rec-torate	di-rec-to-rate
phy-loge-ny	phy-log-e-ny
di-uret-ic	di-u-ret-ic
eat-able	eat-a-ble
topol-o-gy	to-pol-o-gy
hyp-ocrite	hyp-o-crite
re-ducible	re-duc-i-ble
pro-pa-gan-da	prop-a-gan-da
citadel	cit-a-del
es-capism	es-cap-ism
per-fidy	per-fi-dy
unim-peach-able	un-im-peach-a-ble
iron-ing	i-ron-ing
endgame	end-game
evic-tion	e-vic-tion
spark-ly	spar-kly
sep-a-ratism	sep-a-ra-tism
sup-ple-men-tary	sup-ple-men-ta-ry
in-dis-putable	in-dis-put-a-ble
hayloft	hay-loft
archery	ar-cher-y
afraid	a-fraid
de-c-la-ra-tion	dec-la-ra-tion
up-silon	up-si-lon
hobo	ho-bo
ir-ri-tabil-i-ty	ir-ri-ta-bil-i-ty
repa-tri-a-tion	re-pa-tri-a-tion
framer	fram-er
dotage	dot-age
ozone	o-zone
aza-lea	a-zal-ea
mega-lith-ic	meg-a-lith-ic
di-alect	di-a-lect
read-abil-i-ty	read-a-bil-i-ty
damnable	dam-na-ble
an-techam-ber	an-te-cham-ber
ni-troge-nous	ni-trog-e-nous
trans-porta-tion	trans-por-ta-tion
multi-na-tion-al	mul-ti-na-tion-al
ex-citable	ex-cit-a-ble
cruller	crul-ler
laden	lad-en
scoundrel	scoun-drel
transept	tran-sept
may-oral	may-or-al
touris-tic	tour-is-tic
saga-cious	sa-ga-cious
reaf-fir-ma-tion	re-af-fir-ma-tion
whisker	whisk-er
moist-en	mois-ten
turnover	turn-o-ver
pur-port-ed	purported
undi-lut-ed	un-di-lut-ed
util-i-tar-i-an	u-til-i-tar-i-an
ra-bid	rab-id
nugget	nug-get
tan-nery	tan-ner-y
lov-able	lov-a-ble
top-i-ary	to-pi-ar-y
un-able	un-a-ble
elec-tron-ics	e-lec-tron-ics
coac-tion	co-ac-tion
elu-ci-da-tion	e-lu-ci-da-tion
bazaar	ba-zaar
meta-mor-pho-sis	met-a-mor-pho-sis
in-ad-vis-able	in-ad-vis-a-ble
un-avoid-able	un-a-void-a-ble
lovesick	love-sick
in-dictable	in-dict-a-ble
birthright	birth-right
im-per-son-ation	im-per-son-a-tion
flanker	flank-er
zany	za-ny
delict	de-lict
fer-al	fe-ral
un-lucky	un-luck-y
styl-is-tics	sty-lis-tics
sinis-tral	sin-is-tral
springer	spring-er
win-ery	win-er-y
cola	co-la
coinage	coin-age
codling	cod-ling
de-pend-abil-i-ty	de-pend-a-bil-i-ty
zephyr	zeph-yr
emen-da-tion	e-men-da-tion
satin	sat-in
coolant	cool-ant
un-abashed-ly	un-a-bash-ed-ly
steady	stead-y
rene-gade	ren-e-gade
lam-plit	lamp-lit
evap-o-rate	e-vap-o-rate
hal-ibut	hal-i-but
briskly	brisk-ly
apo-lit-i-cal	a-po-lit-i-cal
breathy	breath-y
geezer	gee-zer
idyll	i-dyll
rapi-er	ra-pi-er
slav-ery	slav-er-y
holo-graph-ic	hol-o-graph-ic
in-sulin	in-su-lin
mega-phone	meg-a-phone
de-cider	de-cid-er
raven	ra-ven
va-ri-ety	va-ri-e-ty
nu-clear	nu-cle-ar
sauna	sau-na
viol	vi-ol
apos-tro-phe	a-pos-tro-phe
uni-tary	u-ni-tar-y
dis-turbing-ly	dis-turb-ing-ly
overeat	o-ver-eat
in-ter-locu-to-ry	in-ter-loc-u-to-ry
thau-maturge	thau-ma-turge
iri-des-cent	ir-i-des-cent
pi-anola	pi-a-no-la
rooftop	roof-top
ge-o-mag-net-i-cal-ly	ge-o-mag-ne-ti-cal-ly
cedil-la	ce-dil-la
re-mov-able	re-mov-a-ble
celeb	ce-leb
megas-tar	meg-a-star
dredger	dredg-er
ir-recov-er-able	ir-re-cov-er-a-ble
diox-in	di-ox-in
steeply	steep-ly
elec-tri-cal	e-lec-tri-cal
casi-no	ca-si-no
builder	build-er
in-signif-i-cant	in-sig-nif-i-cant
chantry	chan-try
en-chant-i-ng	en-chant-ing
over-head	o-ver-head
smoother	smooth-er
hexa-dec-i-mal	hex-a-dec-i-mal
sooty	soot-y
gala	ga-la
ephemera	e-phem-er-a
bene-fac-tress	ben-e-fac-tress
bolero	bo-le-ro
salu-tary	sal-u-tar-y
inar-tic-u-late	in-ar-tic-u-late
ogle	o-gle
equal-ly	e-qual-ly
rip-pling	rippling
hy-drochlo-ride	hy-dro-chlo-ride
helpline	help-line
fig-u-ra-tive-ly	fig-ur-a-tive-ly
pearly	pearl-y
salient	sa-li-ent
tu-to-r-i-al	tu-to-ri-al
bridal	brid-al
un-avoid-ably	un-a-void-a-bly
perky	perk-y
blun-der-ing	blundering
nasty	nas-ty
tou-sled	tousled
gloomy	gloom-y
lessee	les-see
pec-toral	pec-to-ral
mo-not-o-n-ic	mon-o-ton-ic
at-tribute	at-trib-ute
squirearchy	squire-ar-chy
over-step	o-ver-step
rever-ie	rev-er-ie
omega	o-me-ga
labyrinth	lab-y-rinth
haiku	hai-ku
pedestal	ped-es-tal
over-feed	o-ver-feed
col-le-gial	col-le-gi-al
killer	kil-ler
ha-track	hat-rack
lumpen	lum-pen
un-pro-nounce-able	un-pro-nounce-a-ble
phone-mic	pho-ne-mic
pro-pri-etress	pro-pri-e-tress
ig-no-min-ious	ig-no-min-i-ous
rosette	ro-sette
ini-tial	in-i-tial
seis-mome-ter	seis-mom-e-ter
vic-ar-i-ous	vi-car-i-ous
avail-abil-i-ty	a-vail-a-bil-i-ty
crin-kled	crinkled
sym-po-sium	sym-po-si-um
batik	ba-tik
plumba-go	plum-ba-go
dearie	dear-ie
un-du-lat-ing	un-du-la-ting
fiat	fi-at
chore-o-graph-ic	cho-re-o-graph-ic
un-en-durable	un-en-dur-a-ble
temptress	tempt-ress
mar-que	marque
in-ter-change-able	in-ter-change-a-ble
restive	res-tive
look-ing	looking
rapid	rap-id
high-lander	high-lan-der
gov-ern-ing	governing
elec-tri-fy	e-lec-tri-fy
testy	tes-ty
respire	re-spire
router	rout-er
in-cor-rupt-ible	in-cor-rupt-i-ble
straight-away	straight-a-way
pion	pi-on
erup-tion	e-rup-tion
real	re-al
evanes-cent	ev-a-nes-cent
treaty	trea-ty
de-mo-li-tion	dem-o-li-tion
promi-nent	prom-i-nent
psy-choki-ne-sis	psy-cho-ki-ne-sis
jit-tery	jit-ter-y
sole-cism	sol-e-cism
un-ob-tain-able	un-ob-tain-a-ble
beamy	beam-y
synapse	syn-apse
geno-type	gen-o-type
tem-pera	tem-per-a
mus-ke-teer	mus-ket-eer
punky	punk-y
snorkel	snor-kel
eman-ci-pate	e-man-ci-pate
awestruck	awe-struck
rat-tlesnake	rat-tle-snake
whole-saler	whole-sal-er
iden-ti-fi-ca-tion	i-den-ti-fi-ca-tion
urchin	ur-chin
whaler	whal-er
feb-ru-ary	feb-ru-ar-y
verisimil-i-tude	ver-i-si-mil-i-tude
body	bod-y
facet	fac-et
every-body	eve-ry-bod-y
minesweep-er	mine-sweep-er
bat-ter-ing	battering
salu-bri-ous	sa-lu-bri-ous
un-ser-vice-able	un-ser-vice-a-ble
poky	pok-y
po-ten-tial-i-ty	po-ten-ti-al-i-ty
dis-ori-ent	dis-o-ri-ent
elec-tro-cute	e-lec-tro-cute
bowsprit	bow-sprit
rocky	rock-y
waster	wast-er
curlew	cur-lew
miser-li-ness	mi-ser-li-ness
la-ryn-geal	la-ryn-ge-al
reaf-firm	re-af-firm
un-sa-vory	un-sa-vor-y
tourism	tour-ism
mea-sure	meas-ure
hor-mon-al	hor-mo-nal
bar-bar-ian	bar-bar-i-an
edit-ed	edited
atavis-tic	at-a-vis-tic
howler	howl-er
over-seas	o-ver-seas
umpteenth	ump-teenth
monothe-ism	mon-o-the-ism
agent	a-gent
un-ex-plain-able	un-ex-plain-a-ble
in-valid	in-va-lid
tribu-la-tion	trib-u-la-tion
bur-nished	burnished
enig-mat-ic	en-ig-mat-ic
incog-ni-to	in-cog-ni-to
blud-geon	bludg-eon
de-odor-ant	de-o-dor-ant
tantrum	tan-trum
con-tin-gency	con-tin-gen-cy
chili	chil-i
there-upon	there-up-on
ha-giog-ra-phy	hag-i-og-ra-phy
id-i-olect	id-i-o-lect
di-aphragm	di-a-phragm
asep-tic	a-sep-tic
omi-nous	om-i-nous
book-binder	book-bind-er
palu-dal	pa-lu-dal
pro-ba-tion-ary	pro-ba-tion-ar-y
gas-troin-testi-nal	gas-tro-in-tes-ti-nal
rogu-ish	ro-guish
in-former	in-form-er
duly	du-ly
shep-herd-ing	shepherding
silage	si-lage
unre-deemed	un-re-deemed
diploid	dip-loid
pur-suant	pur-su-ant
baroque	ba-roque
ca-cao	ca-ca-o
cu-rio	cu-ri-o
bank-able	bank-a-ble
trace-able	trace-a-ble
chi-huahua	chi-hua-hua
weighty	weight-y
auburn	au-burn
aquat-ic	a-quat-ic
erect	e-rect
chaos	cha-os
palatal	pal-a-tal
an-niver-sary	an-ni-ver-sa-ry
legate	leg-ate
re-uni-fy	re-u-ni-fy
palm-istry	palm-is-try
un-achiev-able	un-a-chiev-a-ble
pres-bytery	pres-by-ter-y
stopover	stop-o-ver
grouchy	grouch-y
rheo-stat	rhe-o-stat
read-just	re-ad-just
non-con-for-mi-ty	non-con-form-i-ty
dy-nasty	dy-nas-ty
cobalt	co-balt
thriller	thrill-er
whim-per-ing	whimpering
in-fante	in-fan-te
ru-inous	ru-in-ous
para-noid	par-a-noid
polypho-ny	po-lyph-o-ny
gra-tu-itous	gra-tu-i-tous
soda	so-da
rein-tro-duc-tion	re-in-tro-duc-tion
sawyer	saw-yer
crater	cra-ter
un-equiv-o-cal-ly	un-e-quiv-o-cal-ly
over-bear-ing	o-ver-bear-ing
squeaky	squeak-y
ova-tion	o-va-tion
util-i-tar-i-an-ism	u-til-i-tar-i-an-ism
ma-chete	ma-chet-e
ranter	rant-er
com-forter	com-fort-er
causal	caus-al
turgid	tur-gid
vi-t-a-min	vi-ta-min
give-away	give-a-way
pass-able	pass-a-ble
molten	mol-ten
elab-o-rate-ly	e-lab-o-rate-ly
be-liev-able	be-liev-a-ble
opi-oid	o-pi-oid
loca-tive	loc-a-tive
tint-ed	tinted
mono-lin-gual	mon-o-lin-gual
shaven	shav-en
asyn-chro-nous	a-syn-chro-nous
mi-cro-com-put-er	mi-cro-com-pu-ter
sniff-ing	sniffing
homonym	hom-o-nym
catholic	cath-o-lic
overview	o-ver-view
painful-ly	pain-ful-ly
cochlea	coch-le-a
study	stud-y
re-sul-tant	re-sult-ant
lun-cheon	lunch-eon
as-cen-dant	as-cend-ant
neur-al	neu-ral
pletho-ra	pleth-o-ra
hy-per-boloid	hy-per-bo-loid
epi-taxy	ep-i-tax-y
sui-ci-dal	su-i-cid-al
de-ity	de-i-ty
tourni-quet	tour-ni-quet
aright	a-right
stymie	sty-mie
gen-eros-i-ty	gen-er-os-i-ty
para-troops	par-a-troops
sen-tinel	sen-ti-nel
swishy	swish-y
in-dis-putably	in-dis-put-a-bly
de-viance	de-vi-ance
reval-ue	re-val-ue
mono-ma-nia	mon-o-ma-ni-a
sol-diery	sol-dier-y
laud-ed	lauded
modal	mod-al
odor-ous	o-dor-ous
racon-teur	rac-on-teur
turquoise	tur-quoise
pirou-ette	pir-ou-ette
ex-ult-ing	exulting
corset	cor-set
glis-ten-ing	gli-ste-ning
apart	a-part
pe-trel	pet-rel
banger	bang-er
leisure-ly	lei-sure-ly
in-con-ve-nience	in-con-ven-ience
pornog-ra-phy	por-nog-ra-phy
mod-ernist	mod-ern-ist
cheer-leader	cheer-lead-er
bulky	bulk-y
rea-son-able	rea-son-a-ble
machi-na-tion	mach-i-na-tion
ge-ot-her-mal	ge-o-ther-mal
pilchard	pil-chard
telegram	tel-e-gram
undis-guised	un-dis-guised
kiwi	ki-wi
over-see	o-ver-see
in-ge-nious-ly	in-gen-ious-ly
very	ver-y
canon-ic	ca-non-ic
un-heroic	un-he-ro-ic
geri-atrics	ger-i-at-rics
rounders	round-ers
apoplexy	ap-o-plex-y
horo-scope	hor-o-scope
sabo-teur	sab-o-teur
om-nipo-tence	om-nip-o-tence
re-peater	re-peat-er
pa-pyrus	pa-py-rus
conifer	co-ni-fer
padding	pad-ding
pedi-gree	ped-i-gree
em-bossed	embossed
cor-re-spon-dent	cor-re-spond-ent
reroutes	re-routes
com-fort-ably	com-fort-a-bly
carousel	car-ou-sel
medusa	me-du-sa
purga-tive	pur-ga-tive
es-capee	es-cap-ee
dis-cre-tionary	dis-cre-tion-ar-y
cli-toris	clit-o-ris
rigid-i-ty	ri-gid-i-ty
jumper	jump-er
gi-antism	gi-ant-ism
di-elec-tric	di-e-lec-tric
un-demon-stra-tive	un-de-mon-stra-tive
cut-lery	cut-ler-y
beget	be-get
mod-icum	mod-i-cum
pastille	pas-tille
gen-uine-ness	gen-u-ine-ness
think-able	think-a-ble
sys-temic	sys-tem-ic
gospel	gos-pel
foible	foi-ble
im-preg-nable	im-preg-na-ble
syl-labub	syl-la-bub
satyr	sa-tyr
un-ruly	un-ru-ly
sier-ra	si-er-ra
dis-agree-able	dis-a-gree-a-ble
civics	civ-ics
damask	dam-ask
wether	weth-er
min-uet	min-u-et
atyp-i-cal	a-typ-i-cal
su-per-natant	su-per-na-tant
pol-lard-ed	pollarded
ob-se-quious	ob-se-qui-ous
imag-in-able	im-ag-i-na-ble
cog-nizance	cog-ni-zance
vene-re-al	ve-ne-re-al
sub-atom-ic	sub-a-tom-ic
ar-rester	ar-rest-er
con-sular	con-su-lar
wrestling	wres-tling
cougar	cou-gar
schooner	schoon-er
res-olute-ly	res-o-lute-ly
sum-mery	sum-mer-y
bowlder	bowl-der
cation	cat-i-on
ge-nial-i-ty	ge-ni-al-i-ty
re-minder	re-mind-er
elo-quent	el-o-quent
over-fill	o-ver-fill
tailplane	tail-plane
lanky	lank-y
in-con-gruity	in-con-gru-i-ty
palati-nate	pa-lat-i-nate
ele-giac	el-e-gi-ac
read-mis-sion	re-ad-mis-sion
overt-ly	o-vert-ly
relict	rel-ict
derelict	der-e-lict
reap-point	re-ap-point
heron	her-on
reprisal	re-pris-al
idly	i-dly
eigen-val-ue	ei-gen-val-ue
periscope	per-i-scope
porta-bil-i-ty	port-a-bil-i-ty
fisticuffs	fist-i-cuffs
ma-jorette	ma-jor-ette
turntable	turn-ta-ble
crazy	cra-zy
vine-gar	vin-e-gar
amazed	a-mazed
ter-tiary	ter-ti-ar-y
telecom-mut-ing	te-le-com-mu-ting
over-hand	o-ver-hand
elec-tri-cal-ly	e-lec-tri-cal-ly
thrifty	thrift-y
mi-mosa	mi-mo-sa
de-vour-ing	devouring
mega-lith	meg-a-lith
post-mistress	post-mis-tress
evoke	e-voke
pre-sum-ably	pre-sum-a-bly
hy-dro-sta-t-ic	hy-dro-stat-ic
choco-late	choc-o-late
im-munoas-say	im-mu-no-as-say
ukulele	u-ku-le-le
un-usu-al-ly	un-u-su-al-ly
laugh-ably	laugh-a-bly
the-atri-cals	the-at-ri-cals
amused	a-mused
undis-tort-ed	un-dis-tort-ed
para-noia	par-a-noi-a
icon-o-clast	i-con-o-clast
valen-tine	val-en-tine
di-nosaur	di-no-saur
even-ly	e-ven-ly
iso-lat-ed	i-so-lat-ed
im-pre-sario	im-pre-sa-ri-o
speller	spell-er
slater	slat-er
polon-aise	pol-o-naise
smirk-ing	smirking
gov-er-nance	gov-ern-ance
fleshy	flesh-y
li-able	li-a-ble
metaphor-i-cal	met-a-phor-i-cal
api-ary	a-pi-ar-y
wrap-around	wrap-a-round
unin-spired	un-in-spired
con-for-mi-ty	con-form-i-ty
rob-bery	rob-ber-y
non-event	non-e-vent
sev-ered	severed
stipend	sti-pend
ini-ti-a-tion	in-i-ti-a-tion
som-brero	som-bre-ro
con-tractible	con-tract-i-ble
puffy	puf-fy
pipeline	pipe-line
corkscrew	cork-screw
pro-tect-ed	protected
scrupu-lous	scru-pu-lous
dal-liance	dal-li-ance
redo-lent	red-o-lent
bradawl	brad-awl
steadi-ness	stead-i-ness
icosa-he-dron	i-co-sa-he-dron
tanker	tank-er
avian	a-vi-an
shindig	shin-dig
galaxy	gal-ax-y
re-tini-tis	ret-i-ni-tis
cheeky	cheek-y
funky	funk-y
tra-chea	tra-che-a
plea-sur-able	pleas-ur-a-ble
ob-scu-ran-tist	ob-scu-rant-ist
con-vivial	con-viv-i-al
un-elect-ed	un-e-lect-ed
mag-ne-sium	mag-ne-si-um
turnout	turn-out
anus	a-nus
over-sized	o-ver-sized
ratepay-er	rate-pay-er
ple-nary	ple-na-ry
su-per-nu-mer-ary	su-per-nu-mer-ar-y
crick-eter	crick-et-er
paci-fist	pac-i-fist
ede-ma	e-de-ma
repack-age	re-pack-age
limpet	lim-pet
leg-isla-tive	leg-is-la-tive
lido	li-do
detri-ment	det-ri-ment
hero-ism	her-o-ism
deathbed	death-bed
clien-tele	cli-en-tele
raf-fia	raf-fi-a
up-hol-stery	up-hol-ster-y
mealy	meal-y
ini-tial-ly	in-i-tial-ly
emol-u-ment	e-mol-u-ment
zona-tion	zo-na-tion
shilling	shil-ling
snif-fer	sniff-er
piv-otal	piv-ot-al
bio-morph	bi-o-morph
trainee	train-ee
cream-ery	cream-er-y
pro-le-tari-at	pro-le-tar-i-at
tubu-lar	tu-bu-lar
mere-tri-cious	mer-e-tri-cious
diplo-ma	di-plo-ma
illiq-uid	il-liq-uid
cor-morant	cor-mo-rant
adopt	a-dopt
deci-bel	dec-i-bel
over-coat	o-ver-coat
mo-nop-oly	mo-nop-o-ly
con-demned	condemned
in-de-fati-ga-ble	in-de-fat-i-ga-ble
de-cay-ing	decaying
con-stituent	con-stit-u-ent
cryp-tol-ogy	cryp-tol-o-gy
re-pro-ducibly	re-pro-duc-i-bly
lamp-lighter	lamp-light-er
fifty	fif-ty
pira-cy	pi-ra-cy
goatskin	goat-skin
carotid	ca-rot-id
throaty	throat-y
tricky	trick-y
poly-mor-phous	pol-y-mor-phous
rar-efac-tion	rar-e-fac-tion
en-gi-neered	engineered
ally	al-ly
oner-ous	on-er-ous
sunken	sunk-en
ven-omous	ven-om-ous
weepy	weep-y
chem-istry	chem-is-try
re-cessed	recessed
hi-er-ar-ch	hi-er-arch
guardian-ship	guard-i-an-ship
gofer	go-fer
eu-pho-ria	eu-pho-ri-a
lauda-to-ry	laud-a-to-ry
moral-ly	mor-al-ly
tar-ty	tart-y
triple	tri-ple
galac-tic	ga-lac-tic
ob-jec-tion-able	ob-jec-tion-a-ble
cov-et-ed	coveted
ego-tis-ti-cal	e-go-tis-ti-cal
un-holy	un-ho-ly
switchgear	switch-gear
ide-al-is-tic	i-de-al-is-tic
so-bri-ety	so-bri-e-ty
bristly	bris-tly
goa-tee	goat-ee
bac-te-r-i-al	bac-te-ri-al
par-enter-al	par-en-ter-al
sun-burned	sunburned
par-adise	par-a-dise
geo-physics	ge-o-phys-ics
dif-fuser	dif-fus-er
strudel	stru-del
wall-flower	wall-flow-er
watch-able	watch-a-ble
unin-sur-able	un-in-sur-a-ble
ridicu-lous-ly	ri-dic-u-lous-ly
poltroon	pol-troon
un-der-study	un-der-stud-y
in-domitable	in-dom-i-ta-ble
fash-ion-able	fash-ion-a-ble
testis	tes-tis
rosary	ro-sa-ry
deu-teri-um	deu-te-ri-um
in-ter-atom-ic	in-ter-a-tom-ic
satirist	sat-i-rist
there-abouts	there-a-bouts
busy	bus-y
wretched	wretch-ed
reroute	re-route
re-ori-en-ta-tion	re-o-ri-en-ta-tion
kwacha	kwa-cha
costar	co-star
jus-ti-fi-able	jus-ti-fi-a-ble
bound-ary	bound-a-ry
har-mo-nious-ly	har-mo-ni-ous-ly
bio-engi-neer-ing	bi-o-en-gi-neer-ing
tele-path-ic	tel-e-path-ic
vivid	viv-id
tri-bunal	tri-bu-nal
drowsy	drow-sy
sta-tion-ary	sta-tion-ar-y
syn-onym	syn-o-nym
toka-mak	to-ka-mak
rel-a-tivis-tic	rel-a-tiv-is-tic
dig-ni-tary	dig-ni-tar-y
babysit-ter	ba-by-sit-ter
eter-nal-ly	e-ter-nal-ly
tropopause	trop-o-pause
uni-ver-sal-ly	u-ni-ver-sal-ly
tacky	tack-y
camper	camp-er
trigonom-e-try	trig-o-nom-e-try
shaman	sha-man
un-en-force-able	un-en-force-a-ble
over-much	o-ver-much
cre-ative-ly	cre-a-tive-ly
vis-i-ta-tion	vis-it-a-tion
break-able	break-a-ble
depre-da-tion	dep-re-da-tion
un-usu-al	un-u-su-al
feath-ery	feath-er-y
winger	wing-er
trans-mo-gri-fy	trans-mog-ri-fy
ex-cel-sior	ex-cel-si-or
reper-cus-sion	re-per-cus-sion
potable	po-ta-ble
rib-aldry	rib-ald-ry
dis-tiller	dis-till-er
wag-gery	wag-ger-y
au-dio-vi-su-al	au-di-o-vis-u-al
sim-per-ing	simpering
bases	ba-ses
pi-rat-ed	pirated
hy-drazine	hy-dra-zine
is-lander	is-land-er
en-abled	e-na-bled
para-mag-net-ic	par-a-mag-net-ic
turnip	tur-nip
rapid-ly	rap-id-ly
es-cha-tol-ogy	es-cha-tol-o-gy
mono-mi-al	mo-no-mi-al
awhile	a-while
iso-met-ric	i-so-met-ric
dopey	dope-y
kinder-garten	kin-der-gar-ten
elec-tor	e-lec-tor
para-ble	par-a-ble
glasshouse	glass-house
makeshift	make-shift
pinafore	pin-a-fore
methanol	meth-a-nol
presto	pres-to
gamy	gam-y
pen-i-ten-tiary	pen-i-ten-tia-ry
va-sec-to-my	vas-ec-to-my
pam-phle-teer	pam-phlet-eer
dri-ve-way	drive-way
trackbed	track-bed
aorist	a-o-rist
ne-go-tia-tor	ne-go-ti-a-tor
med-ical-ly	med-i-cal-ly
in-sipid	in-sip-id
eater	eat-er
leisured	lei-sured
elas-ti-cat-ed	e-las-ti-cat-ed
plur-al	plu-ral
opaque	o-paque
quencher	quench-er
pe-tit	pet-it
nougat	nou-gat
ar-guably	ar-gu-a-bly
si-nu-soid	si-nus-oid
aux-il-iary	aux-il-ia-ry
prepar-a-tive	pre-par-a-tive
propane	pro-pane
piety	pi-e-ty
epi-logue	ep-i-logue
steeple-chase	stee-ple-chase
re-vival-ism	re-viv-al-ism
in-clement	in-clem-ent
prospect	pros-pect
ital-ic	i-tal-ic
de-fines	def-ines
em-bassy	em-bas-sy
elvish	elv-ish
gen-i-talia	gen-i-ta-li-a
spoilage	spoil-age
prodi-gy	prod-i-gy
spher-oid	sphe-roid
medi-oc-rity	me-di-oc-ri-ty
negate	ne-gate
re-moval	re-mov-al
wastrel	wast-rel
pu-ri-tanism	pu-ri-tan-ism
punch-able	punch-a-ble
drap-ery	dra-per-y
un-frozen	un-fro-zen
un-rea-son-able	un-rea-son-a-ble
uni-lat-er-al-ist	u-ni-lat-er-al-ist
un-for-get-table	un-for-get-ta-ble
beg-gary	beg-gar-y
hermeneu-tics	her-me-neu-tics
duo-logue	du-o-logue
glo-be-trot-ting	globe-trot-ting
sphyg-mo-manome-ter	sphyg-mo-ma-nom-e-ter
cheru-bic	che-ru-bic
mnemon-ic	mne-mon-ic
pointil-lism	poin-til-lism
hexa-m-e-ter	hex-am-e-ter
aside	a-side
laven-der	lav-en-der
hearti-ly	heart-i-ly
stretchy	stretch-y
isosce-les	i-sos-ce-les
painstak-ing-ly	pains-tak-ing-ly
virus	vi-rus
dis-heart-en-ing	dis-hear-te-ning
filthy	filth-y
papil-la	pa-pil-la
deeply	deep-ly
frontage	front-age
beat-i-tude	be-at-i-tude
nether-most	neth-er-most
habit	hab-it
roundel	roun-del
gerund	ger-und
manikin	man-i-kin
sided	sid-ed
or-ga-nize	or-gan-ize
rent-ed	rented
so-ci-olin-guis-tics	so-ci-o-lin-guis-tics
plen-teous	plen-te-ous
detox	de-tox
redo	re-do
dri-ver-less	driv-er-less
athe-is-tic	a-the-is-tic
gad-getry	gadg-et-ry
botanist	bot-a-nist
manor	man-or
linoleum	li-no-le-um
theta	the-ta
rivulet	riv-u-let
ma-chin-ery	ma-chin-er-y
leisure	lei-sure
liv-able	liv-a-ble
morsel	mor-sel
leath-ery	leath-er-y
recharge-able	re-charge-a-ble
sanc-tu-ary	sanc-tu-ar-y
callable	call-a-ble
petard	pe-tard
su-per-posed	superposed
tri-umphal	tri-um-phal
boater	boat-er
rigid	rig-id
wolfish	wolf-ish
ge-neti-cist	ge-net-i-cist
ex-tra-ditable	ex-tra-dit-a-ble
sce-nario	sce-nar-i-o
cin-e-matog-ra-phy	cin-e-ma-tog-ra-phy
os-teopa-thy	os-te-op-a-thy
telekine-sis	tel-e-ki-ne-sis
the-atri-cal	the-at-ri-cal
desert	de-sert
im-muno-log-i-cal	im-mu-no-log-i-cal
gelati-nous	ge-lat-i-nous
chamomile	cham-o-mile
po-litesse	pol-i-tesse
cesspool	cess-pool
pe-cu-liar-i-ty	pe-cu-li-ar-i-ty
tara-masala-ta	ta-ra-ma-sa-la-ta
poros-i-ty	po-ros-i-ty
icon-o-clasm	i-con-o-clasm
choline	cho-line
ephor	eph-or
platelet	plate-let
ne-ma-tode	nem-a-tode
over-pay	o-ver-pay
even-song	e-ven-song
ar-ti-fi-cial-i-ty	ar-ti-fi-ci-al-i-ty
tele-o-log-i-cal	tel-e-o-log-i-cal
ex-porter	ex-port-er
car-bonyl	car-bon-yl
bidi-rec-tion-al	bi-di-rec-tion-al
queasy	quea-sy
muster	mus-ter
en-v-i-ron	en-vi-ron
mud-dling	muddling
poplar	pop-lar
per-centile	per-cen-tile
cy-tochrome	cy-to-chrome
showy	show-y
washout	wash-out
ship-builder	ship-build-er
ex-igu-ous	ex-ig-u-ous
cor-nu-copia	cor-nu-co-pi-a
recre-ation	rec-re-a-tion
phrase-ol-o-gy	phra-se-ol-o-gy
roofer	roof-er
mishap	mis-hap
elas-tic-i-ty	e-las-tic-i-ty
flood-ing	flooding
mazur-ka	ma-zur-ka
bondage	bond-age
epilep-sy	ep-i-lep-sy
scrib-bling	scribbling
protest-ing	protesting
overt	o-vert
lyrist	lyr-ist
backer	back-er
pati-na-tion	pat-i-na-tion
re-freshed	refreshed
nurs-ery-men	nurs-er-y-men
record-ing	re-cord-ing
im-petu-ous	im-pet-u-ous
hemi-sphere	hem-i-sphere
mesos-phere	mes-o-sphere
sub-lu-nary	sub-lu-nar-y
equal	e-qual
undis-closed	un-dis-closed
frosty	frost-y
so-cialite	so-cial-ite
an-te-dilu-vian	an-te-di-lu-vi-an
posthu-mous	post-hu-mous
rook-ery	rook-er-y
forestry	for-est-ry
an-thro-pocen-tric	an-thro-po-cen-tric
ver-bosi-ty	ver-bos-i-ty
as-bestos	as-bes-tos
nurs-ery-man	nurs-er-y-man
topo-graph-i-cal	top-o-graph-i-cal
boron	bo-ron
di-a-betes	di-a-be-tes
snifter	snif-ter
dis-con-ti-nu-ity	dis-con-ti-nu-i-ty
unas-suaged	un-as-suaged
provin-cial-ism	pro-vin-cial-ism
hater	hat-er
tele-phon-ist	te-leph-o-nist
re-ac-tionary	re-ac-tion-ar-y
beady	bead-y
minibus	min-i-bus
xeno-pho-bia	xen-o-pho-bi-a
tetra	tet-ra
enu-mer-ate	e-nu-mer-ate
pi-anis-si-mo	pi-a-nis-si-mo
sprawl-ing	sprawling
lex-i-cog-ra-ph-er	lex-i-cog-ra-pher
un-aligned	un-a-ligned
crys-talline	crys-tal-line
tun-able	tun-a-ble
beryl-li-um	be-ryl-li-um
echoic	e-cho-ic
taber-na-cle	tab-er-nac-le
con-denser	con-dens-er
method-ol-o-gy	meth-od-ol-o-gy
con-duct-ed	conducted
mi-cro-farad	mi-cro-far-ad
lazy	la-zy
al-ready	al-read-y
over-do	o-ver-do
ur-gency	ur-gen-cy
provider	pro-vid-er
id-iot	id-i-ot
lugubri-ous	lu-gu-bri-ous
iron-mon-ger	i-ron-mon-ger
tri-bune	trib-une
rheuma-tol-ogy	rheu-ma-tol-o-gy
dormer	dor-mer
orig-i-na-tion	o-rig-i-na-tion
mega	meg-a
repli-ca-tor	rep-li-ca-tor
prepo-si-tion	prep-o-si-tion
labi-um	la-bi-um
elec-tro-dy-nam-ics	e-lec-tro-dy-nam-ics
pectin	pec-tin
ranker	rank-er
in-salu-bri-ous	in-sa-lu-bri-ous
above	a-bove
con-t-a-m-i-nate	con-tam-i-nate
fore-see-able	fore-see-a-ble
cabaret	cab-a-ret
cred-it-wor-thy	cred-it-worth-y
periglacial	per-i-gla-cial
cre-osote	cre-o-sote
spiky	spik-y
erad-i-cat-ed	e-rad-i-cat-ed
notwith-stand-ing	not-with-stand-ing
prodi-gal	prod-i-gal
na-iad	nai-ad
shiny	shin-y
unan-i-mous	u-nan-i-mous
econo-met-rics	e-con-o-met-rics
piv-ot-ed	pivoted
re-galia	re-ga-li-a
se-nior	sen-ior
iso-topic	i-so-top-ic
trea-sur-er	treas-ur-er
washy	wash-y
diplo-mat-i-cal-ly	dip-lo-mat-i-cal-ly
bio-rhythm	bi-o-rhythm
diskette	disk-ette
dowry	dow-ry
deism	de-ism
earnest-ness	ear-nest-ness
je-junum	je-ju-num
ped-a-gogy	ped-a-go-gy
pharaoh	phar-aoh
in-ex-orably	in-ex-o-ra-bly
peni-cillin	pen-i-cil-lin
poignant-ly	poign-ant-ly
ap-plic-a-ble	ap-pli-ca-ble
budgie	budg-ie
pre-tender	pre-tend-er
sniper	snip-er
man-i-cured	ma-ni-cured
inane	in-ane
bushel	bush-el
ragout	ra-gout
anony-mous	a-non-y-mous
sub-ter-ranean	sub-ter-ra-ne-an
glut-tony	glut-ton-y
pos-i-tivist	pos-i-tiv-ist
gestalt	ge-stalt
apron	a-pron
mono-syl-lab-ic	mon-o-syl-lab-ic
cir-cuitous	cir-cu-i-tous
en-chant-ed	enchanted
epis-te-mol-o-gy	e-pis-te-mol-o-gy
parsnip	pars-nip
tenor	ten-or
vil-lager	vil-lag-er
gib-ber-ing	gibbering
re-vival	re-viv-al
topog-ra-phy	to-pog-ra-phy
bond-ing	bonding
trendy	trend-y
joyride	joy-ride
in-ter-roga-to-ry	in-ter-rog-a-to-ry
saucepan	sauce-pan
dis-rep-utable	dis-rep-u-ta-ble
an-tithe-sis	an-tith-e-sis
com-ple-men-tary	com-ple-men-ta-ry
in-tu-ition	in-tu-i-tion
taster	tast-er
seabird	sea-bird
res-onate	res-o-nate
car-cino-gen	car-cin-o-gen
sub-cu-ta-neous	sub-cu-ta-ne-ous
lega-tee	leg-a-tee
aquar-i-um	a-quar-i-um
melan-cho-lia	mel-an-cho-li-a
idol-a-trous	i-dol-a-trous
bur-gundy	bur-gun-dy
hook-ing	hooking
em-body	em-bod-y
op-er-a-tional	op-er-a-tion-al
napoleon	na-po-le-on
chi-nois-erie	chi-noi-se-rie
pyra-mid	pyr-a-mid
apos-to-late	a-pos-to-late
monar-chy	mon-ar-chy
re-unite	re-u-nite
oral-ly	o-ral-ly
cau-li-flower	cau-li-flow-er
shoelace	shoe-lace
lemon	lem-on
atom-ic	a-tom-ic
anvil	an-vil
reclu-sive	re-clu-sive
pullover	pull-o-ver
slob-ber-ing	slobbering
recheck	re-check
ugly	ug-ly
puerile	pu-er-ile
es-timable	es-ti-ma-ble
roughage	rough-age
par-tial-i-ty	par-ti-al-i-ty
ben-der	bend-er
writer	writ-er
mauler	maul-er
monas-tic	mo-nas-tic
riv-iera	riv-i-er-a
purview	pur-view
par-al-lelism	par-al-lel-ism
de-po-si-tion	dep-o-si-tion
transna-tion-al	trans-na-tion-al
rec-om-mend-ed	recommended
recita-tion	rec-i-ta-tion
frontal	fron-tal
awning	awn-ing
in-fir-mary	in-fir-ma-ry
mon-o-clon-al	mon-o-clo-nal
foren-sic	fo-ren-sic
whomev-er	whom-ev-er
dis-ori-en-ta-tion	dis-o-ri-en-ta-tion
un-record-ed	un-re-cord-ed
triplex	tri-plex
copy-ist	cop-y-ist
ura-ni-um	u-ra-ni-um
lieu-tenant	lieu-ten-ant
su-per-hero	su-per-he-ro
preach-ing	preaching
shoplifter	shop-lift-er
ref-er-ee-ing	re-fe-ree-ing
de-crepit	de-crep-it
craven	cra-ven
sus-penders	sus-pend-ers
foundry	found-ry
lu-natic	lu-na-tic
li-brary	li-brar-y
print-able	print-a-ble
lit-er-ary	lit-er-ar-y
di-ana	di-an-a
jus-ti-fi-ably	jus-ti-fi-a-bly
rosin	ros-in
pre-s-e-lect	pre-se-lect
scalpel	scal-pel
spillage	spill-age
aris-to-crat-ic	a-ris-to-crat-ic
so-cioe-co-nom-ic	so-ci-o-ec-o-nom-ic
monies	mon-ies
han-dover	hand-o-ver
even-tu-al-ly	e-ven-tu-al-ly
overuse	o-ver-use
her-i-ta-ble	her-it-a-ble
cleanup	clean-up
hy-per-bole	hy-per-bo-le
viceroy	vice-roy
un-wieldy	un-wield-y
veto	ve-to
on-ag-er	on-a-ger
idem	i-dem
ide-al-ly	i-de-al-ly
jerky	jerk-y
as-tro-physi-cist	as-tro-phys-i-cist
menis-cus	me-nis-cus
heather	heath-er
con-cor-dant	con-cord-ant
salty	salt-y
pan-tomime	pan-to-mime
mater	ma-ter
damni-fy	dam-ni-fy
pre-dict-ed	predicted
easy-go-ing	eas-y-go-ing
con-vert-ible	con-vert-i-ble
ex-i-gency	ex-i-gen-cy
savvy	sav-vy
table-land	ta-ble-land
earnest-ly	ear-nest-ly
re-gret-table	re-gret-ta-ble
quan-tifi-able	quan-ti-fi-a-ble
evo-lute	ev-o-lute
navel	na-vel
iota	i-o-ta
pro-peller	pro-pel-ler
de-sirous	de-sir-ous
pesky	pes-ky
sub-sidy	sub-si-dy
over-ween-ing	o-ver-ween-ing
his-toric	his-tor-ic
at-tain-able	at-tain-a-ble
liken	lik-en
timescale	time-scale
abuse	a-buse
dim-pled	dimpled
roast-ed	roasted
stinger	sting-er
over-shot	o-ver-shot
hero-ical-ly	he-ro-i-cal-ly
gal-vanome-ter	gal-va-nom-e-ter
undi-gest-ed	un-di-gest-ed
hypochon-dria	hy-po-chon-dri-a
lega-tor	le-ga-tor
bias	bi-as
ex-porta-bil-i-ty	ex-por-ta-bi-li-ty
teenag-er	teen-ag-er
edict	e-dict
power-boat	pow-er-boat
tele-vised	televised
apoc-ryphal	a-poc-ry-phal
ethanol	eth-a-nol
sagac-i-ty	sa-gac-i-ty
meri-no	me-ri-no
filmic	film-ic
dero-gate	der-o-gate
tiger-ish	ti-ger-ish
gener-ic	ge-ner-ic
poignant	poign-ant
egal-i-tar-i-an	e-gal-i-tar-i-an
dauber	daub-er
legroom	leg-room
idol-a-try	i-dol-a-try
arid	ar-id
dis-pens-able	dis-pen-sa-ble
awash	a-wash
sul-tana	sul-tan-a
grad-ual	grad-u-al
bluish	blu-ish
eon	e-on
macaw	ma-caw
manes	ma-nes
in-stan-ta-neous-ly	in-stan-ta-ne-ous-ly
misty	mist-y
snoop-ing	snooping
sala-cious	sa-la-cious
or-biter	or-bit-er
around	a-round
de-crepi-tude	de-crep-i-tude
le-gionary	le-gion-ar-y
dele-te-ri-ous	del-e-te-ri-ous
syn-ovial	syn-o-vi-al
kosher	ko-sher
satire	sat-ire
epig-ra-phy	e-pig-ra-phy
her-itage	her-it-age
en-durable	en-dur-a-ble
bish-opric	bish-op-ric
sto-ry-telling	sto-ry-tell-ing
laager	laa-ger
re-sult-ing	resulting
reaper	reap-er
pic-turesque	pic-tur-esque
anteater	ant-eat-er
un-healthy	un-health-y
mo-lasses	mo-las-ses
cor-dial	cor-di-al
bleat-ing	bleating
peren-ni-al	per-en-ni-al
apol-o-gist	a-pol-o-gist
emo-tion-less	e-mo-tion-less
moral	mor-al
brava-do	bra-va-do
ebul-lient	e-bul-lient
seafood	sea-food
shrub-bery	shrub-ber-y
over-es-ti-ma-tion	o-ver-es-ti-ma-tion
sta-t-ic	stat-ic
ex-piry	ex-pi-ry
risot-to	ri-sot-to
seclu-sion	se-clu-sion
poly-sac-cha-ride	pol-y-sac-cha-ride
grinder	grind-er
pre-cau-tion-ary	pre-cau-tion-ar-y
cele-ri-ac	ce-ler-i-ac
electro-mechan-i-cal	e-lec-tro-me-chan-i-cal
id-io-path-ic	id-i-o-path-ic
med-i-c-i-nal	me-dic-i-nal
floater	float-er
ine-bri-a-tion	in-e-bri-a-tion
bedrid-den	bed-rid-den
valiant-ly	val-iant-ly
emis-sion	e-mis-sion
seance	se-ance
sub-species	sub-spe-cies
hadron	had-ron
pid-gin	pidg-in
big-otry	big-ot-ry
renowned	re-nowned
bio-chem-istry	bi-o-chem-is-try
dic-ta-to-r-i-al	dic-ta-to-ri-al
wattage	watt-age
stratos-pher-i-cal-ly	stratospherically
ptero-dactyl	pter-o-dac-tyl
po-lice-woman	po-lice-wom-an
pur-veyance	pur-vey-ance
con-gealed	congealed
utopi-an	u-to-pi-an
sa-fari	sa-fa-ri
missal	mis-sal
un-in-ter-pretable	un-in-ter-pret-a-ble
lega-to	le-ga-to
tem-pera-men-tal	tem-per-a-men-tal
over-lie	o-ver-lie
su-prema-cist	su-prem-a-cist
valance	val-ance
raspy	rasp-y
trapeze	tra-peze
mono	mon-o
over-ly-ing	o-ver-ly-ing
era	e-ra
chas-ten-ing	chastening
dan-de-lion	dan-de-li-on
over-sexed	o-ver-sexed
hul-la-baloo	hul-la-ba-loo
heat-wave	heatwave
turkey	tur-key
mis-shapen	mis-shap-en
snaky	snak-y
handrail	hand-rail
even	e-ven
elfin	elf-in
zealot	zeal-ot
topo-graph-ic	top-o-graph-ic
soupy	soup-y
liti-gious	li-ti-gious
viva	vi-va
ca-reerist	ca-reer-ist
del-i-catessen	del-i-ca-tes-sen
haulage	haul-age
apho-rism	aph-o-rism
sonorous	so-no-rous
hy-dropho-bia	hy-dro-pho-bi-a
up-lift-ed	uplifted
herbage	herb-age
in-fini-tive	in-fin-i-tive
avi-a-tion	a-vi-a-tion
un-aware	un-a-ware
piteous	pit-e-ous
punc-til-ious	punc-til-i-ous
in-valu-able	in-val-u-a-ble
elec-tri-cian	e-lec-tri-cian
over-heat	o-ver-heat
bidet	bi-det
undy-ing	un-dy-ing
cheater	cheat-er
whether	wheth-er
or-di-nary	or-di-nar-y
dero-ga-tion	der-o-ga-tion
bumpy	bump-y
bony	bon-y
po-ten-tiome-ter	po-ten-ti-om-e-ter
glossy	gloss-y
urea	u-re-a
ser-vant	serv-ant
epi-demi-ol-o-gist	ep-i-de-mi-ol-o-gist
het-erol-o-gous	het-er-ol-o-gous
chair-woman	chair-wom-an
creak-ing	creaking
hauli-er	haul-ier
ridicu-lous-ness	ri-dic-u-lous-ness
over-time	o-ver-time
trea-sure	treas-ure
seaborne	sea-borne
scholas-tic	scho-las-tic
dolomite	do-lo-mite
rein-tro-duce	re-in-tro-duce
vinyl	vi-nyl
arable	ar-a-ble
grandee	gran-dee
woman	wom-an
cata-ma-ran	cat-a-ma-ran
in-ter-preter	in-ter-pret-er
ria	ri-a
ter-ri-to-r-i-al	ter-ri-to-ri-al
hookah	hook-ah
sug-ary	sug-ar-y
leisurewear	lei-sure-wear
delu-sive	de-lu-sive
mis-cel-la-neous	mis-cel-la-ne-ous
gig-gling	giggling
de-scen-dant	de-scend-ant
promise	prom-ise
igua-na	i-gua-na
haughty	haugh-ty
for-warder	for-ward-er
evo-lu-tion-ary	ev-o-lu-tion-ar-y
mono-rail	mon-o-rail
onion	on-ion
de-plorable	de-plor-a-ble
over-ex-po-sure	o-ver-ex-po-sure
elec-trophore-sis	e-lec-tro-pho-re-sis
rec-i-p-ro-cate	re-cip-ro-cate
de-ni-able	de-ni-a-ble
markup	mark-up
tiger	ti-ger
even-tide	e-ven-tide
uni-ver-sal-ist	u-ni-ver-sal-ist
coro-ner	cor-o-ner
dis-qui-etude	dis-qui-e-tude
elec-trode	e-lec-trode
car-away	car-a-way
dual	du-al
rub-bishy	rub-bish-y
wear-able	wear-a-ble
whiten	whit-en
pold-er	pol-der
gu-ber-na-to-r-i-al	gu-ber-na-to-ri-al
agree	a-gree
waspish	wasp-ish
in-ter-nu-clear	in-ter-nu-cle-ar
in-sa-tiable	in-sa-tia-ble
heretic	her-e-tic
odi-um	o-di-um
un-work-able	un-work-a-ble
dri-ven	driv-en
gree-nie	green-ie
hang-over	hang-o-ver
puni-tive	pu-ni-tive
toupee	tou-pee
dri-ve	drive
daffy	daf-fy
pre-cooked	precooked
censer	cen-ser
glassy	glass-y
tremen-dous	tre-men-dous
iron	i-ron
cli-ma-tol-ogy	cli-ma-tol-o-gy
ge-nom-ic	ge-no-mic
vit-ri-olic	vit-ri-ol-ic
bat-tery	bat-ter-y
preda-to-ry	pred-a-to-ry
re-lax-ation	re-lax-a-tion
aton-al	a-ton-al
dis-able	dis-a-ble
armpit	arm-pit
over-reach	o-ver-reach
de-mount-able	de-mount-a-ble
pussy-cat	pussycat
trace-abil-i-ty	trace-a-bil-i-ty
ir-re-press-ible	ir-re-press-i-ble
repet-i-tive	re-pet-i-tive
river-ine	riv-er-ine
apoc-a-lyp-tic	a-poc-a-lyp-tic
classy	class-y
suit-ably	suit-a-bly
midair	mid-air
as-tronomer	as-tron-o-mer
lentil	len-til
irate	i-rate
lava	la-va
op-por-tunism	op-por-tun-ism
xenon	xe-non
per-sis-tent-ly	per-sist-ent-ly
em-bell-ish	em-bel-lish
iron-work	i-ron-work
milky	milk-y
pu-rifi-ca-tion	pu-ri-fi-ca-tion
epis-te-mo-log-i-cal	e-pis-te-mo-log-i-cal
procla-ma-tion	proc-la-ma-tion
wicked-ly	wick-ed-ly
coral	cor-al
opi-ate	o-pi-ate
gaseous	gas-e-ous
rainy	rain-y
ici-cle	i-ci-cle
plucky	pluck-y
un-af-ford-able	un-af-ford-a-ble
bagatelle	bag-a-telle
mu-cosa	mu-co-sa
area	ar-e-a
emet-ic	e-met-ic
cer-ti-fi-able	cer-ti-fi-a-ble
fet-tered	fettered
cru-cible	cru-ci-ble
open-ly	o-pen-ly
kudu	ku-du
dancer	danc-er
duo	du-o
car-boxyl	car-box-yl
longish	long-ish
uni-di-rec-tion-al	u-ni-di-rec-tion-al
cryo-genic	cry-o-gen-ic
toi-letries	toi-let-ries
retic-u-lar	re-tic-u-lar
leader	lead-er
laun-derette	laun-der-ette
lin-ear	lin-e-ar
de-signed-ly	de-sign-ed-ly
over-pop-u-la-tion	o-ver-pop-u-la-tion
quirky	quirk-y
anon	a-non
in-spi-ra-tional	in-spi-ra-tion-al
mis-er-ably	mis-er-a-bly
doubter	doubt-er
reprise	re-prise
facile	fac-ile
rewrite	re-write
un-awares	un-a-wares
away	a-way
weary-ing	wea-ry-ing
thievish	thiev-ish
wheezy	wheez-y
hindquar-ters	hind-quar-ters
philo-soph-i-cal-ly	phil-o-soph-i-cal-ly
glam-orous	glam-or-ous
marcher	march-er
mil-lenar-i-an	mil-le-nar-i-an
un-drink-able	un-drink-a-ble
oph-thalmic	oph-thal-mic
posthu-mous-ly	post-hu-mous-ly
cryo-stat	cry-o-stat
elit-ism	e-lit-ism
con-spir-a-to-r-i-al	con-spir-a-to-ri-al
kook-abur-ra	kook-a-bur-ra
un-invit-ing	un-in-vit-ing
pre-sen-ta-tion-al	pres-en-ta-tion-al
deluxe	de-luxe
reim-ple-ment-ed	reimplemented
dere-lic-tion	der-e-lic-tion
hedgerow	hedge-row
dy-s-tro-phy	dys-tro-phy
puma	pu-ma
remap	re-map
doyen	doy-en
pig-ment-ed	pig-men-ted
voca-tive	voc-a-tive
orang	o-rang
species	spe-cies
chimera	chi-me-ra
steplad-der	step-lad-der
equip-ment	e-quip-ment
piton	pi-ton
re-dis-cov-ery	re-dis-cov-er-y
dis-putable	dis-put-a-ble
propul-sion	pro-pul-sion
pre-his-toric	pre-his-tor-ic
cater-er	ca-ter-er
climber	climb-er
prover-bial	pro-ver-bi-al
semi-fi-nal	sem-i-fi-nal
deca-dence	dec-a-dence
man-i-festo	man-i-fes-to
rein-ter-pret	re-in-ter-pret
distaff	dis-taff
sec-on-dar-i-ly	sec-ond-ar-i-ly
de-pri-va-tion	dep-ri-va-tion
bauble	bau-ble
myelin	my-e-lin
timetable	time-ta-ble
ho-n-our	ho-nour
teenaged	teen-aged
guru	gu-ru
mas-sacre	mas-sa-cre
city	cit-y
in-con-testable	in-con-test-a-ble
se-nior-i-ty	sen-ior-i-ty
hearsay	hear-say
among	a-mong
church-war-den	church-ward-en
pro-gressed	progressed
cu-rat-ed	curated
fly-over	fly-o-ver
fundrais-er	fund-rais-er
cabri-o-let	cab-ri-o-let
elec-tro-cu-tion	e-lec-tro-cu-tion
emir	e-mir
duik-er	dui-ker
or-bital	or-bit-al
in-spec-torate	in-spec-tor-ate
un-adorned	un-a-dorned
heiress	heir-ess
seedbed	seed-bed
pikestaff	pike-staff
crazi-ness	cra-zi-ness
uni-fi-ca-tion	u-ni-fi-ca-tion
un-man-age-able	un-man-age-a-ble
prodi-gious	pro-di-gious
testos-terone	tes-tos-ter-one
break-away	break-a-way
hab-it-able	hab-it-a-ble
copy-right	cop-y-right
petu-lance	pet-u-lance
stinker	stink-er
en-fee-bled	enfeebled
un-al-ter-able	un-al-ter-a-ble
ar-senic	ar-se-nic
in-ter-roga-tor	in-ter-ro-ga-tor
un-know-able	un-know-a-ble
modal-i-ty	mo-dal-i-ty
medal-lion	me-dal-lion
balus-ter	bal-us-ter
ever	ev-er
chamois	cham-ois
freely	free-ly
video-tape	vid-e-o-tape
rephrase	re-phrase
over-es-ti-mate	o-ver-es-ti-mate
yeasty	yeast-y
hubris-tic	hu-bris-tic
pester	pes-ter
axle	ax-le
busi-ly	bus-i-ly
macaque	ma-caque
mega-volt	meg-a-volt
in-san-i-tary	in-san-i-tar-y
mar-quetry	mar-que-try
bal-moral	bal-mor-al
worka-day	work-a-day
postal	post-al
de-monolo-gy	de-mon-ol-o-gy
oblate	ob-late
ema-ci-a-tion	e-ma-ci-a-tion
repa-ra-tion	rep-a-ra-tion
episode	ep-i-sode
stingy	stin-gy
idle-ness	i-dle-ness
decre-ment	dec-re-ment
en-joy-able	en-joy-a-ble
philoso-pher	phi-los-o-pher
re-spectable	re-spect-a-ble
mono-pole	mon-o-pole
granny	gran-ny
sies-ta	si-es-ta
is-suance	is-su-ance
kilo-hertz	kil-o-hertz
soloist	so-lo-ist
in-quisi-tor	in-quis-i-tor
ap-pendage	ap-pend-age
firmware	firm-ware
labi-al	la-bi-al
tem-po-rary	tem-po-rar-y
courage	cour-age
ex-cus-able	ex-cus-a-ble
cleavers	cleav-ers
moray	mo-ray
aper-ture	ap-er-ture
colo-nial-ist	co-lo-ni-al-ist
neuter	neu-ter
min-istry	min-is-try
grainy	grain-y
cli-toral	clit-o-ral
baili-wick	bail-i-wick
rec-on-cil-able	rec-on-cil-a-ble
as-cetic	as-cet-ic
woody	wood-y
foot-baller	foot-ball-er
con-ceiv-able	con-ceiv-a-ble
com-peti-tor	com-pet-i-tor
elope	e-lope
dis-cred-it-ed	discredited
elec-tro-mo-tive	e-lec-tro-mo-tive
owlet	owl-et
handy	hand-y
pithy	pith-y
di-choto-my	di-chot-o-my
sari	sa-ri
vari-ant	var-i-ant
valise	va-lise
de-pen-dent	de-pend-ent
mo-tocross	mo-to-cross
viaduct	vi-a-duct
en-thalpy	en-thal-py
enig-ma	e-nig-ma
in-choate	in-cho-ate
bene-fac-tion	ben-e-fac-tion
re-alpoli-tik	re-al-po-li-tik
uni-form	u-ni-form
grasshop-per	grass-hop-per
epi-der-mis	ep-i-der-mis
across	a-cross
aba-cus	ab-a-cus
democ-ra-cy	de-moc-ra-cy
tele-ol-o-gy	tel-e-ol-o-gy
bola	bo-la
unan-swer-able	un-an-swer-a-ble
evolve	e-volve
par-alin-guis-tic	par-a-lin-guis-tic
mus-cu-loskele-tal	mus-cu-lo-skel-e-tal
unini-ti-at-ed	un-in-i-ti-at-ed
glycine	gly-cine
topo-log-i-cal	top-o-log-i-cal
miniskirt	min-i-skirt
undi-rect-ed	un-di-rect-ed
pen-sion-able	pen-sion-a-ble
elab-o-rate	e-lab-o-rate
regime	re-gime
saline	sa-line
poly-mer	pol-y-mer
ir-res-olute	ir-res-o-lute
poundage	pound-age
corny	corn-y
evis-cer-ate	e-vis-cer-ate
forego	fore-go
por-traitist	por-trait-ist
bel-liger-ent	bel-lig-er-ent
le-nient	le-ni-ent
re-peat-able	re-peat-a-ble
at-tack-ing	attacking
patchy	patch-y
salmon	salm-on
arch-dio-cese	arch-di-o-cese
back-bencher	back-bench-er
phys-iog-no-my	phys-i-og-no-my
stony	ston-y
over-lay	o-ver-lay
viewfind-er	view-find-er
un-sellable	un-sell-a-ble
ni-hilis-tic	ni-hil-is-tic
veni-son	ven-i-son
beeswax	bees-wax
tena-cious-ly	te-na-cious-ly
geron-toc-ra-cy	ger-on-toc-ra-cy
both-ered	bothered
teleg-ra-phy	te-leg-ra-phy
parochial	pa-ro-chi-al
misog-y-nis-tic	mi-sog-y-nis-tic
eman-ci-pat-ed	e-man-ci-pat-ed
unlove-ly	un-love-ly
il-lim-itable	il-lim-it-a-ble
se-ca-teurs	sec-a-teurs
syl-labary	syl-la-bar-y
plexus	plex-us
over-rule	o-ver-rule
japon-i-ca	ja-pon-i-ca
leg-endary	leg-end-ar-y
dossier	dos-si-er
limo	lim-o
un-read-able	un-read-a-ble
woodsmoke	wood-smoke
emu	e-mu
lithol-o-gy	li-thol-o-gy
emer-gent	e-mer-gent
com-mend-able	com-mend-a-ble
reval-u-a-tion	re-val-u-a-tion
bullfinch	bull-finch
venue	ven-ue
espy	es-py
cun-nilin-gus	cun-ni-lin-gus
pres-tidig-i-ta-tion	pres-ti-dig-i-ta-tion
muti-nous	mu-ti-nous
coro-na	co-ro-na
elastin	e-las-tin
cir-cum-lo-cu-to-ry	cir-cum-loc-u-to-ry
lady	la-dy
transpon-der	tran-spon-der
un-con-tain-able	un-con-tain-a-ble
aqua	aq-ua
event-ful	e-vent-ful
ex-plo-ration	ex-plo-ra-tion
jeal-ousy	jeal-ous-y
her-mitage	her-mit-age
wicked-ness	wick-ed-ness
rein-car-na-tion	re-in-car-na-tion
re-align-ment	re-a-lign-ment
un-mea-sur-able	un-meas-ur-a-ble
stom-achache	stom-ach-ache
nasal	na-sal
soli-tude	sol-i-tude
em-bo-som	em-bos-om
bumper	bump-er
ben-e-fi-cia-ry	ben-e-fi-ci-ar-y
ep-silon	ep-si-lon
col-lec-tivism	col-lec-tiv-ism
cadet	ca-det
athe-ism	a-the-ism
kitchen-ware	kitch-en-ware
blus-ter-ing	blustering
resur-gent	re-sur-gent
isother-mal	i-so-ther-mal
kalei-do-scope	ka-lei-do-scope
jokey	jok-ey
crony	cro-ny
over-crowd-ed	o-ver-crow-ded
brouha-ha	brou-ha-ha
eigh-teenth	eight-eenth
hefty	heft-y
eroti-cism	e-rot-i-cism
dis-agree	dis-a-gree
over-tone	o-ver-tone
cen-trifuge	cen-tri-fuge
sub-servient	sub-ser-vi-ent
con-ceiv-ably	con-ceiv-a-bly
avun-cu-lar	a-vun-cu-lar
physic	phys-ic
proxy	prox-y
cu-rios-i-ty	cu-ri-os-i-ty
con-sul-tan-cy	con-sult-an-cy
ap-pre-cia-ble	ap-pre-ci-a-ble
im-agery	im-age-ry
kine-mat-ics	kin-e-mat-ics
epi-graph	ep-i-graph
un-nec-es-sary	un-nec-es-sar-y
lancet	lan-cet
stripy	strip-y
despot-ic	des-pot-ic
ovum	o-vum
decla-ma-tion	dec-la-ma-tion
car-cino-gen-e-sis	car-cin-o-gen-e-sis
opal	o-pal
crisper	crisp-er
com-mu-nica-tive	com-mu-ni-ca-tive
corol-lary	cor-ol-lar-y
piti-less	pit-i-less
de-scen-dent	de-scend-ent
cordillera	cor-dil-le-ra
in-tra-venous	in-tra-ve-nous
in-escapably	in-es-cap-a-bly
un-com-fort-ably	un-com-fort-a-bly
halite	hal-ite
des-orp-tion	de-sorp-tion
poly-atom-ic	pol-y-a-tom-ic
clema-tis	clem-a-tis
idol	i-dol
cas-sowary	cas-so-war-y
pana-ma	pan-a-ma
tele-sales	tel-e-sales
hero-ine	her-o-ine
tem-porar-i-ly	tem-po-rar-i-ly
pe-cu-niary	pe-cu-ni-ar-y
palate	pal-ate
pho-bia	pho-bi-a
per-pe-tu-ity	per-pe-tu-i-ty
fac-to-r-i-al	fac-to-ri-al
par-ent-ing	parenting
dishar-mo-ny	dis-har-mo-ny
tam-bourine	tam-bou-rine
dodgem	dodg-em
leapfrog	leap-frog
clemen-cy	clem-en-cy
squalid	squal-id
saunter	saun-ter
regi-cide	reg-i-cide
monogamy	mo-nog-a-my
polit-buro	po-lit-bu-ro
comet	com-et
bindweed	bind-weed
dogs-body	dogs-bod-y
fermi-on	fer-mi-on
ruler	rul-er
ebul-lience	e-bul-lience
tri-umvi-rate	tri-um-vi-rate
coralline	cor-al-line
cam-panol-o-gy	cam-pa-nol-o-gy
roundup	round-up
lazy-bones	la-zy-bones
elo-quence	el-o-quence
cousin	cous-in
Words with errors: 1826
Words with incorrect number of syllables: 1735
Total evluated: 6500
Perfect accuracy: 0.72
Number of syllables accuracy: 0.73
Average Levenshtein Distance(across incorrect words): 1.18
