Attempt	Real
billing	bil-ling
crazi-ness	cra-zi-ness
in-es-timable	in-es-ti-ma-ble
nobly	no-bly
ex-i-gency	ex-i-gen-cy
fly-over	fly-o-ver
syl-labus	syl-la-bus
aphe-lion	a-phe-li-on
poly-crys-talline	pol-y-crys-tal-line
nonen-ti-ty	non-en-ti-ty
mac-a-roni	mac-a-ro-ni
politic	pol-i-tic
im-pro-pri-ety	im-pro-pri-e-ty
bawdy	bawd-y
un-set-tling	unsettling
get-away	get-a-way
eq-ui-tably	eq-ui-ta-bly
co-conut	co-co-nut
anti	an-ti
er-bium	er-bi-um
taskmas-ter	task-mas-ter
mesca-line	mes-ca-line
debtor	debt-or
ro-tary	ro-ta-ry
sphyg-mo-manome-ter	sphyg-mo-ma-nom-e-ter
pira-cy	pi-ra-cy
over-shot	o-ver-shot
con-vivi-al-i-ty	con-viv-i-al-i-ty
re-mov-able	re-mov-a-ble
pro-ject-ed	projected
ex-ocrine	ex-o-crine
sus-penders	sus-pend-ers
hang-glid-ed	hang-gli-ded
shorty	short-y
sauna	sau-na
aver-sion	a-ver-sion
trick-ery	trick-er-y
lu-mi-nary	lu-mi-nar-y
coau-thor	co-au-thor
elfin	elf-in
mil-lenar-i-an-ism	mil-le-nar-i-an-ism
colos-sus	co-los-sus
sedi-tious	se-di-tious
tuna	tu-na
stripy	strip-y
pal-isade	pal-i-sade
reti-na	ret-i-na
teardrop	tear-drop
anonymi-ty	an-o-nym-i-ty
crozi-er	cro-zier
omi-nous-ly	om-i-nous-ly
do-lor-ous	dol-or-ous
lethal	le-thal
pre-sen-ta-tion	pres-en-ta-tion
mag-netron	mag-ne-tron
mono-chro-mat-ic	mon-o-chro-mat-ic
roughage	rough-age
se-ca-teurs	sec-a-teurs
pro-boscis	pro-bos-cis
take-away	take-a-way
jiffy	jif-fy
over-rid-ing	o-ver-rid-ing
haver-sack	hav-er-sack
in-deco-rous	in-dec-o-rous
nitwit	nit-wit
pub-lished	published
in-flat-able	in-flat-a-ble
epis-tle	e-pis-tle
trans-fer-able	trans-fer-a-ble
un-in-ter-pretable	un-in-ter-pret-a-ble
chemise	che-mise
ure-thane	u-re-thane
gallery	gal-ler-y
ego-ma-nia	e-go-ma-ni-a
uni-cy-cle	u-ni-cy-cle
en-comi-um	en-co-mi-um
corky	cork-y
liv-ery	liv-er-y
cashier	cash-ier
es-capism	es-cap-ism
carmine	car-mine
naive	na-ive
timid-i-ty	ti-mid-i-ty
struc-tural-ly	struc-tur-al-ly
rigid-i-ty	ri-gid-i-ty
rafter	raft-er
unique-ness	u-nique-ness
an-niver-sary	an-ni-ver-sa-ry
preda-to-ry	pred-a-to-ry
sus-tain-abil-i-ty	sus-tain-a-bil-i-ty
eques-tri-an-ism	e-ques-tri-an-ism
va-sec-to-my	vas-ec-to-my
walkover	walk-o-ver
dispir-it-ed	dis-pir-it-ed
evic-tion	e-vic-tion
hypochon-dri-a-cal	hy-po-chon-dri-a-cal
over-heat-ed	overheated
splut-ter-ing	spluttering
at-tribu-tive	at-trib-u-tive
gigo-lo	gig-o-lo
ileum	il-e-um
yoga	yo-ga
in-erad-i-ca-ble	in-e-rad-i-ca-ble
tragedy	trag-e-dy
mar-quetry	mar-que-try
choco-late	choc-o-late
along	a-long
nadir	na-dir
an-throp-ic	an-thro-pic
castoff	cast-off
un-vary-ing	un-var-y-ing
co-ex-is-tent	co-ex-ist-ent
pro-pri-etor-ship	pro-pri-e-tor-ship
arachno-pho-bia	a-rach-no-pho-bi-a
over-sized	o-ver-sized
iris	i-ris
regime	re-gime
client	cli-ent
pli-able	pli-a-ble
hero-in	her-o-in
unlove-ly	un-love-ly
es-planade	es-pla-nade
speechi-fy-ing	speechifying
bene-fac-tor	ben-e-fac-tor
ir-ra-tional-ly	ir-ra-tion-al-ly
wind-surfer	wind-surf-er
guardian	guard-i-an
sub-servient	sub-ser-vi-ent
postlude	post-lude
thiev-ery	thiev-er-y
im-ple-menter	im-ple-ment-er
me-te-o-ro-log-i-cal	me-te-or-o-log-i-cal
thorny	thorn-y
stormy	storm-y
legate	leg-ate
hy-per-boloid	hy-per-bo-loid
ion-ic	i-on-ic
sober-ly	so-ber-ly
genii	ge-ni-i
re-arrange	re-ar-range
specif-i-cal-ly	spe-cif-i-cal-ly
bac-carat	bac-ca-rat
smelly	smell-y
hack-able	hack-a-ble
clavi-chord	clav-i-chord
over-due	o-ver-due
among	a-mong
anger	an-ger
bio-m-e-try	bi-om-e-try
lira	li-ra
im-pres-sion-able	im-pres-sion-a-ble
vil-lainy	vil-lain-y
gad-getry	gadg-et-ry
dis-ori-ent	dis-o-ri-ent
in-ter-locu-to-ry	in-ter-loc-u-to-ry
piercer	pierc-er
im-moral-i-ty	im-mo-ral-i-ty
stereo	ster-e-o
fundrais-ing	fund-rais-ing
undis-cern-ing	un-dis-cern-ing
blither-ing	blith-er-ing
rent-ed	rented
taunt-ing	taunting
re-moval	re-mov-al
metempsy-chosis	me-tem-psy-cho-sis
onyx	on-yx
bari-tone	bar-i-tone
pro-tea	pro-te-a
san-i-tary	san-i-tar-y
lega-to	le-ga-to
dairy	dair-y
sto-ical-ly	sto-i-cal-ly
es-capist	es-cap-ist
pro-pri-eto-r-i-al	pro-pri-e-to-ri-al
dim-pled	dimpled
dyer	dy-er
di-etet-ic	di-e-tet-ic
ego-tis-ti-cal	e-go-tis-ti-cal
bloomer	bloom-er
lega-tor	le-ga-tor
tri-tium	trit-i-um
humbly	hum-bly
dance-able	dance-a-ble
unadul-ter-at-ed	un-a-dul-ter-at-ed
rock-ery	rock-er-y
mater	ma-ter
totem	to-tem
farewell	fare-well
ob-serv-able	ob-serv-a-ble
gooey	goo-ey
baron-age	bar-on-age
re-cessed	recessed
lousy	lous-y
bevy	bev-y
meta-mor-phosed	metamorphosed
ex-pect-ed	expected
retry	re-try
de-riva-tion	der-i-va-tion
forcible	for-ci-ble
mama	ma-ma
schemat-ic	sche-mat-ic
ex-e-cutable	ex-e-cut-a-ble
bug-gered	buggered
necrophil-ia	nec-ro-phil-i-a
tractable	trac-ta-ble
satchel	satch-el
plebiscite	pleb-i-scite
gatepost	gate-post
aquar-i-um	a-quar-i-um
brasserie	bras-se-rie
apoc-ryphal	a-poc-ry-phal
peremp-to-ry	per-emp-to-ry
monog-a-mous	mo-nog-a-mous
untest-ed	un-test-ed
cel-ery	cel-er-y
stew-ardess	stew-ard-ess
epi-gram	ep-i-gram
ir-rec-on-cil-able	ir-rec-on-cil-a-ble
para-psy-chol-o-gy	par-a-psy-chol-o-gy
coxswain	cox-swain
prece-dence	prec-e-dence
nec-es-sary	nec-es-sar-y
both-ered	bothered
damsel	dam-sel
ex-pand-able	ex-pand-a-ble
pout-ing	pouting
psaltery	psal-ter-y
anony-mous	a-non-y-mous
con-stituent	con-stit-u-ent
cre-ativ-i-ty	cre-a-tiv-i-ty
bracelet	brace-let
min-der	mind-er
pre-his-toric	pre-his-tor-ic
cheery	cheer-y
cam-panol-o-gy	cam-pa-nol-o-gy
con-veyanc-ing	con-vey-anc-ing
tourist	tour-ist
fid-gety	fidg-et-y
swasti-ka	swas-ti-ka
gelatin	gel-a-tin
seabed	sea-bed
un-equiv-o-cal	un-e-quiv-o-cal
de-tainee	de-tain-ee
ever	ev-er
avenge	a-venge
gig-gling	giggling
melan-cholic	mel-an-chol-ic
nympho-ma-nia	nym-pho-ma-ni-a
minu-ti-ae	mi-nu-ti-ae
de-cay-ing	decaying
jus-ti-fi-able	jus-ti-fi-a-ble
elec-tron-ic	e-lec-tron-ic
un-suit-able	un-suit-a-ble
quirky	quirk-y
co-mestible	co-mes-ti-ble
el-e-men-tary	el-e-men-ta-ry
re-deemable	re-deem-a-ble
par-a-sitism	par-a-sit-ism
col-lapsi-ble	col-laps-i-ble
pres-tidig-i-ta-tion	pres-ti-dig-i-ta-tion
ex-tra-or-di-nary	ex-traor-di-nar-y
ap-petite	ap-pe-tite
skater	skat-er
teleprint-er	tel-e-print-er
lap-idary	lap-i-dar-y
viaduct	vi-a-duct
ma-tri-archy	ma-tri-ar-chy
whistler	whis-tler
potas-si-um	po-tas-si-um
salient	sa-li-ent
sergeant	ser-geant
ban-knote	bank-note
con-cil-ia-to-ry	con-cil-i-a-to-ry
envy	en-vy
worsted	wor-sted
tanker	tank-er
avun-cu-lar	a-vun-cu-lar
aque-duct	aq-ue-duct
regress	re-gress
florin	flor-in
gud-geon	gudg-eon
translit-er-ate	trans-lit-er-ate
im-mov-able	im-mov-a-ble
fla-gel-la-tion	flag-el-la-tion
smarten	smart-en
yel-lowed	yellowed
el-dest	eld-est
kina	ki-na
in-nu-mer-able	in-nu-mer-a-ble
frothy	froth-y
detox-i-fy	de-tox-i-fy
stran-gled	strangled
emol-u-ment	e-mol-u-ment
frailty	frail-ty
iras-ci-ble	i-ras-ci-ble
ogre	o-gre
pyra-can-tha	py-ra-can-tha
fur-rowed	furrowed
teller	tell-er
un-beat-able	un-beat-a-ble
beamy	beam-y
unin-su-lat-ed	un-in-su-lat-ed
speci-fici-ty	spec-i-fic-i-ty
blos-som-ing	blossoming
pat-terned	patterned
lyrist	lyr-ist
apos-tate	a-pos-tate
sun-tanned	suntanned
lurid	lu-rid
con-sulate	con-su-late
antacid	ant-ac-id
ex-plic-a-ble	ex-pli-ca-ble
comi-ty	com-i-ty
zany	za-ny
peachy	peach-y
as-phyx-ia	as-phyx-i-a
relict	rel-ict
chameleon	cha-me-le-on
beanstalk	bean-stalk
the-saurus	the-sau-rus
fal-ter-ing	fal-te-ring
hunter	hunt-er
lega-tion	le-ga-tion
be-fud-dling	befuddling
downy	down-y
saline	sa-line
apo-lit-i-cal	a-po-lit-i-cal
fil-i-buster	fil-i-bus-ter
man-telshelf	man-tel-shelf
readi-ness	read-i-ness
melod-ic	me-lod-ic
het-ero-dox	het-er-o-dox
pol-lard-ed	pollarded
rack-e-teer-ing	rack-et-eer-ing
avi-ate	a-vi-ate
es-capade	es-ca-pade
racial	ra-cial
ni-troge-nous	ni-trog-e-nous
provider	pro-vid-er
brandy	bran-dy
premis-es	prem-is-es
mati-nee	mat-i-nee
stag-ger-ing	staggering
semi-de-tached	sem-i-de-tached
her-i-tabil-i-ty	her-it-a-bil-i-ty
unassertive	un-as-ser-tive
lofty	loft-y
in-trauter-ine	in-tra-u-ter-ine
medic	med-ic
xeno-pho-bic	xen-o-pho-bic
di-lata-tion	dil-a-ta-tion
busi-ness-woman	busi-ness-wom-an
rigid-ly	rig-id-ly
arthro-pod	ar-thro-pod
gam-bling	gam-bling
astern	a-stern
acid	ac-id
de-ify	de-i-fy
cheer-leader	cheer-lead-er
lovesick	love-sick
shandy	shan-dy
per-me-abil-i-ty	per-me-a-bil-i-ty
steplad-der	step-lad-der
ide-al	i-de-al
fevered	fe-vered
de-ductible	de-duct-i-ble
tribu-la-tion	trib-u-la-tion
hexa-gon	hex-a-gon
an-tithe-sis	an-tith-e-sis
so-ci-ety	so-ci-e-ty
prov-ably	prov-a-bly
temer-i-ty	te-mer-i-ty
big-otry	big-ot-ry
un-nerv-ing	unnerving
sev-ered	severed
deli	del-i
ed-i-to-r-i-al	ed-i-to-ri-al
limpet	lim-pet
dairy-ing	dair-y-ing
ex-ploita-tive	ex-ploit-a-tive
be-wil-dered	bewildered
ax-iomat-ic	ax-i-o-mat-ic
onto	on-to
exam	ex-am
pan-das	pan-das
pro-mul-gate	prom-ul-gate
poly-graph	pol-y-graph
tiller	till-er
emit	e-mit
brand-ing	branding
par-tici-ple	par-ti-ci-ple
en-joy-ably	en-joy-a-bly
us-abil-i-ty	us-a-bil-i-ty
manes	ma-nes
un-rea-son-ably	un-rea-son-a-bly
timer	tim-er
spec-troscopy	spec-tros-co-py
usu-ri-ous	u-su-ri-ous
ve-nial	ve-ni-al
dredger	dredg-er
in-hab-i-tant	in-hab-it-ant
grasshop-per	grass-hop-per
po-lice-woman	po-lice-wom-an
neu-ro-science	neu-ro-sci-ence
patho-log-i-cal	path-o-log-i-cal
cleavers	cleav-ers
gra-tu-itous	gra-tu-i-tous
un-easi-ly	un-eas-i-ly
cliquey	cli-quey
springy	spring-y
cour-t-house	court-house
pho-to-copi-er	pho-to-cop-i-er
amaz-ing	a-maz-ing
rudi-men-ta-ry	ru-di-men-ta-ry
punch-line	punchline
over-all	o-ver-all
es-pi-onage	es-pi-o-nage
wiper	wip-er
stron-groom	strong-room
un-stop-pable	un-stop-pa-ble
fiery	fier-y
racial-ism	ra-cial-ism
re-for-esta-tion	re-for-est-a-tion
se-quoia	se-quoi-a
rein-sur-ance	re-in-sur-ance
soror-i-ty	so-ror-i-ty
un-change-able	un-change-a-ble
wiz-ardry	wiz-ard-ry
pectin	pec-tin
frosty	frost-y
avow	a-vow
cud-gel	cudg-el
reprise	re-prise
raf-fia	raf-fi-a
chamois	cham-ois
palat-able	pal-at-a-ble
homage	hom-age
crys-talline	crys-tal-line
over-leaf	o-ver-leaf
doyen	doy-en
pot-tery	pot-ter-y
tu-ition	tu-i-tion
no-body	no-bod-y
suit-abil-i-ty	suit-a-bil-i-ty
babysit-ting	babysitting
aqualung	aq-ua-lung
in-tra-venous-ly	in-tra-ve-nous-ly
un-re-pairable	un-re-pair-a-ble
sexy	sex-y
athe-ism	a-the-ism
nether	neth-er
dark-ened	dar-kened
scrolling	scroll-ing
jumper	jump-er
breathy	breath-y
un-en-durable	un-en-dur-a-ble
para-met-ric	par-a-met-ric
motet	mo-tet
un-ac-count-able	un-ac-count-a-ble
drea-ry	drear-y
ra-tio-nal-ly	ra-tion-al-ly
lapel	la-pel
un-ob-tain-able	un-ob-tain-a-ble
hon-esty	hon-es-ty
re-mark-able	re-mark-a-ble
pity	pit-y
podi-um	po-di-um
plea-sur-able	pleas-ur-a-ble
glycine	gly-cine
elec-tro-dy-nam-ics	e-lec-tro-dy-nam-ics
seizure	sei-zure
ap-praisal	ap-prais-al
colo-nial	co-lo-ni-al
drafty	draft-y
macro-eco-nom-ic	mac-ro-ec-o-nom-ic
ovary	o-va-ry
overview	o-ver-view
wacky	wack-y
capri-ole	cap-ri-ole
lun-cheon	lunch-eon
semi-cir-cle	sem-i-cir-cle
suit-ably	suit-a-bly
charge-able	charge-a-ble
hege-mon-ic	heg-e-mon-ic
tes-ta-men-tary	tes-ta-men-ta-ry
ra-dio	ra-di-o
as-bestos	as-bes-tos
bushy	bush-y
mono-syl-lab-ic	mon-o-syl-lab-ic
lender	lend-er
an-ti-sta-t-ic	an-ti-stat-ic
limekiln	lime-kiln
gyro	gy-ro
coac-tion	co-ac-tion
flick-er-ing	flickering
eater	eat-er
deben-ture	de-ben-ture
drudgery	drudg-er-y
over-whelm	o-ver-whelm
kilo-byte	kil-o-byte
ici-cle	i-ci-cle
naughty	naugh-ty
in-dis-pens-able	in-dis-pen-sa-ble
mega-lith	meg-a-lith
satyr	sa-tyr
sandy	sand-y
unique-ly	u-nique-ly
chronome-ter	chro-nom-e-ter
poet	po-et
monog-a-mous-ly	mo-nog-a-mous-ly
psy-chopathol-o-gy	psy-cho-pa-thol-o-gy
fetishis-tic	fet-ish-is-tic
de-c-la-ra-tion	dec-la-ra-tion
over-dose	o-ver-dose
punter	punt-er
phrenol-o-gy	phre-nol-o-gy
trea-so-nous	trea-son-ous
im-pe-cu-nious	im-pe-cu-ni-ous
ca-su-istry	cas-u-ist-ry
un-read-able	un-read-a-ble
bindweed	bind-weed
hec-tor-ing	hectoring
testos-terone	tes-tos-ter-one
alone	a-lone
epi-demi-ol-o-gy	ep-i-de-mi-ol-o-gy
elec-trol-y-sis	e-lec-trol-y-sis
dis-cov-ery	dis-cov-er-y
stroller	stroll-er
evict	e-vict
un-car-ed	un-cared
re-sis-tance	re-sist-ance
adult	a-dult
dis-com-fort-ing	discomforting
wastage	wast-age
en-doge-nous	en-dog-e-nous
greasy	greas-y
undis-turbed	un-dis-turbed
graphite	graph-ite
legume	leg-ume
conifer	co-ni-fer
em-bit-tered	embittered
pre-dictably	pre-dict-a-bly
chee-rio	cheer-i-o
ex-huma-tion	ex-hu-ma-tion
un-palat-able	un-pal-at-a-ble
timetable	time-ta-ble
molyb-de-num	mo-lyb-de-num
de-flower	de-flow-er
polypep-tide	pol-y-pep-tide
emit-ter	e-mit-ter
busk-ing	busking
so-porif-ic	sop-o-rif-ic
fatu-ous	fat-u-ous
spinach	spin-ach
una-nim-i-ty	u-na-nim-i-ty
gourmet	gour-met
overnight	o-ver-night
ureter	u-re-ter
climber	climb-er
ho-minid	hom-i-nid
emas-cu-late	e-mas-cu-late
wingspan	wing-span
tetrox-ide	te-trox-ide
provin-cial-ism	pro-vin-cial-ism
inca	in-ca
castel-lat-ed	cas-tel-lat-ed
par-a-sitic	par-a-sit-ic
sor-cery	sor-cer-y
emer-gence	e-mer-gence
ar-rival	ar-ri-val
every-day	eve-ry-day
in-de-fin-able	in-de-fin-a-ble
scoff-ing	scoffing
wealthy	wealth-y
cack-ling	cackling
crier	cri-er
delu-sive	de-lu-sive
oblo-quy	ob-lo-quy
spir-i-tu-al	spir-it-u-al
detri-men-tal	det-ri-men-tal
re-assess-ment	re-as-sess-ment
hooky	hook-y
loft-ed	lofted
post-mistress	post-mis-tress
warpath	war-path
ridicule	rid-i-cule
tele-ol-o-gy	tel-e-ol-o-gy
sago	sa-go
tom-fool-ery	tom-fool-er-y
uvu-lar	u-vu-lar
fizzy	fizz-y
emo-tive	e-mo-tive
nar-ra-tol-ogy	nar-ra-tol-o-gy
erot-ic	e-rot-ic
katy-did	ka-ty-did
di-ana	di-an-a
phoneme	pho-neme
homonym	hom-o-nym
ob-lig-ate	ob-li-gate
copy-right	cop-y-right
preterite	pret-er-ite
un-pre-dictably	un-pre-dict-a-bly
bio-chem-i-cal	bi-o-chem-i-cal
char-cu-terie	char-cu-te-rie
semi-con-duct-ing	sem-i-con-duct-ing
hawthorn	haw-thorn
iso-topic	i-so-top-ic
lazy-bones	la-zy-bones
proxy	prox-y
sinewy	sin-ew-y
equa-tion	e-qua-tion
im-preg-nable	im-preg-na-ble
sem-i-nary	sem-i-nar-y
ego	e-go
florid	flor-id
emo-tion	e-mo-tion
parish	par-ish
glam-orous	glam-or-ous
as-cen-dant	as-cend-ant
un-wieldy	un-wield-y
cuprous	cu-prous
heresy	her-e-sy
emen-da-tion	e-men-da-tion
incog-ni-to	in-cog-ni-to
bas-ketry	bas-ket-ry
pen-i-ten-tiary	pen-i-ten-tia-ry
ri-ot-ing	ri-o-ting
warhorse	war-horse
avail	a-vail
bizarre	bi-zarre
scruti-ny	scru-ti-ny
spon-ta-neous-ly	spon-ta-ne-ous-ly
ef-fron-tery	ef-fron-ter-y
inkwell	ink-well
atone	a-tone
dis-able	dis-a-ble
bub-blegum	bub-ble-gum
re-versible	re-vers-i-ble
pro-tease	pro-te-ase
de-liv-er-able	de-liv-er-a-ble
equal	e-qual
metro	met-ro
pre-dict-ed	predicted
catal-y-sis	ca-tal-y-sis
in-domitable	in-dom-i-ta-ble
obei-sance	o-bei-sance
in-hos-pitable	in-hos-pi-ta-ble
axis	ax-is
mil-lisec-ond	mil-li-sec-ond
zigzag	zig-zag
trib-u-tary	trib-u-tar-y
vista	vis-ta
un-rea-son-able	un-rea-son-a-ble
enam-el	e-nam-el
para-nor-mal	par-a-nor-mal
in-dec-lin-able	in-de-clin-a-ble
for-syth-ia	for-syth-i-a
ped-a-gogy	ped-a-go-gy
dis-pos-able	dis-pos-a-ble
over-state	o-ver-state
pic-turesque	pic-tur-esque
sier-ra	si-er-ra
drink-able	drink-a-ble
sonorous	so-no-rous
sneaky	sneak-y
siren	si-ren
syn-ony-mous	syn-on-y-mous
scholas-ti-cism	scho-las-ti-cism
dessert	des-sert
the-atri-cal	the-at-ri-cal
io-dine	i-o-dine
un-de-ni-ably	un-de-ni-a-bly
ap-proach-ing	approaching
ma-hogany	ma-hog-a-ny
capy-bara	cap-y-ba-ra
an-tipa-thet-ic	an-ti-pa-thet-ic
avari-cious	av-a-ri-cious
hon-orif-ic	hon-or-if-ic
unso-cia-ble	un-so-cia-ble
bonus	bo-nus
tick-et-ed	ticketed
pom-padour	pom-pa-dour
poster	post-er
ejec-tor	e-jec-tor
teth-er-ing	tethering
re-deemer	re-deem-er
un-sur-pass-able	un-sur-pass-a-ble
ex-plo-ration	ex-plo-ra-tion
tawny	taw-ny
area	ar-e-a
rein-ter-pre-ta-tion	re-in-ter-pre-ta-tion
duster	dust-er
un-shak-able	un-shak-a-ble
evolve	e-volve
arise	a-rise
poly-chrome	pol-y-chrome
be-liev-able	be-liev-a-ble
dy-nasty	dy-nas-ty
ram-shackle	ram-shack-le
lex-i-cog-ra-ph-er	lex-i-cog-ra-pher
voyeurism	vo-yeur-ism
periglacial	per-i-gla-cial
phone-mic	pho-ne-mic
halfway	half-way
saunter	saun-ter
on-tol-ogy	on-tol-o-gy
bion-ic	bi-on-ic
pharaoh	phar-aoh
aqua	aq-ua
herbage	herb-age
apery	ap-er-y
in-sou-ciance	in-sou-ci-ance
sinker	sink-er
grainy	grain-y
over-re-act	o-ver-re-act
se-nior-i-ty	sen-ior-i-ty
eques-tri-an	e-ques-tri-an
archer	arch-er
cop-pery	cop-per-y
venue	ven-ue
bleary	blear-y
polypho-ny	po-lyph-o-ny
up-lift-ed	uplifted
debu-tante	deb-u-tante
turnip	tur-nip
unimag-i-na-tive	un-im-ag-i-na-tive
rene-gade	ren-e-gade
timid-ly	tim-id-ly
im-mutable	im-mu-ta-ble
fri-ary	fri-ar-y
over-flow	o-ver-flow
haz-ardous	haz-ard-ous
reac-cept	re-ac-cept
hys-te-ria	hys-te-ri-a
fo-lio	fo-li-o
sep-a-ratism	sep-a-ra-tism
di-atom	di-a-tom
shaven	shav-en
harshen	harsh-en
clever	clev-er
crum-bling	crumbling
shaman-ic	sha-man-ic
vari-abil-i-ty	var-i-a-bil-i-ty
in-tu-itive-ly	in-tu-i-tive-ly
epiphe-nom-e-non	ep-i-phe-nom-e-non
domi-no	dom-i-no
trea-sure	treas-ure
em-ploy-able	em-ploy-a-ble
ir-ra-tional-i-ty	ir-ra-tion-al-i-ty
over-ac-tive	o-ver-ac-tive
ide-al-i-ty	i-de-al-i-ty
sewage	sew-age
windswept	wind-swept
stovepipe	stove-pipe
ex-tra-galac-tic	ex-tra-ga-lac-tic
arable	ar-a-ble
propen-si-ty	pro-pen-si-ty
glassy	glass-y
pupil	pu-pil
ex-tra-ditable	ex-tra-dit-a-ble
un-treat-able	un-treat-a-ble
baguette	ba-guette
ax-e-man	axe-man
so-cio-bi-ol-o-gy	so-ci-o-bi-ol-o-gy
ashamed	a-shamed
place-bo	pla-ce-bo
nurs-ery-men	nurs-er-y-men
sand-piper	sand-pi-per
apolo-getic	a-pol-o-get-ic
any-thing	an-y-thing
replic-a-ble	rep-li-ca-ble
ar-rester	ar-rest-er
in-frared	in-fra-red
bar-tender	bar-tend-er
re-pro-ducible	re-pro-duc-i-ble
apoplec-tic	ap-o-plec-tic
tetra-he-dron	tet-ra-he-dron
un-shaven	un-shav-en
freely	free-ly
heron-ry	her-on-ry
ques-tion-able	ques-tion-a-ble
saga-cious	sa-ga-cious
redac-tion	re-dac-tion
psalmist	psalm-ist
di-aphanous	di-aph-a-nous
epis-to-lary	e-pis-to-lar-y
goer	go-er
wether	weth-er
para-chutist	par-a-chut-ist
rum-pled	rumpled
chary	char-y
pre-cau-tion-ary	pre-cau-tion-ar-y
mod-ernist	mod-ern-ist
fanci-er	fan-ci-er
laven-der	lav-en-der
liftoff	lift-off
lodestar	lode-star
un-frozen	un-fro-zen
raven-ing	rav-en-ing
reac-qui-si-tion	re-ac-qui-si-tion
un-remit-ting	un-re-mit-ting
salience	sa-li-ence
con-strict-ed	constricted
daf-fodil	daf-fo-dil
clash-ing	clashing
com-modore	com-mo-dore
vi-su-al	vis-u-al
cus-tody	cus-to-dy
patis-serie	pa-tis-se-rie
whizkids	whizkids
basin	ba-sin
ten-able	ten-a-ble
over-sim-pli-fy	o-ver-sim-pli-fy
pe-tit	pet-it
si-nu-soidal	si-nus-oi-dal
despo-tism	des-pot-ism
painter	paint-er
benefice	ben-e-fice
cladding	clad-ding
ep-ithe-li-um	ep-i-the-li-um
melee	me-lee
tarsal	tar-sal
arid	ar-id
sub-stan-dard	sub-stand-ard
napoleon	na-po-le-on
grad-ual	grad-u-al
ra-bid	rab-id
gleam-ing	gleaming
lyri-cist	lyr-i-cist
deny	de-ny
un-pre-dictabil-i-ty	un-pre-dict-a-bil-i-ty
platy-pus	plat-y-pus
over-seer	o-ver-se-er
un-trans-lat-able	un-trans-lat-a-ble
wrestler	wres-tler
de-f-i-n-i-tion	def-i-ni-tion
mar-ketable	mar-ket-a-ble
col-umn	co-lumn
pedol-o-gy	pe-dol-o-gy
stat-u-ary	stat-u-ar-y
bougainvil-lea	bou-gain-vil-le-a
woofer	woof-er
ma-joli-ca	ma-jol-i-ca
dis-agree	dis-a-gree
parochial	pa-ro-chi-al
doubter	doubt-er
con-sul-tant	con-sult-ant
be-fud-dled	befuddled
vir-ginal	vir-gin-al
pre-sentable	pre-sent-a-ble
un-charis-mat-ic	un-char-is-mat-ic
warthog	wart-hog
cur-able	cur-a-ble
heron	her-on
un-avail-abil-i-ty	un-a-vail-a-bil-i-ty
equable	eq-ua-ble
meringue	me-ringue
bud-getary	budg-et-ar-y
respire	re-spire
skua	sku-a
leg-endary	leg-end-ar-y
de-viant	de-vi-ant
re-tini-tis	ret-i-ni-tis
over-bear-ing	o-ver-bear-ing
astride	a-stride
scorcher	scorch-er
polemic	po-lem-ic
ex-porter	ex-port-er
bedrock	bed-rock
phrase-ol-o-gy	phra-se-ol-o-gy
baron	bar-on
colo-nial-ist	co-lo-ni-al-ist
achieve-ment	a-chieve-ment
ob-scu-ran-tism	ob-scu-rant-ism
up-hol-stery	up-hol-ster-y
un-quench-able	un-quench-a-ble
pineal	pin-e-al
oblit-er-a-tion	ob-lit-er-a-tion
erad-i-cat-ed	e-rad-i-cat-ed
phys-io-ther-a-py	phys-i-o-ther-a-py
study	stud-y
usurer	u-su-rer
au-dio	au-di-o
re-spon-dent	re-spond-ent
renown	re-nown
mono-lay-er	mon-o-lay-er
over-crowd	o-ver-crowd
motile	mo-tile
meta-mor-phism	met-a-mor-phism
rhodo-den-dron	rho-do-den-dron
record-ed	re-cor-ded
polo-ni-um	po-lo-ni-um
ionos-phere	i-on-o-sphere
geo-phys-i-cal	ge-o-phys-i-cal
cordage	cord-age
treat-able	treat-a-ble
palmy	palm-y
nowhere	no-where
col-lec-tivist	col-lec-tiv-ist
doorstep	door-step
more-over	more-o-ver
reshow	re-show
re-tain-ing	retaining
bathrobe	bath-robe
trigonom-e-try	trig-o-nom-e-try
gavotte	ga-votte
dimer	di-mer
glad-i-a-to-r-i-al	glad-i-a-to-ri-al
lazy	la-zy
dosage	dos-age
syl-labary	syl-la-bar-y
prompter	prompt-er
skele-ton	skel-e-ton
mari-nade	mar-i-nade
table-cloth	ta-ble-cloth
de-lin-eate	de-lin-e-ate
reroute	re-route
bury	bur-y
rekin-dle	re-kin-dle
rooftop	roof-top
omen	o-men
wicked-ness	wick-ed-ness
wapi-ti	wap-i-ti
over-ca-pac-i-ty	o-ver-ca-pac-i-ty
deca-dence	dec-a-dence
break-able	break-a-ble
spir-i-tu-al-i-ty	spir-it-u-al-i-ty
re-sult-ing	resulting
slinky	slink-y
un-so-licit-ed	un-so-lic-it-ed
de-sir-abil-i-ty	de-sir-a-bil-i-ty
elec-tro-sta-t-ic	e-lec-tro-stat-ic
over-re-ac-tion	o-ver-re-ac-tion
com-mend-able	com-mend-a-ble
foren-sic	fo-ren-sic
cam-era	cam-er-a
heat-wave	heatwave
enor-mi-ty	e-nor-mi-ty
ever-more	ev-er-more
in-sulin	in-su-lin
ori-en-tal-ism	o-ri-en-tal-ism
dodo	do-do
pilchard	pil-chard
oafish	oaf-ish
mi-cro-bial	mi-cro-bi-al
de-mo-graph-ics	dem-o-graph-ics
tepid	tep-id
over-ly	o-ver-ly
api-ary	a-pi-ar-y
trace-abil-i-ty	trace-a-bil-i-ty
moldy	mold-y
join-ery	join-er-y
ine-bri-ate	in-e-bri-ate
un-abashed	un-a-bashed
di-achron-ic	di-a-chron-ic
vivid	viv-id
unchris-t-ian	un-chris-tian
famine	fam-ine
think-able	think-a-ble
elec-tive	e-lec-tive
spir-i-tu-al-ist	spir-it-u-al-ist
con-ve-nient-ly	con-ven-ient-ly
yokel	yo-kel
en-joy-able	en-joy-a-ble
cog-nizant	cog-ni-zant
un-in-for-ma-tive	un-in-form-a-tive
ori-ent	o-ri-ent
weari-ly	wea-ri-ly
marten	mar-ten
meta-mor-pho-sis	met-a-mor-pho-sis
botany	bot-a-ny
chival-rous	chiv-al-rous
poly-mor-phous	pol-y-mor-phous
iden-ti-fi-able	i-den-ti-fi-a-ble
op-er-cu-lum	o-per-cu-lum
pro-pri-etor	pro-pri-e-tor
omega	o-me-ga
emo-tion-al	e-mo-tion-al
silent-ly	si-lent-ly
fac-to-r-i-al	fac-to-ri-al
gassy	gas-sy
orang	o-rang
dili-gent	dil-i-gent
ovar-i-an	o-var-i-an
trea-sury	treas-ur-y
makeweight	make-weight
sander	sand-er
muslin	mus-lin
recre-ation	rec-re-a-tion
psy-cho-me-t-ric	psy-cho-met-ric
su-per-posed	superposed
every-body	eve-ry-bod-y
aside	a-side
in-abil-i-ty	in-a-bil-i-ty
loca-tive	loc-a-tive
in-ter-me-di-ary	in-ter-me-di-ar-y
cre-osote	cre-o-sote
sul-tana	sul-tan-a
monarch	mon-arch
dero-ga-tion	der-o-ga-tion
body	bod-y
horny	horn-y
dri-ving	driv-ing
pi-ran-ha	pi-ra-nha
roller	roll-er
prophe-cy	proph-e-cy
har-mo-nious-ly	har-mo-ni-ous-ly
method	meth-od
para-graph	par-a-graph
equer-ry	eq-uer-ry
chanter	chant-er
taboo	ta-boo
menagerie	me-nag-er-ie
whomev-er	whom-ev-er
eu-kary-ote	eu-kar-y-ote
vo-cab-u-lary	vo-cab-u-lar-y
prosce-ni-um	pro-sce-ni-um
turntable	turn-ta-ble
lanky	lank-y
nodal	nod-al
over-state-ment	o-ver-state-ment
tapi-o-ca	tap-i-o-ca
man-darin	man-da-rin
in-com-men-su-rable	in-com-men-su-ra-ble
in-alien-able	in-al-ien-a-ble
reper-toire	rep-er-toire
lovelorn	love-lorn
dizzi-ness	diz-zi-ness
cervix	cer-vix
bio-med-ical	bi-o-med-i-cal
nau-sea	nau-se-a
premise	prem-ise
penance	pen-ance
pros-e-cu-to-r-i-al	pros-e-cu-to-ri-al
over-print	o-ver-print
chronol-o-gy	chro-nol-o-gy
delin-quent	de-lin-quent
dahlia	dahl-ia
evo-lute	ev-o-lute
min-istry	min-is-try
pro-ject-ing	projecting
over-come	o-ver-come
hos-pitable	hos-pi-ta-ble
pastis	pas-tis
ir-re-versibly	ir-re-vers-i-bly
queru-lous	quer-u-lous
stinky	stink-y
icy	i-cy
sever-i-ty	se-ver-i-ty
per-sona	per-so-na
white-washed	whitewashed
fa-nati-cism	fa-nat-i-cism
over-dra-mat-ic	o-ver-dra-mat-ic
an-tibi-ot-ic	an-ti-bi-ot-ic
savvy	sav-vy
sched-uler	sched-ul-er
mnemon-ics	mne-mon-ics
re-volver	re-volv-er
con-stab-u-lary	con-stab-u-lar-y
height-ened	heightened
tri-umvi-rate	tri-um-vi-rate
lazuli	laz-u-li
crumbly	crum-bly
sewing	sew-ing
peri	pe-ri
lazi-ly	la-zi-ly
click-ing	clicking
mi-cro-elec-tron-ics	mi-cro-e-lec-tron-ics
archdea-con	arch-dea-con
su-per-fluity	su-per-flu-i-ty
um-bili-cus	um-bil-i-cus
liti-gious	li-ti-gious
iden-ti-fi-er	i-den-ti-fi-er
joyride	joy-ride
erot-i-ca	e-rot-i-ca
ir-re-mov-able	ir-re-mov-a-ble
em-ployed	employed
in-vig-o-rat-ing	in-vig-or-at-ing
in-signif-i-cant	in-sig-nif-i-cant
con-vivial	con-viv-i-al
chill-ing	chilling
by-stander	by-stand-er
liar	li-ar
lugubri-ous	lu-gu-bri-ous
repo-si-tion	re-po-si-tion
shim-mer-ing	shimmering
geisha	gei-sha
apolo-gia	ap-o-lo-gi-a
pulpy	pulp-y
leg-isla-tive	leg-is-la-tive
dogged-ly	dog-ged-ly
crevasse	cre-vasse
roundel	roun-del
dis-obe-di-ent	dis-o-be-di-ent
spin-naker	spin-na-ker
ecol-o-gy	e-col-o-gy
sacra-ment	sac-ra-ment
stinger	sting-er
ha-cien-da	ha-ci-en-da
rever-ie	rev-er-ie
as-so-cia-tive	as-so-ci-a-tive
en-abled	e-na-bled
negate	ne-gate
grid-ded	gridded
in-ge-nious-ly	in-gen-ious-ly
apish	ap-ish
ar-te-r-i-al	ar-te-ri-al
slushy	slush-y
sub-jec-tivism	sub-jec-tiv-ism
lisp-ing	lis-ping
reser-va-tion	res-er-va-tion
cater-er	ca-ter-er
for-get-table	for-get-ta-ble
wispy	wisp-y
recital	re-cit-al
claus-tro-pho-bia	claus-tro-pho-bi-a
postal	post-al
fusil-lade	fu-sil-lade
thruster	thrust-er
evap-o-rate	e-vap-o-rate
galleon	gal-le-on
cir-cum-lo-cu-to-ry	cir-cum-loc-u-to-ry
wheezy	wheez-y
in-sur-gency	in-sur-gen-cy
any	an-y
ave	a-ve
apho-rism	aph-o-rism
midair	mid-air
so-bri-ety	so-bri-e-ty
gos-sipy	gos-sip-y
vari-cose	var-i-cose
va-porous	va-por-ous
cus-tom-ary	cus-tom-ar-y
over-play	o-ver-play
coro-na	co-ro-na
wavelet	wave-let
wolfish	wolf-ish
inat-ten-tive	in-at-ten-tive
re-lax-ation	re-lax-a-tion
eq-ui-table	eq-ui-ta-ble
prodi-gal	prod-i-gal
dili-gence	dil-i-gence
taffe-ta	taf-fe-ta
mishap	mis-hap
ex-oge-nous	ex-og-e-nous
stringer	string-er
in-ter-po-lat-able	in-ter-po-la-ta-ble
phys-iog-no-my	phys-i-og-no-my
chrono-graph	chron-o-graph
bindery	bind-er-y
restart	re-start
dele-te-ri-ous	del-e-te-ri-ous
para-chute	par-a-chute
un-ordered	un-or-dered
wash-er-woman	wash-er-wom-an
re-pen-tant	re-pent-ant
squally	squal-ly
frica-tive	fric-a-tive
dyestuff	dye-stuff
unswerv-ing	un-swerv-ing
hazel-nut	ha-zel-nut
vex-ing	vexing
den-tistry	den-tis-try
pol-luter	pol-lut-er
saucepan	sauce-pan
aton-al	a-ton-al
om-nipres-ence	om-ni-pres-ence
con-cate-nate	con-cat-e-nate
teenag-er	teen-ag-er
drowsi-ness	drow-si-ness
dri-ven	driv-en
con-ser-v-a-tive	con-serv-a-tive
rapid	rap-id
vacu-ity	va-cu-i-ty
rainy	rain-y
aris-to-crat	a-ris-to-crat
presto	pres-to
rani	ra-ni
au-toma-tion	au-to-ma-tion
erased	e-rased
equine	e-quine
stapes	sta-pes
firmware	firm-ware
ripen	rip-en
ori-en-ta-tion	o-ri-en-ta-tion
com-plainant	com-plain-ant
cliffhang-er	cliff-hang-er
rewrite	re-write
clink-ing	clin-king
tofu	to-fu
uni-cam-er-al	u-ni-cam-er-al
equip-ment	e-quip-ment
baobab	ba-o-bab
car-roty	car-rot-y
whim-per-ing	whimpering
chrono-log-i-cal	chron-o-log-i-cal
in-ter-de-pen-dent	in-ter-de-pend-ent
pro-to-zoan	pro-to-zo-an
lam-plit	lamp-lit
wreck-ing	wrecking
shifter	shift-er
fes-ter-ing	festering
cheeky	cheek-y
in-con-gruity	in-con-gru-i-ty
salty	salt-y
clank-ing	clan-king
over-seas	o-ver-seas
ex-ploita-tion	ex-ploi-ta-tion
mimet-ic	mi-met-ic
uten-sil	u-ten-sil
porter	por-ter
ir-ra-tional	ir-ra-tion-al
res-onator	res-o-na-tor
longish	long-ish
spillage	spill-age
op-er-a-tional	op-er-a-tion-al
bereft	be-reft
atyp-i-cal	a-typ-i-cal
school-teacher	school-teach-er
dri-ver-less	driv-er-less
avion-ics	a-vi-on-ics
triglyc-eride	tri-glyc-er-ide
apos-tle	a-pos-tle
retic-ule	ret-i-cule
pruri-ent	pru-ri-ent
voodoo	voo-doo
dis-parate	dis-pa-rate
dumb-found-ed	dumbfounded
based	based
orig-i-nate	o-rig-i-nate
retro-fit	ret-ro-fit
inani-ty	in-an-i-ty
un-ques-tion-ably	un-ques-tion-a-bly
edi-tion	e-di-tion
frat-ri-ci-dal	frat-ri-cid-al
triathlon	tri-ath-lon
army	ar-my
mys-tery	mys-ter-y
evan-ge-lis-tic	e-van-ge-lis-tic
legu-mi-nous	le-gu-mi-nous
fidu-cia-ry	fi-du-ci-ar-y
in-quisi-to-r-i-al	in-quis-i-to-ri-al
trio	tri-o
lazi-ness	la-zi-ness
viva	vi-va
fin-ery	fin-er-y
poly-no-mi-al	pol-y-no-mi-al
avid-i-ty	a-vid-i-ty
bios-phere	bi-o-sphere
chore-o-graph-ic	cho-re-o-graph-ic
howler	howl-er
flus-tered	flustered
orang-utan	o-rang-u-tan
crusty	crust-y
az-imuth	az-i-muth
waspish	wasp-ish
polyun-sat-u-rat-ed	pol-y-un-sat-u-rat-ed
re-gret-table	re-gret-ta-ble
litany	lit-a-ny
car-diac	car-di-ac
soli-tary	sol-i-tar-y
ar-ti-fi-cial-i-ty	ar-ti-fi-ci-al-i-ty
ragout	ra-gout
re-uni-fi-ca-tion	re-u-ni-fi-ca-tion
tenor	ten-or
cog-nizance	cog-ni-zance
or-ga-nize	or-gan-ize
emo-tion-less	e-mo-tion-less
un-de-tectable	un-de-tect-a-ble
info	in-fo
in-her-i-ta-ble	in-her-it-a-ble
erect	e-rect
graphol-o-gy	graph-ol-o-gy
icon-o-clast	i-con-o-clast
pe-ri-as-tron	per-i-as-tron
en-riched	enriched
patel-la	pa-tel-la
in-fir-mary	in-fir-ma-ry
cal-care-ous	cal-car-e-ous
crafty	craft-y
platelet	plate-let
evince	e-vince
pinkie	pink-ie
paean	pae-an
over-whelm-ing-ly	o-ver-whelm-ing-ly
pekan	pek-an
panoply	pan-o-ply
un-con-t-a-m-i-nat-ed	un-con-tam-i-nat-ed
syn-chrony	syn-chro-ny
or-a-to-rio	or-a-to-ri-o
con-trivance	con-triv-ance
prefer-ment	pre-fer-ment
un-easi-ness	un-eas-i-ness
uni-sex	u-ni-sex
metas-ta-sis	me-tas-ta-sis
erad-i-ca-tion	e-rad-i-ca-tion
oa-sis	o-a-sis
even-tu-al	e-ven-tu-al
em-bo-som	em-bos-om
table-land	ta-ble-land
tremor	trem-or
rigid-i-fy	ri-gid-i-fy
strate-gic	stra-te-gic
seclu-sion	se-clu-sion
over-draw	o-ver-draw
polyurethane	pol-y-u-re-thane
evil-do-er	e-vil-do-er
ex-per-i-menter	ex-per-i-ment-er
dimwit	dim-wit
un-clas-si-fi-able	un-clas-si-fi-a-ble
con-duc-tance	con-duct-ance
prof-itable	prof-it-a-ble
psy-chopath	psy-cho-path
rein-te-gra-tion	re-in-te-gra-tion
poly-atom-ic	pol-y-a-tom-ic
dis-agree-ment	dis-a-gree-ment
de-con-t-a-m-i-na-tion	de-con-tam-i-na-tion
guru	gu-ru
spoilage	spoil-age
in-ho-mo-ge-neous	in-ho-mo-ge-ne-ous
shunter	shunt-er
undis-tin-guished	un-dis-tin-guished
pri-apic	pri-ap-ic
earplug	ear-plug
leviathan	le-vi-a-than
at-ten-dance	at-tend-ance
im-munol-o-gy	im-mu-nol-o-gy
lega-cy	leg-a-cy
id-io-cy	id-i-o-cy
encage	en-cage
triv-ial	triv-i-al
cat-tery	cat-te-ry
malaise	ma-laise
in-con-ve-nient	in-con-ven-ient
viol	vi-ol
sax-ony	sax-o-ny
slater	slat-er
ur-gency	ur-gen-cy
cycli-cal	cy-cli-cal
ed-uca-tive	ed-u-ca-tive
iron-ic	i-ron-ic
scrib-bling	scribbling
in-sur-mount-able	in-sur-mount-a-ble
at-tack-ing	attacking
coloured	co-loured
rein-vest	re-in-vest
bat-ter-ing	battering
an-tipa-thy	an-tip-a-thy
cli-toris	clit-o-ris
res-olute	res-o-lute
in-her-i-tance	in-her-it-ance
an-thro-pocen-tric	an-thro-po-cen-tric
fever	fe-ver
irate	i-rate
over-grown	o-ver-grown
rocky	rock-y
cat-a-stro-phe	ca-tas-tro-phe
awak-en	a-wak-en
ego-tism	e-go-tism
undis-closed	un-dis-closed
iso-la-tion-ism	i-so-la-tion-ism
rosy	ros-y
asleep	a-sleep
su-perbly	su-perb-ly
felo-nious	fe-lo-ni-ous
over-pow-er	o-ver-pow-er
de-nier	de-ni-er
renum-ber	re-num-ber
veni-son	ven-i-son
petu-lance	pet-u-lance
ga-mete	gam-ete
seedy	seed-y
sub-servience	sub-ser-vi-ence
re-ceiv-able	re-ceiv-a-ble
cred-itable	cred-it-a-ble
retell	re-tell
grotesque	gro-tesque
hookah	hook-ah
sur-viv-able	sur-viv-a-ble
maudlin	maud-lin
frigid	frig-id
bac-te-r-i-al	bac-te-ri-al
dis-tillery	dis-till-er-y
mist-imed	mis-timed
libero	li-be-ro
poros-i-ty	po-ros-i-ty
cougar	cou-gar
an-nu-ity	an-nu-i-ty
overop-ti-mistic	o-ver-op-ti-mis-tic
in-deli-ble	in-del-i-ble
penal-ty	pen-al-ty
table-ware	ta-ble-ware
over-worked	overworked
telegram	tel-e-gram
poly-mor-phism	pol-y-mor-phism
trans-portable	trans-port-a-ble
agent	a-gent
tightrope	tight-rope
needy	need-y
hor-mon-al	hor-mo-nal
di-etit-ian	di-e-ti-tian
kudu	ku-du
stodgy	stodg-y
con-cor-dance	con-cord-ance
lin-eage	lin-e-age
painstak-ing-ly	pains-tak-ing-ly
mem-o-rable	mem-o-ra-ble
overt-ly	o-vert-ly
totemic	to-tem-ic
eon	e-on
despot-ic	des-pot-ic
radar	ra-dar
taster	tast-er
eleventh	e-lev-enth
hy-drangea	hy-dran-gea
rec-i-p-ro-cate	re-cip-ro-cate
uni-verse	u-ni-verse
verisimil-i-tude	ver-i-si-mil-i-tude
ephor	eph-or
fig-u-ra-tive-ly	fig-ur-a-tive-ly
erup-tion	e-rup-tion
rhetoric	rhet-o-ric
grassy	grass-y
serendip-i-tous	ser-en-dip-i-tous
py-rotech-nic	py-ro-tech-nic
cool-ing	cooling
re-pen-tance	re-pent-ance
derelict	der-e-lict
in-audi-ble	in-au-di-ble
laud-able	laud-a-ble
emer-sion	e-mer-sion
oblate	ob-late
bul-letin	bul-le-tin
bio-mass	bi-o-mass
un-nec-es-sary	un-nec-es-sar-y
po-litesse	pol-i-tesse
protest-ing	protesting
hero-ical-ly	he-ro-i-cal-ly
uter-ine	u-ter-ine
axle	ax-le
peanut	pea-nut
gan-g-ly	gan-gly
py-rotech-nics	py-ro-tech-nics
groovy	groov-y
sitar	si-tar
prof-itabil-i-ty	prof-it-a-bil-i-ty
re-liant	re-li-ant
onion	on-ion
quan-tifi-able	quan-ti-fi-a-ble
mono-ma-nia	mon-o-ma-ni-a
snowy	snow-y
in-vol-un-tary	in-vol-un-tar-y
weari-ness	wea-ri-ness
mod-ernism	mod-ern-ism
largo	lar-go
enu-mer-a-tion	e-nu-mer-a-tion
sub-mersible	sub-mers-i-ble
lyri-cism	lyr-i-cism
suf-fragette	suf-fra-gette
viril-i-ty	vi-ril-i-ty
psy-chi-atric	psy-chi-at-ric
oblique	o-blique
piti-ful	pit-i-ful
slav-ery	slav-er-y
in-ter-ci-ty	in-ter-cit-y
may-oral-ty	may-or-al-ty
in-jury	in-ju-ry
beget	be-get
iden-ti-fi-ca-tion	i-den-ti-fi-ca-tion
un-men-tion-able	un-men-tion-a-ble
her-itage	her-it-age
be-trothal	be-troth-al
lama	la-ma
di-a-betes	di-a-be-tes
scrupu-lous-ly	scru-pu-lous-ly
re-seller	re-sell-er
pota-to	po-ta-to
dry-s-tone	dry-stone
there-abouts	there-a-bouts
or-nithol-o-gist	or-ni-thol-o-gist
eu-phemisti-cal-ly	eu-phe-mis-ti-cal-ly
fri-able	fri-a-ble
bound-ary	bound-a-ry
moun-taineer	moun-tain-eer
mea-sure-less	meas-ure-less
char-i-o-teer	char-i-ot-eer
crofter	croft-er
elec-table	e-lect-a-ble
repli-cate	rep-li-cate
nurs-ery-man	nurs-er-y-man
sleepi-ness	sleep-i-ness
spokesper-son	spokes-per-son
reify	re-i-fy
diva	di-va
poly-cyclic	pol-y-cy-clic
teenaged	teen-aged
pam-phle-teer	pam-phlet-eer
minibus	min-i-bus
seedbed	seed-bed
bio-chemist	bi-o-chem-ist
hefty	heft-y
carouse	ca-rouse
guano	gua-no
wari-ness	war-i-ness
apos-to-late	a-pos-to-late
facet	fac-et
un-drink-able	un-drink-a-ble
ab-solute	ab-so-lute
maser	ma-ser
curvi-lin-ear	cur-vi-lin-e-ar
lifebelt	life-belt
founder	found-er
lyric	lyr-ic
heraldic	he-ral-dic
hearthrug	hearth-rug
post-mortem	post-mor-tem
smelt-ing	smelting
unchecked	un-checked
peas-antry	peas-ant-ry
piv-otal	piv-ot-al
song-writer	song-writ-er
cen-trifuge	cen-tri-fuge
er-ro-neous-ly	er-ro-ne-ous-ly
ge-nial	ge-ni-al
hilly	hill-y
diet	di-et
chester-field	ches-ter-field
beau-teous	beau-te-ous
drainage	drain-age
scraper	scrap-er
en-hancer	en-hanc-er
calami-ty	ca-lam-i-ty
or-biter	or-bit-er
in-spi-ra-tional	in-spi-ra-tion-al
palate	pal-ate
re-open	re-o-pen
kedgeree	ked-ger-ee
in-com-press-ible	in-com-press-i-ble
defuse	de-fuse
far-away	far-a-way
dis-mem-bered	dismembered
ugly	ug-ly
trousers	trou-sers
babysit-ter	ba-by-sit-ter
unin-spir-ing	un-in-spir-ing
positron	pos-i-tron
dodgem	dodg-em
stoa	sto-a
scaly	scal-y
in-ter-roga-to-ry	in-ter-rog-a-to-ry
de-ca-pod	dec-a-pod
feb-ru-ary	feb-ru-ar-y
vanil-la	va-nil-la
bond-ing	bonding
foot-balling	foot-ball-ing
solem-ni-ty	so-lem-ni-ty
odi-um	o-di-um
elec-tro-cu-tion	e-lec-tro-cu-tion
sacral	sa-cral
tele-graph	tel-e-graph
apol-o-gist	a-pol-o-gist
backer	back-er
ion	i-on
brassy	brass-y
herbal-ist	herb-al-ist
mono-graph-ic	mon-o-graph-ic
avalanche	av-a-lanche
con-ducive	con-du-cive
donor	do-nor
ap-proval	ap-prov-al
un-gentle-man-ly	un-gen-tle-man-ly
lawyer	law-yer
equate	e-quate
de-mo-c-ra-t-ic	dem-o-crat-ic
link-able	link-a-ble
re-formist	re-form-ist
lion	li-on
brew-ery	brew-er-y
doyenne	doy-enne
tachy-on	tach-y-on
cari-bou	car-i-bou
lever	lev-er
us-able	us-a-ble
woman	wom-an
psy-chother-a-py	psy-cho-ther-a-py
even	e-ven
con-ge-nial	con-gen-ial
painful	pain-ful
over-run	o-ver-run
ru-ined	ruined
pesti-len-tial	pes-ti-len-tial
payable	pay-a-ble
purga-tive	pur-ga-tive
decade	dec-ade
gree-nie	green-ie
lol-lipop	lol-li-pop
flautist	flau-tist
en-vi-able	en-vi-a-ble
seis-mome-ter	seis-mom-e-ter
demise	de-mise
sur-vival	sur-viv-al
moun-taineer-ing	moun-tain-eer-ing
galling	gall-ing
mist-ime	mis-time
refugee	ref-u-gee
celeb	ce-leb
retroac-tive	ret-ro-ac-tive
trusty	trust-y
elab-o-rate	e-lab-o-rate
sober-ing	sobering
bio-rhythm	bi-o-rhythm
sycamore	syc-a-more
euro	eu-ro
elan	e-lan
lumpy	lump-y
mul-ti-proces-sor	mul-ti-proc-es-sor
nico-tine	nic-o-tine
dyad	dy-ad
un-e-lec-table	un-e-lect-a-ble
het-erol-o-gous	het-er-ol-o-gous
hexag-o-nal	hex-ag-o-nal
rangy	rang-y
dy-namo	dy-na-mo
mis-sion-ary	mis-sion-ar-y
rely	re-ly
telling-ly	tell-ing-ly
asex-u-al	a-sex-u-al
shekel	shek-el
bap-tismal	bap-tis-mal
canopy	can-o-py
unar-guable	un-ar-gu-a-ble
mega	meg-a
pedestal	ped-es-tal
en-able	en-a-ble
neo-prene	ne-o-prene
sec-ondary	sec-ond-ar-y
dy-namism	dy-na-mism
dauber	daub-er
mis-nomer	mis-no-mer
noisy	nois-y
li-brary	li-brar-y
pael-la	pa-el-la
stilet-to	sti-let-to
decla-ma-tion	dec-la-ma-tion
ca-su-al-ty	cas-u-al-ty
hermeneu-tic	her-me-neu-tic
aquiline	aq-ui-line
pic-to-r-i-al	pic-to-ri-al
com-man-der	com-mand-er
equiv-o-ca-tion	e-quiv-o-ca-tion
longevi-ty	lon-gev-i-ty
po-ten-tial-i-ty	po-ten-ti-al-i-ty
broc-coli	broc-co-li
in-con-tro-vert-ible	in-con-tro-vert-i-ble
charis-ma	cha-ris-ma
id-iot	id-i-ot
necro-mancer	nec-ro-man-cer
taxi-der-mist	tax-i-der-mist
semi	sem-i
scullery	scul-ler-y
blud-geon	bludg-eon
ini-tia-tive	in-i-ti-a-tive
lethar-gy	leth-ar-gy
tourni-quet	tour-ni-quet
chantry	chan-try
bur-ial	bur-i-al
pep-pery	pep-per-y
amused	a-mused
cam-era-man	cam-er-a-man
synap-tic	syn-ap-tic
mildewy	mil-dew-y
turpi-tude	tur-pi-tude
para-sol	par-a-sol
mediocre	me-di-o-cre
foam-ing	foaming
fuel	fu-el
oblige	o-blige
squashy	squash-y
chemist	chem-ist
un-steady	un-stead-y
sunspot	sun-spot
gnom-ic	gno-mic
apol-o-gize	a-pol-o-gize
laud-ed	lauded
caviar	cav-i-ar
gantry	gan-try
odi-ous	o-di-ous
re-stroom	rest-room
cryp-tol-ogy	cryp-tol-o-gy
de-posi-tary	de-pos-i-tar-y
epic	ep-ic
egre-gious	e-gre-gious
con-fronta-tion-al	con-fron-ta-tion-al
sporran	spor-ran
stranger	stran-ger
olive	ol-ive
prodi-gy	prod-i-gy
ri-boflavin	ri-bo-fla-vin
uri-nary	u-ri-nar-y
per-former	per-form-er
marzi-pan	mar-zi-pan
bearskin	bear-skin
turnout	turn-out
teenage	teen-age
coro-na-tion	cor-o-na-tion
heifer	heif-er
rial	ri-al
naive-ly	na-ive-ly
tenac-i-ty	te-nac-i-ty
delete	de-lete
mar-itime	mar-i-time
stealth-ily	stealth-i-ly
citadel	cit-a-del
un-solv-able	un-solv-a-ble
en-gi-neered	engineered
eman-ci-pa-tion	e-man-ci-pa-tion
broody	brood-y
de-con-struc-tive	deconstructive
kerosene	ker-o-sene
ini-tia-tor	in-i-ti-a-tor
pan-golin	pan-go-lin
dic-ta-to-r-i-al	dic-ta-to-ri-al
pirou-ette	pir-ou-ette
cagey	cag-ey
re-searcher	re-search-er
por-phyry	por-phy-ry
con-tretemps	con-tre-temps
rata-touille	ra-ta-touille
hexa-m-e-ter	hex-am-e-ter
roulette	rou-lette
elec-trode	e-lec-trode
torus	to-rus
guilty	guilt-y
mistype	mis-type
origa-mi	o-ri-ga-mi
bur-nished	burnished
con-tender	con-tend-er
mul-ti-pro-cess-ing	mul-ti-proc-ess-ing
quotable	quot-a-ble
per-jury	per-ju-ry
rhap-sody	rhap-so-dy
can-tilever	can-ti-le-ver
con-sis-tent	con-sist-ent
mariner	mar-i-ner
cos-mopoli-tan	cos-mo-pol-i-tan
grenade	gre-nade
pro-tean	pro-te-an
meta-bol-ic	met-a-bol-ic
gullible	gul-li-ble
in-ter-vie-wee	in-ter-view-ee
comet	com-et
ria	ri-a
defam-a-to-ry	de-fam-a-to-ry
de-nial	de-ni-al
quartzite	quartz-ite
pu-gna-cious	pug-na-cious
soda	so-da
un-abashed-ly	un-a-bash-ed-ly
necro-man-cy	nec-ro-man-cy
ro-mancer	ro-manc-er
pre-s-e-lect	pre-se-lect
prophet-ic	pro-phet-ic
deca-dent	dec-a-dent
in-ter-preter	in-ter-pret-er
re-pairable	re-pair-a-ble
ter-rapin	ter-ra-pin
flesh-ing	fleshing
su-prema-cy	su-prem-a-cy
per-fidy	per-fi-dy
te-dious	te-di-ous
eru-dite	er-u-dite
bonobo	bo-no-bo
open-er	o-pen-er
ocean-ic	o-ce-an-ic
blitzkrieg	blitz-krieg
mae-stro	maes-tro
unsweet-ened	un-sweet-ened
aria	a-ri-a
cam-panile	cam-pa-ni-le
prover-bial	pro-ver-bi-al
over-sleep	o-ver-sleep
prowess	prow-ess
gen-i-talia	gen-i-ta-li-a
un-de-ni-able	un-de-ni-a-ble
aslant	a-slant
celi-bate	cel-i-bate
chromi-um	chro-mi-um
aban-doned	a-ban-doned
fruit-ing	fruiting
deci-bel	dec-i-bel
bad-ger	badg-er
ni-hilism	ni-hil-ism
he-do-nism	he-don-ism
tillage	till-age
he-li-copter	hel-i-cop-ter
break-away	break-a-way
fig-u-ra-tive	fig-ur-a-tive
papule	pap-ule
carousel	car-ou-sel
wilder-ness	wil-der-ness
misty	mist-y
vel-veteen	vel-vet-een
dirty	dirt-y
afraid	a-fraid
gecko	geck-o
poly-merase	pol-y-mer-ase
pion	pi-on
yippee	yip-pee
elvish	elv-ish
hero-ine	her-o-ine
laun-derette	laun-der-ette
aster	as-ter
cochlea	coch-le-a
lava-to-r-i-al	lav-a-to-ri-al
cloven	clo-ven
vivid-ly	viv-id-ly
duo-logue	du-o-logue
trade-marked	trademarked
para-noid	par-a-noid
hostel-ry	hos-tel-ry
vol-cano	vol-ca-no
record-ing	re-cord-ing
rein-vest-ment	re-in-vest-ment
shoplift-ing	shop-lift-ing
med-dling	meddling
spinal	spi-nal
het-ero-sex-u-al	het-er-o-sex-u-al
rota	ro-ta
loader	load-er
blowfly	blow-fly
jugu-lar	jug-u-lar
fold-ing	folding
diox-ide	di-ox-ide
sec-toral	sec-tor-al
over	o-ver
cowslip	cow-slip
in-vari-able	in-var-i-a-ble
dea-coness	dea-con-ess
condi-ment	con-di-ment
prodi-gious	pro-di-gious
pho-to-elec-tric	pho-to-e-lec-tric
in-ca-pable	in-ca-pa-ble
so-ci-etal	so-ci-e-tal
plover	plov-er
paci-fism	pac-i-fism
cashew	cash-ew
plan-e-tary	plan-e-tar-y
awry	a-wry
gable	ga-ble
paving	pav-ing
deroga-to-ry	de-rog-a-to-ry
tasty	tast-y
uniden-ti-fi-able	un-i-den-ti-fi-a-ble
un-al-ter-able	un-al-ter-a-ble
archival	ar-chi-val
snorkel	snor-kel
ir-re-triev-able	ir-re-triev-a-ble
rock-et-ing	rocketing
pornog-ra-phy	por-nog-ra-phy
poly-he-dron	pol-y-he-dron
cupo-la	cu-po-la
sparkler	spar-kler
gerund	ger-und
chaffinch	chaf-finch
strate-gi-cal-ly	stra-te-gi-cal-ly
puma	pu-ma
hauli-er	haul-ier
any-way	an-y-way
bazooka	ba-zoo-ka
epicy-cloid	ep-i-cy-cloid
averse	a-verse
al-ready	al-read-y
cu-rios-i-ty	cu-ri-os-i-ty
tawdry	taw-dry
frilly	frill-y
sisal	si-sal
neuter	neu-ter
defe-cate	def-e-cate
im-politic	im-pol-i-tic
trea-sur-er	treas-ur-er
vale-dic-tion	val-e-dic-tion
reread	re-read
repar-tee	rep-ar-tee
ephemera	e-phem-er-a
con-tour-ing	con-touring
con-tention	con-ten-tion
epi-dem-ic	ep-i-dem-ic
scathing	scath-ing
chiefly	chief-ly
friendlily	friend-li-ly
mis-aligned	mis-a-ligned
ho-muncu-lus	ho-mun-cu-lus
api-an	a-pi-an
steadi-ness	stead-i-ness
sub-si-dence	sub-sid-ence
pho-tore-cep-tor	pho-to-re-cep-tor
hearti-ly	heart-i-ly
vic-arage	vic-ar-age
beach-comber	beach-comb-er
in-valu-able	in-val-u-a-ble
mata-dor	mat-a-dor
je-junum	je-ju-num
dis-uni-ty	dis-u-ni-ty
fool-hardy	fool-har-dy
codling	cod-ling
ori-en-tal	o-ri-en-tal
elec-torate	e-lec-tor-ate
mauler	maul-er
spiky	spik-y
Words with errors: 1909
Words with incorrect number of syllables: 1797
Total evluated: 6500
Perfect accuracy: 0.71
Number of syllables accuracy: 0.72
Average Levenshtein Distance(across incorrect words): 1.18
