Attempt	Real
mi-croor-gan-ism	mi-cro-or-gan-ism
howdy	how-dy
pari-ah	pa-ri-ah
blitzkrieg	blitz-krieg
con-cil-iar	con-cil-i-ar
trust-ed	trusted
in-escapably	in-es-cap-a-bly
dullard	dull-ard
ca-su-istry	cas-u-ist-ry
syl-labub	syl-la-bub
every-day	eve-ry-day
pre-sen-ter	pre-sent-er
man-dolin	man-do-lin
litur-gi-cal	li-tur-gi-cal
con-tention	con-ten-tion
os-teopa-thy	os-te-op-a-thy
phys-io-ther-a-py	phys-i-o-ther-a-py
ether	e-ther
para-mag-net-ic	par-a-mag-net-ic
school-teacher	school-teach-er
cityscape	cit-y-scape
wormy	worm-y
un-du-lat-ing	un-du-la-ting
fish-ery	fish-er-y
iden-ti-cal-ly	i-den-ti-cal-ly
un-fore-see-able	un-fore-see-a-ble
fruiter	fruit-er
un-awak-ened	un-a-wak-ened
ex-ocrine	ex-o-crine
avian	a-vi-an
hobo	ho-bo
idyll	i-dyll
un-elect-ed	un-e-lect-ed
quater-nion	qua-ter-ni-on
mono-phon-ic	mon-o-phon-ic
de-fend-ing	defending
pecan	pe-can
scenery	scen-er-y
roundel	roun-del
gam-bling	gam-bling
ar-guable	ar-gu-a-ble
barom-e-ter	ba-rom-e-ter
un-am-bigu-ous	un-am-big-u-ous
item	i-tem
in-hala-tion	in-ha-la-tion
calorime-ter	cal-o-rim-e-ter
wapi-ti	wap-i-ti
ranger	rang-er
mul-ti-pro-cess-ing	mul-ti-proc-ess-ing
sub-jec-tivism	sub-jec-tiv-ism
in-fla-tion-ary	in-fla-tion-ar-y
fel-la-tio	fel-la-ti-o
preva-lence	prev-a-lence
medal	med-al
con-sumerist	con-sum-er-ist
uni-cy-cle	u-ni-cy-cle
im-per-me-able	im-per-me-a-ble
lachry-mose	lach-ry-mose
salience	sa-li-ence
poly-atom-ic	pol-y-a-tom-ic
an-tibi-ot-ic	an-ti-bi-ot-ic
penin-su-lar	pen-in-su-lar
carotene	car-o-tene
gra-tu-ity	gra-tu-i-ty
ini-tial	in-i-tial
un-pre-dictabil-i-ty	un-pre-dict-a-bil-i-ty
enor-mous-ly	e-nor-mous-ly
aback	a-back
midi	mid-i
shandy	shan-dy
unglam-orous	un-glam-or-ous
me-te-oric	me-te-or-ic
poli-ty	pol-i-ty
serai	se-ra-i
far-away	far-a-way
lyrist	lyr-ist
stan-dard	stand-ard
neu-ronal	neu-ron-al
com-fort-able	com-fort-a-ble
bud-get	budg-et
wimpy	wimp-y
sali-vate	sal-i-vate
whistler	whis-tler
phonon	pho-non
hexa-gon	hex-a-gon
bereft	be-reft
hairy	hair-y
re-mark-able	re-mark-a-ble
odome-ter	o-dom-e-ter
data-base	da-ta-base
talon	tal-on
may-oral	may-or-al
over-weight	o-ver-weight
chamomile	cham-o-mile
paraf-fin	par-af-fin
pre-sen-ta-tion-al	pres-en-ta-tion-al
un-prof-itable	un-prof-it-a-ble
ex-plic-a-ble	ex-pli-ca-ble
mere-tri-cious	mer-e-tri-cious
ap-pre-cia-ble	ap-pre-ci-a-ble
phrasal	phras-al
macaw	ma-caw
broadsword	broad-sword
tele-vi-sion	tel-e-vi-sion
petu-lant	pet-u-lant
bish-opric	bish-op-ric
in-vestor	in-ves-tor
megas-tar	meg-a-star
un-opened	un-o-pened
avail	a-vail
over-fly	o-ver-fly
askew	a-skew
ap-proach-able	ap-proach-a-ble
necro-mancer	nec-ro-man-cer
iras-ci-ble	i-ras-ci-ble
eon	e-on
au-thoress	au-thor-ess
uned-i-fy-ing	un-ed-i-fy-ing
neur-al	neu-ral
simil-i-tude	si-mil-i-tude
pleat-ed	pleated
stu-dentship	stu-dent-ship
porno-graph-ic	por-no-graph-ic
trumpery	trump-er-y
the-atri-cal	the-at-ri-cal
prog-es-terone	pro-ges-ter-one
dis-senter	dis-sent-er
se-lectee	se-lect-ee
arum	ar-um
prompter	prompt-er
penum-bra	pe-num-bra
hered-i-ty	he-red-i-ty
hexa-gram	hex-a-gram
un-set-tling	unsettling
wispy	wisp-y
delec-ta-tion	de-lec-ta-tion
river-side	riv-er-side
philo-soph-i-cal	phil-o-soph-i-cal
cryp-tol-ogy	cryp-tol-o-gy
drink-able	drink-a-ble
pold-er	pol-der
alive	a-live
lacteal	lac-te-al
asymp-to-matic	a-symp-to-mat-ic
quiet-ness	qui-et-ness
tachy-car-dia	tach-y-car-di-a
sooty	soot-y
mu-cosa	mu-co-sa
over-sim-pli-fi-ca-tion	o-ver-sim-pli-fi-ca-tion
au-tonomous	au-ton-o-mous
dif-fer-ing	differing
mer-cu-r-ial	mer-cu-ri-al
dais	da-is
bleat-ing	bleating
de-mo-c-rat	dem-o-crat
no-to-ri-ety	no-to-ri-e-ty
elide	e-lide
re-uni-fy	re-u-ni-fy
biodegrad-able	bi-o-de-grad-a-ble
slalom	sla-lom
nu-clear	nu-cle-ar
gallery	gal-ler-y
strug-gling	struggling
cus-tom-ary	cus-tom-ar-y
by-stander	by-stand-er
lazy-bones	la-zy-bones
over-throw	o-ver-throw
polyandry	pol-y-an-dry
malev-o-lence	ma-lev-o-lence
her-i-tabil-i-ty	her-it-a-bil-i-ty
prison	pris-on
coca	co-ca
ovary	o-va-ry
an-tifreeze	an-ti-freeze
dancer	danc-er
meta-mor-phism	met-a-mor-phism
propul-sion	pro-pul-sion
mega-lo-ma-nia	meg-a-lo-ma-ni-a
cognoscen-ti	co-gno-scen-ti
dean-ery	dean-er-y
un-playable	un-play-a-ble
gramo-phone	gram-o-phone
recheck	re-check
voyeur	vo-yeur
restau-rant	res-tau-rant
castel-lat-ed	cas-tel-lat-ed
heat-wave	heatwave
geno-type	gen-o-type
un-af-ford-able	un-af-ford-a-ble
un-cre-ative	un-cre-a-tive
eigen-func-tion	ei-gen-func-tion
lengthy	length-y
footwear	foot-wear
un-fash-ion-able	un-fash-ion-a-ble
cliquey	cli-quey
polypep-tide	pol-y-pep-tide
athe-is-tic	a-the-is-tic
un-print-able	un-print-a-ble
apoc-ryphal	a-poc-ry-phal
pan-das	pan-das
corny	corn-y
es-o-teric	es-o-ter-ic
brunette	bru-nette
bizarre	bi-zarre
mic-turi-tion	mic-tu-ri-tion
dri-vable	driv-a-ble
lapel	la-pel
sul-tana	sul-tan-a
atroc-i-ty	a-troc-i-ty
asun-der	a-sun-der
dis-ori-ent-ed	disoriented
uvu-lar	u-vu-lar
piety	pi-e-ty
adapt	a-dapt
id-iot	id-i-ot
elec-tive	e-lec-tive
oculist	oc-u-list
trilo-bite	tri-lo-bite
changeover	change-o-ver
as-so-cia-tive	as-so-ci-a-tive
gos-sipy	gos-sip-y
con-flict-ual	con-flic-tu-al
sole-cism	sol-e-cism
for-get-table	for-get-ta-ble
geo-physics	ge-o-phys-ics
across	a-cross
queru-lous	quer-u-lous
painful-ly	pain-ful-ly
weari-ly	wea-ri-ly
psy-chopath	psy-cho-path
prophet	proph-et
uniden-ti-fi-able	un-i-den-ti-fi-a-ble
pseu-do-ny-mous	pseu-don-y-mous
choosy	choos-y
cuboid	cu-boid
precipice	prec-i-pice
unan-nounced	un-an-nounced
opi-oid	o-pi-oid
vacu-ity	va-cu-i-ty
teatime	tea-time
ridicu-lous-ly	ri-dic-u-lous-ly
ar-bore-tum	ar-bo-re-tum
impi-ety	im-pi-e-ty
cesspit	cess-pit
des-tiny	des-ti-ny
lanky	lank-y
leer-ing	leering
cider	ci-der
hero-ical-ly	he-ro-i-cal-ly
ir-re-ducible	ir-re-duc-i-ble
icon-o-clasm	i-con-o-clasm
coro-net	cor-o-net
sanc-ti-mo-nious	sanc-ti-mo-ni-ous
philoso-pher	phi-los-o-pher
flinch-ing	flin-ching
hia-tus	hi-a-tus
detox	de-tox
rein-tro-duce	re-in-tro-duce
climber	climb-er
semi-con-duct-ing	sem-i-con-duct-ing
boater	boat-er
turgid	tur-gid
un-solv-able	un-solv-a-ble
re-sis-tance	re-sist-ance
turn-around	turn-a-round
solem-ni-ty	so-lem-ni-ty
sa-fari	sa-fa-ri
tib-ia	tib-i-a
stran-gled	strangled
diplo-ma-cy	di-plo-ma-cy
kalei-do-scop-ic	ka-lei-do-scop-ic
trouper	troup-er
pi-caresque	pic-a-resque
en-riched	enriched
mer-chantable	mer-chant-a-ble
sonar	so-nar
cologne	co-logne
garbage	gar-bage
bunker	bun-ker
geron-tol-ogy	ger-on-tol-o-gy
erode	e-rode
chal-lenger	chal-leng-er
unique-ly	u-nique-ly
in-con-ve-nient	in-con-ven-ient
ragged	rag-ged
in-her-i-ta-ble	in-her-it-a-ble
seroneg-a-tive	se-ro-neg-a-tive
un-der-writer	un-der-writ-er
dili-gent-ly	dil-i-gent-ly
lazuli	laz-u-li
brioche	bri-oche
vit-ri-olic	vit-ri-ol-ic
raven-ing	rav-en-ing
rosette	ro-sette
redo-lent	red-o-lent
sewage	sew-age
unan-i-mous	u-nan-i-mous
brochure	bro-chure
soloist	so-lo-ist
antler	ant-ler
de-crepit	de-crep-it
unlov-ing	un-lov-ing
conur-ba-tion	con-ur-ba-tion
over-ly-ing	o-ver-ly-ing
syn-onym	syn-o-nym
archangel	arch-an-gel
flanker	flank-er
cherub	cher-ub
tele-pho-ny	te-leph-o-ny
dentin	den-tin
pre-s-e-lect	pre-se-lect
unglazed	un-glazed
duo	du-o
nonex-is-tence	non-ex-ist-ence
con-temptible	con-tempt-i-ble
autarchy	au-tar-chy
tou-sled	tousled
oxy-gen	ox-y-gen
smoother	smooth-er
eval-u-a-tor	e-val-u-a-tor
cutout	cut-out
speci-fici-ty	spec-i-fic-i-ty
ahead	a-head
elon-gat-ed	e-lon-gat-ed
un-even-ly	un-e-ven-ly
bi-og-ra-ph-er	bi-og-ra-pher
spin-naker	spin-na-ker
chi-nois-erie	chi-noi-se-rie
ide-al	i-de-al
pe-trel	pet-rel
elec-tri-fy	e-lec-tri-fy
over-pass	o-ver-pass
guilty	guilt-y
con-t-a-m-i-na-tion	con-tam-i-na-tion
platelet	plate-let
unau-dit-ed	un-au-dit-ed
re-silience	re-sil-ience
sand-piper	sand-pi-per
basal	ba-sal
in-fir-mary	in-fir-ma-ry
spinal	spi-nal
per-me-able	per-me-a-ble
hab-er-dash-ery	hab-er-dash-er-y
pur-port-ed	purported
untest-ed	un-test-ed
whisker	whisk-er
de-signed-ly	de-sign-ed-ly
scal-able	scal-a-ble
archdea-con-ry	arch-dea-con-ry
para-dox	par-a-dox
dis-able	dis-a-ble
evening	eve-ning
hy-gien-ic	hy-gi-en-ic
in-vert-ed	inverted
en-teri-tis	en-ter-i-tis
cir-cum-lo-cu-to-ry	cir-cum-loc-u-to-ry
dopey	dope-y
rep-til-ian	rep-til-i-an
carpal	car-pal
un-ortho-dox	un-or-tho-dox
hermeneu-tic	her-me-neu-tic
dimin-u-en-do	di-min-u-en-do
erupt	e-rupt
no-tice-able	no-tice-a-ble
para-mount-cy	par-a-mount-cy
livid	liv-id
dereg-u-la-tion	de-reg-u-lation
bradawl	brad-awl
plea-sur-able	pleas-ur-a-ble
equian-gu-lar	e-qui-an-gu-lar
teapot	tea-pot
hero	he-ro
yeti	yet-i
foxy	fox-y
em-bed-d-a-ble	em-bed-da-ble
oblate	ob-late
kestrel	kes-trel
patho-log-i-cal	path-o-log-i-cal
beamy	beam-y
frica-tive	fric-a-tive
holis-tic	ho-lis-tic
july	ju-ly
baguette	ba-guette
mis-nomer	mis-no-mer
coro-ner	cor-o-ner
aura	au-ra
ex-pand-able	ex-pand-a-ble
em-bolism	em-bo-lism
porter-age	por-ter-age
de-monolo-gy	de-mon-ol-o-gy
maxi	max-i
poseur	po-seur
lam-plit	lamp-lit
key-boardist	key-board-ist
meri-no	me-ri-no
imam	i-mam
ther-mome-ter	ther-mom-e-ter
apron	a-pron
un-steady	un-stead-y
video-tape	vid-e-o-tape
soapy	soap-y
avenge	a-venge
marzi-pan	mar-zi-pan
arrange-ment	ar-range-ment
gra-nary	gra-na-ry
await	a-wait
athe-ism	a-the-ism
con-tin-gency	con-tin-gen-cy
jeer-ing	jeering
colos-sus	co-los-sus
eland	e-land
in-di-gestible	in-di-gest-i-ble
bloomer	bloom-er
ashore	a-shore
stroller	stroll-er
hu-mankind	hu-man-kind
di-alec-ti-cal	di-a-lec-ti-cal
tele-path-ic	tel-e-path-ic
homi-cide	hom-i-cide
rene-go-ti-ate	re-ne-go-ti-ate
ovoid	o-void
steeple-chase	stee-ple-chase
ragout	ra-gout
lethal-ly	le-thal-ly
my-ocar-dial	my-o-car-di-al
sharp-en-er	shar-pen-er
potas-si-um	po-tas-si-um
zeta	ze-ta
face-tious	fa-ce-tious
tenet	ten-et
broc-coli	broc-co-li
je-junum	je-ju-num
weav-ing	weaving
clash-ing	clashing
grandiose	gran-di-ose
idea	i-de-a
at-tribute	at-trib-ute
riv-iera	riv-i-er-a
char-woman	char-wom-an
se-nior	sen-ior
fla-gel-la-tion	flag-el-la-tion
rar-efied	rar-e-fied
banger	bang-er
doily	doi-ly
pat-terned	patterned
unchris-t-ian	un-chris-tian
capri-cious	ca-pri-cious
evolve	e-volve
per-sona	per-so-na
stealthy	stealth-y
gestalt	ge-stalt
be-fud-dled	befuddled
leav-ened	leavened
beg-gary	beg-gar-y
cus-tomer	cus-tom-er
sol-diery	sol-dier-y
teardrop	tear-drop
tele-graph	tel-e-graph
baloney	ba-lo-ney
liquor-ish	liq-uor-ish
valid-ly	val-id-ly
re-spectable	re-spect-a-ble
in-ex-haustible	in-ex-haust-i-ble
geo-sta-tion-ary	ge-o-sta-tion-ar-y
raster	ras-ter
recre-ation-al	rec-re-a-tion-al
per-ineum	per-i-ne-um
ceme-tery	cem-e-ter-y
any-thing	an-y-thing
porta-bil-i-ty	port-a-bil-i-ty
rogu-ish	ro-guish
inkling	ink-ling
alarm	a-larm
coastal	coast-al
colan-der	col-an-der
apoth-e-o-sis	a-poth-e-o-sis
labi-al	la-bi-al
suet	su-et
lemon	lem-on
rocky	rock-y
eroge-nous	e-rog-e-nous
green-ery	green-er-y
ori-en-tate	o-ri-en-tate
sub-species	sub-spe-cies
liti-gious	li-ti-gious
regime	re-gime
essence	es-sence
hubris-tic	hu-bris-tic
ex-is-tent	ex-ist-ent
firkin	fir-kin
renown	re-nown
chrysalis	chrys-a-lis
colobus	col-o-bus
warpaint	war-paint
mantra	man-tra
cine	cin-e
ex-oge-nous	ex-og-e-nous
dis-tillery	dis-till-er-y
steamship	steam-ship
be-liev-abil-i-ty	be-liev-a-bil-i-ty
un-de-tectable	un-de-tect-a-ble
im-pro-visato-ry	im-pro-vi-sa-to-ry
uten-sil	u-ten-sil
un-awares	un-a-wares
mim-ic-k-er	mim-ick-er
bluish	blu-ish
per-former	per-form-er
quotable	quot-a-ble
glitzy	glitz-y
creepy	creep-y
post-mod-ernist	post-mod-ern-ist
de-cay-ing	decaying
au-tonomous-ly	au-ton-o-mous-ly
gerund	ger-und
bi-l-abi-al	bi-la-bi-al
sub-cu-ta-neous	sub-cu-ta-ne-ous
vic-ar-i-ous	vi-car-i-ous
bun-gled	bungled
in-fantry	in-fan-try
sto-ical	sto-i-cal
bologna	bo-lo-gna
detox-i-fi-ca-tion	de-tox-i-fi-ca-tion
emul-sion	e-mul-sion
un-handy	un-hand-y
elon-gate	e-lon-gate
vi-sion-ary	vi-sion-ar-y
triplet	tri-plet
over-cast	o-ver-cast
nightin-gale	night-in-gale
cau-tion-ary	cau-tion-ar-y
re-s-e-lect	re-se-lect
un-emo-tion-al	un-e-mo-tion-al
despot	des-pot
tiler	til-er
ec-sta-t-ic	ec-stat-ic
api-ary	a-pi-ar-y
pho-to-elec-tric	pho-to-e-lec-tric
sa-tanism	sa-tan-ism
ex-ecu-tor	ex-ec-u-tor
ura-ni-um	u-ra-ni-um
rigid-i-ty	ri-gid-i-ty
sago	sa-go
pre-dictabil-i-ty	pre-dict-a-bil-i-ty
melan-choly	mel-an-chol-y
mis-an-thropy	mis-an-thro-py
whomev-er	whom-ev-er
re-uni-fi-ca-tion	re-u-ni-fi-ca-tion
pa-tois	pat-ois
pleas-antry	pleas-ant-ry
mil-i-taris-tic	mil-i-ta-ris-tic
undis-turbed	un-dis-turbed
seg-ment-ed	seg-men-ted
bio-mass	bi-o-mass
ima-go	i-ma-go
polo-ni-um	po-lo-ni-um
bion-ic	bi-on-ic
glo-be-trot-ting	globe-trot-ting
lyri-cism	lyr-i-cism
ephemeris	e-phem-er-is
sloven-ly	slov-en-ly
viper	vi-per
un-ob-jec-tion-able	un-ob-jec-tion-a-ble
parsnip	pars-nip
jumper	jump-er
sep-a-ratism	sep-a-ra-tism
re-gret-table	re-gret-ta-ble
crosstalk	cross-talk
orac-u-lar	o-rac-u-lar
prowler	prowl-er
hy-draulic	hy-drau-lic
palu-dal	pa-lu-dal
mama	ma-ma
elec-tron	e-lec-tron
gooey	goo-ey
un-der-stand-able	un-der-stand-a-ble
ori-en-tal-ism	o-ri-en-tal-ism
sub-si-dence	sub-sid-ence
awestruck	awe-struck
in-equitable	in-eq-ui-ta-ble
crossover	cross-o-ver
es-pi-onage	es-pi-o-nage
so-lic-it-ing	soliciting
apoc-a-lyp-tic	a-poc-a-lyp-tic
trac-ery	trac-er-y
yel-lowed	yellowed
maya	ma-ya
dri-ving	driv-ing
oral	o-ral
kinder-garten	kin-der-gar-ten
sta-t-ic	stat-ic
metatarsal	met-a-tar-sal
fifti-eth	fif-ti-eth
guinea	guin-ea
mar-riage-able	mar-riage-a-ble
out-landish	out-land-ish
leaky	leak-y
un-in-ter-pretable	un-in-ter-pret-a-ble
hayloft	hay-loft
unasked	un-asked
in-cur-able	in-cur-a-ble
ia-tro-genic	i-at-ro-gen-ic
pa-paya	pa-pa-ya
re-pro-ducible	re-pro-duc-i-ble
mys-tery	mys-ter-y
so-cioe-co-nom-ic	so-ci-o-ec-o-nom-ic
pi-rat-ed	pirated
aton-al	a-ton-al
elec-torate	e-lec-tor-ate
ephemer-al	e-phem-er-al
pesti-len-tial	pes-ti-len-tial
study	stud-y
er-gonom-ics	er-go-nom-ics
lunchtime	lunch-time
fragili-ty	fra-gil-i-ty
pan-tomime	pan-to-mime
earnest-ness	ear-nest-ness
har-mo-nious-ly	har-mo-ni-ous-ly
rani	ra-ni
elon-ga-tion	e-lon-ga-tion
col-lec-tivism	col-lec-tiv-ism
re-order	re-or-der
saver	sav-er
hooli-gan	hoo-li-gan
ves-ti-gial	ves-tig-i-al
tele-vise	tel-e-vise
fil-i-buster	fil-i-bus-ter
timid	tim-id
elec-trolyte	e-lec-tro-lyte
in-ter-ci-ty	in-ter-cit-y
java	ja-va
ro-mancer	ro-manc-er
shopfront	shop-front
demon-stra-bly	de-mon-stra-bly
open-er	o-pen-er
lovesick	love-sick
ra-dio-ther-a-py	ra-di-o-ther-a-py
gi-antism	gi-ant-ism
moldy	mold-y
domi-no	dom-i-no
uni-sex	u-ni-sex
om-nipo-tent	om-nip-o-tent
un-equiv-o-cal	un-e-quiv-o-cal
scarab	scar-ab
au-toma-ton	au-tom-a-ton
mono-rail	mon-o-rail
stripling	strip-ling
over-sexed	o-ver-sexed
cel-ery	cel-er-y
lega-to	le-ga-to
ar-senic	ar-se-nic
hashish	hash-ish
an-niver-sary	an-ni-ver-sa-ry
tapi-o-ca	tap-i-o-ca
chrono-graph	chron-o-graph
herbal	herb-al
amuse	a-muse
un-linked	unlinked
poly-chrome	pol-y-chrome
eman-ci-pa-tion	e-man-ci-pa-tion
wrap-around	wrap-a-round
mag-ne-tos-phere	mag-ne-to-sphere
sniper	snip-er
dugout	dug-out
mir-ror-ing	mirroring
lessor	les-sor
com-plain-ing	complaining
groom-ing	grooming
co-terie	co-te-rie
ac-cept-able	ac-cept-a-ble
bes-tiary	bes-ti-ar-y
neme-sis	nem-e-sis
over-draft	o-ver-draft
dis-ori-ent	dis-o-ri-ent
soma	so-ma
email	e-mail
hardy	har-dy
smoth-ered	smothered
mi-cro-bial	mi-cro-bi-al
panacea	pan-a-ce-a
er-bium	er-bi-um
drinker	drink-er
dis-turbing-ly	dis-turb-ing-ly
nestling	nest-ling
un-bear-ably	un-bear-a-bly
boohoo	boo-hoo
phono-log-i-cal	pho-no-log-i-cal
crin-kled	crinkled
an-nu-ity	an-nu-i-ty
jus-ti-fi-ably	jus-ti-fi-a-bly
chasti-ty	chas-ti-ty
elastin	e-las-tin
sinewy	sin-ew-y
taxi-cab	tax-i-cab
egal-i-tar-i-an	e-gal-i-tar-i-an
scapu-la	scap-u-la
iso-ton-ic	i-so-ton-ic
roulette	rou-lette
lack-adaisi-cal	lack-a-dai-si-cal
re-union	re-un-ion
weapon	weap-on
sero-tonin	ser-o-to-nin
midlife	mid-life
de-gauss-ing	degaussing
metal-lic	me-tal-lic
lig-and	li-gand
com-pen-sato-ry	com-pen-sa-to-ry
steplad-der	step-lad-der
prov-ably	prov-a-bly
mac-a-roni	mac-a-ro-ni
here-upon	here-up-on
he-do-nism	he-don-ism
en-cycli-cal	en-cyc-li-cal
pygmy	pyg-my
froward	fro-ward
holo-graph-ic	hol-o-graph-ic
ela-tion	e-la-tion
flotil-la	flo-til-la
con-fi-den-tial-i-ty	con-fi-den-ti-al-i-ty
econo-met-rics	e-con-o-met-rics
ter-raform	ter-ra-form
chem-istry	chem-is-try
un-know-able	un-know-a-ble
com-forter	com-fort-er
tawny	taw-ny
over-man-tel	o-ver-man-tel
wicked-ness	wick-ed-ness
con-vivial	con-viv-i-al
opales-cent	o-pal-es-cent
cir-cuitous	cir-cu-i-tous
un-equiv-o-cal-ly	un-e-quiv-o-cal-ly
vi-t-a-min	vi-ta-min
au-tomat	au-to-mat
puni-tive	pu-ni-tive
de-r-ate	de-rate
raver	rav-er
clavi-chord	clav-i-chord
undiplo-mat-ic	un-dip-lo-mat-ic
illiq-uid	il-liq-uid
pen-sion-able	pen-sion-a-ble
valance	val-ance
chester-field	ches-ter-field
dy-namo	dy-na-mo
placid	plac-id
bilin-gual-ism	bi-lin-gual-ism
yokel	yo-kel
evo-lu-tion-ary	ev-o-lu-tion-ar-y
depre-da-tion	dep-re-da-tion
read-mis-sion	re-ad-mis-sion
rosary	ro-sa-ry
swindler	swin-dler
reawak-en	re-a-wak-en
res-onator	res-o-na-tor
rheuma-tol-ogy	rheu-ma-tol-o-gy
en-tourage	en-tou-rage
metas-ta-sis	me-tas-ta-sis
ten-able	ten-a-ble
deca-dent	dec-a-dent
heresy	her-e-sy
ex-ul-tant	ex-ult-ant
era	e-ra
un-ob-ser-vant	un-ob-serv-ant
bib-lio-phile	bib-li-o-phile
dimwit	dim-wit
moun-taineer-ing	moun-tain-eer-ing
pro-lactin	pro-lac-tin
tiller	till-er
styling	styl-ing
elect	e-lect
teacher	teach-er
elec-tri-cal	e-lec-tri-cal
pe-tit	pet-it
plexus	plex-us
lol-lipop	lol-li-pop
vil-lainy	vil-lain-y
cuneiform	cu-ne-i-form
para-troop-er	par-a-troop-er
un-able	un-a-ble
clement	clem-ent
se-quencer	se-quenc-er
aba-cus	ab-a-cus
con-duct-ed	conducted
un-avoid-able	un-a-void-a-ble
ure-thra	u-re-thra
brazen-ly	bra-zen-ly
tofu	to-fu
rev-o-lu-tion-ary	rev-o-lu-tion-ar-y
droopy	droop-y
pro-boscis	pro-bos-cis
nonessen-tial	non-es-sen-tial
iden-ti-fi-able	i-den-ti-fi-a-ble
hip-pocam-pus	hip-po-cam-pus
id-iom	id-i-om
rein-car-nate	re-in-car-nate
sies-ta	si-es-ta
every	eve-ry
un-fet-tered	unfettered
over-tone	o-ver-tone
out-sider	out-sid-er
holo-caust	hol-o-caust
li-bido	li-bi-do
even-tide	e-ven-tide
junker	jun-ker
ashamed	a-shamed
skintight	skin-tight
satin	sat-in
vial	vi-al
procla-ma-tion	proc-la-ma-tion
tan-ger-ine	tan-ge-rine
psy-chother-a-pist	psy-cho-ther-a-pist
po-ten-tial-i-ty	po-ten-ti-al-i-ty
antrum	an-trum
foundry	found-ry
in-trauter-ine	in-tra-u-ter-ine
famine	fam-ine
su-per-hero	su-per-he-ro
melod-ic	me-lod-ic
stam-mer-ing	stammering
ter-tiary	ter-ti-ar-y
chromi-um	chro-mi-um
lech-ery	lech-er-y
ra-tio-nal	ra-tion-al
ge-o-mag-net-i-cal-ly	ge-o-mag-ne-ti-cal-ly
ool-o-gy	o-ol-o-gy
leucine	leu-cine
oviduct	o-vi-duct
evoke	e-voke
doc-u-men-tary	doc-u-men-ta-ry
mer-ce-nary	mer-ce-nar-y
ma-jorette	ma-jor-ette
de-ity	de-i-ty
glac-i-er	gla-cier
im-memo-r-i-al	im-me-mo-ri-al
id-iomat-ic	id-i-o-mat-ic
opi-ate	o-pi-ate
souther-ly	south-er-ly
libero	li-be-ro
un-prece-dent-ed	un-prec-e-dent-ed
open	o-pen
plucky	pluck-y
racon-teur	rac-on-teur
straight-away	straight-a-way
con-formable	con-form-a-ble
brevi-ty	brev-i-ty
as-tro-physics	as-tro-phys-ics
messy	mess-y
caliph	ca-liph
aubergine	au-ber-gine
stoma	sto-ma
lament-ed	la-ment-ed
astride	a-stride
pur-suer	pur-su-er
busk-ing	busking
necro-man-tic	nec-ro-man-tic
every-where	eve-ry-where
or-biter	or-bit-er
quencher	quench-er
arch-i-pel-ago	ar-chi-pel-a-go
im-pro-pri-ety	im-pro-pri-e-ty
triage	tri-age
wa-ver-ing	wavering
ver-i-fi-able	ver-i-fi-a-ble
im-pe-cu-nious	im-pe-cu-ni-ous
quizzi-cal	quiz-zi-cal
cafe-te-ria	caf-e-te-ri-a
stranger	stran-ger
hon-esty	hon-es-ty
un-de-mo-c-ra-t-ic	un-dem-o-crat-ic
as-tronomer	as-tron-o-mer
fi-nis	fin-is
velo-drome	ve-lo-drome
louis	lou-is
botany	bot-a-ny
quadri-par-tite	quad-ri-par-tite
muslin	mus-lin
pesky	pes-ky
vanil-la	va-nil-la
tra-cheoto-my	tra-che-ot-o-my
palate	pal-ate
ex-tra-galac-tic	ex-tra-ga-lac-tic
mauler	maul-er
repack	re-pack
avion-ics	a-vi-on-ics
tem-pera-men-tal	tem-per-a-men-tal
re-sis-tant	re-sist-ant
blocky	block-y
macro	mac-ro
moi-ety	moi-e-ty
stapes	sta-pes
teacup	tea-cup
re-tiree	re-tir-ee
needle-work	nee-dle-work
petrol-o-gy	pe-trol-o-gy
politic	pol-i-tic
equa-nim-i-ty	e-qua-nim-i-ty
scam-per	scamp-er
bur-sary	bur-sa-ry
cav-ernous	cav-ern-ous
upon	up-on
even	e-ven
beefy	beef-y
elec-tri-cian	e-lec-tri-cian
vil-lager	vil-lag-er
foundling	found-ling
in-tu-itive	in-tu-i-tive
un-sellable	un-sell-a-ble
mono-chro-mat-ic	mon-o-chro-mat-ic
cagoule	ca-goule
sober-ly	so-ber-ly
blotchy	blotch-y
celebri-ty	ce-leb-ri-ty
in-ter-mol-e-c-u-lar	in-ter-mo-lec-u-lar
com-press-ibil-i-ty	com-pres-si-bil-i-ty
tripoli	trip-o-li
flota-tion	flo-ta-tion
rhodi-um	rho-di-um
quiv-er-ing	quivering
seaborne	sea-borne
bovine	bo-vine
cour-tesy	cour-te-sy
tun-able	tun-a-ble
dis-playable	displayable
pe-riph-ery	pe-riph-er-y
about	a-bout
unloved	un-loved
dyad	dy-ad
earnest-ly	ear-nest-ly
pullover	pull-o-ver
data	da-ta
piton	pi-ton
over-grown	o-ver-grown
seden-tary	sed-en-tar-y
grenade	gre-nade
disin-gen-u-ous	dis-in-gen-u-ous
moorhen	moor-hen
rigid-i-fy	ri-gid-i-fy
cata-ton-ic	cat-a-ton-ic
ho-minid	hom-i-nid
em-bo-som	em-bos-om
va-grancy	va-gran-cy
decade	dec-ade
salu-tary	sal-u-tar-y
thau-maturge	thau-ma-turge
par-tial-i-ty	par-ti-al-i-ty
satel-lite	sat-el-lite
squeaky	squeak-y
rum-pled	rumpled
duo-logue	du-o-logue
re-port-ed	reported
bak-ery	bak-er-y
fishy	fish-y
postal	post-al
plaza	pla-za
de-con-struc-tive	deconstructive
dodo	do-do
un-sink-able	un-sink-a-ble
steadi-ly	stead-i-ly
han-dover	hand-o-ver
event	e-vent
cheery	cheer-y
seclu-sion	se-clu-sion
prof-i-teer-ing	profiteering
epi-cure	ep-i-cure
geo-cen-tric	ge-o-cen-tric
waxy	wax-y
sun-flower	sun-flow-er
bar-racu-da	bar-ra-cu-da
opaque	o-paque
karate	ka-ra-te
dis-hon-esty	dis-hon-es-ty
hefty	heft-y
espy	es-py
mogul	mo-gul
sarong	sa-rong
unswerv-ing	un-swerv-ing
con-demned	condemned
maisonette	mai-son-ette
med-ical-ly	med-i-cal-ly
pro-pri-eto-r-i-al	pro-pri-e-to-ri-al
boxy	box-y
tri-bunal	tri-bu-nal
rat-tlesnake	rat-tle-snake
seashore	sea-shore
unau-then-ti-cat-ed	un-au-then-ti-cat-ed
ir-ra-tional	ir-ra-tion-al
in-hos-pitable	in-hos-pi-ta-ble
ex-citable	ex-cit-a-ble
psalter	psal-ter
mileage	mile-age
roofer	roof-er
re-s-e-lect-ed	re-se-lected
vale-dic-tion	val-e-dic-tion
rack-e-teer-ing	rack-et-eer-ing
scrapie	scrap-ie
centi-grade	cen-ti-grade
gur-gling	gurgling
forester	for-est-er
over-shoot	o-ver-shoot
over-rule	o-ver-rule
keynote	key-note
sec-ondary	sec-ond-ar-y
barefaced	bare-faced
temptress	tempt-ress
bol-stered	bolstered
over-land	o-ver-land
cor-dial	cor-di-al
gaga	ga-ga
vizier	vi-zier
coolant	cool-ant
satchel	satch-el
siphon	si-phon
eq-ui-tably	eq-ui-ta-bly
warmer	warm-er
signet	sig-net
be-witch-ing	bewitching
trapeze	tra-peze
re-pairable	re-pair-a-ble
avowed	a-vowed
tele-vised	televised
tillage	till-age
min-is-te-r-i-al	min-is-te-ri-al
pho-to-volta-ic	pho-to-vol-ta-ic
snoop-ing	snooping
para-mount	par-a-mount
de-scen-dant	de-scend-ant
edgy	edg-y
de-pend-able	de-pend-a-ble
in-frared	in-fra-red
pekan	pek-an
drap-ery	dra-per-y
leisurewear	lei-sure-wear
un-at-tain-able	un-at-tain-a-ble
sundry	sun-dry
wiring	wir-ing
pe-cu-niary	pe-cu-ni-ar-y
clemen-cy	clem-en-cy
in-quiry	in-quir-y
showy	show-y
stipend	sti-pend
kook-abur-ra	kook-a-bur-ra
punky	punk-y
uni-for-mi-ty	u-ni-form-i-ty
com-plaisant	com-plai-sant
un-re-served-ly	un-re-serv-ed-ly
unas-signed	un-as-signed
in-escapable	in-es-cap-a-ble
avid	av-id
porcine	por-cine
curvi-lin-ear	cur-vi-lin-e-ar
hangar	hang-ar
pre-pared-ness	pre-par-ed-ness
tar-ragon	tar-ra-gon
ar-ti-fi-cial-i-ty	ar-ti-fi-ci-al-i-ty
re-assess	re-as-sess
ashy	ash-y
deuteron	deu-ter-on
prospect	pros-pect
sac-risty	sac-ris-ty
mazy	ma-zy
un-adorned	un-a-dorned
vivid	viv-id
con-cussed	concussed
vine-gar	vin-e-gar
mini	min-i
erup-tive	e-rup-tive
noisy	nois-y
dri-ver-less	driv-er-less
nephew	neph-ew
bel-liger-ence	bel-lig-er-ence
per-ora-tion	per-o-ra-tion
drowsy	drow-sy
nurs-ery-men	nurs-er-y-men
whoso-ev-er	who-so-ev-er
lifebelt	life-belt
enig-ma	e-nig-ma
drom-e-dary	drom-e-dar-y
epochal	ep-och-al
tem-po-rary	tem-po-rar-y
sali-vary	sal-i-var-y
covert-ly	cov-ert-ly
painful	pain-ful
de-sirous	de-sir-ous
snifter	snif-ter
sil-vered	silvered
book-binder	book-bind-er
ex-hibitor	ex-hib-i-tor
beloved	be-lov-ed
as-sailant	as-sail-ant
parent-age	par-ent-age
boule-vard	boul-e-vard
con-cate-na-tion	con-cat-e-na-tion
car-rion	car-ri-on
moun-taineer	moun-tain-eer
obe-di-ent	o-be-di-ent
cov-et-ed	coveted
stratos-pher-i-cal-ly	stratospherically
em-broi-dery	em-broi-der-y
debonair	deb-o-nair
wafer	wa-fer
forcibly	for-ci-bly
con-toured	contoured
cor-re-spon-dent	cor-re-spond-ent
mol-e-c-u-lar	mo-lec-u-lar
undis-tort-ed	un-dis-tort-ed
boast-ing	boas-ting
knowl-edge-able	knowl-edge-a-ble
hu-manoid	hu-man-oid
fash-ion-able	fash-ion-a-ble
bio-met-ric	bi-o-met-ric
erot-i-ca	e-rot-i-ca
brio	bri-o
cli-toral	clit-o-ral
tumes-cent	tu-mes-cent
un-usu-al	un-u-su-al
monar-chy	mon-ar-chy
eru-di-tion	er-u-di-tion
for-mu-la-ry	for-mu-lar-y
here-inafter	here-in-af-ter
hypochon-dri-a-cal	hy-po-chon-dri-a-cal
provin-cial-ism	pro-vin-cial-ism
frontal	fron-tal
obe-di-ence	o-be-di-ence
decagon	dec-a-gon
evan-gel-i-cal	e-van-gel-i-cal
elo-quent	el-o-quent
makeover	make-o-ver
es-capade	es-ca-pade
unlov-able	un-lov-a-ble
poundage	pound-age
tacky	tack-y
camisole	cam-i-sole
sniff-ing	sniffing
in-ex-orably	in-ex-o-ra-bly
cleavers	cleav-ers
dila-tor	di-la-tor
de-mount-able	de-mount-a-ble
mist-imed	mis-timed
front-ed	fronted
olive	ol-ive
emu	e-mu
modal-i-ty	mo-dal-i-ty
smudgy	smudg-y
bauble	bau-ble
uni-ver-sal-ly	u-ni-ver-sal-ly
strate-gist	strat-e-gist
parabo-la	pa-rab-o-la
ec-topic	ec-top-ic
oily	oil-y
pread-o-les-cent	pre-ad-o-les-cent
over-flow	o-ver-flow
mistyp-ings	mis-ty-pings
against	a-gainst
warthog	wart-hog
crevasse	cre-vasse
elas-tic	e-las-tic
reprint	re-print
brasserie	bras-se-rie
im-port-ed	imported
car-dioid	car-di-oid
com-mis-sari-at	com-mis-sar-i-at
viril-i-ty	vi-ril-i-ty
hair-styling	hairstyling
mandible	man-di-ble
lever-age	lev-er-age
over-sub-scribed	o-ver-sub-scribed
menu	men-u
no-body	no-bod-y
trans-paren-cy	trans-par-en-cy
dogs-body	dogs-bod-y
proac-tive	pro-ac-tive
leaflet	leaf-let
steeply	steep-ly
iden-ti-cal	i-den-ti-cal
any-ways	an-y-ways
turkey	tur-key
translit-er-ate	trans-lit-er-ate
sub-scriber	sub-scrib-er
hazy	ha-zy
sim-per-ing	simpering
ker-atin	ker-a-tin
over-e-mo-tion-al	o-ver-e-mo-tion-al
freestyle	free-style
un-miss-able	un-miss-a-ble
pe-riphrastic	per-i-phras-tic
coy-ote	coy-o-te
biotech-nol-o-gy	bi-o-tech-nol-o-gy
medi-oc-rity	me-di-oc-ri-ty
repast	re-past
pho-tore-cep-tor	pho-to-re-cep-tor
voca-tive	voc-a-tive
in-deli-bly	in-del-i-bly
stringy	string-y
sushi	su-shi
di-alect	di-a-lect
pageantry	pag-eant-ry
bank-able	bank-a-ble
cli-toris	clit-o-ris
un-e-lec-table	un-e-lect-a-ble
un-der-achieve-ment	un-der-a-chieve-ment
buck-min-ster-fullerene	buck-min-ster-ful-ler-ene
un-re-peat-able	un-re-peat-a-ble
over-do	o-ver-do
ketchup	ketch-up
coac-tion	co-ac-tion
hoary	hoar-y
crotch-ety	crotch-et-y
bug-gered	buggered
helper	help-er
courage	cour-age
citadel	cit-a-del
corkscrew	cork-screw
mas-sacre	mas-sa-cre
igloo	ig-loo
elec-tro-mo-tive	e-lec-tro-mo-tive
psy-choki-ne-sis	psy-cho-ki-ne-sis
lamp-lighter	lamp-light-er
smoky	smok-y
reti-nal	ret-i-nal
un-remit-ting	un-re-mit-ting
ap-palling-ly	ap-pall-ing-ly
im-petu-ous	im-pet-u-ous
dual	du-al
ha-giog-ra-phy	hag-i-og-ra-phy
op-por-tunis-tic	op-por-tun-is-tic
hazel	ha-zel
peremp-to-ry	per-emp-to-ry
linkup	link-up
eter-ni-ty	e-ter-ni-ty
colos-sal	co-los-sal
ravi-o-li	ra-vi-o-li
petard	pe-tard
over-board	o-ver-board
comber	comb-er
unim-paired	un-im-paired
as-cen-dan-cy	as-cend-an-cy
suf-frag-ist	suf-fra-gist
sub-unit	sub-u-nit
un-palat-able	un-pal-at-a-ble
scarci-ty	scar-ci-ty
carousel	car-ou-sel
gullible	gul-li-ble
hy-dropho-bic	hy-dro-pho-bic
apho-rism	aph-o-rism
recre-ation	rec-re-a-tion
cerise	ce-rise
heartache	heart-ache
arrange	ar-range
timid-ly	tim-id-ly
lin-gerie	lin-ge-rie
cathar-tic	ca-thar-tic
turpi-tude	tur-pi-tude
di-rec-torate	di-rec-to-rate
agency	a-gen-cy
un-in-hab-it-able	un-in-hab-it-a-ble
swarthy	swarth-y
un-so-licit-ed	un-so-lic-it-ed
macaque	ma-caque
demon-stra-tive	de-mon-stra-tive
ob-tain-able	ob-tain-a-ble
cathar-sis	ca-thar-sis
monothe-is-tic	mon-o-the-is-tic
domi-cile	dom-i-cile
castoff	cast-off
metic-u-lous-ly	me-tic-u-lous-ly
elim-i-nate	e-lim-i-nate
caiman	cai-man
pen-i-ten-tiary	pen-i-ten-tia-ry
oa-sis	o-a-sis
con-fronta-tion-al	con-fron-ta-tion-al
gaslight	gas-light
javelin	jave-lin
gala	ga-la
glycine	gly-cine
pathfind-er	path-find-er
reim-ple-ment-ed	reimplemented
unabridged	un-a-bridged
ecol-o-gist	e-col-o-gist
firmware	firm-ware
breast-feed	breastfeed
teenage	teen-age
phys-iog-no-my	phys-i-og-no-my
pres-tidig-i-ta-tion	pres-ti-dig-i-ta-tion
con-sulate	con-su-late
sym-bio-sis	sym-bi-o-sis
apo-lit-i-cal	a-po-lit-i-cal
unadul-ter-at-ed	un-a-dul-ter-at-ed
es-calade	es-ca-lade
costar	co-star
lo-quaci-ty	lo-quac-i-ty
break-away	break-a-way
im-pre-sario	im-pre-sa-ri-o
spir-i-tu-al-ism	spir-it-u-al-ism
fusible	fu-si-ble
tute-lage	tu-te-lage
con-ser-v-a-tive	con-serv-a-tive
smelt-ing	smelting
con-cil-ia-tor	con-cil-i-a-tor
coda	co-da
lazy	la-zy
isosce-les	i-sos-ce-les
ir-re-place-able	ir-re-place-a-ble
ho-n-our	ho-nour
de-ductible	de-duct-i-ble
freighter	freight-er
buffer	buff-er
comet	com-et
phil-an-thropy	phi-lan-thro-py
over-val-ue	o-ver-val-ue
qua-drat-ic	quad-rat-ic
kinky	kink-y
idyl-lic	i-dyl-lic
block-buster	block-bust-er
pearly	pearl-y
cor-re-spon-dence	cor-re-spond-ence
fool-hardy	fool-har-dy
reper-toire	rep-er-toire
saucepan	sauce-pan
leath-ery	leath-er-y
sus-tain-abil-i-ty	sus-tain-a-bil-i-ty
in-stan-ta-neous	in-stan-ta-ne-ous
cy-clotron	cy-clo-tron
bio-ta	bi-o-ta
promis-cu-ous	pro-mis-cu-ous
busker	busk-er
elude	e-lude
flood-ing	flooding
trackbed	track-bed
video-taped	videotaped
pu-ri-tanism	pu-ri-tan-ism
stealth-ily	stealth-i-ly
lender	lend-er
iso-met-ric	i-so-met-ric
artery	ar-ter-y
de-pen-den-cy	de-pend-en-cy
rapid	rap-id
pe-ri-as-tron	per-i-as-tron
bungee	bun-gee
brand-ed	bran-ded
iron-work	i-ron-work
heron	her-on
syn-ony-mous	syn-on-y-mous
con-sul-tan-cy	con-sult-an-cy
anon	a-non
motile	mo-tile
an-thracite	an-thra-cite
parochial-ism	pa-ro-chi-al-ism
prob-a-bilis-tic	prob-a-bi-lis-tic
overt-ly	o-vert-ly
pre-sentable	pre-sent-a-ble
uni-cam-er-al	u-ni-cam-er-al
un-apolo-getic	un-a-pol-o-get-ic
re-vival	re-viv-al
pogo	po-go
precinct	pre-cinct
feldspar	feld-spar
prophe-cy	proph-e-cy
mayfly	may-fly
aside	a-side
cater	ca-ter
con-trast-ing	contrasting
de-scen-der	de-scend-er
ra-dioac-tiv-i-ty	ra-di-o-ac-tiv-i-ty
tractable	trac-ta-ble
speedy	speed-y
pow-dery	pow-der-y
loony	loon-y
re-li-ably	re-li-a-bly
con-sum-able	con-sum-a-ble
florist	flo-rist
brack-et-ed	bracketed
em-ploy-able	em-ploy-a-ble
over-growth	o-ver-growth
dark-ened	dar-kened
lentil	len-til
prelate	prel-ate
su-per-fluity	su-per-flu-i-ty
ir-re-solv-able	ir-re-solv-a-ble
idol-a-trous	i-dol-a-trous
over-haul	o-ver-haul
in-vesti-ture	in-ves-ti-ture
mor-phia	mor-phi-a
over-com-pen-sate	o-ver-com-pen-sate
chivvy	chiv-vy
gas-troin-testi-nal	gas-tro-in-tes-ti-nal
dis-in-fec-tant	dis-in-fect-ant
pot-tery	pot-ter-y
im-agery	im-age-ry
reagent	re-a-gent
mer-curic	mer-cu-ric
cretin	cre-tin
lo-goff	log-off
rein-ven-tion	re-in-ven-tion
carat	car-at
evil-do-er	e-vil-do-er
celiba-cy	cel-i-ba-cy
blood-thirsty	blood-thirst-y
phono-graph	pho-no-graph
par-don-able	par-don-a-ble
scholas-tic	scho-las-tic
equable	eq-ua-ble
jagged	jag-ged
de-bauch-ery	de-bauch-er-y
in-ter-nu-clear	in-ter-nu-cle-ar
preschool	pre-school
mis-cel-lany	mis-cel-la-ny
aris-toc-ra-cy	ar-is-toc-ra-cy
het-ero-ge-neous	het-er-o-ge-ne-ous
cursed	curs-ed
pro-ject-ing	projecting
icy	i-cy
over-due	o-ver-due
valu-able	val-u-a-ble
residu-um	re-sid-u-um
in-con-testable	in-con-test-a-ble
chico-ry	chic-o-ry
splashy	splash-y
piv-otal	piv-ot-al
phooey	phoo-ey
pro-pi-onate	pro-pi-o-nate
whole-saler	whole-sal-er
artiste	ar-tiste
naughty	naugh-ty
blus-tery	blus-ter-y
tuba	tu-ba
peachy	peach-y
breathy	breath-y
un-aware	un-a-ware
su-per-abun-dant	su-per-a-bun-dant
treaty	trea-ty
gravy	gra-vy
trencher	trench-er
irony	i-ro-ny
polypropy-lene	pol-y-pro-pyl-ene
ca-reerist	ca-reer-ist
over-pro-duc-tion	o-ver-pro-duc-tion
gib-ber-ing	gibbering
triplex	tri-plex
opi-um	o-pi-um
pes-simist	pes-si-mist
erad-i-ca-tion	e-rad-i-ca-tion
retest	re-test
potable	po-ta-ble
burly	bur-ly
emir	e-mir
dis-pos-able	dis-pos-a-ble
refuge	ref-uge
mock-ery	mock-er-y
dis-con-ti-nu-ity	dis-con-ti-nu-i-ty
cleanser	cleans-er
pael-la	pa-el-la
feath-erlight	feath-er-light
song-writer	song-writ-er
op-er-a-tional-ly	op-er-a-tion-al-ly
pos-i-tivism	pos-i-tiv-ism
briny	brin-y
avul-sion	a-vul-sion
stonework	stone-work
gu-nite	gun-ite
civic	civ-ic
de-mo-c-ra-t-i-cal-ly	dem-o-crat-i-cal-ly
bari-tone	bar-i-tone
declam-a-to-ry	de-clam-a-to-ry
cashier	cash-ier
re-sult-ing	resulting
torus	to-rus
fever-ish	fe-ver-ish
risot-to	ri-sot-to
poly-mor-phic	pol-y-mor-phic
lager	la-ger
tri-bune	trib-une
in-vig-o-rate	in-vig-or-ate
tur-bocharg-er	tur-bo-charg-er
bion-ics	bi-on-ics
welder	weld-er
rachis	ra-chis
uni-lat-er-al	u-ni-lat-er-al
tonedeaf	tone-deaf
damni-fy	dam-ni-fy
retry	re-try
nonex-is-tent	non-ex-ist-ent
sen-hor	se-nhor
con-ti-nu-ity	con-ti-nu-i-ty
seag-ull	sea-gull
dusty	dust-y
kalei-do-scope	ka-lei-do-scope
bathrobe	bath-robe
re-for-esta-tion	re-for-est-a-tion
inan-i-mate	in-an-i-mate
diplo-mat-ic	dip-lo-mat-ic
tyran-ny	tyr-an-ny
domi-cil-iary	dom-i-cil-i-ar-y
dodger	dodg-er
re-tal-ia-to-ry	re-tal-i-a-to-ry
re-place-able	re-place-a-ble
monar-chi-cal	mo-nar-chi-cal
corky	cork-y
chesty	chest-y
round-about	round-a-bout
chival-rous	chiv-al-rous
par-al-lelepiped	par-al-lel-e-pi-ped
sadis-tic	sa-dis-tic
ex-porta-bil-i-ty	ex-por-ta-bi-li-ty
elec-tro-car-dio-gram	e-lec-tro-car-di-o-gram
bedrag-gled	be-drag-gled
hearsay	hear-say
spir-i-tu-al-i-ty	spir-it-u-al-i-ty
celi-bate	cel-i-bate
mnemon-ic	mne-mon-ic
un-mea-sur-able	un-meas-ur-a-ble
discog-ra-phy	dis-cog-ra-phy
bur-nished	burnished
sui-ci-dal	su-i-cid-al
ex-trater-res-tri-al	ex-tra-ter-res-tri-al
jazzy	jazz-y
tren-chant-ly	trench-ant-ly
viva	vi-va
de-caf-feinate	de-caf-fein-ate
pres-bytery	pres-by-ter-y
eigen-val-ue	ei-gen-val-ue
lisp-ing	lis-ping
gen-uine-ly	gen-u-ine-ly
porter	por-ter
bather	bath-er
un-al-ter-able	un-al-ter-a-ble
pep-pery	pep-per-y
emo-tion-less	e-mo-tion-less
dis-putable	dis-put-a-ble
peri	pe-ri
dis-obey	dis-o-bey
gelatin	gel-a-tin
notwith-stand-ing	not-with-stand-ing
rhodo-den-dron	rho-do-den-dron
hab-it-able	hab-it-a-ble
en-thralling	en-thral-ling
as-so-ciate	as-so-ci-ate
mar-ke-teer	mar-ket-eer
copy-ist	cop-y-ist
pro-bity	pro-bi-ty
species	spe-cies
colo-nial	co-lo-ni-al
bazooka	ba-zoo-ka
tho-racic	tho-rac-ic
paean	pae-an
duo-de-num	du-o-de-num
cir-cling	circling
blessed	bless-ed
pe-rusal	pe-rus-al
brazen	bra-zen
bromine	bro-mine
im-pri-matur	im-pri-ma-tur
coast-ing	coasting
ridicu-lous	ri-dic-u-lous
de-ni-able	de-ni-a-ble
camper	camp-er
diesel	die-sel
rheumat-ic	rheu-mat-ic
in-vari-ably	in-var-i-a-bly
veg-etable	veg-e-ta-ble
usurp-er	u-surp-er
eclec-tic	ec-lec-tic
skater	skat-er
psy-chi-atric	psy-chi-at-ric
thrifty	thrift-y
grimy	grim-y
pony-tail	po-ny-tail
babysit-ter	ba-by-sit-ter
risky	risk-y
scrumhalf	scrum-half
scorcher	scorch-er
lozenge	loz-enge
idem	i-dem
in-cor-rupt-ible	in-cor-rupt-i-ble
punchy	punch-y
wrin-kled	wrinkled
he-li-copter	hel-i-cop-ter
lighter	light-er
dis-cour-tesy	dis-cour-te-sy
fuzzy	fuzz-y
youngish	young-ish
minute	mi-nute
loafer	loaf-er
winder	wind-er
ju-nior	jun-ior
spiky	spik-y
valen-tine	val-en-tine
promis-cu-ity	prom-is-cu-i-ty
flow-ery	flow-er-y
sabra	sa-bra
morass	mo-rass
deco	dec-o
ghana	ghana
wigeon	wig-eon
si-nu-soid	si-nus-oid
detri-men-tal	det-ri-men-tal
hy-acinth	hy-a-cinth
para-nor-mal	par-a-nor-mal
car-cino-gen-e-sis	car-cin-o-gen-e-sis
rosy	ros-y
physi-cian	phy-si-cian
pussy-cat	pussycat
tren-chant	trench-ant
deli	del-i
op-er-a-tional	op-er-a-tion-al
groundswell	ground-swell
hi-er-ar-ch	hi-er-arch
reap-pear	re-ap-pear
bistable	bi-sta-ble
bondage	bond-age
retic-u-lum	re-tic-u-lum
sealant	seal-ant
te-dious	te-di-ous
tem-pera-ment	tem-per-a-ment
aquiline	aq-ui-line
de-ca-pod	dec-a-pod
lectern	lec-tern
ethanol	eth-a-nol
prepara-to-ry	pre-par-a-to-ry
both-ered	bothered
delta	del-ta
modal	mod-al
unin-su-lat-ed	un-in-su-lat-ed
eclip-tic	e-clip-tic
seedbed	seed-bed
re-newed	renewed
nonen-ti-ty	non-en-ti-ty
any-how	an-y-how
graphite	graph-ite
grouchy	grouch-y
turfy	turf-y
event-ing	e-vent-ing
bubon-ic	bu-bon-ic
iri-des-cent	ir-i-des-cent
fi-deli-ty	fi-del-i-ty
gui-tarist	gui-tar-ist
trea-sure	treas-ure
where-abouts	where-a-bouts
gospel	gos-pel
ob-lig-ate	ob-li-gate
dolomite	do-lo-mite
sali-va	sa-li-va
brouha-ha	brou-ha-ha
vari-abil-i-ty	var-i-a-bil-i-ty
so-cio-cul-tur-al	so-ci-o-cul-tur-al
trigonom-e-try	trig-o-nom-e-try
as-cen-dant	as-cend-ant
reread	re-read
courtier	cour-ti-er
pruri-ent	pru-ri-ent
facet	fac-et
arise	a-rise
ready	read-y
jam-boree	jam-bo-ree
poly-no-mi-al	pol-y-no-mi-al
dis-abil-i-ty	dis-a-bil-i-ty
opera	o-pe-ra
mod-esty	mod-es-ty
prostaglandin	pros-ta-glan-din
delu-sive	de-lu-sive
avowed-ly	a-vow-ed-ly
catgut	cat-gut
tusker	tusk-er
artis-tic	ar-tis-tic
bedrid-den	bed-rid-den
mil-ligram	mil-li-gram
gra-tu-itous-ly	gra-tu-i-tous-ly
ethos	e-thos
over-state-ment	o-ver-state-ment
para-graph	par-a-graph
di-achron-ic	di-a-chron-ic
tremu-lous	trem-u-lous
protest	pro-test
kaolin	ka-o-lin
ago	a-go
valiant	val-iant
rock-etry	rock-et-ry
tepid	tep-id
in-tra-venous-ly	in-tra-ve-nous-ly
pinafore	pin-a-fore
ir-re-proach-able	ir-re-proach-a-ble
charge-able	charge-a-ble
telepa-thy	te-lep-a-thy
sharply	sharp-ly
toughie	tough-ie
ga-lop	gal-op
car-bonyl	car-bon-yl
reap-point	re-ap-point
enam-el	e-nam-el
unas-sist-ed	un-as-sist-ed
relict	rel-ict
overindul-gence	o-ver-in-dul-gence
mis-ery	mis-er-y
manikin	man-i-kin
dis-plea-sure	dis-pleas-ure
even-tu-al	e-ven-tu-al
lino	li-no
iron-stone	i-ron-stone
sprayer	spray-er
teach-able	teach-a-ble
plushy	plush-y
eman-ci-pate	e-man-ci-pate
im-ple-menter	im-ple-ment-er
stereo	ster-e-o
power-boat	pow-er-boat
hero-in	her-o-in
eques-tri-an-ism	e-ques-tri-an-ism
con-cor-dance	con-cord-ance
su-per-tanker	su-per-tank-er
ide-al-ist	i-de-al-ist
planter	plant-er
in-de-ter-minable	in-de-ter-mi-na-ble
over-stretch	o-ver-stretch
over-ly	o-ver-ly
emet-ic	e-met-ic
slant-ed	slanted
clin-i-cian	cli-ni-cian
reshow	re-show
any-body	an-y-bod-y
bumper	bump-er
promis-so-ry	prom-is-so-ry
decile	dec-ile
crisply	crisp-ly
topol-o-gy	to-pol-o-gy
tremo-lo	trem-o-lo
in-com-men-su-rable	in-com-men-su-ra-ble
tremor	trem-or
myelin	my-e-lin
orate	o-rate
chrysan-the-mum	chry-san-the-mum
li-censee	li-cen-see
prebend	preb-end
dilu-ent	dil-u-ent
ben-der	bend-er
horny	horn-y
fifty	fif-ty
purview	pur-view
furtive	fur-tive
respire	re-spire
in-ter-preter	in-ter-pret-er
worsted	wor-sted
up-hol-stery	up-hol-ster-y
bean-ery	bean-er-y
trans-mo-gri-fy	trans-mog-ri-fy
clink-ing	clin-king
lazi-ness	la-zi-ness
lega-tee	leg-a-tee
or-a-to-rio	or-a-to-ri-o
phoneme	pho-neme
poly-crys-talline	pol-y-crys-tal-line
en-chantress	en-chant-ress
equi-lib-ri-um	e-qui-lib-ri-um
milk-shake	milkshake
un-invit-ing	un-in-vit-ing
elu-ci-date	e-lu-ci-date
masseuse	mas-seuse
recom-mence	re-com-mence
chi-huahua	chi-hua-hua
buildup	build-up
un-promis-ing	un-prom-is-ing
atoll	at-oll
un-sea-son-ably	un-sea-son-a-bly
break-able	break-a-ble
hauli-er	haul-ier
mirac-u-lous	mi-rac-u-lous
pul-monary	pul-mo-nar-y
unimag-i-na-tive	un-im-ag-i-na-tive
his-toric	his-tor-ic
un-drink-able	un-drink-a-ble
bil-iary	bil-i-ar-y
pa-tri-o-tism	pa-tri-ot-ism
mono-graph-ic	mon-o-graph-ic
flus-tered	flustered
lumpy	lump-y
award	a-ward
shaver	shav-er
ecol-o-gy	e-col-o-gy
em-anate	em-a-nate
os-teopath	os-te-o-path
ma-nia	ma-ni-a
in-elas-tic	in-e-las-tic
cho-ris-ter	chor-is-ter
arranger	ar-rang-er
cleanup	clean-up
stratos-phere	strat-o-sphere
dy-nasty	dy-nas-ty
bur-ial	bur-i-al
pornog-ra-phy	por-nog-ra-phy
pro-tect-ed	protected
im-mutable	im-mu-ta-ble
urol-o-gist	u-rol-o-gist
curvy	curv-y
tri-adic	tri-ad-ic
pro-pa-gan-dist	prop-a-gan-dist
profli-ga-cy	prof-li-ga-cy
theta	the-ta
dowa-ger	dow-a-ger
baroque	ba-roque
de-odor-ant	de-o-dor-ant
min-uet	min-u-et
pantry	pan-try
equa-tor	e-qua-tor
me-te-o-rol-o-gy	me-te-or-ol-o-gy
dif-fer-en-tiable	dif-fer-en-ti-a-ble
tau-tol-ogy	tau-tol-o-gy
im-munoas-say	im-mu-no-as-say
homage	hom-age
siren	si-ren
muti-nous	mu-ti-nous
ergo	er-go
paci-fism	pac-i-fism
phone-mic	pho-ne-mic
iso-topic	i-so-top-ic
ra-tio-nal-ly	ra-tion-al-ly
newsy	news-y
sto-ry-telling	sto-ry-tell-ing
tulip	tu-lip
ki-mono	ki-mo-no
mul-ti-me-dia	mul-ti-me-di-a
glis-ten-ing	gli-ste-ning
rewritable	re-writ-a-ble
rarebit	rare-bit
de-tach-able	de-tach-a-ble
gazette	ga-zette
se-questered	se-ques-tered
owlish	owl-ish
beaver	bea-ver
whirlpool	whirl-pool
itin-er-ant	i-tin-er-ant
coro-nary	cor-o-nar-y
li-able	li-a-ble
marigold	mar-i-gold
con-sul-tant	con-sult-ant
tick-et-ed	ticketed
perquisite	per-qui-site
stretchy	stretch-y
di-a-bolism	di-ab-o-lism
perdi-tion	per-di-tion
arachno-pho-bia	a-rach-no-pho-bi-a
slouch-ing	slouching
scan-dalous	scan-dal-ous
rhubarb	rhu-barb
sea-son-able	sea-son-a-ble
taxis	tax-is
florin	flor-in
fly-over	fly-o-ver
sus-penders	sus-pend-ers
shogun	sho-gun
nar-ra-tol-ogy	nar-ra-tol-o-gy
mendele-vi-um	men-de-le-vi-um
fum-bling	fumbling
unim-por-tant	un-im-por-tant
reprise	re-prise
Words with errors: 1850
Words with incorrect number of syllables: 1749
Total evluated: 6500
Perfect accuracy: 0.72
Number of syllables accuracy: 0.73
Average Levenshtein Distance(across incorrect words): 1.20
