Attempt	Real
counter	coun-ter
e-s-planade	es-pla-nade
de-men-t	de-ment
necrop-sy	nec-rop-sy
coura-geous	cou-ra-geous
ran-corous	ran-cor-ous
bluish	blu-ish
s-mug-gling	smuggling
re-mark-ably	re-mark-a-bly
ibis	i-bis
crit-i-cis-m	crit-i-cism
s-cis-sors	scis-sors
green-ery	green-er-y
vol-canic	vol-can-ic
func-tion-al-is-m	func-tion-al-ism
fanci-er	fan-ci-er
plea-sure	pleas-ure
reawak-en	re-a-wak-en
artiste	ar-tiste
cycli-cal	cy-cli-cal
shad-owy	shad-ow-y
liquor	liq-uor
in-duc-t	in-duct
in-es-timable	in-es-ti-ma-ble
re-main-s	re-mains
bur-geon-ing	burgeoning
hectare	hec-tare
newsagen-t	news-a-gent
d-u-al	du-al
weed-s	weeds
d-warfed	dwarfed
con-troller	con-trol-ler
meta-phys-i-cal	met-a-phys-i-cal
skintight	skin-tight
painful-ly	pain-ful-ly
re-uni-fi-ca-tion	re-u-ni-fi-ca-tion
in-spec-t	in-spect
tubu-lar	tu-bu-lar
welder	weld-er
ivy	i-vy
eigen-func-tion	ei-gen-func-tion
navel	na-vel
illiq-uid	il-liq-uid
dis-ar-ma-men-t	dis-ar-ma-ment
warhorse	war-horse
be-fal-l	be-fall
bond-ing	bonding
cater-pil-lar	cat-er-pil-lar
pro-ba-tion-ary	pro-ba-tion-ar-y
awestruc-k	awe-struck
y-owl	yowl
com-mu-nica-tive	com-mu-ni-ca-tive
dis-re-spec-t	dis-re-spect
in-trepid	in-trep-id
radon	ra-don
tu-mul-tuous	tu-mul-tu-ous
mu-nif-i-cen-t	mu-nif-i-cent
over-worked	overworked
s-melt-ing	smelting
temer-i-ty	te-mer-i-ty
un-re-solv-able	un-re-solv-a-ble
omis-sion	o-mis-sion
triglyc-eride	tri-glyc-er-ide
catarac-t	cat-a-ract
d-ab-bing	dab-bing
in-elas-tic	in-e-las-tic
foot-baller	foot-ball-er
mi-cro-farad	mi-cro-far-ad
de-ten-t	de-tent
rock-etry	rock-et-ry
in-sis-tence	in-sist-ence
sub-ur-bia	sub-ur-bi-a
widen	wid-en
owlish	owl-ish
s-tave	stave
radix	ra-dix
aplom-b	a-plomb
unso-cia-ble	un-so-cia-ble
ju-ridi-cal	ju-rid-i-cal
mul-ti-level	mul-ti-lev-el
g-land	gland
co-pra	cop-ra
mut-t	mutt
seashore	sea-shore
busi-nesslike	busi-ness-like
pen-i-ten-tiary	pen-i-ten-tia-ry
grasshop-per	grass-hop-per
s-lick-er	slick-er
om-nipo-ten-t	om-nip-o-tent
over-done	o-ver-done
avoid-ance	a-void-ance
s-tokes	stokes
re-as-sign-men-t	re-as-sign-ment
hori-zon	ho-ri-zon
spencer	spen-cer
wicked	wick-ed
saline	sa-line
pover-ty	pov-er-ty
in-den-t	in-dent
syco-phancy	syc-o-phan-cy
un-bear-ably	un-bear-a-bly
scream-ing	screaming
tele-vised	televised
nougat	nou-gat
pub-lished	published
bassist	bass-ist
chi-canery	chi-can-er-y
io-ta	i-o-ta
ep-ithe-lial	ep-i-the-li-al
milk-shake	milkshake
schoolmistress	school-mis-tress
ref-er-en-t	ref-er-ent
per-jury	per-ju-ry
s-lump	slump
ma-chin-ery	ma-chin-er-y
trainee	train-ee
an-tipodes	an-tip-o-des
ig-no-min-ious	ig-no-min-i-ous
sier-ra	si-er-ra
sar-cas-m	sar-casm
s-able	sa-ble
darter	dart-er
fore-stal-l	fore-stall
fri-able	fri-a-ble
flotil-la	flo-til-la
elec-tri-cal	e-lec-tri-cal
tru-is-m	tru-ism
eeri-ly	ee-ri-ly
cru-ci-for-m	cru-ci-form
e-d-uca-tive	ed-u-ca-tive
sum-mon-s	sum-mons
transcon-ti-nen-tal	trans-con-ti-nen-tal
s-ce-nari-o	sce-nar-i-o
dis-tan-t	dis-tant
readi-ness	read-i-ness
n-ear-sight-ed	near-sight-ed
cloudy	cloud-y
species	spe-cies
enu-mer-a-tion	e-nu-mer-a-tion
choline	cho-line
ex-u-ber-an-t	ex-u-ber-ant
crafty	craft-y
video-taped	videotaped
y-acht-ing	yacht-ing
in-vari-ant	in-var-i-ant
pat-terned	patterned
artistry	art-ist-ry
sub-ter-ranean	sub-ter-ra-ne-an
sec-re-tar-iat	sec-re-tar-i-at
elec-tro-cu-tion	e-lec-tro-cu-tion
ethnog-ra-phy	eth-nog-ra-phy
er-ran-t	er-rant
asi-nine	as-i-nine
school-teacher	school-teach-er
en-force-men-t	en-force-ment
au-to-bah-n	au-to-bahn
in-con-solable	in-con-sol-a-ble
ide-o-log-i-cal-ly	i-de-o-log-i-cal-ly
grad-u-al-is-m	grad-u-al-ism
easy-go-ing	eas-y-go-ing
b-lis-ter	blis-ter
s-tim-u-lat-ing	stim-u-lat-ing
pick-ax-e	pick-axe
in-audi-ble	in-au-di-ble
giblet-s	gib-lets
d-enizen	den-i-zen
s-cam-per	scamp-er
jour-nalese	jour-nal-ese
s-par-ing	spar-ing
mar-keter	mar-ket-er
mono-mi-al	mo-no-mi-al
g-luten	glu-ten
de-liv-er-able	de-liv-er-a-ble
s-can-ner	scan-ner
s-now-stor-m	snow-storm
con-duc-t	con-duct
resin	res-in
body-guard	bod-y-guard
ma-joli-ca	ma-jol-i-ca
co-pro-lite	cop-ro-lite
cameo	cam-e-o
breather	breath-er
in-ter-men-t	in-ter-ment
catholic	cath-o-lic
cra-nial	cra-ni-al
many	man-y
di-eti-tian	di-e-ti-tian
o-vary	o-va-ry
lemon-ade	lem-on-ade
fault-ing	faulting
craven	cra-ven
gale-na	ga-le-na
u-n-adorned	un-a-dorned
mega-phone	meg-a-phone
corset	cor-set
s-coot-er	scoot-er
ax-olotl	ax-o-lotl
pu-ri-tanis-m	pu-ri-tan-ism
tripoli	trip-o-li
dotage	dot-age
ga-lop	gal-op
con-fec-tionery	con-fec-tion-er-y
s-to-ical	sto-i-cal
over-step	o-ver-step
col-lec-t	col-lect
with-ered	withered
gad-getry	gadg-et-ry
tal-l	tall
s-louch	slouch
paragon	par-a-gon
in-hos-pitable	in-hos-pi-ta-ble
pass-ably	pass-a-bly
staphy-lo-coc-cus	staph-y-lo-coc-cus
pointil-lis-m	poin-til-lism
gazelle	ga-zelle
melo-dra-mat-ic	mel-o-dra-mat-ic
balmy	balm-y
cy-ber-net-ic-s	cy-ber-net-ics
over-wrought	o-ver-wrought
mono-gram	mon-o-gram
ca-cophonous	ca-coph-o-nous
hauler	haul-er
s-lut	slut
her-bi-cide	herb-i-cide
table-cloth	ta-ble-cloth
unin-spired	un-in-spired
s-tom-ach	stom-ach
hu-manoid	hu-man-oid
wom-b	womb
con-vect-ed	convected
prospec-t	pros-pect
rigid-i-ty	ri-gid-i-ty
poly-the-is-tic	pol-y-the-is-tic
gaga	ga-ga
plenum	ple-num
trans-paren-cy	trans-par-en-cy
premise	prem-ise
em-bez-zle-men-t	em-bez-zle-ment
wa-terbed	wa-ter-bed
rec-ol-lec-t	rec-ol-lect
para-m-ag-net-ic	par-a-mag-net-ic
there-upon	there-up-on
recla-ma-tion	rec-la-ma-tion
taskmas-ter	task-mas-ter
en-counter	en-coun-ter
ringer	ring-er
multi-na-tion-al	mul-ti-na-tion-al
plenipo-ten-tiary	plen-i-po-ten-ti-ar-y
camel	cam-el
prof-i-teer-ing	profiteering
granny	gran-ny
sedi-tion	se-di-tion
un-read-able	un-read-a-ble
s-pa-cious	spa-cious
burn-ings	bur-nings
ne-go-tia-tor	ne-go-ti-a-tor
heat-wave	heatwave
num-b	numb
un-drink-able	un-drink-a-ble
polyg-y-ny	po-lyg-y-ny
unswerv-ing	un-swerv-ing
de-ni-able	de-ni-a-ble
serene	se-rene
sub-atom-ic	sub-a-tom-ic
s-trap-ping	strap-ping
s-pat-ter	spat-ter
garbage	gar-bage
g-nash	gnash
haz-ardous	haz-ard-ous
con-tigu-ous	con-tig-u-ous
paunchy	paunch-y
ion-ic	i-on-ic
at-temp-t	at-tempt
over-re-ac-tion	o-ver-re-ac-tion
stealthy	stealth-y
mal-l	mall
at-ten-dan-t	at-tend-ant
choco-late	choc-o-late
spunky	spunk-y
cre-ative-ly	cre-a-tive-ly
maybe	may-be
gen-eros-i-ty	gen-er-os-i-ty
con-sis-ten-t	con-sist-ent
oblige	o-blige
b-room	broom
con-sul-tan-cy	con-sult-an-cy
velum	ve-lum
damna-tion	dam-na-tion
li-able	li-a-ble
poly-gon	pol-y-gon
avail-abil-i-ty	a-vail-a-bil-i-ty
sec-u-lar-is-m	sec-u-lar-ism
mod-ernism	mod-ern-ism
i-nat-ten-tion	in-at-ten-tion
huf-f	huff
felo-nious	fe-lo-ni-ous
refugee	ref-u-gee
damask	dam-ask
penin-su-la	pen-in-su-la
lyri-cal	lyr-i-cal
e-s-prit	es-prit
chaffinch	chaf-finch
shoplift-ing	shop-lift-ing
squirearchy	squire-ar-chy
wolfish	wolf-ish
or-biter	or-bit-er
sushi	su-shi
colony	col-o-ny
sec-on-dar-i-ly	sec-ond-ar-i-ly
holis-m	ho-lism
sanc-ti-mo-nious	sanc-ti-mo-ni-ous
s-taid	staid
re-stric-t	re-strict
u-p-load	up-load
chlo-ro-for-m	chlo-ro-form
taunt-ing	taunting
restau-ra-teur	res-tau-ra-teur
grapevine	grape-vine
ac-coun-t	ac-count
trackbed	track-bed
vari-ance	var-i-ance
ra-tio-nal-ly	ra-tion-al-ly
s-pank-ing	spank-ing
liqueur	li-queur
over-whelm-ing-ly	o-ver-whelm-ing-ly
mis-ery	mis-er-y
prophet-ic	pro-phet-ic
as-para-gus	as-par-a-gus
dev-il-men-t	dev-il-ment
s-api-en-t	sa-pi-ent
stealth-ily	stealth-i-ly
cour-tesy	cour-te-sy
un-linked	unlinked
pathogen	path-o-gen
merid-i-an	me-rid-i-an
herba-ceous	her-ba-ceous
bene-fac-tion	ben-e-fac-tion
prefer-able	pref-er-a-ble
s-ing	sing
in-tra-venous-ly	in-tra-ve-nous-ly
fussy	fuss-y
dairy-man	dair-y-man
tele-scop-ic	tel-e-scop-ic
af-fec-t	af-fect
hor-mon-al	hor-mo-nal
un-cre-ative	un-cre-a-tive
s-ta-tionery	sta-tion-er-y
touris-m	tour-ism
rapid-ly	rap-id-ly
in-signif-i-can-t	in-sig-nif-i-cant
gov-ern-men-t	gov-ern-ment
un-kep-t	un-kept
doyenne	doy-enne
ledger	ledg-er
colo-nial	co-lo-ni-al
muslin	mus-lin
rewritable	re-writ-a-ble
whar-f	wharf
desert-s	de-serts
waxy	wax-y
psy-chopathol-o-gy	psy-cho-pa-thol-o-gy
ther-mo-elec-tric	ther-mo-e-lec-tric
join-t	joint
mi-crosec-ond	mi-cro-sec-ond
gal-vanome-ter	gal-va-nom-e-ter
s-cent-ed	scent-ed
rein-ter-pre-ta-tion	re-in-ter-pre-ta-tion
palace	pal-ace
paraquat	par-a-quat
steady-ing	steadying
n-ear-by	near-by
hireling	hire-ling
arach-noid	a-rach-noid
dimin-u-en-do	di-min-u-en-do
in-hab-it-able	in-hab-it-a-ble
mal-odor-ous	mal-o-dor-ous
cov-e	cove
mo-lesta-tion	mo-les-ta-tion
over-spill	o-ver-spill
mush-room-ing	mushrooming
s-tovepipe	stove-pipe
fraugh-t	fraught
ar-chi-tec-t	ar-chi-tect
round-about	round-a-bout
celiba-cy	cel-i-ba-cy
opaque	o-paque
stripling	strip-ling
con-san-guineous	con-san-guin-e-ous
chromite	chro-mite
a-ca-dem-ic	ac-a-dem-ic
pollen	pol-len
va-ri-etal	va-ri-e-tal
benev-o-len-t	be-nev-o-lent
lever	lev-er
whif-f	whiff
vary	var-y
ra-dio-graph	ra-di-o-graph
im-pro-vi-sa-tion	im-prov-i-sa-tion
o-r-a-cle	or-a-cle
at-tack-ing	attacking
augite	au-gite
side-re-al	si-de-re-al
d-weller	dwell-er
forty	for-ty
killjoy	kill-joy
e-lastin	e-las-tin
s-lot	slot
hearti-ly	heart-i-ly
painstak-ing-ly	pains-tak-ing-ly
un-pleas-an-t	un-pleas-ant
over-throw	o-ver-throw
mantrap	man-trap
ileum	il-e-um
s-tooge	stooge
ex-pec-t	ex-pect
hack-able	hack-a-ble
i-n-ac-ti-va-tion	in-ac-ti-va-tion
se-mi	sem-i
translu-cen-cy	trans-lu-cen-cy
petard	pe-tard
topaz	to-paz
in-con-sis-ten-cy	in-con-sist-en-cy
de-rail-men-t	de-rail-ment
phy-loge-ny	phy-log-e-ny
ibex	i-bex
dean-ery	dean-er-y
repli-ca	rep-li-ca
gen-uine-ly	gen-u-ine-ly
hide-away	hide-a-way
aor-tic	a-or-tic
para-troop-s	par-a-troops
waspish	wasp-ish
un-mea-sur-able	un-meas-ur-a-ble
nega-tion	ne-ga-tion
c-om-mend-ably	com-mend-a-bly
promis-ing	prom-is-ing
who-dunit	who-dun-it
strol-l	stroll
in-flat-able	in-flat-a-ble
n-odal	nod-al
pro-ges-terone	pro-ges-ter-one
re-im-burse-men-t	re-im-burse-ment
di-rec-torate	di-rec-to-rate
the-saurus	the-sau-rus
le-nien-t	le-ni-ent
un-heroic	un-he-ro-ic
freestyle	free-style
whirlpool	whirl-pool
humerus	hu-mer-us
h-es-i-tant-ly	hes-i-tant-ly
tepid	tep-id
con-vivial	con-viv-i-al
gour-d	gourd
myx-o-mato-sis	myx-o-ma-to-sis
mala-chite	mal-a-chite
as-siduity	as-si-du-i-ty
twisty	twist-y
sun-burned	sunburned
gaudy	gaud-y
frip-pery	frip-per-y
sur-fac-tan-t	sur-fac-tant
stager	stag-er
elec-troneg-a-tive	e-lec-tro-neg-a-tive
bak-ery	bak-er-y
teatime	tea-time
dum-b	dumb
oblig-ing-ly	o-blig-ing-ly
ex-pres-sion-is-m	ex-pres-sion-ism
ex-i-gen-t	ex-i-gent
g-luti-nous	glu-ti-nous
pup-peteer	pup-pet-eer
forego	fore-go
hotspot	hot-spot
phos-phatase	phos-pha-tase
it-s	its
saga-cious	sa-ga-cious
postage	post-age
za-g	zag
raven	ra-ven
opac-i-ty	o-pac-i-ty
cere-bel-lum	cer-e-bel-lum
mis-nomer	mis-no-mer
beget	be-get
tourist	tour-ist
clank-ing	clan-king
as-so-cia-tive	as-so-ci-a-tive
pres-bytery	pres-by-ter-y
gra-tu-itous-ly	gra-tu-i-tous-ly
metempsy-chosis	me-tem-psy-cho-sis
run-t	runt
a-vian	a-vi-an
briefly	brief-ly
sloven-ly	slov-en-ly
ta-pes-try	tap-es-try
aster	as-ter
voyeuris-tic	voy-eur-is-tic
tele-phone	tel-e-phone
reg-istry	reg-is-try
vel-veteen	vel-vet-een
bur-bling	burbling
t-wofaced	two-faced
petu-lance	pet-u-lance
handy-man	hand-y-man
glow-wor-m	glow-worm
in-dictable	in-dict-a-ble
ri-fled	rifled
bondage	bond-age
cleaver	cleav-er
gener-i-cal-ly	ge-ner-i-cal-ly
holler	hol-ler
re-strain-t	re-straint
epi-taxy	ep-i-tax-y
wigeon	wig-eon
hasti-ly	hast-i-ly
or-ga-nize	or-gan-ize
e-u-pho-ri-a	eu-pho-ri-a
tu-atara	tu-a-ta-ra
meta-mor-phic	met-a-mor-phic
coau-thor	co-au-thor
medusa	me-du-sa
ven-omous	ven-om-ous
porno-graph-ic	por-no-graph-ic
rooi-bos	roo-i-bos
pom-p	pomp
grun-t	grunt
wreck-ing	wrecking
a-part-men-t	a-part-ment
s-tay	stay
limp-ing	limping
un-quench-able	un-quench-a-ble
u-topi-a	u-to-pi-a
duster	dust-er
ditch-ing	ditching
jaun-t	jaunt
ex-ac-t	ex-act
papule	pap-ule
in-ex-orably	in-ex-o-ra-bly
prepo-si-tion	prep-o-si-tion
her-itage	her-it-age
sus-pender-s	sus-pend-ers
loutish	lout-ish
here-inafter	here-in-af-ter
com-mis-sari-at	com-mis-sar-i-at
melee	me-lee
el-e-men-t	el-e-ment
rub-bishy	rub-bish-y
lig-and	li-gand
cud-gel	cudg-el
feath-ery	feath-er-y
n-ev-er-the-less	nev-er-the-less
wrestling	wres-tling
promi-nent-ly	prom-i-nent-ly
askew	a-skew
ole-an-der	o-le-an-der
over-tax	o-ver-tax
in-quisi-to-ri-al	in-quis-i-to-ri-al
con-ve-nient-ly	con-ven-ient-ly
s-mall-ish	small-ish
bailout	bail-out
s-cathe	scathe
diathermy	di-a-ther-my
non-even-t	non-e-vent
re-vi-sion-is-m	re-vi-sion-ism
eardrum	ear-drum
over-win-ter	o-ver-win-ter
salaam	sa-laam
surgery	sur-ger-y
naive-ly	na-ive-ly
s-ingly	sin-gly
baleen	ba-leen
elec-tri-fi-ca-tion	e-lec-tri-fi-ca-tion
t-inc-ture	tinc-ture
bonobo	bo-no-bo
cy-tochrome	cy-to-chrome
gaze-bo	ga-ze-bo
i-cosa-he-dron	i-co-sa-he-dron
pedan-t	ped-ant
oven	ov-en
seren-i-ty	se-ren-i-ty
propo-si-tion-al	prop-o-si-tion-al
paramount-cy	par-a-mount-cy
lo-quac-ity	lo-quac-i-ty
re-frac-t	re-fract
evince	e-vince
bom-bard-men-t	bom-bard-ment
s-word	sword
case-men-t	case-ment
d-if-fer-en-ti-a-tion	dif-fer-en-ti-a-tion
avi-a-tion	a-vi-a-tion
s-tiff-en-ing	stiff-en-ing
par-lia-men-tary	par-lia-men-ta-ry
pedi-gree	ped-i-gree
gud-geon	gudg-eon
stapes	sta-pes
over-re-ac-t	o-ver-re-act
teth-er-ing	tethering
episode	ep-i-sode
ob-so-les-cen-t	ob-so-les-cent
awak-en	a-wak-en
re-newed	renewed
finick-y	fin-ick-y
com-mu-nica-tive-ness	com-mu-ni-ca-tive-ness
dis-able	dis-a-ble
lazi-ness	la-zi-ness
preva-len-t	prev-a-lent
in-ter-preter	in-ter-pret-er
hadron	had-ron
mic-turi-tion	mic-tu-ri-tion
translu-cen-t	trans-lu-cent
di-aphrag-mat-ic	di-a-phrag-mat-ic
geron-toc-ra-cy	ger-on-toc-ra-cy
as-cer-tain-men-t	as-cer-tain-ment
cigar	ci-gar
flan-nelette	flan-nel-ette
gu-nite	gun-ite
speci-fici-ty	spec-i-fic-i-ty
s-to-chas-tic	sto-chas-tic
d-if-fer-en-ti-ate	dif-fer-en-ti-ate
silky	silk-y
ev-ery-where	eve-ry-where
s-e-lec-t	se-lect
dessert	des-sert
par-a-bola	pa-rab-o-la
tox-i-c	tox-ic
polyurethane	pol-y-u-re-thane
g-lut-tonous	glut-ton-ous
steadi-ly	stead-i-ly
rheumat-ic-s	rheu-mat-ics
yel-l	yell
s-tates-man-ship	states-man-ship
pho-to-elec-tric	pho-to-e-lec-tric
mili-tia-man	mi-li-tia-man
carmine	car-mine
volup-tuous	vo-lup-tu-ous
u-nashamed	un-a-shamed
wag-gery	wag-ger-y
suc-cu-len-t	suc-cu-lent
in-cor-rec-t	in-cor-rect
buck-min-ster-fullerene	buck-min-ster-ful-ler-ene
promi-nence	prom-i-nence
colum-nar	co-lum-nar
zany	za-ny
leg-erde-main	leg-er-de-main
se-nior-i-ty	sen-ior-i-ty
i-nan-i-mate	in-an-i-mate
s-teer	steer
pro-ce-du-ral-ly	pro-ce-dur-al-ly
k-in-folk	kin-folk
rooftop	roof-top
fac-t	fact
en-joy-men-t	en-joy-ment
mi-cro-com-put-er	mi-cro-com-pu-ter
pornog-ra-pher	por-nog-ra-pher
glam-orous	glam-or-ous
ob-serv-able	ob-serv-a-ble
laun-derette	laun-der-ette
birdie	bird-ie
pari-etal	pa-ri-e-tal
valu-able	val-u-a-ble
mis-t	mist
as-sort-men-t	as-sort-ment
read-mis-sion	re-ad-mis-sion
in-cisor	in-ci-sor
cider	ci-der
dis-pos-able	dis-pos-a-ble
undis-cern-ing	un-dis-cern-ing
macroe-co-nom-ic	mac-ro-ec-o-nom-ic
re-ceiver-ship	re-ceiv-er-ship
p-salmist	psalm-ist
stringy	string-y
ir-rec-on-cil-able	ir-rec-on-cil-a-ble
fash-ion-able	fash-ion-a-ble
po-ten-tiome-ter	po-ten-ti-om-e-ter
papil-la	pa-pil-la
beaver	bea-ver
om-nipo-tence	om-nip-o-tence
e-vic-t	e-vict
thral-l	thrall
fusil-lade	fu-sil-lade
de-pri-va-tion	dep-ri-va-tion
stingy	stin-gy
vengeance	venge-ance
sain-t	saint
shril-l	shrill
con-trol-lable	con-trol-la-ble
shaver	shav-er
mer-chan-t	mer-chant
tetra	tet-ra
s-cur-ry	scur-ry
debonair	deb-o-nair
gory	gor-y
vinyl	vi-nyl
kil-n	kiln
tropopause	trop-o-pause
opin-ion-at-ed	o-pin-ion-at-ed
erec-t	e-rect
poly-styrene	pol-y-sty-rene
ca-ress-ing	ca-res-sing
in-ter-dis-ci-pli-nary	in-ter-dis-ci-pli-nar-y
s-now	snow
dearie	dear-ie
methy-lene	meth-yl-ene
s-wot	swot
hubris-tic	hu-bris-tic
plan-gen-t	plan-gent
cough-ing	coughing
ex-pan-sion-ary	ex-pan-sion-ar-y
re-portage	re-port-age
par-venu	par-ve-nu
hy-drazine	hy-dra-zine
hunter	hunt-er
me-galith-ic	meg-a-lith-ic
undi-rect-ed	un-di-rect-ed
floury	flour-y
ure-thane	u-re-thane
smithereen-s	smith-er-eens
scrolling	scroll-ing
earshot	ear-shot
s-loshed	sloshed
cedil-la	ce-dil-la
miser-ly	mi-ser-ly
re-trench-men-t	re-trench-ment
muf-f	muff
debone	de-bone
ro-botic	ro-bot-ic
s-paniel	span-iel
pastille	pas-tille
sacral	sa-cral
per-tur-b	per-turb
plat-i-tudi-nous	plat-i-tu-di-nous
creduli-ty	cre-du-li-ty
trusty	trust-y
idio-syn-crasy	id-i-o-syn-cra-sy
un-der-ar-m	un-der-arm
en-chan-t	en-chant
cryo-stat	cry-o-stat
poly-mor-phous	pol-y-mor-phous
speedy	speed-y
pa-tois	pat-ois
s-lant-wise	slant-wise
ra-dius	ra-di-us
non-con-formist	non-con-form-ist
con-veyanc-ing	con-vey-anc-ing
u-nimag-in-ably	un-im-ag-i-na-bly
re-ver-ber-an-t	re-ver-ber-ant
tidi-ness	ti-di-ness
moldy	mold-y
e-d-u-ca-tion-al	ed-u-ca-tion-al
ex-emp-t	ex-empt
bound-ary	bound-a-ry
breathy	breath-y
based	based
bromine	bro-mine
aza-lea	a-zal-ea
ine-bri-ate	in-e-bri-ate
s-ports-man	sports-man
enu-mer-ate	e-nu-mer-ate
s-toat	stoat
busker	busk-er
sinew	sin-ew
e-mery	em-er-y
antrum	an-trum
over-turn	o-ver-turn
anti-gen	an-ti-gen
jeop-ardy	jeop-ard-y
dis-so-nan-t	dis-so-nant
non-vi-o-len-t	non-vi-o-lent
apoc-ryphal	a-poc-ry-phal
un-bo-som	un-bos-om
an-throp-ic	an-thro-pic
re-tiree	re-tir-ee
millinery	mil-li-ner-y
chateau	cha-teau
o-belisk	ob-e-lisk
be-fud-dling	befuddling
obe-di-en-t	o-be-di-ent
fore-ar-m	fore-arm
s-cabbed	scabbed
driver-less	driv-er-less
prepo-si-tion-al	prep-o-si-tion-al
here-after	here-af-ter
ori-en-tate	o-ri-en-tate
ori-en-tal	o-ri-en-tal
hered-i-tary	he-red-i-tar-y
boatswain	boat-swain
arum	ar-um
an-tag-o-nis-m	an-tag-o-nism
colonic	co-lon-ic
sus-tain-ably	sus-tain-a-bly
vig-i-lante	vig-i-lan-te
s-neer-ing	sneering
ini-tia-tive	in-i-ti-a-tive
wit-ti-cis-m	wit-ti-cism
in-choate	in-cho-ate
coro-na-tion	cor-o-na-tion
veni-son	ven-i-son
crack-er-s	crack-ers
mas-cara	mas-car-a
p-re-sen-ter	pre-sent-er
ethe-re-al	e-the-re-al
lul-la-by	lull-a-by
amoun-t	a-mount
stinker	stink-er
s-tonework	stone-work
reval-u-a-tion	re-val-u-a-tion
doorstop	door-stop
minia-ture	min-i-a-ture
over-writ-ing	overwriting
chuf-f	chuff
forcibly	for-ci-bly
an-tivi-ral	an-ti-vi-ral
ar-senide	ar-se-nide
s-tarve	starve
in-valu-able	in-val-u-a-ble
phil-an-thropic	phil-an-throp-ic
mono-lin-gual	mon-o-lin-gual
over-state	o-ver-state
leisurewear	lei-sure-wear
l-it-i-ga-tion	lit-i-ga-tion
d-if-fuse	dif-fuse
metic-u-lous	me-tic-u-lous
s-coff-in-g	scoffing
recorder	re-cord-er
over-board	o-ver-board
i-n-ad-e-qua-cy	in-ad-e-qua-cy
by-stander	by-stand-er
im-moral-i-ty	im-mo-ral-i-ty
en-trap-men-t	en-trap-ment
en-joy-ably	en-joy-a-bly
su-per-fluity	su-per-flu-i-ty
edgy	edg-y
un-con-quer-able	un-con-quer-a-ble
nightwear	night-wear
ox-alate	ox-a-late
laser	la-ser
babysit-ter	ba-by-sit-ter
hip-pocam-pus	hip-po-cam-pus
nurs-ery	nurs-er-y
s-lack-er	slack-er
con-fi-dan-t	con-fi-dant
apho-ris-m	aph-o-rism
nurs-ery-men	nurs-er-y-men
healthi-ly	health-i-ly
n-erve	nerve
pheas-an-t	pheas-ant
k-er-nel	ker-nel
vari-a-tion	var-i-a-tion
con-tac-t	con-tact
rel-a-tivis-tic	rel-a-tiv-is-tic
s-woop	swoop
chim-p	chimp
ex-ploita-tive	ex-ploit-a-tive
s-lum-ber	slum-ber
tes-ta-men-tary	tes-ta-men-ta-ry
enor-mous-ly	e-nor-mous-ly
or-b	orb
shrub-bery	shrub-ber-y
re-f	ref
s-nuf-fle	snuf-fle
dis-join-t	dis-joint
byprod-uc-t	by-prod-uct
glas-nos-t	glas-nost
s-pore	spore
man-age-men-t	man-age-ment
de-crepi-tude	de-crep-i-tude
ex-clu-sion-ary	ex-clu-sion-ar-y
turnkey	turn-key
com-man-der	com-mand-er
neonate	ne-o-nate
table-ware	ta-ble-ware
birthright	birth-right
koala	ko-a-la
por-ten-t	por-tent
mio-sis	mi-o-sis
sweater	sweat-er
par-alin-guis-tic	par-a-lin-guis-tic
monastery	mon-as-ter-y
flood-ing	flooding
in-ter-ci-ty	in-ter-cit-y
panache	pa-nache
zigza-g	zig-zag
elec-tro-mo-tive	e-lec-tro-mo-tive
en-crust-ed	encrusted
re-assert	re-as-sert
abaft	a-baft
g-nom-ic	gno-mic
pa-troness	pa-tron-ess
qua-drat-ic	quad-rat-ic
phrenol-o-gy	phre-nol-o-gy
s-lug	slug
es-tab-lish-men-t	es-tab-lish-ment
op-por-tunis-tic	op-por-tun-is-tic
sys-temic	sys-tem-ic
op-ti-mis-m	op-ti-mism
kaiser	kai-ser
de-ter-min-is-m	de-ter-min-ism
fool-hardy	fool-har-dy
rant-ing	ranting
prepa-ra-tion	prep-a-ra-tion
s-hears	shears
ure-thra	u-re-thra
pimp-ing	pimping
earplug	ear-plug
sen-ti-men-tal-is-m	sen-ti-men-tal-ism
easy	eas-y
mealie	meal-ie
par-ent-ing	parenting
manor	man-or
poly-the-is-m	pol-y-the-ism
fever-ish	fe-ver-ish
s-tock-tak-ing	stock-tak-ing
sub-servien-t	sub-ser-vi-ent
video	vid-e-o
frozen	fro-zen
emir	e-mir
obei-sance	o-bei-sance
bridal	brid-al
profli-ga-cy	prof-li-ga-cy
pris-m	prism
mora-to-ri-um	mor-a-to-ri-um
je-junum	je-ju-num
di-ver-sion-ary	di-ver-sion-ar-y
flu-en-t	flu-ent
en-docrine	en-do-crine
pome-lo	pom-e-lo
colos-sus	co-los-sus
ragged	rag-ged
copy-ist	cop-y-ist
diminu-tive	di-min-u-tive
k-ilt	kilt
un-quan-tifi-able	un-quan-ti-fi-a-ble
reser-va-tion	res-er-va-tion
woofer	woof-er
epi-graph	ep-i-graph
pyri-dine	pyr-i-dine
groundswell	ground-swell
poi-sonous	poi-son-ous
eerie	ee-rie
daun-t	daunt
chronol-o-gy	chro-nol-o-gy
winnable	win-na-ble
i-n-ad-vis-able	in-ad-vis-a-ble
u-nion-ist	un-ion-ist
gib-ber-ing	gibbering
naval	na-val
sacra-men-t	sac-ra-ment
wa-ter-fal-l	wa-ter-fall
unabridged	un-a-bridged
herbal	herb-al
ef-fer-en-t	ef-fer-ent
damper	damp-er
ass-es	as-ses
ide-al	i-de-al
reim-ple-ment-ed	reimplemented
s-tun-t	stunt
curie	cu-rie
me-nial	me-ni-al
dis-turbing-ly	dis-turb-ing-ly
op-po-nen-t	op-po-nent
limekil-n	lime-kiln
tat-ter-s	tat-ters
or-tho-doxy	or-tho-dox-y
bla-tan-t	bla-tant
un-com-mu-nica-tive	un-com-mu-ni-ca-tive
pubescen-t	pu-bes-cent
po-ten-tial-i-ty	po-ten-ti-al-i-ty
pavil-ion	pa-vil-ion
d-if-fi-den-t	dif-fi-dent
gelatin	gel-a-tin
mar-ketabil-i-ty	mar-ket-a-bil-i-ty
ma-hogany	ma-hog-a-ny
benev-o-lence	be-nev-o-lence
moist-en	mois-ten
can-taloupe	can-ta-loupe
s-tar-let	star-let
ratepay-er	rate-pay-er
porcine	por-cine
sur-f	surf
frilly	frill-y
qua-dru-pli-cate	quad-ru-pli-cate
poundage	pound-age
s-nug-ly	snug-ly
hauli-er	haul-ier
rewind	re-wind
haver-sack	hav-er-sack
s-narl	snarl
eru-di-tion	er-u-di-tion
pid-gin	pidg-in
b-i-fur-ca-tion	bi-fur-ca-tion
lot-tery	lot-ter-y
backgam-mon	back-gam-mon
wardrobe	ward-robe
de-fen-dan-t	de-fend-ant
roundup	round-up
un-con-ge-nial	un-con-gen-ial
cele-b	ce-leb
periscope	per-i-scope
s-coop	scoop
pullover	pull-o-ver
over-rid-ing	o-ver-rid-ing
s-ap-phire	sap-phire
meta-mor-phis-m	met-a-mor-phism
ir-re-place-able	ir-re-place-a-ble
itin-er-ary	i-tin-er-ar-y
cir-cum-ven-t	cir-cum-vent
pe-cu-liar-i-ty	pe-cu-li-ar-i-ty
cruller	crul-ler
tac-t	tact
bre-viary	bre-vi-ar-y
vil-lainy	vil-lain-y
no-madic	no-mad-ic
s-core-board	score-board
foam-ing	foaming
s-woon	swoon
mazy	ma-zy
delir-i-um	de-lir-i-um
marcher	march-er
puffy	puf-fy
pitiable	pit-i-a-ble
neu-ro-science	neu-ro-sci-ence
porter	por-ter
s-cuf-fle	scuf-fle
whiskey	whis-key
un-be-liev-able	un-be-liev-a-ble
bot-tled	bottled
coulom-b	cou-lomb
pedestal	ped-es-tal
medicine	med-i-cine
in-vol-un-tary	in-vol-un-tar-y
s-ab-o-tage	sab-o-tage
erad-i-cat-ed	e-rad-i-cat-ed
moral	mor-al
dim-pled	dimpled
bug-gery	bug-ger-y
pan-the-is-m	pan-the-ism
pri-apic	pri-ap-ic
com-mod-e	com-mode
re-can-t	re-cant
phys-iog-no-my	phys-i-og-no-my
minute-ly	mi-nute-ly
s-ti-fle	sti-fle
ec-to-plas-m	ec-to-plasm
pe-riph-ery	pe-riph-er-y
hairy	hair-y
dauphin	dau-phin
com-men-t	com-ment
duo	du-o
in-fantry	in-fan-try
thumbprint	thumb-print
badtem-pered	bad-tem-pered
con-fir-m	con-firm
out-cal-l	out-call
arachno-pho-bi-a	a-rach-no-pho-bi-a
buf-f	buff
dis-tin-guish-able	dis-tin-guish-a-ble
bene-dic-tion	ben-e-dic-tion
land-fil-l	land-fill
s-tole	stole
as-trin-gen-t	as-trin-gent
homage	hom-age
coro-nary	cor-o-nar-y
mor-dan-t	mor-dant
quizzi-cal	quiz-zi-cal
theoc-ra-cy	the-oc-ra-cy
trol-l	troll
sui-ci-dal	su-i-cid-al
video-phone	vid-e-o-phone
un-ser-vice-able	un-ser-vice-a-ble
damni-fy	dam-ni-fy
dairy	dair-y
antwer-p	antwerp
iri-des-cen-t	ir-i-des-cent
over-sup-ply	o-ver-sup-ply
u-nim-pressed	un-im-pressed
sec-tar-i-an-is-m	sec-tar-i-an-ism
sub-sidiary	sub-sid-i-ar-y
ab-sen-t	ab-sent
rhea	rhe-a
elec-tro-dy-nam-ic-s	e-lec-tro-dy-nam-ics
ide-al-i-ty	i-de-al-i-ty
un-ob-serv-able	un-ob-serv-a-ble
over-dose	o-ver-dose
poignant-ly	poign-ant-ly
tomboy	tom-boy
va-grancy	va-gran-cy
sur-viv-abil-i-ty	sur-viv-a-bil-i-ty
haystack	hay-stack
trawler	trawl-er
supine	su-pine
deathbed	death-bed
anony-mous	a-non-y-mous
catchy	catch-y
ex-ten-der	ex-tend-er
c-itadel	cit-a-del
solid-ly	sol-id-ly
jumper	jump-er
ben-t	bent
tena-cious	te-na-cious
over-anx-ious	o-ver-anx-ious
pere-grine	per-e-grine
sen-hor	se-nhor
vis-coun-t	vis-count
di-atom-ic	di-a-tom-ic
er-ro-neous-ly	er-ro-ne-ous-ly
ax-il-lary	ax-il-lar-y
fit-men-t	fit-ment
crenel-la-tion-s	cren-el-la-tions
dil-l	dill
laager	laa-ger
eter-nal-ly	e-ter-nal-ly
islet	is-let
s-cam	scam
dirty	dirt-y
bigamy	big-a-my
tele-work-ing	teleworking
bases	ba-ses
watch-able	watch-a-ble
u-n-am-bigu-ous	un-am-big-u-ous
crock-ery	crock-er-y
quo-tien-t	quo-tient
or-gan-is-m	or-gan-ism
dy-nasty	dy-nas-ty
an-nu-ity	an-nu-i-ty
short-s	shorts
luke-war-m	luke-warm
curlew	cur-lew
homi-cide	hom-i-cide
s-core	score
rem-nan-t	rem-nant
in-ex-pe-di-en-t	in-ex-pe-di-ent
pol-l	poll
delu-sion-al	de-lu-sion-al
de-for-mi-ty	de-form-i-ty
ir-refutable	ir-ref-u-ta-ble
ex-pen-di-ture	ex-pend-i-ture
funky	funk-y
de-testable	de-test-a-ble
de-cathlon	de-cath-lon
neu-ro-surgery	neu-ro-sur-ger-y
cos-mopoli-tan	cos-mo-pol-i-tan
coro-net	cor-o-net
lig-a-men-t	lig-a-ment
moi-ety	moi-e-ty
res-i-den-t	res-i-dent
trigonom-e-try	trig-o-nom-e-try
in-dus-tri-al-is-m	in-dus-tri-al-ism
hostel-ry	hos-tel-ry
ap-point-men-t	ap-point-ment
lega-to	le-ga-to
bathrobe	bath-robe
broadleaved	broad-leaved
s-lip-ping	slipping
bi-car-bon-ate	bi-car-bo-nate
den-tistry	den-tis-try
s-mile	smile
philoso-pher	phi-los-o-pher
rad-i-cal-is-m	rad-i-cal-ism
type-scrip-t	type-script
over-spend	o-ver-spend
post-mod-ernist	post-mod-ern-ist
vol-can-is-m	vol-can-ism
par-enter-al	par-en-ter-al
l-it-i-gate	lit-i-gate
skil-l	skill
un-ruly	un-ru-ly
hare-bel-l	hare-bell
pig-gery	pig-ger-y
ir-re-vo-ca-bly	ir-rev-o-ca-bly
scrip-t	script
rip-pling	rippling
foot-balling	foot-ball-ing
in-dica-tive	in-dic-a-tive
d-if-fer-en-tial-ly	dif-fer-en-tial-ly
hy-dropho-bi-a	hy-dro-pho-bi-a
en-chant-men-t	en-chant-ment
d-if-fi-cult	dif-fi-cult
wrinkly	wrin-kly
edi-tion	e-di-tion
mishap	mis-hap
vi-o-len-t	vi-o-lent
aro-mather-a-py	a-ro-ma-ther-a-py
op-er-a-tional	op-er-a-tion-al
stringer	string-er
bedrock	bed-rock
ide-al-ist	i-de-al-ist
bal-lis-tic-s	bal-lis-tics
s-trait-ened	strait-ened
mi-crodot	mi-cro-dot
spir-i-tu-al-ly	spir-it-u-al-ly
pass-able	pass-a-ble
leviathan	le-vi-a-than
prophe-cy	proph-e-cy
pot-tery	pot-ter-y
sales-woman	sales-wom-an
oblig-ing	o-blig-ing
shekel	shek-el
cre-ation	cre-a-tion
foothill	foot-hill
bawl-ing	baw-ling
con-temptible	con-tempt-i-ble
pruri-en-t	pru-ri-ent
do-lor-ous	dol-or-ous
tain-t	taint
squalor	squal-or
liar	li-ar
ero-sion	e-ro-sion
souther-ly	south-er-ly
re-cruiter	re-cruit-er
chary	char-y
in-ves-tiga-tive	in-ves-ti-ga-tive
open-ly	o-pen-ly
ouster	oust-er
vivi-sec-tion	viv-i-sec-tion
kelvin	kel-vin
unin-spir-ing	un-in-spir-ing
m-i-lieu	mi-lieu
in-her-i-tance	in-her-it-ance
poly-syl-lab-ic	pol-y-syl-lab-ic
pygmy	pyg-my
sen-tinel	sen-ti-nel
un-in-ter-pretable	un-in-ter-pret-a-ble
curvy	curv-y
hec-tor-ing	hectoring
ir-ra-tional-i-ty	ir-ra-tion-al-i-ty
trea-son-able	trea-son-a-ble
un-wrap-s	un-wraps
gamut	gam-ut
de-posi-tary	de-pos-i-tar-y
som-no-len-t	som-no-lent
s-paced	spaced
s-niff-in-g	sniffing
scenery	scen-er-y
serene-ly	se-rene-ly
blankly	blank-ly
lol-l	loll
poly-chrome	pol-y-chrome
sever-i-ty	se-ver-i-ty
p-neu-mat-ic	pneu-mat-ic
paren-the-sis	pa-ren-the-sis
bowl-s	bowls
s-tud-ied	stud-ied
idly	i-dly
er-ro-neous	er-ro-ne-ous
tele-vi-sion	tel-e-vi-sion
dis-en-fran-chise-men-t	dis-en-fran-chise-ment
k-itchen	kitch-en
per-i-he-lion	per-i-he-li-on
trans-par-en-t	trans-par-ent
re-gret-tably	re-gret-ta-bly
ined-i-ble	in-ed-i-ble
deuteron	deu-ter-on
seraph-ic	se-raph-ic
un-proven	un-prov-en
s-mudgy	smudg-y
dis-cor-dance	dis-cord-ance
renter	rent-er
epis-co-pal	e-pis-co-pal
s-lop-py	slop-py
an-tithe-sis	an-tith-e-sis
pow-dery	pow-der-y
aor-ta	a-or-ta
chan-cellery	chan-cel-ler-y
sovereign-ty	sov-er-eign-ty
geo-physic-s	ge-o-phys-ics
s-cat-o-log-i-cal	scat-o-log-i-cal
s-lope-d	sloped
bleat-ing	bleating
wis-p	wisp
s-cat-ter-ing	scat-ter-ing
mil-lenar-i-an-is-m	mil-le-nar-i-an-ism
pi-quan-t	pi-quant
provider	pro-vid-er
land-fal-l	land-fall
supra-na-tion-al	su-pra-na-tion-al
mousy	mous-y
mis-s	miss
schis-m	schism
graphol-o-gy	graph-ol-o-gy
ath-leti-cis-m	ath-let-i-cism
res-onator	res-o-na-tor
be-wil-dered	bewildered
ha-giog-ra-phy	hag-i-og-ra-phy
kayak	kay-ak
un-pro-nounce-able	un-pro-nounce-a-ble
s-toke	stoke
barony	bar-o-ny
sepul-chral	se-pul-chral
re-pro-cess	re-proc-ess
em-piri-cist	em-pir-i-cist
s-tarlight	star-light
in-san-i-tary	in-san-i-tar-y
elvish	elv-ish
penum-bra	pe-num-bra
ar-ro-gan-t	ar-ro-gant
sealan-t	seal-ant
em-i-nen-t	em-i-nent
laden	lad-en
im-ple-men-t	im-ple-ment
s-tum-ble	stum-ble
b-o-rax	bo-rax
mer-ce-nary	mer-ce-nar-y
im-paction	im-pac-tion
berserk	ber-serk
un-break-able	un-break-a-ble
he-lio-cen-tric	he-li-o-cen-tric
im-pressed	impressed
b-land	bland
mil-l	mill
un-ut-ter-able	un-ut-ter-a-ble
ingress	in-gress
pal-isade	pal-i-sade
stew-ardess	stew-ard-ess
dis-am-biguate	dis-am-big-u-ate
y-on	yon
catal-y-sis	ca-tal-y-sis
ger-m	germ
with-er-s	with-ers
nowa-days	now-a-days
reprise	re-prise
at-mo-spher-ic	at-mos-pher-ic
s-teril-i-ty	ste-ril-i-ty
whomev-er	whom-ev-er
mil-i-tan-t	mil-i-tant
in-fil-l	in-fill
geo-ther-mal	ge-o-ther-mal
ef-fron-tery	ef-fron-ter-y
quater-nion	qua-ter-ni-on
lech-ery	lech-er-y
awak-en-ing	a-wak-en-ing
s-core-card	score-card
iron-i-cal-ly	i-ron-i-cal-ly
cam-panol-o-gy	cam-pa-nol-o-gy
trans-fer-able	trans-fer-a-ble
skele-ton	skel-e-ton
port-fo-lio	port-fo-li-o
coastal	coast-al
s-lant-ing	slant-ing
in-eluctable	in-e-luc-ta-ble
thorny	thorn-y
con-sor-tium	con-sor-ti-um
un-for-giv-able	un-for-giv-a-ble
con-se-quen-t	con-se-quent
in-vert-ed	inverted
mis-judg-men-t	mis-judg-ment
dauber	daub-er
moral-is-tic	mor-al-is-tic
mon-e-taris-m	mon-e-ta-rism
or-na-men-t	or-na-ment
rein-vig-o-rate	re-in-vig-or-ate
an-tic-s	an-tics
frizzy	friz-zy
aloud	a-loud
e-mol-lien-t	e-mol-lient
simil-i-tude	si-mil-i-tude
za-p	zap
s-neak	sneak
provin-cial-is-m	pro-vin-cial-ism
s-tam-mer	stam-mer
mela-tonin	mel-a-to-nin
reshow	re-show
fre-quen-t	fre-quent
s-tub-bly	stub-bly
sinker	sink-er
repet-i-tive	re-pet-i-tive
molec-u-lar	mo-lec-u-lar
un-sa-vory	un-sa-vor-y
tachy-on	tach-y-on
grapeshot	grape-shot
seamy	seam-y
cu-nei-form	cu-ne-i-form
meta-bol-ic	met-a-bol-ic
draugh-t	draught
hemi-sphere	hem-i-sphere
con-tender	con-tend-er
s-targaze	star-gaze
tele-vise	tel-e-vise
co-her-en-t	co-her-ent
motet	mo-tet
sahib	sa-hib
bristling	bris-tling
cys-teine	cys-te-ine
psy-cholin-guis-tic-s	psy-cho-lin-guis-tics
bracelet	brace-let
s-courge	scourge
scintig-ra-phy	scin-tig-ra-phy
sundry	sun-dry
labi-al	la-bi-al
un-steady	un-stead-y
s-port	sport
light-s	lights
babes	babes
dra-mat-ic-s	dra-mat-ics
anger	an-ger
eleventh	e-lev-enth
mini-bar	min-i-bar
re-align	re-a-lign
japon-i-ca	ja-pon-i-ca
s-lop-ing	slop-ing
sibyl	sib-yl
grotesque	gro-tesque
kril-l	krill
catalep-sy	cat-a-lep-sy
k-lax-on	klax-on
rein-ven-t	re-in-vent
leath-ery	leath-er-y
tapi-o-ca	tap-i-o-ca
sooty	soot-y
heron	her-on
in-dex-ing	indexing
monar-chist	mon-ar-chist
s-lip-per	slip-per
con-duct-ed	conducted
n-ev-er	nev-er
un-treat-able	un-treat-a-ble
in-sur-mount-able	in-sur-mount-a-ble
cen-trifu-ga-tion	cen-trif-u-ga-tion
shandy	shan-dy
repack	re-pack
mushy	mush-y
unglazed	un-glazed
e-d-u-ca-tor	ed-u-ca-tor
s-tature	stat-ure
recharge	re-charge
healthy	health-y
mal-leable	mal-le-a-ble
cashier	cash-ier
prebendary	preb-en-dar-y
e-mis-sary	em-is-sar-y
per-mafrost	per-ma-frost
sitar	si-tar
mono-lay-er	mon-o-lay-er
isosce-les	i-sos-ce-les
sexy	sex-y
tan-nery	tan-ner-y
e-s-pousal	es-pous-al
id-io-path-ic	id-i-o-path-ic
bal-l	ball
em-bassy	em-bas-sy
im-pinge-men-t	im-pinge-ment
virtue	vir-tue
atavis-tic	at-a-vis-tic
paraglid-ing	par-a-glid-ing
fuse-lage	fu-se-lage
there-about-s	there-a-bouts
s-cout	scout
cylin-dri-cal	cy-lin-dri-cal
vest-men-t	vest-ment
reap-praisal	re-ap-prais-al
un-pre-dictably	un-pre-dict-a-bly
serol-o-gy	se-rol-o-gy
fun-da-men-tal-is-m	fun-da-men-tal-ism
fi-brob-last	fi-bro-blast
re-sult-ing	resulting
taxi-der-mist	tax-i-der-mist
bi-cep-s	bi-ceps
mis-spel-l	mis-spell
sher-if-f	sher-iff
grid-iron	grid-i-ron
de-mo-li-tion	dem-o-li-tion
ini-ti-ate	in-i-ti-ate
har-m	harm
s-aber	sa-ber
cle-f	clef
e-go-is-m	e-go-ism
over-heat	o-ver-heat
pan-theon	pan-the-on
mam-malian	mam-ma-li-an
c-it-i-zen-ship	cit-i-zen-ship
erec-tile	e-rec-tile
semide-tached	sem-i-de-tached
pro-gressed	progressed
knuck-le-duster	knuck-le-dust-er
aso-cial	a-so-cial
pun-y	pu-ny
boater	boat-er
um-bili-cus	um-bil-i-cus
millpond	mill-pond
s-port-ing-ly	sport-ing-ly
re-tal-ia-to-ry	re-tal-i-a-to-ry
pre-cep-t	pre-cept
defama-tion	def-a-ma-tion
eigen-state	ei-gen-state
paci-fist	pac-i-fist
resid-u-al	re-sid-u-al
fin-ery	fin-er-y
s-tock-ing	stock-ing
co-mestible	co-mes-ti-ble
over-in-flat-ed	o-ver-in-flat-ed
springy	spring-y
s-tate-craft	state-craft
ephor	eph-or
techno-pho-bi-a	tech-no-pho-bia
in-ge-nious-ly	in-gen-ious-ly
stric-t	strict
polyandry	pol-y-an-dry
ha-track	hat-rack
mo-lester	mo-lest-er
sud-s	suds
welly	wel-ly
cham-pi-onship	cham-pi-on-ship
hab-it-able	hab-it-a-ble
lap-idary	lap-i-dar-y
weightlift-ing	weight-lift-ing
metronome	met-ro-nome
del-l	dell
as-bestos	as-bes-tos
vestibu-lar	ves-tib-u-lar
rar-efied	rar-e-fied
em-piri-cis-m	em-pir-i-cism
cyanide	cy-a-nide
arc-ing	arcing
transat-lantic	trans-at-lan-tic
copy-right	cop-y-right
ar-ma-men-t	ar-ma-ment
pro-lactin	pro-lac-tin
nu-tri-en-t	nu-tri-ent
e-s-o-ter-ic	es-o-ter-ic
wun-derkind	wun-der-kind
ap-nea	ap-ne-a
s-tate-less	state-less
clink-ing	clin-king
spinach	spin-ach
kwacha	kwa-cha
sickbed	sick-bed
s-tan-za	stan-za
im-porter	im-port-er
mul-tira-cial	mul-ti-ra-cial
b-less	bless
hypochon-dri-a	hy-po-chon-dri-a
in-ex-orable	in-ex-o-ra-ble
s-ap-per	sap-per
babysit-ting	babysitting
mis-con-duc-t	mis-con-duct
s-cup-per	scup-per
con-sumeris-m	con-sum-er-ism
seis-mome-ter	seis-mom-e-ter
frangi-pani	fran-gi-pan-i
gra-nary	gra-na-ry
u-n-ac-count-able	un-ac-count-a-ble
s-tim-u-lan-t	stim-u-lant
im-mi-nen-t	im-mi-nent
s-calar	sca-lar
but-tressed	buttressed
lieu-tenan-t	lieu-ten-ant
satrap	sa-trap
stingray	sting-ray
blowfly	blow-fly
around	a-round
s-tair-way	stair-way
s-meg-ma	smeg-ma
smoky	smok-y
ex-pe-di-en-t	ex-pe-di-ent
fire-bal-l	fire-ball
over-ground	o-ver-ground
s-tatute	stat-ute
gener-ic	ge-ner-ic
detri-men-t	det-ri-ment
dais	da-is
im-par-tial-i-ty	im-par-ti-al-i-ty
gra-di-en-t	gra-di-ent
up-heaval	up-heav-al
erad-i-cate	e-rad-i-cate
pa-gan-is-m	pa-gan-ism
s-mall-hold-ing	small-hold-ing
pedes-tri-an	pe-des-tri-an
quadru-ple	quad-ru-ple
bank-able	bank-a-ble
con-va-les-cen-t	con-va-les-cent
ukulele	u-ku-le-le
pointy	point-y
serendip-i-ty	ser-en-dip-i-ty
s-not-ty	snot-ty
pho-to-copy	pho-to-cop-y
s-nowflake	snow-flake
plea-sur-able	pleas-ur-a-ble
covenan-t	cov-e-nant
s-take-hold-er	stake-hold-er
lethar-gic	le-thar-gic
about	a-bout
dis-obey	dis-o-bey
en-tomb-men-t	en-tomb-ment
com-mis-sioned	commissioned
s-pate	spate
s-tar-lit	star-lit
cuirass	cui-rass
con-fronta-tion-al	con-fron-ta-tion-al
morsel	mor-sel
po-ten-t	po-tent
in-cip-i-en-t	in-cip-i-ent
in-tegri-ty	in-teg-ri-ty
trans-mo-gri-fy	trans-mog-ri-fy
dis-trac-t	dis-tract
itin-er-an-t	i-tin-er-ant
ri-boflavin	ri-bo-fla-vin
ef-fec-t	ef-fect
s-ta-tis-ti-cal	sta-tis-ti-cal
tri-bune	trib-une
bulky	bulk-y
i-n-ap-pli-ca-ble	in-ap-pli-ca-ble
en-treat-ing	entreating
so-lace	sol-ace
dura-bil-i-ty	du-ra-bil-i-ty
un-vary-ing	un-var-y-ing
lugubri-ous	lu-gu-bri-ous
s-tat-ue	stat-ue
over-bear-ing	o-ver-bear-ing
copy-cat	cop-y-cat
brainy	brain-y
diesel	die-sel
baby-ish	ba-by-ish
body	bod-y
trans-for-m	trans-form
c-on-cil-i-ate	con-cil-i-ate
min-uet	min-u-et
s-tain-less	stain-less
shep-herdess	shep-herd-ess
in-sis-ten-t	in-sist-ent
stilet-to	sti-let-to
con-so-nan-t	con-so-nant
bi-car-b	bi-carb
s-lack-en	slack-en
lu-mi-nes-cen-t	lu-mi-nes-cent
cat-a-com-b	cat-a-comb
her-aldry	her-ald-ry
ethos	e-thos
im-pov-er-ish-men-t	im-pov-er-ish-ment
ex-pect-ed	expected
tabloid	tab-loid
foible	foi-ble
an-thro-pogenic	an-thro-po-gen-ic
tun-able	tun-a-ble
syco-phan-tic	syc-o-phan-tic
u-nattain-able	un-at-tain-a-ble
talon	tal-on
promp-t	prompt
weari-ness	wea-ri-ness
stagfla-tion	stag-fla-tion
ni-hilis-tic	ni-hil-is-tic
in-ter-sec-t	in-ter-sect
wind-sur-f	wind-surf
elec-tro-mag-net-ic	e-lec-tro-mag-net-ic
grouper	group-er
piebald	pie-bald
in-cite-men-t	in-cite-ment
cul-l	cull
feath-erlight	feath-er-light
archer	arch-er
junker	jun-ker
t-wang	twang
flutist	flut-ist
lam-plit	lamp-lit
s-tan-dard	stand-ard
masseur	mas-seur
cliquey	cli-quey
fuller	full-er
de-jec-t	de-ject
mea-sured	meas-ured
i-n-alien-able	in-al-ien-a-ble
armistice	ar-mi-stice
ve-loci-pede	ve-loc-i-pede
megas-tar	meg-a-star
penul-ti-mate	pe-nul-ti-mate
pesti-len-t	pes-ti-lent
blus-ter-ing	blustering
satel-lite	sat-el-lite
per-e-stroi-ka	pe-re-stroi-ka
spooky	spook-y
ridicu-lous-ly	ri-dic-u-lous-ly
in-deco-rous	in-dec-o-rous
pul-l	pull
leisured	lei-sured
monog-a-mous	mo-nog-a-mous
gaslight	gas-light
s-mut-ty	smut-ty
cou-pled	coupled
regi-cide	reg-i-cide
re-vival-is-m	re-viv-al-ism
epis-te-mo-log-i-cal	e-pis-te-mo-log-i-cal
isother-mal	i-so-ther-mal
leo-tard	le-o-tard
ter-rapin	ter-ra-pin
syn-di-cal-is-m	syn-di-cal-ism
ex-per-i-men-t	ex-per-i-ment
in-cum-ben-t	in-cum-bent
fel-l	fell
se-nior	sen-ior
un-fath-omable	un-fath-om-a-ble
s-tore-house	store-house
moth-er-stobe	mo-ther-stobe
tol-l	toll
mist-ime	mis-time
groupie	group-ie
in-com-pe-ten-t	in-com-pe-tent
undis-put-ed	un-dis-put-ed
tenet	ten-et
un-easi-ness	un-eas-i-ness
cen-tau-r	cen-taur
u-n-avail-able	un-a-vail-a-ble
catheter	cath-e-ter
pe-rusal	pe-rus-al
assig-na-tion	as-sig-na-tion
obe-di-ence	o-be-di-ence
p-tarmi-gan	ptar-mi-gan
bil-iary	bil-i-ar-y
plumage	plum-age
su-perbly	su-perb-ly
unlov-ing	un-lov-ing
re-porter	re-port-er
ravi-o-li	ra-vi-o-li
salary	sal-a-ry
s-teep-en	steep-en
dumpling	dump-ling
ra-dio-graph-ic	ra-di-o-graph-ic
bur-sary	bur-sa-ry
par-lia-men-t	par-lia-ment
over-ture	o-ver-ture
iso-lat-ing	i-so-lat-ing
verdi-gris	ver-di-gris
over-sight	o-ver-sight
c-on-cil-ia-tor	con-cil-i-a-tor
predilec-tion	pre-di-lec-tion
pineal	pin-e-al
s-tock-ist	stock-ist
in-sa-tiable	in-sa-tia-ble
power-boat	pow-er-boat
gan-g-ly	gan-gly
man-i-cured	ma-ni-cured
purga-tive	pur-ga-tive
con-gealed	congealed
s-mog	smog
de-ca-pod	dec-a-pod
iso-bar	i-so-bar
mariner	mar-i-ner
mer-chan-dis-e	mer-chan-dise
grater	grat-er
con-struc-tivist	con-struc-tiv-ist
he-liotrope	he-li-o-trope
chesty	chest-y
bearskin	bear-skin
ar-senic	ar-se-nic
kook-abur-ra	kook-a-bur-ra
epi-dem-ic	ep-i-dem-ic
reaf-fir-ma-tion	re-af-fir-ma-tion
footwear	foot-wear
n-u-mis-mat-ic-s	nu-mis-mat-ics
legal-ly	le-gal-ly
ede-ma	e-de-ma
roller	roll-er
pre-ven-t	pre-vent
s-cud	scud
hypochon-dri-ac	hy-po-chon-dri-ac
run-away	run-a-way
su-perla-tive	su-per-la-tive
tran-scrip-t	tran-script
piety	pi-e-ty
s-plashy	splash-y
turfy	turf-y
ex-porter	ex-port-er
query	que-ry
deeply	deep-ly
dugout	dug-out
blun-der-ing	blundering
s-tair-case	stair-case
shipown-er	ship-own-er
sil-vered	silvered
in-fras-truc-tural	in-fra-struc-tur-al
delu-sion	de-lu-sion
gillie	gil-lie
ne-ma-tode	nem-a-tode
april	a-pril
tusker	tusk-er
s-pear-head	spear-head
enig-mat-ic	en-ig-mat-ic
cob-we-b	cob-web
n-u-mis-mat-ic	nu-mis-mat-ic
flick-er-ing	flickering
teach-able	teach-a-ble
over-hang	o-ver-hang
over-crowd	o-ver-crowd
s-tu-dio	stu-di-o
mimicry	mim-ic-ry
louis	lou-is
morass	mo-rass
megabyte	meg-a-byte
tar-if-f	tar-iff
c-on-cil-i-a-tion	con-cil-i-a-tion
blus-tery	blus-ter-y
in-ward-s	in-wards
heifer	heif-er
s-tiff-ness	stiff-ness
jester	jest-er
in-ten-t	in-tent
in-stal-l	in-stall
biop-sy	bi-op-sy
deca-den-t	dec-a-dent
sug-ary	sug-ar-y
waster	wast-er
pan-golin	pan-go-lin
limpid	lim-pid
restive	res-tive
com-pli-men-t	com-pli-ment
spicy	spic-y
ril-l	rill
nestling	nest-ling
pol-lu-tan-t	pol-lu-tant
in-suf-fer-able	in-suf-fer-a-ble
crotch-ety	crotch-et-y
en-tropy	en-tro-py
ide-al-is-tic	i-de-al-is-tic
forester	for-est-er
gym-nas-tic-s	gym-nas-tics
arith-metic	a-rith-me-tic
quil-l	quill
en-dow-men-t	en-dow-ment
y-acht	yacht
epi-taph	ep-i-taph
s-can-sion	scan-sion
puni-tive	pu-ni-tive
laun-dered	laundered
necro-mancer	nec-ro-man-cer
nan-otech-nol-o-gy	nan-o-tech-nol-o-gy
sur-vival	sur-viv-al
oxy-gen	ox-y-gen
pleat-ed	pleated
s-ten-tor	sten-tor
s-mart-ly	smart-ly
be-liev-abil-i-ty	be-liev-a-bil-i-ty
un-con-trol-lable	un-con-trol-la-ble
salien-t	sa-li-ent
dis-parate	dis-pa-rate
s-lipped	slipped
u-nion-is-m	un-ion-ism
over-whelm-ing	o-ver-whelm-ing
base-men-t	base-ment
diehard	die-hard
impi-ety	im-pi-e-ty
crick-eter	crick-et-er
un-ex-plain-able	un-ex-plain-a-ble
mi-crowave	mi-cro-wave
skua	sku-a
dal-liance	dal-li-ance
k-nave	knave
fever	fe-ver
pushy	push-y
in-ex-tin-guish-able	in-ex-tin-guish-a-ble
temptress	tempt-ress
goofy	goof-y
sen-sa-tion-al-is-m	sen-sa-tion-al-ism
car-dio-vas-cu-lar	car-di-o-vas-cu-lar
s-calp	scalp
i-n-ap-pro-pri-ate-ly	in-ap-pro-pri-ate-ly
ide-al-is-m	i-de-al-ism
panz-er	pan-zer
u-nion	un-ion
paraf-fin	par-af-fin
re-liant	re-li-ant
eu-kary-ote	eu-kar-y-ote
ex-per-i-menter	ex-per-i-ment-er
record-ed	re-cor-ded
undis-tribut-ed	un-dis-trib-ut-ed
im-pru-den-t	im-pru-dent
a-tol-l	at-oll
re-in-state-men-t	re-in-state-ment
rat-tlesnake	rat-tle-snake
pu-tres-cen-t	pu-tres-cent
falset-to	fal-set-to
cuprous	cu-prous
en-cam-p	en-camp
ple-beian	ple-be-ian
in-spec-torate	in-spec-tor-ate
nau-tilus	nau-ti-lus
ma-lig-nan-t	ma-lig-nant
greedy	greed-y
grenade	gre-nade
u-nim-proved	un-im-proved
rescale	re-scale
s-park	spark
ret-i-cen-t	ret-i-cent
peren-ni-al-ly	per-en-ni-al-ly
pur-po-sive	pur-pos-ive
spir-i-tu-al-is-m	spir-it-u-al-ism
in-fla-tion-ary	in-fla-tion-ar-y
s-neaky	sneak-y
s-tar-dom	star-dom
un-der-achieve-men-t	un-der-a-chieve-ment
dor-man-t	dor-mant
s-lat	slat
de-spi-ca-ble	des-pi-ca-ble
cau-tion-ary	cau-tion-ar-y
igua-na	i-gua-na
co-ex-is-ten-t	co-ex-ist-ent
taster	tast-er
impi	im-pi
howler	howl-er
un-equiv-o-cal-ly	un-e-quiv-o-cal-ly
s-tate-ly	state-ly
lifeblood	life-blood
s-cant-i-ly	scant-i-ly
as-sertive	as-ser-tive
hillock	hill-ock
s-coundrel	scoun-drel
in-sou-ciant	in-sou-ci-ant
ap-pre-cia-ble	ap-pre-ci-a-ble
au-thoress	au-thor-ess
painter	paint-er
dat-able	dat-a-ble
flinty	flint-y
cov-etous	cov-et-ous
episod-ic	ep-i-sod-ic
s-nooze	snooze
u-til-i-tar-i-an-is-m	u-til-i-tar-i-an-ism
d-if-fer	dif-fer
s-ingsong	sing-song
s-tone-ma-son	stone-ma-son
h-es-i-tan-t	hes-i-tant
innkeep-er	inn-keep-er
s-cale	scale
s-tran-gu-la-tion	stran-gu-la-tion
ir-re-mov-able	ir-re-mov-a-ble
manger	man-ger
over-stretch	o-ver-stretch
bony	bon-y
par-tial-i-ty	par-ti-al-i-ty
p-saltery	psal-ter-y
de-liv-ery	de-liv-er-y
id-iom	id-i-om
cata-ma-ran	cat-a-ma-ran
aware	a-ware
body-work	bod-y-work
quit-s	quits
dizzy	diz-zy
con-dem-n	con-demn
tour-na-men-t	tour-na-ment
unre-deemed	un-re-deemed
dis-rup-t	dis-rupt
so-cialite	so-cial-ite
calorif-ic	cal-o-rif-ic
pesti-lence	pes-ti-lence
we-b	web
e-d-u-cat-ed	ed-u-cat-ed
ex-ploita-tion	ex-ploi-ta-tion
rar-efac-tion	rar-e-fac-tion
cam-p	camp
read-mit	re-ad-mit
pagean-t	pag-eant
tantrum	tan-trum
mys-tery	mys-ter-y
grandiose	gran-di-ose
bumpy	bump-y
s-pas-m	spasm
dusty	dust-y
stinger	sting-er
re-us-able	re-us-a-ble
re-former	re-form-er
per-man-ganate	per-man-ga-nate
stag-nan-t	stag-nant
un-even	un-e-ven
com-mit-men-t	com-mit-ment
pronom-i-nal	pro-nom-i-nal
valid-ly	val-id-ly
mufti	muf-ti
lit-er-ary	lit-er-ar-y
grumpy	grump-y
s-nob-bery	snob-ber-y
spillage	spill-age
es-calade	es-ca-lade
s-port-ing	sport-ing
drach-m	drachm
moc-casin	moc-ca-sin
be-twix-t	be-twixt
velo-drome	ve-lo-drome
pasty	past-y
meio-sis	mei-o-sis
madras	mad-ras
leapfrog	leap-frog
d-inghy	din-ghy
in-fini-tive	in-fin-i-tive
ex-pan-sion-is-m	ex-pan-sion-ism
de-ter-mi-nan-t	de-ter-mi-nant
fir-ma-men-t	fir-ma-ment
silent-ly	si-lent-ly
l-it-i-gan-t	lit-i-gant
emit	e-mit
el-l	ell
the-o-reti-cian	the-o-re-ti-cian
s-mart-ing	smart-ing
parachutist	par-a-chut-ist
s-tiffly	stiff-ly
tal-en-t	tal-ent
satire	sat-ire
s-targaz-er	star-gaz-er
en-doge-nous	en-dog-e-nous
bar-barous	bar-ba-rous
cre-ativ-i-ty	cre-a-tiv-i-ty
ready	read-y
s-phyg-mo-manome-ter	sphyg-mo-ma-nom-e-ter
bean-ery	bean-er-y
s-ports-wear	sports-wear
hal-l	hall
chro-matog-ra-phy	chro-ma-tog-ra-phy
clair-voy-an-t	clair-voy-ant
gad-get	gadg-et
u-niden-ti-fi-able	un-i-den-ti-fi-a-ble
ap-petite	ap-pe-tite
gen-t	gent
s-lug-gard	slug-gard
fibu-la	fib-u-la
u-nan-nounced	un-an-nounced
herbal-ist	herb-al-ist
sauer-kraut	sau-er-kraut
d-elec-ta-tion	de-lec-ta-tion
ox-i-dan-t	ox-i-dant
in-fect-ed	in-fec-ted
laud-able	laud-a-ble
re-len-t	re-lent
fever-ish-ly	fe-ver-ish-ly
cuboid	cu-boid
s-naky	snak-y
s-tar-va-tion	star-va-tion
im-per-son-ation	im-per-son-a-tion
de-caf-feinate	de-caf-fein-ate
tele-graph	tel-e-graph
nephew	neph-ew
servi-ette	ser-vi-ette
de-vel-op-men-t	de-vel-op-ment
clemen-cy	clem-en-cy
cen-tral-is-m	cen-tral-ism
gov-er-nance	gov-ern-ance
lacteal	lac-te-al
classy	class-y
rainy	rain-y
projec-t	proj-ect
u-nattrac-tive	un-at-trac-tive
b-lessed	bless-ed
lu-mi-nary	lu-mi-nar-y
whiten	whit-en
v-enue	ven-ue
u-nadul-ter-at-ed	un-a-dul-ter-at-ed
julep	ju-lep
monomer	mon-o-mer
in-ca-pable	in-ca-pa-ble
flota-tion	flo-ta-tion
to-tal-i-tar-i-an-is-m	to-tal-i-tar-i-an-ism
s-car-i-fy	scar-i-fy
re-luc-tan-t	re-luc-tant
prod-uc-t	prod-uct
daf-fodil	daf-fo-dil
drea-r	drear
frumpy	frump-y
whaler	whal-er
s-nide	snide
palatal	pal-a-tal
bathos	ba-thos
s-teeple	stee-ple
un-abat-ed	un-a-bat-ed
si-lencer	si-lenc-er
con-stituen-cy	con-stit-u-en-cy
cat-e-chis-m	cat-e-chism
pig-men-t	pig-ment
tav-er-na	ta-ver-na
reify	re-i-fy
drudgery	drudg-er-y
mag-nil-o-quen-t	mag-nil-o-quent
dis-il-lu-sion-men-t	dis-il-lu-sion-ment
bias	bi-as
i-n-or-gan-ic	in-or-gan-ic
epis-temic	ep-i-ste-mic
bes-tial-i-ty	bes-ti-al-i-ty
di-aphrag-m	di-a-phragm
baroque	ba-roque
reload	re-load
fraud-u-len-t	fraud-u-lent
chaf-f	chaff
kedgeree	ked-ger-ee
ex-pe-di-tionary	ex-pe-di-tion-ar-y
com-ple-men-tary	com-ple-men-ta-ry
s-niper	snip-er
ear-l	earl
saver	sav-er
chro-mo-so-ma-l	chro-mo-so-mal
over-lay	o-ver-lay
un-miss-able	un-miss-a-ble
tri-tium	trit-i-um
ge-nealog-i-cal	ge-ne-a-log-i-cal
dis-pen-sary	dis-pen-sa-ry
seafood	sea-food
n-ode	node
me-dieval	me-di-e-val
chamomile	cham-o-mile
na-tion-al-is-m	na-tion-al-ism
shiv-er-ing	shivering
techno-pho-bic	tech-no-pho-bic
prove-nance	prov-e-nance
my-ocar-dial	my-o-car-di-al
mys-ti-cis-m	mys-ti-cism
unini-ti-at-ed	un-in-i-ti-at-ed
un-der-stand-ably	un-der-stand-a-bly
pen-nan-t	pen-nant
s-po-radic	spo-rad-ic
ves-ti-gial	ves-tig-i-al
hatch-ery	hatch-er-y
sadis-tic	sa-dis-tic
im-muno-sup-pres-sion	im-mu-no-sup-pres-sion
doc-tor-ing	doctoring
para-dox-i-cal-ly	par-a-dox-i-cal-ly
prof-itably	prof-it-a-bly
cygnet	cyg-net
berry	ber-ry
discog-ra-phy	dis-cog-ra-phy
cre-ation-is-m	cre-a-tion-ism
anoin-t	a-noint
para-graph	par-a-graph
head-quar-ter-s	head-quar-ters
tribu-la-tion	trib-u-la-tion
apolo-gia	ap-o-lo-gi-a
top-i-ary	to-pi-ar-y
u-nimag-in-able	un-im-ag-i-na-ble
archetype	ar-che-type
eye-bal-l	eye-ball
ri-otous	ri-ot-ous
physic	phys-ic
epi-demi-ol-o-gist	ep-i-de-mi-ol-o-gist
omen	o-men
pathol-o-gy	pa-thol-o-gy
s-moother	smooth-er
mono-graph-ic	mon-o-graph-ic
recital	re-cit-al
modal-i-ty	mo-dal-i-ty
punchy	punch-y
e-dic-t	e-dict
sun-tanned	suntanned
s-tam-pede	stam-pede
ra-dio	ra-di-o
re-hearsal	re-hears-al
over-con-fi-den-t	o-ver-con-fi-dent
in-di-gestible	in-di-gest-i-ble
lodger	lodg-er
mis-treat-men-t	mis-treat-ment
cyn-i-cis-m	cyn-i-cism
iron	i-ron
mon-o-clon-al	mon-o-clo-nal
cochlea	coch-le-a
re-cal-ci-tran-t	re-cal-ci-trant
ir-re-versibly	ir-re-vers-i-bly
cagey	cag-ey
crawler	crawl-er
sausage	sau-sage
cin-e-matog-ra-pher	cin-e-ma-tog-ra-pher
in-dict-men-t	in-dict-ment
u-n-ac-knowl-edged	un-ac-knowl-edged
gaun-t	gaunt
tremu-lous	trem-u-lous
b-land-ness	bland-ness
mogul	mo-gul
de-co	dec-o
rose-mary	rose-mar-y
prairie	prai-rie
boomer	boom-er
foundry	found-ry
out-ward-s	out-wards
an-te-dilu-vian	an-te-di-lu-vi-an
tri-umphal-is-m	tri-um-phal-ism
in-sup-port-able	in-sup-port-a-ble
sim-u-lacrum	sim-u-la-crum
s-plash	splash
out-pa-tien-t	out-pa-tient
rec-ti-lin-ear	rec-ti-lin-e-ar
w-hole-heart-ed	whole-heart-ed
para-sol	par-a-sol
con-sular	con-su-lar
im-pris-on-men-t	im-pris-on-ment
take-away	take-a-way
Words with errors: 2172
Words with incorrect number of syllables: 1967
Total evluated: 6500
Perfect accuracy: 0.67
Number of syllables accuracy: 0.70
Average Levenshtein Distance(across incorrect words): 1.21
