Attempt	Real
gaiter	gait-er
glossy	gloss-y
con-cep-t	con-cept
ac-cen-t	ac-cent
lapel	la-pel
s-melly	smell-y
penin-su-la	pen-in-su-la
chaos	cha-os
arch-dio-cese	arch-di-o-cese
im-prison	im-pris-on
raga-muf-fin	rag-a-muf-fin
sitar	si-tar
deci-bel	dec-i-bel
ath-leti-cis-m	ath-let-i-cism
s-lum-ber	slum-ber
hu-morist	hu-mor-ist
pes-simist	pes-si-mist
par-lia-men-t	par-lia-ment
crazi-ness	cra-zi-ness
hauli-er	haul-ier
re-new-able	re-new-a-ble
eat-able	eat-a-ble
tem-po-rar-ily	tem-po-rar-i-ly
fi-brob-last	fi-bro-blast
schoolmistress	school-mis-tress
leg-isla-tive	leg-is-la-tive
i-den-ti-fi-able	i-den-ti-fi-a-ble
con-tra-dic-t	con-tra-dict
dis-abled	dis-a-bled
dis-senter	dis-sent-er
s-toked	stoked
g-narl	gnarl
pris-m	prism
in-ter-po-lat-able	in-ter-po-la-ta-ble
over-lie	o-ver-lie
con-se-quen-t	con-se-quent
de-b	deb
crater	cra-ter
chrysalis	chrys-a-lis
s-pan-gled	spangled
her-bi-cide	herb-i-cide
an-thro-po-mor-phis-m	an-thro-po-mor-phism
crosstalk	cross-talk
an-nounce-men-t	an-nounce-ment
tasty	tast-y
coolan-t	cool-ant
pil-l	pill
posse	pos-se
pros-e	prose
touris-tic	tour-is-tic
ide-al-is-m	i-de-al-ism
damper	damp-er
manes	ma-nes
g-lut-tonous	glut-ton-ous
peachy	peach-y
wreck-ing	wrecking
gra-tu-itous-ly	gra-tu-i-tous-ly
chrono-graph	chron-o-graph
dis-heart-ened	dis-hear-tened
im-per-me-able	im-per-me-a-ble
wily	wil-y
desert-s	de-serts
pen-tathlon	pen-tath-lon
gazelle	ga-zelle
chi-ropody	chi-rop-o-dy
par-lia-men-tary	par-lia-men-ta-ry
wolfish	wolf-ish
markup	mark-up
s-word	sword
grumpy	grump-y
ar-rival	ar-ri-val
tick-et-ed	ticketed
u-n-adapt-ed	un-a-dapt-ed
poly-cyclic	pol-y-cy-clic
over-ride	o-ver-ride
any-more	an-y-more
ex-cep-tion-able	ex-cep-tion-a-ble
seg-men-t	seg-ment
transpon-der	tran-spon-der
pre-pon-der-an-t	pre-pon-der-ant
chival-ry	chiv-al-ry
rover	rov-er
dark-ened	dar-kened
hyp-ocrite	hyp-o-crite
re-design	re-de-sign
s-jam-bok	sjam-bok
em-body	em-bod-y
potable	po-ta-ble
cin-e-matog-ra-pher	cin-e-ma-tog-ra-pher
s-car-i-ly	scar-i-ly
sedan	se-dan
mis-cre-an-t	mis-cre-ant
notepad	note-pad
nico-tine	nic-o-tine
de-served-ly	de-serv-ed-ly
e-mer-gen-t	e-mer-gent
ready	read-y
in-ter-jec-t	in-ter-ject
in-con-ve-nience	in-con-ven-ience
limpet	lim-pet
geopo-lit-i-cal	ge-o-po-lit-i-cal
oop-s	oops
for-m	form
body-work	bod-y-work
coleslaw	cole-slaw
posy	po-sy
l-itotes	li-to-tes
me-dieval	me-di-e-val
an-tithe-sis	an-tith-e-sis
unin-spir-ing	un-in-spir-ing
in-fin-ite-ly	in-fi-nite-ly
un-chal-lenge-able	un-chal-lenge-a-ble
oblo-quy	ob-lo-quy
i-ambus	i-am-bus
r-e-fit	re-fit
s-lut	slut
s-e-lec-tor	se-lec-tor
durable	du-ra-ble
in-ces-san-t	in-ces-sant
ex-trem-is-m	ex-trem-ism
flan-nelette	flan-nel-ette
in-cisor	in-ci-sor
cen-trifu-ga-tion	cen-trif-u-ga-tion
de-po-nen-t	de-po-nent
quizzi-cal	quiz-zi-cal
apol-o-gize	a-pol-o-gize
enu-mer-a-tor	e-nu-mer-a-tor
cupo-la	cu-po-la
itchy	itch-y
menar-che	men-ar-che
hearthrug	hearth-rug
groom-ing	grooming
wa-ter-work-s	wa-ter-works
s-tub-born	stub-born
crumbly	crum-bly
anorex-i-c	an-o-rex-ic
z-inc	zinc
dean-ery	dean-er-y
im-mov-able	im-mov-a-ble
s-teed	steed
puz-zle-men-t	puz-zle-ment
pul-l	pull
be-wil-dered	bewildered
athe-ist	a-the-ist
hashish	hash-ish
luke-war-m	luke-warm
suf-frag-ist	suf-fra-gist
s-mall-hold-ing	small-hold-ing
hermeneu-tic	her-me-neu-tic
e-h	eh
con-jec-tural	con-jec-tur-al
de-men-t	de-ment
mistle-toe	mis-tle-toe
itin-er-an-t	i-tin-er-ant
dis-en-fran-chise-men-t	dis-en-fran-chise-ment
im-pinge-men-t	im-pinge-ment
re-versible	re-vers-i-ble
re-plen-ish-men-t	re-plen-ish-ment
s-teer-ing	steer-ing
par-tial-i-ty	par-ti-al-i-ty
cho-ris-ter	chor-is-ter
messy	mess-y
ar-cana	ar-ca-na
fungi-cide	fun-gi-cide
n-in-com-poop	nin-com-poop
pedi-gree	ped-i-gree
golfer	golf-er
valiant-ly	val-iant-ly
graphite	graph-ite
un-de-vel-ope-d	un-de-vel-oped
awake	a-wake
u-ni-lat-er-al-is-m	u-ni-lat-er-al-ism
eu-kary-ote	eu-kar-y-ote
mini-cab	min-i-cab
naked-ness	na-ked-ness
p-res-ence	pres-ence
swishy	swish-y
body	bod-y
nir-vana	nir-va-na
ori-en-ta-tion	o-ri-en-ta-tion
mar-ketabil-i-ty	mar-ket-a-bil-i-ty
catarac-t	cat-a-ract
bire-frin-gen-t	bi-re-frin-gent
crim-p	crimp
up-silon	up-si-lon
s-late	slate
fermion	fer-mi-on
par-enter-al	par-en-ter-al
preg-nan-t	preg-nant
beg-gary	beg-gar-y
tilde	til-de
vary	var-y
elec-t	e-lect
funky	funk-y
karate	ka-ra-te
democ-ra-cy	de-moc-ra-cy
trans-mo-gri-fy	trans-mog-ri-fy
lul-la-by	lull-a-by
in-tu-itive	in-tu-i-tive
minia-ture	min-i-a-ture
camisole	cam-i-sole
es-capade	es-ca-pade
pati-na-tion	pat-i-na-tion
ex-oge-nous	ex-og-e-nous
im-pru-den-t	im-pru-dent
diathermy	di-a-ther-my
fuz-z	fuzz
syn-ony-mous	syn-on-y-mous
s-ca-lene	sca-lene
ev-i-den-t	ev-i-dent
pastis	pas-tis
necro-man-tic	nec-ro-man-tic
quiver	quiv-er
sun-burned	sunburned
eeri-ly	ee-ri-ly
s-tat-ed	stat-ed
wave-for-m	wave-form
geni-i	ge-ni-i
s-ti-fling	sti-fling
shel-l	shell
hy-acinth	hy-a-cinth
s-tock-bro-ker	stock-brok-er
di-vider	di-vid-er
over-due	o-ver-due
in-tegri-ty	in-teg-ri-ty
er-ro-neous-ly	er-ro-ne-ous-ly
marcher	march-er
dread-lock-s	dread-locks
killer	kil-ler
silk-wor-m	silk-worm
k-er-chief	ker-chief
over-state-men-t	o-ver-state-ment
bi-cep-s	bi-ceps
diplo-mat-ic	dip-lo-mat-ic
disin-gen-u-ous	dis-in-gen-u-ous
in-con-stan-t	in-con-stant
lar-ynx-es	la-rynx-es
ap-praisal	ap-prais-al
u-nas-signed	un-as-signed
in-tifa-da	in-ti-fa-da
video-phone	vid-e-o-phone
anoma-lous	a-nom-a-lous
haiku	hai-ku
d-if-fract	dif-fract
detox-i-fi-ca-tion	de-tox-i-fi-ca-tion
ir-ra-tional-ly	ir-ra-tion-al-ly
prefa-to-ry	pref-a-to-ry
s-paghet-ti	spa-ghet-ti
quotable	quot-a-ble
tremor	trem-or
tute-lage	tu-te-lage
polyandry	pol-y-an-dry
grouchy	grouch-y
duck-bil-l	duck-bill
tan-nery	tan-ner-y
mar-malade	mar-ma-lade
g-nash	gnash
rosin	ros-in
s-ta-tion-er	sta-tion-er
usu-al	u-su-al
b-land	bland
merid-i-an	me-rid-i-an
flab-ber-gast-ed	flabbergasted
sana-to-ri-um	san-a-to-ri-um
daisy	dai-sy
japan	ja-pan
po-litesse	pol-i-tesse
coun-ter-rev-o-lu-tion-ary	coun-ter-rev-o-lu-tion-ar-y
nugget	nug-get
in-tel-li-gen-t	in-tel-li-gent
whaler	whal-er
voca-tive	voc-a-tive
s-tu-dentship	stu-dent-ship
mo-lasses	mo-las-ses
aquifer	aq-ui-fer
land-fal-l	land-fall
claret	clar-et
b-lis-s	bliss
in-dis-tinc-t	in-dis-tinct
torus	to-rus
s-po-rad-i-cal-ly	spo-rad-i-cal-ly
baronet	bar-on-et
grater	grat-er
un-re-cov-er-able	un-re-cov-er-a-ble
positron	pos-i-tron
k-i-na	ki-na
pave-men-t	pave-ment
bel-liger-en-t	bel-lig-er-ent
mul-ti-for-m	mul-ti-form
toma-to	to-ma-to
millinery	mil-li-ner-y
re-stroom	rest-room
trib-al-is-m	trib-al-ism
dis-sec-t	dis-sect
bud-getary	budg-et-ar-y
haver-sack	hav-er-sack
b-lis-ter-ing	blis-ter-ing
grandee	gran-dee
ad-d	add
un-cre-ative	un-cre-a-tive
an-nul-men-t	an-nul-ment
re-ceiver-ship	re-ceiv-er-ship
laud-s	lauds
em-piri-cist	em-pir-i-cist
ge-ome-ter	ge-om-e-ter
en-docrine	en-do-crine
quad-ran-t	quad-rant
rapid	rap-id
abuse	a-buse
per-me-able	per-me-a-ble
com-mod-e	com-mode
testy	tes-ty
s-mat-ter-ing	smat-ter-ing
postal	post-al
ob-struc-t	ob-struct
s-toke	stoke
raven-ing	rav-en-ing
en-force-able	en-force-a-ble
in-spec-t	in-spect
ante	an-te
di-ary	di-a-ry
touristy	tour-ist-y
s-tim-u-la-tor	stim-u-la-tor
aven-s	av-ens
monastery	mon-as-ter-y
s-tur-dy	stur-dy
n-od-ule	nod-ule
mis-in-for-m	mis-in-form
over-throw	o-ver-throw
rani	ra-ni
respite	res-pite
parochial-is-m	pa-ro-chi-al-ism
s-pleen	spleen
va-porous	va-por-ous
ex-pan-sion-is-m	ex-pan-sion-ism
n-odal	nod-al
mi-croscopy	mi-cros-co-py
s-nob-bery	snob-ber-y
s-esame	ses-a-me
breast-feed-ing	breastfeeding
igloo	ig-loo
o-r-ange	or-ange
un-der-e-d-u-cat-ed	un-der-ed-u-cat-ed
over-writ-ing	overwriting
cur-tilage	cur-ti-lage
cob-we-b	cob-web
washy	wash-y
s-pat-ter	spat-ter
b-i-fur-ca-tion	bi-fur-ca-tion
perquisite	per-qui-site
eru-di-tion	er-u-di-tion
tour-na-men-t	tour-na-ment
quain-t	quaint
the-atri-cal-s	the-at-ri-cals
piti-ful	pit-i-ful
over	o-ver
here-inafter	here-in-af-ter
delir-i-um	de-lir-i-um
cathe-dral	ca-the-dral
fer-al	fe-ral
lighter	light-er
mas-tery	mas-ter-y
cliffhang-er	cliff-hang-er
cel-ery	cel-er-y
dis-cotheque	dis-co-theque
port-fo-lio	port-fo-li-o
pas-san-t	pas-sant
e-t-y-mo-log-i-cal	et-y-mo-log-i-cal
tran-scen-dence	tran-scend-ence
penul-ti-mate	pe-nul-ti-mate
galling	gall-ing
fara-day	far-a-day
beaver	bea-ver
satire	sat-ire
trans-par-en-t	trans-par-ent
bes-tial-i-ty	bes-ti-al-i-ty
mis-nomer	mis-no-mer
col-liery	col-lier-y
s-nail	snail
bolero	bo-le-ro
sim-per-ing	simpering
ide-al-is-tic	i-de-al-is-tic
mul-ti-me-ter	mul-tim-e-ter
lu-natic	lu-na-tic
saga-cious	sa-ga-cious
in-con-gruity	in-con-gru-i-ty
panz-er	pan-zer
s-lug-gish	slug-gish
quater-nion	qua-ter-ni-on
elide	e-lide
k-ilo-hertz	kil-o-hertz
electable	e-lect-a-ble
pyra-mid	pyr-a-mid
valet	val-et
pep-pered	peppered
re-con-struc-t	re-con-struct
u-n-ad-just-ed	un-ad-just-ed
di-rec-t	di-rect
cousin	cous-in
s-ta-tis-tics	sta-tis-tics
g-lut-ton	glut-ton
bul-l	bull
in-ter-con-nec-t	in-ter-con-nect
gui-tarist	gui-tar-ist
un-ut-ter-able	un-ut-ter-a-ble
in-vesti-ture	in-ves-ti-ture
baoba-b	ba-o-bab
gib-ber-ing	gibbering
over-flow	o-ver-flow
racial-is-m	ra-cial-ism
wind-mil-l	wind-mill
patel-la	pa-tel-la
dis-abling	disabling
pa-pery	pa-per-y
tele-work-ing	teleworking
auger	au-ger
b-liss-ful-ly	bliss-ful-ly
fontanel	fon-ta-nel
look-ing	looking
buz-z	buzz
hor-mon-al	hor-mo-nal
un-frozen	un-fro-zen
benefice	ben-e-fice
mono-cul-ture	mon-o-cul-ture
i-nessen-tial	in-es-sen-tial
syl-labub	syl-la-bub
mono-tone	mon-o-tone
misog-y-ny	mi-sog-y-ny
ethic-s	eth-ics
place-bo	pla-ce-bo
com-pla-cen-t	com-pla-cent
bil-liard-s	bil-liards
virtue	vir-tue
u-nar-guable	un-ar-gu-a-ble
fran-chisee	fran-chi-see
in-fect-ed	in-fec-ted
rar-efac-tion	rar-e-fac-tion
over-rate	o-ver-rate
jan-u-ary	jan-u-ar-y
quadruped	quad-ru-ped
fevered	fe-vered
for-get-table	for-get-ta-ble
round-about	round-a-bout
s-lip-stream	slip-stream
re-ac-tan-t	re-ac-tant
redo-len-t	red-o-lent
changeover	change-o-ver
bevy	bev-y
ret-ro-spec-t	ret-ro-spect
re-pro-cess	re-proc-ess
grid-ded	gridded
meringue	me-ringue
missal	mis-sal
ar-senic	ar-se-nic
manome-ter	ma-nom-e-ter
pere-grine	per-e-grine
i-nane	in-ane
recharge-able	re-charge-a-ble
c-it-i-zen	cit-i-zen
in-con-ti-nen-t	in-con-ti-nent
julep	ju-lep
wag-gery	wag-ger-y
ev-ery-body	eve-ry-bod-y
tiling	til-ing
pun-t	punt
ro-mancer	ro-manc-er
delu-sion	de-lu-sion
con-troller	con-trol-ler
rigid-i-fy	ri-gid-i-fy
novice	nov-ice
obe-di-en-t	o-be-di-ent
gale-na	ga-le-na
d-e-fi-cien-t	de-fi-cient
urine	u-rine
para-mil-i-tary	par-a-mil-i-tar-y
en-durance	en-dur-ance
palate	pal-ate
hus-bandry	hus-band-ry
teenage	teen-age
craven	cra-ven
drach-m	drachm
sewage	sew-age
dra-mat-ic-s	dra-mat-ics
s-worn	sworn
holler	hol-ler
he-do-nist	he-don-ist
s-nout	snout
op-por-tunis-tic	op-por-tun-is-tic
pantry	pan-try
mis-shapen	mis-shap-en
ego	e-go
in-hos-pitable	in-hos-pi-ta-ble
fluffy	fluff-y
sophistry	soph-ist-ry
o-cean-ic	o-ce-an-ic
s-cat-o-log-i-cal	scat-o-log-i-cal
in-ter-de-pen-den-t	in-ter-de-pend-ent
dairy-man	dair-y-man
ni-hilis-m	ni-hil-ism
puerile	pu-er-ile
tripoli	trip-o-li
trans-portable	trans-port-a-ble
sel-l	sell
demon-stra-bly	de-mon-stra-bly
en-abled	e-na-bled
reawak-en	re-a-wak-en
curly	curl-y
spillage	spill-age
elec-tive	e-lec-tive
imag-i-na-tion	im-ag-i-na-tion
sub-scrip-t	sub-script
mi-cro-com-put-er	mi-cro-com-pu-ter
mil-lisec-ond	mil-li-sec-ond
gov-ern-ing	governing
in-ter-locu-tor	in-ter-loc-u-tor
in-tran-si-gen-t	in-tran-si-gent
psy-cholin-guis-tic-s	psy-cho-lin-guis-tics
in-es-timable	in-es-ti-ma-ble
un-speak-able	un-speak-a-ble
dumper	dump-er
ar-guable	ar-gu-a-ble
lega-cy	leg-a-cy
beget	be-get
vial	vi-al
melt-ed	melted
grinder	grind-er
pen-i-ten-t	pen-i-tent
com-fort-able	com-fort-a-ble
can-dlelit	can-dle-lit
loutish	lout-ish
mock-ery	mock-er-y
iso-late	i-so-late
u-n-ap-proach-able	un-ap-proach-a-ble
bat-s	bats
dis-ap-point-men-t	dis-ap-point-ment
gaseous	gas-e-ous
debonair	deb-o-nair
petu-lance	pet-u-lance
c-og-nizance	cog-ni-zance
newsagen-t	news-a-gent
cater	ca-ter
neuter	neu-ter
stripy	strip-y
ban-ter-ing	bantering
com-forter	com-fort-er
binoc-u-lar	bin-oc-u-lar
fre-quent-ed	frequented
mushy	mush-y
ra-dia-tive	ra-di-a-tive
seabed	sea-bed
twitchy	twitch-y
able	a-ble
de-scend-ing	descending
scratchy	scratch-y
easy-go-ing	eas-y-go-ing
k-ing-fish-er	king-fish-er
cardi-gan	car-di-gan
for-warder	for-ward-er
hideous-ly	hid-e-ous-ly
les-bian	les-bi-an
winder	wind-er
papule	pap-ule
reach-able	reach-a-ble
man-ner-is-m	man-ner-ism
ar-chaeopteryx	ar-chae-op-ter-yx
ini-tial	in-i-tial
ori-en-tal-is-m	o-ri-en-tal-ism
tempter	tempt-er
e-lo-cu-tion	el-o-cu-tion
di-atom-ic	di-a-tom-ic
inkling	ink-ling
avail-abil-i-ty	a-vail-a-bil-i-ty
s-mog-gy	smog-gy
pho-to-genic	pho-to-gen-ic
im-pov-er-ish-men-t	im-pov-er-ish-ment
in-ter-vie-wee	in-ter-view-ee
vestal	ves-tal
e-d-u-ca-tion-al-ly	ed-u-ca-tion-al-ly
a-pos-tolic	ap-os-tol-ic
es-tab-lish-men-t	es-tab-lish-ment
el-e-men-tary	el-e-men-ta-ry
river-side	riv-er-side
steamship	steam-ship
episode	ep-i-sode
ir-re-deemable	ir-re-deem-a-ble
brawny	brawn-y
e-u-pho-nious	eu-pho-ni-ous
telepa-thy	te-lep-a-thy
mea-sure	meas-ure
un-sol-d	un-sold
g-luten	glu-ten
rolling	roll-ing
d-if-fus-er	dif-fus-er
rel-a-tivis-tic	rel-a-tiv-is-tic
catholic	cath-o-lic
en-thralling	en-thral-ling
s-trand-ed	strand-ed
fleecy	fleec-y
ru-mi-nan-t	ru-mi-nant
in-de-struc-tible	in-de-struct-i-ble
aplen-ty	a-plen-ty
poly-atom-ic	pol-y-a-tom-ic
vil-lager	vil-lag-er
s-plin-t	splint
matin-s	mat-ins
uterus	u-ter-us
tat-ter-s	tat-ters
poundage	pound-age
gasi-fy	gas-i-fy
pam-phle-teer	pam-phlet-eer
aver	a-ver
sideshow	side-show
floozy	floo-zy
aster-n	a-stern
bal-alai-ka	bal-a-lai-ka
s-lant-ing	slant-ing
e-d-uca-tive	ed-u-ca-tive
un-con-tain-able	un-con-tain-a-ble
unglazed	un-glazed
het-ero-ge-neous	het-er-o-ge-ne-ous
reprisal	re-pris-al
tomboy	tom-boy
bat-tle-men-t	bat-tle-ment
im-per-ti-nen-t	im-per-ti-nent
un-par-don-able	un-par-don-a-ble
get-away	get-a-way
u-n-ac-com-mo-dat-ing	un-ac-com-mo-dat-ing
ravi-o-li	ra-vi-o-li
in-el-e-gan-t	in-el-e-gant
quixot-ic	quix-ot-ic
p-re-set	pre-set
an-te-dilu-vian	an-te-di-lu-vi-an
frozen	fro-zen
cy-tochrome	cy-to-chrome
un-healthy	un-health-y
can-taloupe	can-ta-loupe
dis-con-nec-t	dis-con-nect
medusa	me-du-sa
poly-thene	pol-y-thene
con-demned	condemned
in-hibito-ry	in-hib-i-to-ry
abaft	a-baft
medicine	med-i-cine
re-cruit-men-t	re-cruit-ment
open-ing	o-pen-ing
re-al-ness	real-ness
dul-cimer	dul-ci-mer
zither	zith-er
ret-i-cen-t	ret-i-cent
emit-ter	e-mit-ter
pro-ceed-s	pro-ceeds
un-learned	un-learn-ed
in-ven-t	in-vent
in-tac-t	in-tact
casse-role	cas-se-role
us-abil-i-ty	us-a-bil-i-ty
around	a-round
im-agery	im-age-ry
cherub	cher-ub
ur-ticari-a	ur-ti-car-i-a
idly	i-dly
palat-able	pal-at-a-ble
test-ing	testing
un-electable	un-e-lect-a-ble
re-dun-dan-t	re-dun-dant
an-tivi-ral	an-ti-vi-ral
biosyn-the-sis	bi-o-syn-the-sis
arith-metic	a-rith-me-tic
leucine	leu-cine
hair-spray	hairspray
d-if-fer-en-ti-ate	dif-fer-en-ti-ate
jerky	jerk-y
freestyle	free-style
baguette	ba-guette
per-jury	per-ju-ry
dig-ni-tary	dig-ni-tar-y
epi-graph	ep-i-graph
cun-nilin-gus	cun-ni-lin-gus
eru-dite	er-u-dite
per-i-he-lion	per-i-he-li-on
wran-gling	wrangling
in-deli-ble	in-del-i-ble
mi-crocode	mi-cro-code
s-tool	stool
transcon-ti-nen-tal	trans-con-ti-nen-tal
d-enizen	den-i-zen
borstal	bor-stal
ef-flu-en-t	ef-flu-ent
co-pro-lite	cop-ro-lite
tirade	ti-rade
o-r-a-to-ry	or-a-to-ry
s-traight	straight
smithy	smith-y
s-tur-geon	stur-geon
pi-quan-t	pi-quant
min-der	mind-er
ephemer-a	e-phem-er-a
sub-terfuge	sub-ter-fuge
mogul	mo-gul
swimwear	swim-wear
thril-l	thrill
testis	tes-tis
ar-ranger	ar-rang-er
s-lake	slake
s-tock-ist	stock-ist
wun-derkind	wun-der-kind
costar	co-star
bulky	bulk-y
rarebit	rare-bit
s-now-fal-l	snow-fall
mo-torist	mo-tor-ist
condi-men-t	con-di-ment
classy	class-y
re-porter	re-port-er
cli-toris	clit-o-ris
e-u-nuch	eu-nuch
s-porty	sport-y
pres-i-den-t	pres-i-dent
gut-sy	guts-y
cre-ation-ist	cre-a-tion-ist
vig-i-lante	vig-i-lan-te
bur-gundy	bur-gun-dy
restau-ra-teur	res-tau-ra-teur
baby-ish	ba-by-ish
record-ing	re-cord-ing
pro-cre-ation	pro-cre-a-tion
masseuse	mas-seuse
plan-t	plant
loony	loon-y
over-stretch	o-ver-stretch
troglodyte	trog-lo-dyte
s-pear-head	spear-head
asleep	a-sleep
shipload	ship-load
white-washed	whitewashed
pur-suan-t	pur-su-ant
s-moother	smooth-er
rasper	rasp-er
tight-s	tights
s-tom-a	sto-ma
defini-tive-ly	de-fin-i-tive-ly
s-nack	snack
pro-pri-etor	pro-pri-e-tor
mono	mon-o
seclu-sion	se-clu-sion
un-ortho-dox	un-or-tho-dox
coulom-b	cou-lomb
enu-mer-a-tion	e-nu-mer-a-tion
flota-tion	flo-ta-tion
physic-s	phys-ics
di-choto-mous	di-chot-o-mous
n-od-dle	nod-dle
un-sur-pass-able	un-sur-pass-a-ble
gud-geon	gudg-eon
cy-to-plas-m	cy-to-plasm
s-lan-der	slan-der
over-es-ti-ma-tion	o-ver-es-ti-ma-tion
cle-f	clef
edgy	edg-y
en-riched	enriched
som-brero	som-bre-ro
baroness	bar-on-ess
chameleon	cha-me-le-on
skul-l	skull
ox-i-dan-t	ox-i-dant
s-culp-tress	sculp-tress
mealy	meal-y
het-erol-o-gous	het-er-ol-o-gous
pageantry	pag-eant-ry
feath-erlight	feath-er-light
con-join-t	con-joint
mu-tan-t	mu-tant
movie	mov-ie
briny	brin-y
hooli-gan	hoo-li-gan
con-sid-er-ably	con-sid-er-a-bly
d-if-fer-en-t	dif-fer-ent
detri-men-t	det-ri-ment
i-nat-ten-tion	in-at-ten-tion
joyride	joy-ride
ex-che-quer	ex-cheq-uer
de-scen-t	de-scent
an-tifreeze	an-ti-freeze
repa-tri-ate	re-pa-tri-ate
bivouac	biv-ou-ac
in-sa-tiable	in-sa-tia-ble
testable	test-a-ble
trans-for-m	trans-form
dilem-ma	di-lem-ma
fid-get	fidg-et
dis-obey	dis-o-bey
unso-cial	un-so-cial
p-resent-ly	pres-ent-ly
iso-la-tion-ist	i-so-la-tion-ist
crick-eter	crick-et-er
know-able	know-a-ble
in-ter-change-able	in-ter-change-a-ble
brava-do	bra-va-do
coro-n-a	co-ro-na
pre-de-ter-mined	predetermined
cus-p	cusp
palace	pal-ace
cloven	clo-ven
re-ori-en-ta-tion	re-o-ri-en-ta-tion
gullible	gul-li-ble
wim-p	wimp
para-psy-chol-o-gy	par-a-psy-chol-o-gy
ge-neal-o-gy	ge-ne-al-o-gy
reclu-sive	re-clu-sive
ragged	rag-ged
p-salm	psalm
un-prof-itable	un-prof-it-a-ble
conifer	co-ni-fer
ap-proval	ap-prov-al
pan-theon	pan-the-on
hosepipe	hose-pipe
dis-com-fort-ing	discomforting
s-coot	scoot
par-a-bola	pa-rab-o-la
t-in-ware	tin-ware
bel-liger-ence	bel-lig-er-ence
ath-let-ic-s	ath-let-ics
undis-guised	un-dis-guised
re-tal-ia-to-ry	re-tal-i-a-to-ry
flesh-pot-s	flesh-pots
de-sir-able	de-sir-a-ble
charis-ma	cha-ris-ma
pizze-ri-a	piz-ze-ri-a
cud-gel	cudg-el
pre-dict-ed	predicted
biom-e-try	bi-om-e-try
c-holes-terol	cho-les-ter-ol
sa-far-i	sa-fa-ri
count-able	count-a-ble
garbage	gar-bage
lachry-mose	lach-ry-mose
re-sen-t	re-sent
i-n-ac-cu-rate-ly	in-ac-cu-rate-ly
tur-f	turf
non-cha-lan-t	non-cha-lant
teach-able	teach-a-ble
theta	the-ta
un-de-ni-ably	un-de-ni-a-bly
mio-sis	mi-o-sis
s-tar	star
metaphor-i-cal-ly	met-a-phor-i-cal-ly
turmer-ic	tur-mer-ic
over-sim-pli-fy	o-ver-sim-pli-fy
in-no-cen-t	in-no-cent
k-lax-on	klax-on
su-per-nu-mer-ary	su-per-nu-mer-ar-y
re-moun-t	re-mount
servi-ette	ser-vi-ette
e-co-log-i-cal	ec-o-log-i-cal
ar-chi-tec-tural	ar-chi-tec-tur-al
hooli-gan-is-m	hoo-li-gan-ism
cor-po-ratism	cor-po-rat-ism
e-quinox	e-qui-nox
lyric	lyr-ic
light-s	lights
s-ta-tion-mas-ter	sta-tion-mas-ter
taboo	ta-boo
sub-con-ti-nen-t	sub-con-ti-nent
mis-cel-lanea	mis-cel-la-ne-a
s-lant-ed	slanted
im-munoas-say	im-mu-no-as-say
dis-per-san-t	dis-per-sant
as-pirin	as-pi-rin
em-bod-i-men-t	em-bod-i-ment
s-ab-bat-i-cal	sab-bat-i-cal
bio-met-ric	bi-o-met-ric
poly-styrene	pol-y-sty-rene
archdea-con-ry	arch-dea-con-ry
re-ver-ber-an-t	re-ver-ber-ant
ex-trav-a-gan-t	ex-trav-a-gant
roguery	ro-guer-y
s-todgy	stodg-y
s-pline	spline
ki-net-ic-s	ki-net-ics
mod-icum	mod-i-cum
re-pel-len-t	re-pel-lent
painter	paint-er
reat-temp-t	re-at-tempt
pro-tec-torate	pro-tec-tor-ate
reis-sue	re-is-sue
tele-tex-t	tel-e-text
mid-dleweight	mid-dle-weight
enu-mer-ate	e-nu-mer-ate
caviar	cav-i-ar
pro-pri-etary	pro-pri-e-tar-y
ra-dio-gram	ra-di-o-gram
sub-species	sub-spe-cies
refu-ta-tion	ref-u-ta-tion
macro-scop-ic	mac-ro-scop-ic
dosage	dos-age
ir-rec-on-cil-able	ir-rec-on-cil-a-ble
incog-ni-to	in-cog-ni-to
grandil-o-quen-t	gran-dil-o-quent
e-gal-i-tar-i-an-is-m	e-gal-i-tar-i-an-ism
ivy	i-vy
re-deemer	re-deem-er
i-cosa-he-dron	i-co-sa-he-dron
as-pi-ra-tional	as-pi-ra-tion-al
be-lit-tling	belittling
tri-tium	trit-i-um
gas-troin-testi-nal	gas-tro-in-tes-ti-nal
prepara-to-ry	pre-par-a-to-ry
cagoule	ca-goule
sig-nif-i-can-t	sig-nif-i-cant
sed-i-men-t	sed-i-ment
hy-dro-stat-ic-s	hy-dro-stat-ics
mis-t	mist
sorghum	sor-ghum
re-as-sur-ing	reassuring
atom-ic	a-tom-ic
a-ban-don-men-t	a-ban-don-ment
s-car-let	scar-let
avenge	a-venge
ob-scu-ran-tist	ob-scu-rant-ist
curlew	cur-lew
tequi-la	te-qui-la
ex-pec-tant-ly	ex-pect-ant-ly
armistice	ar-mi-stice
in-fec-t	in-fect
sober-ly	so-ber-ly
s-ti-fle	sti-fle
bug-gery	bug-ger-y
turnover	turn-o-ver
pleat-ed	pleated
proph-esy	proph-e-sy
out-sel-l	out-sell
con-coc-t	con-coct
bizarre	bi-zarre
sooty	soot-y
eerie	ee-rie
s-mirk-ing	smirking
diplo-mat-i-cal-ly	dip-lo-mat-i-cal-ly
ser-pen-t	ser-pent
miser	mi-ser
re-mov-able	re-mov-a-ble
en-camp-men-t	en-camp-ment
s-mug-gler	smug-gler
tor-men-t	tor-ment
fidu-cia-ry	fi-du-ci-ar-y
antacid	ant-ac-id
sagac-i-ty	sa-gac-i-ty
op-ti-mis-m	op-ti-mism
tor-toise-shel-l	tor-toise-shell
boater	boat-er
n-ear-sight-ed	near-sight-ed
duchess	duch-ess
un-nec-es-sary	un-nec-es-sar-y
hin-t	hint
sen-t	sent
we-b	web
guinea	guin-ea
haystack	hay-stack
item	i-tem
un-demon-stra-tive	un-de-mon-stra-tive
con-ve-nient-ly	con-ven-ient-ly
obey	o-bey
penance	pen-ance
s-plit-ter	split-ter
aro-ma	a-ro-ma
vagabond	vag-a-bond
brethren	breth-ren
maya	ma-ya
ru-ina-tion	ru-in-a-tion
un-jus-ti-fi-able	un-jus-ti-fi-a-ble
cere-bel-lum	cer-e-bel-lum
fun-da-men-tal-is-m	fun-da-men-tal-ism
minute-ly	mi-nute-ly
reser-va-tion	res-er-va-tion
s-now-bal-l	snow-ball
mildewy	mil-dew-y
s-tratig-ra-phy	stra-tig-ra-phy
un-shak-able	un-shak-a-ble
steve-dore	ste-ve-dore
trel-lised	trellised
u-nis-sued	un-is-sued
pit-fal-l	pit-fall
s-cout-mas-ter	scout-mas-ter
biki-ni	bi-ki-ni
rivulet	riv-u-let
in-ter-men-t	in-ter-ment
depre-da-tion	dep-re-da-tion
tidal	tid-al
s-trate-gi-cal-ly	stra-te-gi-cal-ly
fir-m	firm
read-mit	re-ad-mit
translit-er-ate	trans-lit-er-ate
l-it-mus	lit-mus
con-fi-dan-t	con-fi-dant
com-peti-tor	com-pet-i-tor
biodegrad-able	bi-o-de-grad-a-ble
solid-ly	sol-id-ly
eye-bal-l	eye-ball
un-ortho-doxy	un-or-tho-dox-y
re-pro-ducibly	re-pro-duc-i-bly
swampy	swamp-y
res-onate	res-o-nate
exe-un-t	ex-e-unt
brew-ery	brew-er-y
en-doge-nous	en-dog-e-nous
ap-point-men-t	ap-point-ment
spokesman	spokes-man
rheumat-ic-s	rheu-mat-ics
bour-geoisie	bour-geoi-sie
un-wary	un-war-y
in-tel-lec-t	in-tel-lect
gen-tri-fied	gentrified
nurs-ery	nurs-er-y
cam-panol-o-gy	cam-pa-nol-o-gy
blun-der-ing	blundering
land-fil-l	land-fill
dis-union	dis-un-ion
lemur	le-mur
athe-is-m	a-the-ism
pur-po-sive	pur-pos-ive
shipown-er	ship-own-er
okapi	o-ka-pi
penol-o-gy	pe-nol-o-gy
quo-tien-t	quo-tient
frumpy	frump-y
foundling	found-ling
o-ri-gin	or-i-gin
tabloid	tab-loid
facet	fac-et
vivid-ly	viv-id-ly
deco-rous	dec-o-rous
n-er-vous	nerv-ous
caseload	case-load
re-silience	re-sil-ience
cloudy	cloud-y
karaoke	kar-a-o-ke
warthog	wart-hog
rhubar-b	rhu-barb
c-og-nizan-t	cog-ni-zant
clemen-cy	clem-en-cy
ir-ri-tan-t	ir-ri-tant
plan-gen-t	plan-gent
pumice	pum-ice
forcible	for-ci-ble
calum-ny	cal-um-ny
servi-tude	ser-vi-tude
legalese	le-gal-ese
supreme-ly	su-preme-ly
testos-terone	tes-tos-ter-one
bur-sary	bur-sa-ry
s-lick-er	slick-er
musty	mus-ty
toupee	tou-pee
quadri-lat-er-al	quad-ri-lat-er-al
meanie	mean-ie
man-i-cured	ma-ni-cured
hypochon-dri-a	hy-po-chon-dri-a
turnip	tur-nip
codex	co-dex
overop-ti-mistic	o-ver-op-ti-mis-tic
bar-baris-m	bar-ba-rism
prof-itabil-i-ty	prof-it-a-bil-i-ty
demon-stra-tive	de-mon-stra-tive
re-minder	re-mind-er
crys-talline	crys-tal-line
triple	tri-ple
cuf-f	cuff
spongy	spon-gy
hooray	hoo-ray
leisure	lei-sure
em-piri-cis-m	em-pir-i-cism
s-nap-per	snap-per
im-peach-men-t	im-peach-ment
s-hear	shear
re-cal-ci-tran-t	re-cal-ci-trant
s-tomp-ing	stomp-ing
di-elec-tric	di-e-lec-tric
wrin-kled	wrinkled
su-per-scrip-t	su-per-script
ig-no-ran-t	ig-no-rant
anon	a-non
ban-knote	bank-note
palm-istry	palm-is-try
le-nien-t	le-ni-ent
bromine	bro-mine
elec-trol-y-sis	e-lec-trol-y-sis
garage	ga-rage
c-on-cil-ia-tor	con-cil-i-a-tor
im-muno-com-pro-mised	im-mu-no-com-pro-mised
com-modi-ous	com-mo-di-ous
hy-gien-ic	hy-gi-en-ic
glis-ten-ing	gli-ste-ning
pim-p	pimp
id-iom	id-i-om
ine-bri-a-tion	in-e-bri-a-tion
s-tate-men-t	state-ment
ir-re-place-able	ir-re-place-a-ble
triglyc-eride	tri-glyc-er-ide
de-brief-in-g	debriefing
s-lushy	slush-y
flip-pan-t	flip-pant
pathfind-er	path-find-er
promon-to-ry	prom-on-to-ry
rosette	ro-sette
moc-casin	moc-ca-sin
miser-ly	mi-ser-ly
iso-tope	i-so-tope
turnkey	turn-key
u-n-ap-pre-ci-at-ed	un-ap-pre-ci-at-ed
eleventh	e-lev-enth
felo-nious	fe-lo-ni-ous
s-loth	sloth
prostate	pros-tate
in-tra-venous	in-tra-ve-nous
fifti-eth	fif-ti-eth
poster	post-er
s-ta-tion	sta-tion
s-cullery	scul-ler-y
pedan-t	ped-ant
ra-dius	ra-di-us
fron-t	front
chaf-f	chaff
re-for-m	re-form
y-outh	youth
s-pear	spear
s-ports-man	sports-man
lamp-lighter	lamp-light-er
s-e-lec-tiv-i-ty	se-lec-tiv-i-ty
un-kep-t	un-kept
erec-tile	e-rec-tile
fault-ing	faulting
k-ilo-ton	kil-o-ton
un-com-fort-ably	un-com-fort-a-bly
pre-sum-ably	pre-sum-a-bly
s-tar-tling-ly	star-tling-ly
prom-is-sory	prom-is-so-ry
avalanche	av-a-lanche
stereo-typ-i-cal	ster-e-o-typ-i-cal
dis-place-men-t	dis-place-ment
tiller	till-er
psy-chother-a-py	psy-cho-ther-a-py
gillie	gil-lie
reagen-t	re-a-gent
tri-umphal-is-m	tri-um-phal-ism
whisker	whisk-er
sander	sand-er
rhetor-i-cal-ly	rhe-tor-i-cal-ly
delu-sive	de-lu-sive
welling-ton	wel-ling-ton
cy-berspace	cy-ber-space
good-s	goods
s-tim-u-lat-ing	stim-u-lat-ing
ge-nial	ge-ni-al
catal-y-sis	ca-tal-y-sis
par-tici-ple	par-ti-ci-ple
fire-bom-b	fire-bomb
s-tud-ded	stud-ded
genre	gen-re
glan-s	glans
mistype	mis-type
per-fec-t	per-fect
un-prov-able	un-prov-a-ble
shad-owy	shad-ow-y
over-pow-er-ing	o-ver-pow-er-ing
cast-away	cast-a-way
apex	a-pex
s-cape	scape
data-base	da-ta-base
leghorn	leg-horn
opaque	o-paque
ha-track	hat-rack
s-lack-er	slack-er
roast-ed	roasted
re-sent-men-t	re-sent-ment
forcibly	for-ci-bly
repa-tri-a-tion	re-pa-tri-a-tion
spen-t	spent
s-parkle	spar-kle
jagged	jag-ged
he-li-pad	hel-i-pad
rigid-ly	rig-id-ly
c-itadel	cit-a-del
demo-crat-i-cal-ly	dem-o-crat-i-cal-ly
mis-treat-men-t	mis-treat-ment
qua-dru-pli-cate	quad-ru-pli-cate
im-pla-ca-ble	im-plac-a-ble
minute	mi-nute
satrap	sa-trap
avul-sion	a-vul-sion
u-n-ap-peal-ing	un-ap-peal-ing
con-certi-na	con-cer-ti-na
dearie	dear-ie
ju-ridi-cal	ju-rid-i-cal
pre-lim-i-nary	pre-lim-i-nar-y
ex-trater-res-tri-al	ex-tra-ter-res-tri-al
jus-ti-fi-able	jus-ti-fi-a-ble
repa-ra-tion	rep-a-ra-tion
prefer-ably	pref-er-a-bly
elec-tro-stat-ic	e-lec-tro-stat-ic
e-bul-lien-t	e-bul-lient
coura-geous-ly	cou-ra-geous-ly
s-care-crow	scare-crow
retic-u-lar	re-tic-u-lar
aver-sive	a-ver-sive
s-tarve	starve
un-change-able	un-change-a-ble
s-taid	staid
t-wo-some	two-some
stat-ic-s	stat-ics
lawyer	law-yer
chas-ten-ing	chastening
ap-pa-ra-tus	ap-pa-rat-us
charmer	charm-er
de-for-m	de-form
marginal-ly	mar-gin-al-ly
naugh-t	naught
sausage	sau-sage
de-flec-t	de-flect
bindery	bind-er-y
willpow-er	will-pow-er
mono-pole	mon-o-pole
metic-u-lous-ly	me-tic-u-lous-ly
re-former	re-form-er
bac-teri-um	bac-te-ri-um
prove-nance	prov-e-nance
ate-lier	at-el-ier
lassie	las-sie
mag-netite	mag-net-ite
ranker	rank-er
erad-i-cat-ed	e-rad-i-cat-ed
unin-sured	un-in-sured
re-volt-ed	revolted
jovial	jo-vi-al
mar-i-onette	mar-i-on-ette
s-lang	slang
hazel	ha-zel
fuch-si-a	fuch-sia
e-d-u-ca-tor	ed-u-ca-tor
perigee	per-i-gee
over-con-fi-den-t	o-ver-con-fi-dent
pro-pri-eto-ri-al	pro-pri-e-to-ri-al
counter	coun-ter
up-hol-stery	up-hol-ster-y
swarthy	swarth-y
neo-prene	ne-o-prene
s-pace-suit	space-suit
at-tain-able	at-tain-a-ble
mit-t	mitt
su-per-fluity	su-per-flu-i-ty
s-pade	spade
delin-quen-t	de-lin-quent
w-hole-some	whole-some
castof-f	cast-off
rigid	rig-id
re-tiree	re-tir-ee
imag-in-ings	im-ag-in-ings
hori-zon	ho-ri-zon
adap-t	a-dapt
i-n-alien-able	in-al-ien-a-ble
p-re-sen-ta-tion	pres-en-ta-tion
gra-tu-ity	gra-tu-i-ty
fash-ion-able	fash-ion-a-ble
cu-nei-form	cu-ne-i-form
fuzzy	fuzz-y
mega-phone	meg-a-phone
im-politic	im-pol-i-tic
trouper	troup-er
stylish-ly	styl-ish-ly
im-pro-vi-sa-tion-al	im-prov-i-sa-tion-al
teleg-ra-phy	te-leg-ra-phy
an-tic-s	an-tics
con-sor-tium	con-sor-ti-um
s-tovepipe	stove-pipe
cor-rup-t	cor-rupt
prophe-cy	proph-e-cy
lam-ben-t	lam-bent
clin-i-cian	cli-ni-cian
mar-quetry	mar-que-try
flood-ing	flooding
over-sub-scribed	o-ver-sub-scribed
u-n-adorned	un-a-dorned
s-cores	scores
ver-dan-t	ver-dant
syco-phan-t	syc-o-phant
can-tilevered	cantilevered
techno-pho-bic	tech-no-pho-bic
in-tern-men-t	in-tern-ment
in-de-cen-t	in-de-cent
un-sup-port-able	un-sup-port-a-ble
no-ti-fi-able	no-ti-fi-a-ble
con-nivance	con-niv-ance
s-cowl	scowl
unchecked	un-checked
covert-ly	cov-ert-ly
pagean-t	pag-eant
stri-den-t	stri-dent
n-ev-er-the-less	nev-er-the-less
e-s-pouse	es-pouse
s-cout	scout
biomass	bi-o-mass
nadir	na-dir
s-pa	spa
in-vig-o-rat-ing	in-vig-or-at-ing
e-vanes-cen-t	ev-a-nes-cent
un-sink-able	un-sink-a-ble
col-lo-qui-al-is-m	col-lo-qui-al-ism
s-nug-gle	snug-gle
quit-s	quits
bio-ta	bi-o-ta
u-nion	un-ion
cordiller-a	cor-dil-le-ra
so-cialite	so-cial-ite
gofer	go-fer
chas-m	chasm
frica-tive	fric-a-tive
un-lac-ing	un-lacing
emet-ic	e-met-ic
philo-soph-i-cal-ly	phil-o-soph-i-cal-ly
s-cal-a-bil-i-ty	scal-a-bil-i-ty
stringy	string-y
serif	ser-if
radar	ra-dar
un-demo-crat-ic	un-dem-o-crat-ic
tax-able	tax-a-ble
over-much	o-ver-much
s-tain-less	stain-less
c-it-rate	cit-rate
winnable	win-na-ble
seraph-ic	se-raph-ic
posthu-mous-ly	post-hu-mous-ly
de-plorable	de-plor-a-ble
f-reak-ish	freak-ish
monomolec-u-lar	mon-o-mo-lec-u-lar
ge-o-mag-net-i-cal-ly	ge-o-mag-ne-ti-cal-ly
iso-trop-ic	i-so-trop-ic
res-o-nan-t	res-o-nant
tri-umphal	tri-um-phal
pho-tore-cep-tor	pho-to-re-cep-tor
re-moval	re-mov-al
i-n-ad-ver-ten-t	in-ad-vert-ent
bot-tled	bottled
k-ilo-byte	kil-o-byte
de-tec-t	de-tect
s-cab	scab
con-ic-s	con-ics
cor-moran-t	cor-mo-rant
in-ex-ac-t	in-ex-act
en-dow-men-t	en-dow-ment
puffy	puf-fy
naive	na-ive
hys-terec-to-my	hys-ter-ec-to-my
para-ble	par-a-ble
satirist	sat-i-rist
bad-land-s	bad-lands
in-tractable	in-trac-ta-ble
opine	o-pine
fig-u-ra-tive-ly	fig-ur-a-tive-ly
di-nosaur	di-no-saur
busy-body	bus-y-bod-y
in-fil-l	in-fill
lack-adaisi-cal	lack-a-dai-si-cal
briefer	brief-er
lacrosse	la-crosse
syl-labus	syl-la-bus
showy	show-y
lazi-ness	la-zi-ness
s-pade-work	spade-work
read-able	read-a-ble
uten-sil	u-ten-sil
ir-rel-e-van-t	ir-rel-e-vant
e-mer-ald	em-er-ald
atop	a-top
trea-son-able	trea-son-a-ble
projec-t	proj-ect
for-giv-able	for-giv-a-ble
manikin	man-i-kin
liftof-f	lift-off
illiq-uid	il-liq-uid
assig-na-tion	as-sig-na-tion
semi-cir-cu-lar	sem-i-cir-cu-lar
rhap-sody	rhap-so-dy
p-ri-mo-gen-i-ture	pri-mo-gen-i-ture
wether	weth-er
plushy	plush-y
romper	romp-er
nobly	no-bly
fetish	fet-ish
propul-sive	pro-pul-sive
on-slaugh-t	on-slaught
moun-taineer-ing	moun-tain-eer-ing
ex-cel-sior	ex-cel-si-or
undiplo-mat-ic	un-dip-lo-mat-ic
creak-ing	creaking
in-cor-rec-t	in-cor-rect
diplo-ma	di-plo-ma
ra-dio-met-ric	ra-di-o-met-ric
stealth-ily	stealth-i-ly
diode	di-ode
e-vo-ca-tion	ev-o-ca-tion
frivol	friv-ol
septet	sep-tet
touris-m	tour-ism
lever-age	lev-er-age
mufti	muf-ti
re-trieval	re-triev-al
man-dolin	man-do-lin
c-on-cil-i-ate	con-cil-i-ate
con-tex-t	con-text
video-tape	vid-e-o-tape
mer-chantable	mer-chant-a-ble
u-n-ac-cus-tomed	un-ac-cus-tomed
oviduc-t	o-vi-duct
s-par-ing-ly	spar-ing-ly
apish	ap-ish
mau-soleum	mau-so-le-um
s-paced	spaced
degra-da-tion	deg-ra-da-tion
un-nerv-ing	unnerving
how-itzer	how-itz-er
d-e-duce	de-duce
au-tonomous-ly	au-ton-o-mous-ly
steadi-ness	stead-i-ness
in-tox-i-can-t	in-tox-i-cant
spon-tane-ity	spon-ta-ne-i-ty
in-ex-orable	in-ex-o-ra-ble
un-touch-able	un-touch-a-ble
to-po-graph-ic	top-o-graph-ic
leak-ing	leaking
bul-b	bulb
book-stal-l	book-stall
po-ten-tial-i-ty	po-ten-ti-al-i-ty
mari-nade	mar-i-nade
sax-ony	sax-o-ny
lig-a-men-t	lig-a-ment
d-if-fu-sive	dif-fu-sive
bungee	bun-gee
dis-agree	dis-a-gree
per-ish-able	per-ish-a-ble
turtle-neck	tur-tle-neck
mal-leable	mal-le-a-ble
s-tar-dust	star-dust
in-ter-me-di-ary	in-ter-me-di-ar-y
im-pres-sion-is-m	im-pres-sion-ism
best-seller	best-sell-er
leafy	leaf-y
high-lander	high-lan-der
tox-i-c-i-ty	tox-ic-i-ty
bil-l	bill
spec-tropho-tome-ter	spec-tro-pho-tom-e-ter
s-teer	steer
u-nipo-lar	u-ni-po-lar
se-can-t	se-cant
based	based
op-er-cu-lum	o-per-cu-lum
pota-to	po-ta-to
longish	long-ish
molyb-de-num	mo-lyb-de-num
ap-par-en-t	ap-par-ent
s-mug-ly	smug-ly
epis-temic	ep-i-ste-mic
de-ten-t	de-tent
s-lip-pery	slip-per-y
hasti-ly	hast-i-ly
gleam-ing	gleaming
pa-paya	pa-pa-ya
shogun	sho-gun
s-coot-er	scoot-er
in-dictable	in-dict-a-ble
hel-l	hell
dy-nam-ic-s	dy-nam-ics
weighty	weight-y
re-frac-t	re-fract
glacier	gla-cier
randy	rand-y
plexus	plex-us
para-noia	par-a-noi-a
im-moral-i-ty	im-mo-ral-i-ty
i-n-or-di-nate-ly	in-or-di-nate-ly
ether	e-ther
pri-apic	pri-ap-ic
retroac-tive	ret-ro-ac-tive
s-tiff-en	stiff-en
s-corcher	scorch-er
misog-y-nis-tic	mi-sog-y-nis-tic
li-bido	li-bi-do
leviathan	le-vi-a-than
run-t	runt
skele-ton	skel-e-ton
butch-ery	butch-er-y
satir-ic	sa-tir-ic
de-po-si-tion	dep-o-si-tion
squeegee	squee-gee
s-in-cere	sin-cere
vinyl	vi-nyl
d-warfed	dwarfed
wind-sur-f	wind-surf
macro	mac-ro
a-tone-men-t	a-tone-ment
tablet	tab-let
up-heaval	up-heav-al
mac-a-roni	mac-a-ro-ni
physi-cist	phys-i-cist
in-duce-men-t	in-duce-ment
con-scrip-t	con-script
miser-li-ness	mi-ser-li-ness
trans-paren-cy	trans-par-en-cy
un-mis-tak-able	un-mis-tak-a-ble
tam-p	tamp
un-rep-re-sen-ta-tive	un-rep-re-sent-a-tive
pyri-dine	pyr-i-dine
overeat	o-ver-eat
ele-phan-t	el-e-phant
pa-ter-nal-is-m	pa-ter-nal-ism
stetho-scope	steth-o-scope
jugu-lar	jug-u-lar
vi-sion-ary	vi-sion-ar-y
pro-ges-terone	pro-ges-ter-one
duik-er	dui-ker
a-vian	a-vi-an
en-cryp-t	en-crypt
mar-chioness	mar-chion-ess
dandy	dan-dy
ev-ery-thing	eve-ry-thing
hexa-dec-i-mal	hex-a-dec-i-mal
regress	re-gress
fu-tur-is-m	fu-tur-ism
in-de-pen-den-t	in-de-pend-ent
bridal	brid-al
en-light-en-men-t	en-light-en-ment
nightlife	night-life
anger	an-ger
s-cut-tle	scut-tle
maudlin	maud-lin
beamy	beam-y
un-de-cid-able	un-de-cid-a-ble
san-i-tary	san-i-tar-y
quadru-ply	quad-ru-ply
coali-tion	co-a-li-tion
post-mistress	post-mis-tress
feal-ty	fe-al-ty
u-nion-is-m	un-ion-ism
sali-vary	sal-i-var-y
trendy	trend-y
s-cout-ing	scout-ing
tribesman	tribes-man
chid-ing	chiding
steam-roller	steam-roll-er
opac-i-ty	o-pac-i-ty
malev-o-len-t	ma-lev-o-lent
in-dis-tin-guish-able	in-dis-tin-guish-a-ble
u-nim-pres-sive	un-im-pres-sive
ra-j	raj
mul-tira-cial	mul-ti-ra-cial
un-reach-able	un-reach-a-ble
s-ab-bath	sab-bath
ser-van-t	serv-ant
hy-drochlo-ride	hy-dro-chlo-ride
navel	na-vel
au-topi-lot	au-to-pi-lot
elec-tro-mag-net	e-lec-tro-mag-net
sec-t	sect
s-pas-m	spasm
retsi-na	ret-si-na
macron	ma-cron
mis-cel-la-neous	mis-cel-la-ne-ous
table-land	ta-ble-land
as-siduity	as-si-du-i-ty
en-forcer	en-forc-er
capri-cious	ca-pri-cious
rein-sur-ance	re-in-sur-ance
ex-oti-cis-m	ex-ot-i-cism
cor-ti-cos-teroid	cor-ti-co-ster-oid
maser	ma-ser
lim-b	limb
gherkin	gher-kin
ir-re-solv-able	ir-re-solv-a-ble
prosody	pros-o-dy
het-ero-sex-u-al-i-ty	het-er-o-sex-u-al-i-ty
undig-ni-fied	un-dig-ni-fied
un-ser-vice-able	un-ser-vice-a-ble
leav-ened	leavened
dick-en-s	dick-ens
leo-tard	le-o-tard
ranch-ing	ranching
u-topi-an	u-to-pi-an
erase	e-rase
de-lim-it-ed	delimited
hege-mo-ny	he-gem-o-ny
spindly	spin-dly
tailplane	tail-plane
curvy	curv-y
i-n-ad-e-qua-cy	in-ad-e-qua-cy
be-fud-dled	befuddled
pager	pag-er
labi-al	la-bi-al
bubon-ic	bu-bon-ic
com-mit-men-t	com-mit-ment
neo-plas-m	ne-o-plasm
in-de-pen-dent-ly	in-de-pend-ent-ly
ax-olotl	ax-o-lotl
u-p-lift	up-lift
sul-tana	sul-tan-a
s-now-bound	snow-bound
trackbed	track-bed
mytho-log-i-cal	myth-o-log-i-cal
s-cuf-f	scuff
reshow	re-show
cen-tau-r	cen-taur
en-durable	en-dur-a-ble
moun-taineer	moun-tain-eer
bond-ing	bonding
pup-peteer	pup-pet-eer
sol-ven-t	sol-vent
colum-nar	co-lum-nar
rip-pling	rippling
raster	ras-ter
plea-sur-able	pleas-ur-a-ble
chateau	cha-teau
pru-den-t	pru-dent
un-man-age-able	un-man-age-a-ble
fiendish	fiend-ish
s-toned	stoned
in-ter-roga-tor	in-ter-ro-ga-tor
ta-pes-try	tap-es-try
un-solv-able	un-solv-a-ble
cus-tody	cus-to-dy
prop-s	props
astrad-dle	a-strad-dle
s-ple-net-ic	sple-net-ic
redac-tion	re-dac-tion
newsprint	news-print
erec-t	e-rect
b-otany	bot-a-ny
s-can	scan
cider	ci-der
s-tum-bling	stum-bling
for-mu-la-ry	for-mu-lar-y
polyester	pol-y-es-ter
epi-logue	ep-i-logue
ure-a	u-re-a
solem-ni-ty	so-lem-ni-ty
s-mug	smug
hal-lelu-jah	hal-le-lu-jah
sumo	su-mo
cochlea	coch-le-a
bar-b	barb
in-con-tro-vert-ible	in-con-tro-vert-i-ble
s-words-man	swords-man
e-voca-tive	e-voc-a-tive
par-ent-ing	parenting
gratic-ule	grat-i-cule
tidi-ness	ti-di-ness
motile	mo-tile
gory	gor-y
crafty	craft-y
any-one	an-y-one
melo-dra-ma	mel-o-dra-ma
d-e-duc-tive	de-duc-tive
ema-ci-a-tion	e-ma-ci-a-tion
grand-par-en-t	grand-par-ent
swarm-ing	swarming
soupy	soup-y
re-seller	re-sell-er
un-ten-able	un-ten-a-ble
ex-per-i-menter	ex-per-i-ment-er
en-joy-able	en-joy-a-ble
poly-merase	pol-y-mer-ase
ca-cao	ca-ca-o
filthy	filth-y
gallery	gal-ler-y
s-tac-ca-to	stac-ca-to
glacia-tion	gla-ci-a-tion
knowl-edge-able	knowl-edge-a-ble
tread-mil-l	tread-mill
climber	climb-er
parental	pa-ren-tal
foundry	found-ry
aper-i-tif	a-pe-ri-tif
un-con-trol-lable	un-con-trol-la-ble
exother-mic	ex-o-ther-mic
p-re-serv-er	pre-serv-er
di-atom	di-a-tom
as-trin-gen-t	as-trin-gent
coy-ote	coy-o-te
ca-cophonous	ca-coph-o-nous
dis-traugh-t	dis-traught
bal-cony	bal-co-ny
dia-lec-tic	di-a-lec-tic
ac-coun-t	ac-count
wicked	wick-ed
u-nan-swered	un-an-swered
ar-ran-t	ar-rant
needy	need-y
limo	lim-o
iron-stone	i-ron-stone
deis-m	de-ism
e-s-planade	es-pla-nade
framer	fram-er
goatskin	goat-skin
dero-gate	der-o-gate
huffy	huff-y
vene-re-al	ve-ne-re-al
showjumper-s	show-jum-pers
cre-osote	cre-o-sote
over-write	o-ver-write
chemise	che-mise
derelic-t	der-e-lict
elec-tri-cal-ly	e-lec-tri-cal-ly
re-li-ably	re-li-a-bly
io-dide	i-o-dide
vari-able	var-i-a-ble
s-tupid-ly	stu-pid-ly
per-for-m	per-form
un-ob-ser-van-t	un-ob-serv-ant
detox	de-tox
a-ca-dem-ic	ac-a-dem-ic
mantling	man-tling
fly-over	fly-o-ver
unsweet-ened	un-sweet-ened
vac-uole	vac-u-ole
con-tes-tant	con-test-ant
seda-tive	sed-a-tive
gigo-lo	gig-o-lo
cy-ber-net-ic-s	cy-ber-net-ics
d-educ-t	de-duct
cram-p	cramp
phys-iog-no-my	phys-i-og-no-my
s-lop	slop
nyala	nya-la
caliph	ca-liph
skir-l	skirl
ex-pres-sion-is-m	ex-pres-sion-ism
ap-pari-tion	ap-pa-ri-tion
ure-thra	u-re-thra
clam-orous	clam-or-ous
tightrope	tight-rope
undis-tort-ed	un-dis-tort-ed
prof-itably	prof-it-a-bly
pen-nan-t	pen-nant
seascape	sea-scape
weary-ing	wea-ry-ing
monar-chist	mon-ar-chist
de-sirous	de-sir-ous
sub-trop-ic-s	sub-trop-ics
va-ri-etal	va-ri-e-tal
an-tide-pres-san-t	an-ti-de-pres-sant
il-lim-itable	il-lim-it-a-ble
seag-ul-l	sea-gull
fil-a-men-t	fil-a-ment
pro-gressed	progressed
tele-pho-ny	te-leph-o-ny
sovereign-ty	sov-er-eign-ty
aver-sion	a-ver-sion
deriva-tion	der-i-va-tion
s-tore-house	store-house
mo-lester	mo-lest-er
treat-able	treat-a-ble
e-quable	eq-ua-ble
ranter	rant-er
dis-abuse	dis-a-buse
pen-chan-t	pen-chant
prodi-gious	pro-di-gious
de-con-struc-t	de-con-struct
re-us-able	re-us-a-ble
elec-tric-i-ty	e-lec-tric-i-ty
leather	leath-er
pu-ri-tanis-m	pu-ri-tan-ism
rheuma-tol-o-gy	rheu-ma-tol-o-gy
s-plash	splash
steadi-ly	stead-i-ly
may-oral	may-or-al
scruf-f	scruff
origa-mi	o-ri-ga-mi
s-tun-ner	stun-ner
hoard-ed	hoarded
un-san-i-tary	un-san-i-tar-y
un-in-hab-it-able	un-in-hab-it-a-ble
provoca-tive	pro-voc-a-tive
ram-p	ramp
satin	sat-in
d-u-al-is-tic	du-al-is-tic
unre-deemed	un-re-deemed
di-a-bolis-m	di-ab-o-lism
visa	vi-sa
sanc-tu-ary	sanc-tu-ar-y
an-nu-ity	an-nu-i-ty
navy	na-vy
d-if-fi-cul-ty	dif-fi-cul-ty
poly-mor-phous	pol-y-mor-phous
lyrist	lyr-ist
ther-mome-ter	ther-mom-e-ter
vo-cab-u-lary	vo-cab-u-lar-y
be-reaved	bereaved
s-lop-py	slop-py
rap-proche-men-t	rap-proche-ment
loft-ed	lofted
restora-tion	res-to-ra-tion
stopover	stop-o-ver
un-re-pairable	un-re-pair-a-ble
codling	cod-ling
beefeater	beef-eat-er
de-sir-abil-i-ty	de-sir-a-bil-i-ty
dat-able	dat-a-ble
pro-le-tari-at	pro-le-tar-i-at
iron-work	i-ron-work
frilli-er	fril-li-er
draftee	draft-ee
bla-tan-t	bla-tant
mis-rep-re-sen-t	mis-rep-re-sent
cyn-i-cis-m	cyn-i-cism
placid	plac-id
e-bony	eb-on-y
hero	he-ro
t-in-gle	tin-gle
pro-cure-men-t	pro-cure-ment
promis-ing	prom-is-ing
tillage	till-age
tra-di-tion-al-is-m	tra-di-tion-al-ism
sali-vate	sal-i-vate
un-ready	un-read-y
laity	la-i-ty
dis-sent-ing	dissenting
de-lin-eate	de-lin-e-ate
un-treat-able	un-treat-a-ble
el-e-men-t	el-e-ment
il-l	ill
awhile	a-while
slaver	slav-er
se-quoia	se-quoi-a
quadri-par-tite	quad-ri-par-tite
noisy	nois-y
drom-e-dary	drom-e-dar-y
carat	car-at
s-to-ry-book	sto-ry-book
spir-i-tu-al-is-m	spir-it-u-al-ism
c-etacean	ce-ta-cean
con-tem-po-rary	con-tem-po-rar-y
cari-bou	car-i-bou
en-vi-ron-men-tal-is-m	en-vi-ron-men-tal-ism
ap-pre-cia-ble	ap-pre-ci-a-ble
mata-dor	mat-a-dor
io-ta	i-o-ta
quasar	qua-sar
paving	pav-ing
plu-ral-is-m	plu-ral-ism
bio-sphere	bi-o-sphere
he-li-copter	hel-i-cop-ter
en-chanter	en-chant-er
k-in-folk	kin-folk
can-ni-bal-is-m	can-ni-bal-ism
y-acht-ing	yacht-ing
avarice	av-a-rice
pa-gan-is-m	pa-gan-ism
tele-o-log-i-cal	tel-e-o-log-i-cal
oner-ous	on-er-ous
over-anx-ious	o-ver-anx-ious
s-lick	slick
s-pa-tial-ly	spa-tial-ly
pan-the-is-m	pan-the-ism
mis-er-able	mis-er-a-ble
zigza-g	zig-zag
s-tan-za	stan-za
sil-very	sil-ver-y
piti-ful-ly	pit-i-ful-ly
scrip-t	script
pro-pel-lan-t	pro-pel-lant
dis-moun-t	dis-mount
or-nithol-o-gist	or-ni-thol-o-gist
racist	rac-ist
elec-tro-mo-tive	e-lec-tro-mo-tive
odor-if-er-ous	o-dor-if-er-ous
u-p-lift-ing	up-lift-ing
wiz-ardry	wiz-ard-ry
dis-ori-en-ta-tion	dis-o-ri-en-ta-tion
wilder-ness	wil-der-ness
de-sir-abil-i-a	de-si-ra-bi-li-a
apery	ap-er-y
hobo	ho-bo
apol-o-gy	a-pol-o-gy
in-tu-itive-ly	in-tu-i-tive-ly
ac-ci-den-t	ac-ci-dent
milk-shake	milkshake
copy-cat	cop-y-cat
syn-onym	syn-o-nym
t-inc-ture	tinc-ture
calder-a	cal-de-ra
yokel	yo-kel
rel-a-tivis-m	rel-a-tiv-ism
in-fante	in-fan-te
mousy	mous-y
im-po-ten-t	im-po-tent
re-port-ed	reported
mil-lenar-i-an	mil-le-nar-i-an
u-p-end-ed	upended
colobus	col-o-bus
foot-balling	foot-ball-ing
per-cip-i-en-t	per-cip-i-ent
en-chantress	en-chant-ress
zany	za-ny
nonen-ti-ty	non-en-ti-ty
re-luc-tan-t	re-luc-tant
laven-der	lav-en-der
giro	gi-ro
monarch	mon-arch
sarong	sa-rong
s-paniel	span-iel
in-ter-atom-ic	in-ter-a-tom-ic
refugee	ref-u-gee
up-fron-t	up-front
in-de-fin-able	in-de-fin-a-ble
s-tiff-ness	stiff-ness
ra-tio-nal-ist	ra-tion-al-ist
haven	ha-ven
saunter	saun-ter
shunter	shunt-er
domi-no	dom-i-no
d-if-fu-siv-i-ty	dif-fu-siv-i-ty
wiry	wir-y
s-lob-ber	slob-ber
freely	free-ly
s-trate-gist	strat-e-gist
re-gion-al-is-m	re-gion-al-ism
sahib	sa-hib
undis-tin-guished	un-dis-tin-guished
pity	pit-y
in-jury	in-ju-ry
halite	hal-ite
de-scen-dan-t	de-scend-ant
di-rec-torate	di-rec-to-rate
yel-lowed	yellowed
the-atri-cal	the-at-ri-cal
gatepost	gate-post
s-tar-ship	star-ship
but-t	butt
vari-ate	var-i-ate
lithog-ra-phy	li-thog-ra-phy
ref-er-en-t	ref-er-ent
bacil-lus	ba-cil-lus
platy-pus	plat-y-pus
read-abil-i-ty	read-a-bil-i-ty
dahli-a	dahl-ia
mil-i-taris-tic	mil-i-ta-ris-tic
over-fil-l	o-ver-fill
con-tin-gen-t	con-tin-gent
weedy	weed-y
husky	hus-ky
ter-rapin	ter-ra-pin
l-it-i-gan-t	lit-i-gant
ni-troge-nous	ni-trog-e-nous
shal-l	shall
so-cioe-co-nom-ic	so-ci-o-ec-o-nom-ic
sibyl	sib-yl
cin-e-matog-ra-phy	cin-e-ma-tog-ra-phy
darter	dart-er
s-caled	scaled
gateau	ga-teau
s-naky	snak-y
ran-corous	ran-cor-ous
stinker	stink-er
n-ev-er	nev-er
hip-popota-mus	hip-po-pot-a-mus
crum-b	crumb
gro-cery	gro-cer-y
stapes	sta-pes
com-men-t	com-ment
s-plen-did	splen-did
dis-tin-guish-able	dis-tin-guish-a-ble
n-ode	node
seedy	seed-y
sophist	soph-ist
s-cor-er	scor-er
in-signi-a	in-sig-ni-a
o-belisk	ob-e-lisk
won-der-men-t	won-der-ment
es-capee	es-cap-ee
in-stinc-t	in-stinct
basil	bas-il
s-tok-er	stok-er
s-nug-ly	snug-ly
lit-toral	lit-to-ral
finick-y	fin-ick-y
c-it-i-zen-ship	cit-i-zen-ship
s-panker	spank-er
frigate	frig-ate
ar-chais-m	ar-cha-ism
s-porran	spor-ran
calami-ty	ca-lam-i-ty
com-ple-men-tary	com-ple-men-ta-ry
i-n-ad-ver-tent-ly	in-ad-vert-ent-ly
bol-stered	bolstered
ju-di-cia-ry	ju-di-ci-ar-y
awry	a-wry
cougar	cou-gar
in-valid	in-va-lid
lichen	li-chen
im-peri-um	im-pe-ri-um
cre-ativ-i-ty	cre-a-tiv-i-ty
un-de-sir-able	un-de-sir-a-ble
un-proven	un-prov-en
adop-t	a-dopt
hangar	hang-ar
ele-phan-tine	el-e-phan-tine
un-sea-son-ably	un-sea-son-a-bly
notepa-per	note-pa-per
omis-sion	o-mis-sion
balus-ter	bal-us-ter
gamy	gam-y
trap-s	traps
in-cor-rupt-ible	in-cor-rupt-i-ble
im-pass-able	im-pass-a-ble
con-struc-t	con-struct
al-l	all
s-tul-ti-fy	stul-ti-fy
do-h	doh
an-nal-s	an-nals
clam-p	clamp
s-tock-pile	stock-pile
spinet	spin-et
cheer-ing	cheering
draugh-t	draught
un-ob-jec-tion-able	un-ob-jec-tion-a-ble
im-pro-pri-ety	im-pro-pri-e-ty
the-atri-cal-i-ty	the-at-ri-cal-i-ty
paradig-mat-ic	par-a-dig-mat-ic
skul-dug-gery	skul-dug-ger-y
clink-ing	clin-king
pheas-an-t	pheas-ant
com-mer-cial-is-m	com-mer-cial-ism
con-fi-den-t	con-fi-dent
endgame	end-game
s-tate-hood	state-hood
neg-ligee	neg-li-gee
tyran-ni-cal	ty-ran-ni-cal
ex-porta-bil-i-ty	ex-por-ta-bi-li-ty
peas-an-t	peas-ant
o-rang-utan	o-rang-u-tan
curie	cu-rie
tol-er-an-t	tol-er-ant
p-ith	pith
taran-tu-la	ta-ran-tu-la
celiba-cy	cel-i-ba-cy
jalopy	ja-lop-y
transat-lantic	trans-at-lan-tic
harpist-s	har-pists
boun-teous	boun-te-ous
cata-ton-ic	cat-a-ton-ic
rhetoric	rhet-o-ric
an-cien-t	an-cient
iron-work-s	i-ron-works
payable	pay-a-ble
aloud	a-loud
bul-letin	bul-le-tin
flashy	flash-y
t-setse	tset-se
a-balone	ab-a-lo-ne
de-nial	de-ni-al
s-corn	scorn
con-tender	con-tend-er
he-do-nis-m	he-don-ism
es-cape-men-t	es-cape-ment
colosto-my	co-los-to-my
un-equiv-o-cal	un-e-quiv-o-cal
sain-t	saint
medi-ocrity	me-di-oc-ri-ty
banker	bank-er
con-juror	con-ju-ror
dessert	des-sert
dis-cor-dan-t	dis-cord-ant
d-ab-bing	dab-bing
re-formist	re-form-ist
hy-dro-elec-tric	hy-dro-e-lec-tric
skim-p	skimp
both-ered	bothered
mid-ship-s	mid-ships
over-rule	o-ver-rule
sawyer	saw-yer
nitwit	nit-wit
ruler	rul-er
us-able	us-a-ble
flu-vial	flu-vi-al
rheo-stat	rhe-o-stat
dili-gent-ly	dil-i-gent-ly
sandy	sand-y
babysit-ting	babysitting
en-comi-um	en-co-mi-um
builder	build-er
d-welling	dwell-ing
multi-na-tion-al	mul-ti-na-tion-al
sen-tinel	sen-ti-nel
pigsty	pig-sty
melanin	mel-a-nin
over-sized	o-ver-sized
knitwear	knit-wear
prosce-ni-um	pro-sce-ni-um
padre	pa-dre
gos-sipy	gos-sip-y
metronome	met-ro-nome
s-nip-ing	snip-ing
in-fras-truc-tural	in-fra-struc-tur-al
repro-bate	rep-ro-bate
prefer-men-t	pre-fer-ment
oxy-moron	ox-y-mo-ron
un-der-body	un-der-bod-y
s-tair-case	stair-case
tri-bunal	tri-bu-nal
over-view	o-ver-view
su-per-b	su-perb
aqualung	aq-ua-lung
dis-cor-dance	dis-cord-ance
cox-com-b	cox-comb
dero-ga-tion	der-o-ga-tion
gal-axy	gal-ax-y
un-spen-t	un-spent
tin-t	tint
prodi-gy	prod-i-gy
un-de-tectable	un-de-tect-a-ble
silent-ly	si-lent-ly
gra-tu-itous	gra-tu-i-tous
earnest	ear-nest
aback	a-back
rea-son-able	rea-son-a-ble
opi-um	o-pi-um
tuner	tun-er
tiler	til-er
hadron	had-ron
unchris-tian	un-chris-tian
over-joyed	o-ver-joyed
renum-ber	re-num-ber
roundel	roun-del
bereft	be-reft
s-tock	stock
untest-ed	un-test-ed
heifer	heif-er
u-n-aligned	un-a-ligned
de-vel-op-men-t	de-vel-op-ment
artist	art-ist
freighter	freight-er
mala-chite	mal-a-chite
vam-p	vamp
leaky	leak-y
serendip-i-tous	ser-en-dip-i-tous
moral-is-m	mor-al-ism
s-ce-nari-o	sce-nar-i-o
query	que-ry
boa	bo-a
rainy	rain-y
mi-crochip	mi-cro-chip
un-watch-able	un-watch-a-ble
s-parse-ly	sparse-ly
k-i-nase	ki-nase
elu-ci-da-tion	e-lu-ci-da-tion
over-long	o-ver-long
in-vestor	in-ves-tor
py-rotech-nic-s	py-ro-tech-nics
s-lump	slump
re-searcher	re-search-er
be-liev-able	be-liev-a-ble
epicy-cloid	ep-i-cy-cloid
pala-tine	pal-a-tine
bidi-rec-tion-al	bi-di-rec-tion-al
peri-toneum	per-i-to-ne-um
scrip-tural	scrip-tur-al
pala-tial	pa-la-tial
s-tair-well	stair-well
plaza	pla-za
s-mudge	smudge
im-per-ish-able	im-per-ish-a-ble
are-na	a-re-na
im-mun-od-e-fi-cien-cy	im-mu-no-de-fi-cien-cy
paral-y-sis	pa-ral-y-sis
causal-i-ty	cau-sal-i-ty
across	a-cross
balder-dash	bal-der-dash
im-mea-sur-ably	im-meas-ur-a-bly
epit-o-me	e-pit-o-me
s-lag	slag
morale	mo-rale
s-tove	stove
s-noop	snoop
neon	ne-on
un-buried	un-bur-ied
tubu-lar	tu-bu-lar
eosin	e-o-sin
nether	neth-er
i-n-ac-ti-va-tion	in-ac-ti-va-tion
sadis-tic	sa-dis-tic
springer	spring-er
pro-mul-gate	prom-ul-gate
bio-chem-i-cal	bi-o-chem-i-cal
roughshod	rough-shod
overem-pha-sis	o-ver-em-pha-sis
decor	de-cor
greasy	greas-y
bil-iary	bil-i-ar-y
overkil-l	o-ver-kill
dumb-found-ed	dumbfounded
mag-ne-sium	mag-ne-si-um
philoso-pher	phi-los-o-pher
h-es-i-tan-t	hes-i-tant
s-core-less	score-less
pan-t	pant
daf-fodil	daf-fo-dil
er-gonom-ic	er-go-nom-ic
eigen-state	ei-gen-state
dais	da-is
dipole	di-pole
el-dest	eld-est
teenaged	teen-aged
fet-tered	fettered
s-torm-ing	storm-ing
mar-itime	mar-i-time
k-nap-sack	knap-sack
dil-l	dill
gin-sen-g	gin-seng
s-pa-tial	spa-tial
cobalt	co-balt
af-fec-t	af-fect
ethno-graph-ic	eth-no-graph-ic
in-haler	in-hal-er
triv-ial	triv-i-al
ep-silon	ep-si-lon
lazi-ly	la-zi-ly
p-reser-va-tive	pre-serv-a-tive
en-trap-men-t	en-trap-ment
e-pochal	ep-och-al
e-co-log-i-cal-ly	ec-o-log-i-cal-ly
dimwit	dim-wit
te-dious	te-di-ous
tele-vi-sion	tel-e-vi-sion
dele-te-ri-ous	del-e-te-ri-ous
duc-t	duct
miniskirt	min-i-skirt
apho-ris-m	aph-o-rism
u-niden-ti-fi-able	un-i-den-ti-fi-a-ble
madras	mad-ras
transep-t	tran-sept
in-cite-men-t	in-cite-ment
menswear	mens-wear
creduli-ty	cre-du-li-ty
s-pate	spate
g-ly-col	gly-col
odd-s	odds
boot-s	boots
propane	pro-pane
re-len-t	re-lent
i-n-ac-cu-rate	in-ac-cu-rate
minke	min-ke
bud-get	budg-et
car-dio-vas-cu-lar	car-di-o-vas-cu-lar
net-work-ing	networking
serum	se-rum
war-ran-t	war-rant
navvy	nav-vy
con-strain-t	con-straint
l-o-go	lo-go
an-tibi-ot-ic	an-ti-bi-ot-ic
unin-su-lat-ed	un-in-su-lat-ed
dotage	dot-age
cor-duroy	cor-du-roy
fool-ery	fool-er-y
asym-me-try	a-sym-me-try
res-cuer	res-cu-er
im-muno-sup-pres-sion	im-mu-no-sup-pres-sion
in-con-testable	in-con-test-a-ble
om-ni-science	om-nis-cience
dishy	dish-y
trage-di-an	tra-ge-di-an
en-vi-ron-men-t	en-vi-ron-ment
piv-otal	piv-ot-al
legume	leg-ume
coitus	co-i-tus
Words with errors: 2270
Words with incorrect number of syllables: 2075
Total evluated: 6500
Perfect accuracy: 0.65
Number of syllables accuracy: 0.68
Average Levenshtein Distance(across incorrect words): 1.21
