Attempt	Real
jeop-ardy	jeop-ard-y
de-served-ly	de-serv-ed-ly
con-ti-nen-t	con-ti-nent
re-cidi-vist	re-cid-i-vist
in-cisor	in-ci-sor
arabesque	ar-a-besque
vengeance	venge-ance
willpow-er	will-pow-er
s-to-ical	sto-i-cal
t-in-pot	tin-pot
seizure	sei-zure
un-us-able	un-us-a-ble
pyra-mi-dal	py-ram-i-dal
re-moval	re-mov-al
u-n-avail-able	un-a-vail-a-ble
wa-terbed	wa-ter-bed
stealth-ily	stealth-i-ly
bio-sphere	bi-o-sphere
mighty	might-y
sober-ly	so-ber-ly
s-culp-tor	sculp-tor
at-temp-t	at-tempt
dumb-bel-l	dumb-bell
lan-der	land-er
k-i-na	ki-na
hereto-fore	here-to-fore
sacral	sa-cral
no-ti-fi-able	no-ti-fi-a-ble
u-nas-sum-ing	un-as-sum-ing
over-spend	o-ver-spend
t-suna-mi	tsu-na-mi
grassy	grass-y
re-minder	re-mind-er
huf-f	huff
cir-cum-ven-t	cir-cum-vent
s-tun-ning-ly	stun-ning-ly
hearti-ly	heart-i-ly
guille-mot	guil-le-mot
dancer	danc-er
s-nooze	snooze
frilli-er	fril-li-er
b-otany	bot-a-ny
askance	a-skance
kinky	kink-y
philis-tine	phil-is-tine
vi-bran-t	vi-brant
e-quinox	e-qui-nox
psy-choso-cial	psy-cho-so-cial
lan-guorous	lan-guor-ous
gen-uine-ly	gen-u-ine-ly
per-cu-ta-neous	per-cu-ta-ne-ous
biki-ni	bi-ki-ni
pedes-tri-an	pe-des-tri-an
steadi-ly	stead-i-ly
chaot-ic	cha-ot-ic
car-borun-dum	car-bo-run-dum
per-for-m	per-form
s-cant	scant
prophet-ic	pro-phet-ic
tor-ren-t	tor-rent
servi-tude	ser-vi-tude
chintzy	chintz-y
heron	her-on
car-cino-genic	car-cin-o-gen-ic
s-trait-ened	strait-ened
thyris-tor	thy-ris-tor
iso-lat-ing	i-so-lat-ing
medusa	me-du-sa
benef-i-cen-t	be-nef-i-cent
nico-tine	nic-o-tine
lano-lin	lan-o-lin
avari-cious	av-a-ri-cious
gigo-lo	gig-o-lo
tetrox-ide	te-trox-ide
z-inc	zinc
s-tu-pe-fac-tion	stu-pe-fac-tion
de-scen-t	de-scent
en-cam-p	en-camp
per-ish-able	per-ish-a-ble
lama	la-ma
over-ac-tive	o-ver-ac-tive
bil-liard-s	bil-liards
ex-cel-len-t	ex-cel-lent
im-pe-cu-nious	im-pe-cu-ni-ous
d-u-al-is-tic	du-al-is-tic
chop-s	chops
aor-ta	a-or-ta
ig-no-ran-t	ig-no-rant
ben-e-fi-cia-ry	ben-e-fi-ci-ar-y
s-loth	sloth
axle	ax-le
in-vest-men-t	in-vest-ment
u-topi-a	u-to-pi-a
deliri-ous	de-lir-i-ous
im-pon-der-able	im-pon-der-a-ble
s-now-man	snow-man
over-step	o-ver-step
relic-t	rel-ict
vi-o-len-t	vi-o-lent
in-quisi-tor	in-quis-i-tor
matin-s	mat-ins
ex-pec-tant-ly	ex-pect-ant-ly
ru-ined	ruined
sen-ti-men-t	sen-ti-ment
man-telshelf	man-tel-shelf
kril-l	krill
plan-t	plant
un-con-trol-lable	un-con-trol-la-ble
s-train	strain
e-d-u-ca-tion-al	ed-u-ca-tion-al
bes-tial-i-ty	bes-ti-al-i-ty
in-tac-t	in-tact
s-pank	spank
tangy	tang-y
s-mog-gy	smog-gy
in-con-gruity	in-con-gru-i-ty
d-if-fuse	dif-fuse
who-dunit	who-dun-it
in-fantry-man	in-fan-try-man
me-te-orite	me-te-or-ite
tremen-dous	tre-men-dous
salmon	salm-on
chee-ri-o	cheer-i-o
harpist	har-pist
be-trothal	be-troth-al
u-n-alike	un-a-like
famine	fam-ine
er-ro-neous-ly	er-ro-ne-ous-ly
re-sel-l	re-sell
chid-ing	chiding
thrifty	thrift-y
iso-lat-ed	i-so-lat-ed
i-nani-ty	in-an-i-ty
g-lut-tony	glut-ton-y
await	a-wait
cor-rec-t	cor-rect
ul-tra-son-ic-s	ul-tra-son-ics
dis-tric-t	dis-trict
pesti-len-tial	pes-ti-len-tial
palu-dal	pa-lu-dal
ap-pre-cia-ble	ap-pre-ci-a-ble
legu-mi-nous	le-gu-mi-nous
so-cioe-co-nom-ic	so-ci-o-ec-o-nom-ic
mag-netite	mag-net-ite
can-non-bal-l	can-non-ball
felon	fel-on
laud-s	lauds
hep-tagon	hep-ta-gon
d-ab-ble	dab-ble
lig-and	li-gand
im-pa-tien-t	im-pa-tient
heretic	her-e-tic
un-de-vel-ope-d	un-de-vel-oped
re-peat-able	re-peat-a-ble
judg-men-t	judg-ment
preter-nat-u-ral	pre-ter-nat-u-ral
capri-ole	cap-ri-ole
s-ta-tus	sta-tus
pi-ran-ha	pi-ra-nha
layabout	lay-a-bout
perime-ter	pe-rim-e-ter
de-spon-den-cy	de-spond-en-cy
aper-ture	ap-er-ture
gin-sen-g	gin-seng
woodsmoke	wood-smoke
s-log	slog
gleam-ing	gleaming
his-tamine	his-ta-mine
pira-cy	pi-ra-cy
k-lax-on	klax-on
raider	raid-er
par-tic-i-pan-t	par-tic-i-pant
in-spec-torate	in-spec-tor-ate
over-cast	o-ver-cast
celandine	cel-an-dine
ex-pand-able	ex-pand-a-ble
coun-terof-fen-sive	coun-ter-of-fen-sive
s-tair-head	stair-head
leapfrog	leap-frog
gos-samer	gos-sa-mer
mantra	man-tra
golfer	golf-er
prepa-ra-tion	prep-a-ra-tion
re-cov-ery	re-cov-er-y
palm-istry	palm-is-try
colon	co-lon
fo-men-t	fo-ment
lin-eage	lin-e-age
frothy	froth-y
triv-ial	triv-i-al
gullible	gul-li-ble
pre-de-ter-mined	predetermined
green-ery	green-er-y
tetra	tet-ra
en-tomb-men-t	en-tomb-ment
wash-able	wash-a-ble
meta-lan-guage	met-a-lan-guage
s-ports-man-ship	sports-man-ship
dis-com-fort-ing	discomforting
con-fi-dan-t	con-fi-dant
chi-canery	chi-can-er-y
serif	ser-if
in-ten-t	in-tent
caiman	cai-man
need-s	needs
n-ev-er-the-less	nev-er-the-less
bribery	brib-er-y
overqual-i-fied	o-ver-qual-i-fied
pre-dictabil-i-ty	pre-dict-a-bil-i-ty
parachutist	par-a-chut-ist
delux-e	de-luxe
carouse	ca-rouse
de-port-men-t	de-port-ment
paraglid-ing	par-a-glid-ing
navvy	nav-vy
em-bar-rass-men-t	em-bar-rass-ment
u-nashamed-ly	un-a-sham-ed-ly
un-buried	un-bur-ied
k-ing-dom	king-dom
prosce-ni-um	pro-sce-ni-um
es-cu-d-o	es-cu-do
lazi-ness	la-zi-ness
s-ingsong	sing-song
gallery	gal-ler-y
mis-nomer	mis-no-mer
repli-ca-tion	rep-li-ca-tion
colobus	col-o-bus
geo-physic-s	ge-o-phys-ics
shal-l	shall
ar-guably	ar-gu-a-bly
untest-ed	un-test-ed
s-tran-gle-hold	stran-gle-hold
gloat-ing	gloating
cater	ca-ter
leather	leath-er
raspy	rasp-y
sawmil-l	saw-mill
ir-re-sistible	ir-re-sist-i-ble
codex	co-dex
anx-i-ety	anx-i-e-ty
re-pel-len-t	re-pel-lent
break-away	break-a-way
in-ces-t	in-cest
aqua-naut	aq-ua-naut
con-temptible	con-tempt-i-ble
pol-lu-tan-t	pol-lu-tant
satir-i-cal	sa-tir-i-cal
panoply	pan-o-ply
un-re-solv-able	un-re-solv-a-ble
dud-geon	dudg-eon
man-ganese	man-ga-nese
mas-tery	mas-ter-y
killing	kill-ing
nosy	nos-y
e-m-anate	em-a-nate
repa-tri-a-tion	re-pa-tri-a-tion
s-pan-gled	spangled
cus-tody	cus-to-dy
s-luice	sluice
pom-padour	pom-pa-dour
over-work	o-ver-work
callable	call-a-ble
e-pochal	ep-och-al
my-opic	my-op-ic
rubric	ru-bric
short-ter-m	short-term
im-petu-ous	im-pet-u-ous
mil-i-tan-t	mil-i-tant
frica-tive	fric-a-tive
cara-pace	car-a-pace
tute-lage	tu-te-lage
un-bo-som	un-bos-om
quif-f	quiff
s-tud-ded	stud-ded
ter-ror-is-m	ter-ror-ism
corol-lary	cor-ol-lar-y
vari-a-tion	var-i-a-tion
ex-ecu-tor	ex-ec-u-tor
learned	learn-ed
re-fin-ery	re-fin-er-y
in-ter-plan-e-tary	in-ter-plan-e-tar-y
dat-able	dat-a-ble
lumpen	lum-pen
aware	a-ware
gateau	ga-teau
meaty	meat-y
u-n-ap-pre-ci-at-ed	un-ap-pre-ci-at-ed
poly-chrome	pol-y-chrome
geno-ci-dal	gen-o-cid-al
un-trans-lat-able	un-trans-lat-a-ble
roughage	rough-age
lyrist	lyr-ist
wave-fron-t	wave-front
squin-t	squint
cerise	ce-rise
cov-etous	cov-et-ous
at-tempt-ed	at-temp-ted
physi-cist	phys-i-cist
war-m	warm
an-nounce-men-t	an-nounce-ment
tractable	trac-ta-ble
s-ta-tion	sta-tion
im-muno-sup-pres-sion	im-mu-no-sup-pres-sion
hooky	hook-y
par-al-lelepiped	par-al-lel-e-pi-ped
elec-tro-dy-nam-ic-s	e-lec-tro-dy-nam-ics
s-i-nu-soid	si-nus-oid
on-slaugh-t	on-slaught
dis-ori-ent-ed	disoriented
com-pen-dium	com-pen-di-um
draught-s	draughts
metaphor-i-cal	met-a-phor-i-cal
de-liv-ery	de-liv-er-y
necrop-o-lis	ne-crop-o-lis
ra-tio-nale	ra-tion-ale
macro-cos-m	mac-ro-cosm
renum-ber	re-num-ber
pen-i-ten-tiary	pen-i-ten-tia-ry
aven-s	av-ens
pur-veyance	pur-vey-ance
e-choic	e-cho-ic
ex-cus-able	ex-cus-a-ble
novice	nov-ice
punch-line	punchline
au-thoress	au-thor-ess
drama-tist	dram-a-tist
me-galith-ic	meg-a-lith-ic
d-u-al	du-al
quartzite	quartz-ite
dis-ori-en-ta-tion	dis-o-ri-en-ta-tion
re-plan-t	re-plant
mono-gram	mon-o-gram
polypho-ny	po-lyph-o-ny
very	ver-y
e-s-pe-cial	es-pe-cial
dis-burse-men-t	dis-burse-ment
overuse	o-ver-use
hy-drangea	hy-dran-gea
vari-ant	var-i-ant
s-traight-away	straight-a-way
au-dio	au-di-o
s-tiffly	stiff-ly
dis-en-fran-chise-men-t	dis-en-fran-chise-ment
purga-tive	pur-ga-tive
car-boxyl	car-box-yl
baldy	bald-y
con-fine-men-t	con-fine-ment
re-deemer	re-deem-er
s-cis-sors	scis-sors
han-dover	hand-o-ver
trans-former	trans-form-er
bo-som	bos-om
ei-de-t-ic	ei-det-ic
u-nassertive	un-as-ser-tive
s-pace-craft	space-craft
lega-tion	le-ga-tion
ar-rival	ar-ri-val
frizzy	friz-zy
at-ten-dan-t	at-tend-ant
sum-mery	sum-mer-y
mori-bund	mor-i-bund
pep-pered	peppered
un-gentle-man-ly	un-gen-tle-man-ly
silken	silk-en
ban-ish-men-t	ban-ish-ment
liken	lik-en
s-trate-gist	strat-e-gist
fetid	fet-id
hedgerow	hedge-row
transna-tion-al	trans-na-tion-al
messy	mess-y
fore-stal-l	fore-stall
con-tes-tant	con-test-ant
s-tim-u-late	stim-u-late
imag-i-na-tion	im-ag-i-na-tion
promp-t	prompt
gen-i-tali-a	gen-i-ta-li-a
mayfly	may-fly
hermeneu-tic	her-me-neu-tic
om-nipres-ence	om-ni-pres-ence
qui-eten	qui-et-en
s-tub-born-ly	stub-born-ly
nut-s	nuts
toma-to	to-ma-to
lit-er-al-is-m	lit-er-al-ism
re-vam-p	re-vamp
razzmataz-z	razz-ma-tazz
g-naw-ing	gnaw-ing
so-ciopo-lit-i-cal	so-ci-o-po-lit-i-cal
wolfhound	wolf-hound
in-stan-ta-neous	in-stan-ta-ne-ous
des-orp-tion	de-sorp-tion
mau-soleum	mau-so-le-um
re-s-e-lect-ed	re-se-lected
avi-a-tion	a-vi-a-tion
tequi-la	te-qui-la
per-son-a	per-so-na
pit-fal-l	pit-fall
puffy	puf-fy
un-san-i-tary	un-san-i-tar-y
un-men-tion-able	un-men-tion-a-ble
g-lycine	gly-cine
mono-syl-la-ble	mon-o-syl-la-ble
tar-if-f	tar-iff
os-tracis-m	os-tra-cism
sa-tanis-m	sa-tan-ism
grand-par-en-t	grand-par-ent
pullover	pull-o-ver
non-pay-men-t	non-pay-ment
aor-tic	a-or-tic
astrad-dle	a-strad-dle
e-u-pho-nious	eu-pho-ni-ous
pla-gia-ris-m	pla-gia-rism
over-reach	o-ver-reach
u-n-aligned	un-a-ligned
di-eti-tian	di-e-ti-tian
quater-nion	qua-ter-ni-on
eater	eat-er
sonorous	so-no-rous
wastage	wast-age
e-cono-met-ric-s	e-con-o-met-rics
seg-ment-ed	seg-men-ted
sahib	sa-hib
wa-ter-fal-l	wa-ter-fall
shifter	shift-er
stylish-ly	styl-ish-ly
con-demned	condemned
re-coun-t	re-count
lurk-ing	lurking
bio-chem-i-cal	bi-o-chem-i-cal
torus	to-rus
tem-po-rary	tem-po-rar-y
mus-cle-d	mus-cled
fungi-cide	fun-gi-cide
unini-ti-at-ed	un-in-i-ti-at-ed
con-nivance	con-niv-ance
s-parkler	spar-kler
troglodyte	trog-lo-dyte
con-denser	con-dens-er
ma-chete	ma-chet-e
dis-claimer	dis-claim-er
dis-traugh-t	dis-traught
un-print-able	un-print-a-ble
re-versible	re-vers-i-ble
i-a-tro-genic	i-at-ro-gen-ic
s-tormer	storm-er
id-io-cy	id-i-o-cy
sep-a-ratism	sep-a-ra-tism
s-low-ness	slow-ness
s-cat	scat
per-mit-ting	permitting
parochial	pa-ro-chi-al
light-s	lights
drudgery	drudg-er-y
con-queror	con-quer-or
cir-cling	circling
i-n-or-di-nate-ly	in-or-di-nate-ly
as-sis-tan-t	as-sis-tant
in-can-t	in-cant
table-cloth	ta-ble-cloth
e-mis-sary	em-is-sar-y
squalid	squal-id
s-lip-per-i-ness	slip-per-i-ness
fruity	fruit-y
over-re-ac-t	o-ver-re-act
s-tu-pe-fy	stu-pe-fy
pout-ing	pouting
s-noop-ing	snooping
an-te-dilu-vian	an-te-di-lu-vi-an
needle-work	nee-dle-work
hero-ic	he-ro-ic
prospec-tus	pro-spec-tus
mono-plane	mon-o-plane
s-lice	slice
wimpy	wimp-y
s-coop	scoop
resti-tu-tion	res-ti-tu-tion
tou-sled	tousled
i-n-or-gan-ic	in-or-gan-ic
doorstop	door-stop
im-pru-den-t	im-pru-dent
in-com-men-su-rable	in-com-men-su-ra-ble
glaciat-ed	gla-ci-at-ed
ef-ful-gen-t	ef-ful-gent
idly	i-dly
s-naky	snak-y
edi-tion	e-di-tion
procla-ma-tion	proc-la-ma-tion
risky	risk-y
minibus	min-i-bus
re-de-ploy-men-t	re-de-ploy-ment
turfy	turf-y
ovoid	o-void
py-rotech-nic	py-ro-tech-nic
i-n-ap-pro-pri-ate	in-ap-pro-pri-ate
foot-fal-l	foot-fall
catal-y-sis	ca-tal-y-sis
molten	mol-ten
sub-stan-dard	sub-stand-ard
s-lope-d	sloped
redo-len-t	red-o-lent
clema-tis	clem-a-tis
sub-ur-bia	sub-ur-bi-a
im-moral	im-mor-al
de-monolo-gy	de-mon-ol-o-gy
edgy	edg-y
shaman	sha-man
au-tum-n	au-tumn
sleepi-ness	sleep-i-ness
s-trat-e-gy	strat-e-gy
re-tini-tis	ret-i-ni-tis
in-de-ter-minable	in-de-ter-mi-na-ble
s-trag-gly	strag-gly
hero-in	her-o-in
thorny	thorn-y
elec-t	e-lect
napoleon	na-po-le-on
my-ocar-dial	my-o-car-di-al
fe-lic-i-ta-tion-s	fe-lic-i-ta-tions
pub-lished	published
shad-owy	shad-ow-y
s-tock-y	stock-y
u-n-ap-proach-able	un-ap-proach-a-ble
count-able	count-a-ble
feath-ery	feath-er-y
caramel	car-a-mel
u-n-af-fect-ed	un-af-fect-ed
y-acht-ing	yacht-ing
kriegspiel	krieg-spiel
poly-eth-yl-ene	pol-y-eth-yl-ene
busy	bus-y
man-darin	man-da-rin
lin-guis-tic-s	lin-guis-tics
s-tranger	stran-ger
pasty	past-y
u-n-adorned	un-a-dorned
as-cetic	as-cet-ic
puz-zle-men-t	puz-zle-ment
hul-la-baloo	hul-la-ba-loo
ringlet	ring-let
an-thro-pogenic	an-thro-po-gen-ic
mas-sacre	mas-sa-cre
marten	mar-ten
dis-union	dis-un-ion
sign-er-s	sign-ers
col-lapsi-ble	col-laps-i-ble
ob-stet-ric-s	ob-stet-rics
s-lip-per	slip-per
milky	milk-y
be-atif-ic	be-a-tif-ic
aro-ma	a-ro-ma
of-fend-ing	of-fen-ding
s-trange-ness	strange-ness
iron-mon-ger	i-ron-mon-ger
beanstalk	bean-stalk
lieu-tenan-t	lieu-ten-ant
psy-chopath	psy-cho-path
plan-e-tary	plan-e-tar-y
buoy	bu-oy
elec-troneg-a-tive	e-lec-tro-neg-a-tive
viaduc-t	vi-a-duct
on-ag-er	on-a-ger
greasy	greas-y
turn-about	turn-a-bout
pro-tean	pro-te-an
s-nig-ger	snig-ger
sailor	sail-or
banker	bank-er
s-core	score
ir-re-deemable	ir-re-deem-a-ble
e-vanes-cen-t	ev-a-nes-cent
lam-ben-t	lam-bent
re-main-s	re-mains
s-tand-by	stand-by
puffer	puff-er
tonal-i-ty	to-nal-i-ty
teach-able	teach-a-ble
dil-l	dill
fiery	fier-y
s-nuf-fle	snuf-fle
scrapie	scrap-ie
ob-serv-able	ob-serv-a-ble
spi-ran-t	spi-rant
sol-ven-t	sol-vent
premise	prem-ise
s-pear-head	spear-head
curvi-lin-ear	cur-vi-lin-e-ar
over-load	o-ver-load
neonate	ne-o-nate
s-tomp-ing	stomp-ing
thril-l	thrill
coinage	coin-age
ir-re-triev-ably	ir-re-triev-a-bly
mono	mon-o
detox-i-fi-ca-tion	de-tox-i-fi-ca-tion
con-tac-t	con-tact
ren-dered	rendered
es-trange-men-t	es-trange-ment
projec-t	proj-ect
re-in-state-men-t	re-in-state-ment
con-comi-tan-t	con-com-i-tant
struc-tural	struc-tur-al
n-erve-less	nerve-less
politic	pol-i-tic
se-quen-t	se-quent
undi-min-ished	un-di-min-ished
busi-ly	bus-i-ly
bloomer	bloom-er
s-link	slink
hu-manoid	hu-man-oid
over-drive	o-ver-drive
qua-train	quat-rain
nonex-is-tence	non-ex-ist-ence
di-aphanous	di-aph-a-nous
eu-kary-ote	eu-kar-y-ote
leisurewear	lei-sure-wear
timid-ly	tim-id-ly
sedi-tion	se-di-tion
des-tiny	des-ti-ny
loosen	loos-en
so-lace	sol-ace
c-holes-terol	cho-les-ter-ol
over-crowd	o-ver-crowd
lar-ynx-es	la-rynx-es
so-cial-is-m	so-cial-ism
ar-rester	ar-rest-er
e-n-ac-t	en-act
pro-trac-t	pro-tract
over-spill	o-ver-spill
bio-met-ric-s	bi-o-met-rics
opac-i-ty	o-pac-i-ty
u-nas-suaged	un-as-suaged
tourist	tour-ist
mys-tery	mys-ter-y
cys-teine	cys-te-ine
d-elec-ta-tion	de-lec-ta-tion
ra-dia-tive	ra-di-a-tive
b-o-rax	bo-rax
ante	an-te
debonair	deb-o-nair
opales-cen-t	o-pal-es-cent
aquiline	aq-ui-line
raven	ra-ven
gable	ga-ble
habi-ta-tion	hab-i-ta-tion
re-cov-er-able	re-cov-er-a-ble
e-d-uca-tive	ed-u-ca-tive
az-imuth	az-i-muth
her-i-tabil-i-ty	her-it-a-bil-i-ty
poundage	pound-age
un-ob-jec-tion-able	un-ob-jec-tion-a-ble
ac-t	act
dis-avow-al	dis-a-vow-al
ful-l	full
dugout	dug-out
epis-tle	e-pis-tle
s-tock-ist	stock-ist
bleary	blear-y
over-dose	o-ver-dose
an-ti-body	an-ti-bod-y
k-ismet	kis-met
tightrope	tight-rope
geosyn-chronous	ge-o-syn-chro-nous
di-gester	di-gest-er
gantry	gan-try
avid	av-id
pyra-mid	pyr-a-mid
waster	wast-er
catch-men-t	catch-ment
specif-i-cal-ly	spe-cif-i-cal-ly
re-mis-s	re-miss
s-cotch	scotch
brawny	brawn-y
satin	sat-in
en-rol-l	en-roll
mega-volt	meg-a-volt
in-sis-tence	in-sist-ence
s-culp-tress	sculp-tress
un-clas-si-fi-able	un-clas-si-fi-a-ble
canal	ca-nal
craven	cra-ven
blender	blend-er
brasserie	bras-se-rie
de-gauss-ing	degaussing
over-laden	o-ver-lad-en
ro-tary	ro-ta-ry
mul-ti-plica-tive	mul-ti-pli-ca-tive
un-fa-mil-iar-i-ty	un-fa-mil-i-ar-i-ty
limo	lim-o
ra-tio-nal-i-ty	ra-tion-al-i-ty
tiger-ish	ti-ger-ish
s-courge	scourge
cre-ation-ist	cre-a-tion-ist
shiv-er-ing	shivering
query	que-ry
valid-ly	val-id-ly
fire-bal-l	fire-ball
payable	pay-a-ble
prefer-men-t	pre-fer-ment
s-plat	splat
hostel-ry	hos-tel-ry
epi-dem-ic	ep-i-dem-ic
triplet	tri-plet
foolscap	fools-cap
s-port-ing-ly	sport-ing-ly
un-easy	un-eas-y
dis-cov-er-able	dis-cov-er-a-ble
codling	cod-ling
s-ta-tis-ti-cal-ly	sta-tis-ti-cal-ly
repos-i-to-ry	re-pos-i-to-ry
rasper	rasp-er
n-erd	nerd
bougainvil-lea	bou-gain-vil-le-a
n-u-mis-mat-ic-s	nu-mis-mat-ics
twisty	twist-y
cleanser	cleans-er
coleslaw	cole-slaw
bal-cony	bal-co-ny
enor-mous-ly	e-nor-mous-ly
in-so-len-t	in-so-lent
ap-t	apt
skimpy	skimp-y
forego	fore-go
ge-net-ic-s	ge-net-ics
wigeon	wig-eon
lin-t	lint
sim-per-ing	simpering
navel	na-vel
un-lac-ing	un-lacing
granny	gran-ny
in-ter-fer-e	in-ter-fere
bilin-gual-is-m	bi-lin-gual-ism
p-re-sen-ta-tion-al	pres-en-ta-tion-al
birthright	birth-right
pesti-lence	pes-ti-lence
u-nar-guable	un-ar-gu-a-ble
un-em-ploy-men-t	un-em-ploy-ment
charge-able	charge-a-ble
prowler	prowl-er
rose-mary	rose-mar-y
geri-atric-s	ger-i-at-rics
u-nion-ist	un-ion-ist
dyestuff	dye-stuff
far-m	farm
s-tri-at-ed	stri-at-ed
electro-mechan-i-cal	e-lec-tro-me-chan-i-cal
mae-stro	maes-tro
flick-er-ing	flickering
con-nect-ing	con-nec-ting
com-men-tary	com-men-tar-y
in-de-fati-ga-ble	in-de-fat-i-ga-ble
pro-po-nen-t	pro-po-nent
pe-ri-od-ic-i-ty	pe-ri-o-dic-i-ty
en-tourage	en-tou-rage
par-enter-al	par-en-ter-al
mega-lo-ma-ni-a	meg-a-lo-ma-ni-a
habit	hab-it
ren-dezvous	ren-dez-vous
u-ni-for-mi-ty	u-ni-form-i-ty
telling-ly	tell-ing-ly
erup-tive	e-rup-tive
geo-ther-mal	ge-o-ther-mal
in-ter-dic-t	in-ter-dict
schoolmistress	school-mis-tress
ridicu-lous	ri-dic-u-lous
s-ki	ski
ogle	o-gle
sen-sa-tion-al-is-m	sen-sa-tion-al-ism
aun-t	aunt
s-tat-ed	stat-ed
unglam-orous	un-glam-or-ous
rel-e-van-t	rel-e-vant
ex-huma-tion	ex-hu-ma-tion
hectare	hec-tare
re-as-sign-men-t	re-as-sign-ment
blur-b	blurb
atom-ic-i-ty	at-o-mic-i-ty
en-comi-um	en-co-mi-um
er-gonomic-s	er-go-nom-ics
stenog-ra-pher	ste-nog-ra-pher
en-doge-nous	en-dog-e-nous
cougar	cou-gar
g-lyph	glyph
xenon	xe-non
mul-l	mull
pe-cu-liar-i-ty	pe-cu-li-ar-i-ty
ril-l	rill
com-ple-men-t	com-ple-ment
s-lay-er	slay-er
wiring	wir-ing
tri-bunal	tri-bu-nal
s-lip-stream	slip-stream
genre	gen-re
hosan-na	ho-san-na
in-fir-mary	in-fir-ma-ry
trol-l	troll
mul-tira-cial	mul-ti-ra-cial
boater	boat-er
s-cur-rilous	scur-ril-ous
asleep	a-sleep
beach-comber	beach-comb-er
stopover	stop-o-ver
murky	murk-y
i-n-escapably	in-es-cap-a-bly
rudi-men-ta-ry	ru-di-men-ta-ry
d-if-fu-siv-i-ty	dif-fu-siv-i-ty
tru-is-m	tru-ism
ju-ridi-cal	ju-rid-i-cal
mort-gagor	mort-ga-gor
cud-gel	cudg-el
transep-t	tran-sept
vulpine	vul-pine
ex-ploita-tive	ex-ploit-a-tive
enor-mi-ty	e-nor-mi-ty
helpline	help-line
lethal-i-ty	le-thal-i-ty
ex-ul-tan-t	ex-ult-ant
vivi-sec-tion	viv-i-sec-tion
an-tipa-thy	an-tip-a-thy
ave	a-ve
hered-i-ty	he-red-i-ty
found-ing	founding
idio-syn-cratic	id-i-o-syn-crat-ic
num-b	numb
any-how	an-y-how
colonel	colo-nel
macro-scop-ic	mac-ro-scop-ic
balustrade	bal-us-trade
paradig-mat-ic	par-a-dig-mat-ic
re-cum-ben-t	re-cum-bent
clien-t	cli-ent
chro-matog-ra-phy	chro-ma-tog-ra-phy
bevy	bev-y
marshy	marsh-y
s-todgy	stodg-y
in-ves-tiga-tive	in-ves-ti-ga-tive
over-re-act-s	o-ver-re-acts
do-h	doh
su-per-tanker	su-per-tank-er
ar-m	arm
lantern	lan-tern
ex-or-cis-m	ex-or-cism
avail	a-vail
gillie	gil-lie
flutist	flut-ist
lofty	loft-y
tor-toise-shel-l	tor-toise-shell
her-itage	her-it-age
ro-den-t	ro-dent
pushy	push-y
loony	loon-y
soli-tude	sol-i-tude
oint-men-t	oint-ment
labi-um	la-bi-um
urchin	ur-chin
ridicu-lous-ly	ri-dic-u-lous-ly
apo-lit-i-cal	a-po-lit-i-cal
un-re-served-ly	un-re-serv-ed-ly
pre-ventable	pre-vent-a-ble
reach-able	reach-a-ble
unre-deemed	un-re-deemed
dev-il-men-t	dev-il-ment
catas-tro-phe	ca-tas-tro-phe
barter	bar-ter
y-outh	youth
u-nan-nounced	un-an-nounced
velour	ve-lour
tes-ta-men-t	tes-ta-ment
megabyte	meg-a-byte
s-lick	slick
record-ed	re-cor-ded
vagabond	vag-a-bond
in-vert-ed	inverted
facile	fac-ile
o-ver-seer	o-ver-se-er
opaque	o-paque
colos-sal	co-los-sal
tachy-car-dia	tach-y-car-di-a
stony	ston-y
precinc-t	pre-cinct
sub-lu-nary	sub-lu-nar-y
con-tigu-ous	con-tig-u-ous
k-nave	knave
gelig-nite	gel-ig-nite
con-stituen-t	con-stit-u-ent
de-cay-ing	decaying
encage	en-cage
p-saltery	psal-ter-y
buf-f	buff
de-file-men-t	de-file-ment
fo-liage	fo-li-age
no-table	no-ta-ble
over-whelm-ing	o-ver-whelm-ing
un-scrupu-lous	un-scru-pu-lous
an-tibi-ot-ic	an-ti-bi-ot-ic
over-lord	o-ver-lord
ar-gen-t	ar-gent
peachy	peach-y
s-niv-el	sniv-el
pick-ax-e	pick-axe
e-quip-men-t	e-quip-ment
wind-fal-l	wind-fall
de-scen-den-t	de-scend-ent
cafe-te-ri-a	caf-e-te-ri-a
dis-moun-t	dis-mount
anon	a-non
face-tious	fa-ce-tious
enu-mer-a-tor	e-nu-mer-a-tor
monoc-u-lar	mo-noc-u-lar
s-liv-er	sliv-er
u-n-awak-ened	un-a-wak-ened
reprisal	re-pris-al
dis-tan-t	dis-tant
ema-ci-at-ed	e-ma-ci-at-ed
crois-san-t	crois-sant
gun-metal	gun-met-al
bazooka	ba-zoo-ka
her-s	hers
eighty	eight-y
hater	hat-er
touristy	tour-ist-y
boast-ing	boas-ting
domi-cile	dom-i-cile
b-i-fur-ca-tion	bi-fur-ca-tion
ar-bore-tum	ar-bo-re-tum
thumbprint	thumb-print
de-tec-t	de-tect
more-over	more-o-ver
river-side	riv-er-side
chi-ropody	chi-rop-o-dy
pyri-dine	pyr-i-dine
he-li-cal	hel-i-cal
an-tipa-thet-ic	an-ti-pa-thet-ic
cir-cum-spec-t	cir-cum-spect
miniskirt	min-i-skirt
in-vi-o-lable	in-vi-o-la-ble
leath-ery	leath-er-y
beeswax	bees-wax
ranter	rant-er
cloa-ca	clo-a-ca
paragon	par-a-gon
whizkid-s	whizkids
lethal-ly	le-thal-ly
mas-cara	mas-car-a
fiendish	fiend-ish
ser-van-t	serv-ant
asi-nine	as-i-nine
phys-io-ther-a-pist	phys-i-o-ther-a-pist
overt-ly	o-vert-ly
cen-trifuge	cen-tri-fuge
fun-da-men-tal-is-m	fun-da-men-tal-ism
gu-nite	gun-ite
s-lop-py	slop-py
rooi-bos	roo-i-bos
per-e-stroi-ka	pe-re-stroi-ka
pe-riph-ery	pe-riph-er-y
short-s	shorts
gut-sy	guts-y
manger	man-ger
elec-tro	e-lec-tro
ini-tial-ly	in-i-tial-ly
weapon	weap-on
s-cathing	scath-ing
in-de-scrib-able	in-de-scrib-a-ble
sym-po-sium	sym-po-si-um
s-ta-tis-ti-cal	sta-tis-ti-cal
stag-ger-s	stag-gers
iron-ing	i-ron-ing
lazi-ly	la-zi-ly
sub-servience	sub-ser-vi-ence
s-tan-dard	stand-ard
com-mon-s	com-mons
per-fec-t	per-fect
re-gret-table	re-gret-ta-ble
s-lum	slum
undis-crim-i-nat-ing	un-dis-crim-i-nat-ing
frontal	fron-tal
anoin-t	a-noint
o-rang-utan	o-rang-u-tan
s-culp-tural	sculp-tur-al
k-itsch	kitsch
perky	perk-y
o-vary	o-va-ry
hy-gien-e	hy-giene
wringer	wring-er
s-mack	smack
con-juror	con-ju-ror
d-e-ductible	de-duct-i-ble
rev-o-lu-tion-ary	rev-o-lu-tion-ar-y
land-fil-l	land-fill
testable	test-a-ble
molec-u-lar	mo-lec-u-lar
b-lis-ter	blis-ter
pleat-ed	pleated
in-sou-ciant	in-sou-ci-ant
gatepost	gate-post
video-con-fer-enc-ing	vid-e-o-con-fer-enc-ing
sur-fac-tan-t	sur-fac-tant
arch-dio-cese	arch-di-o-cese
out-pa-tien-t	out-pa-tient
s-tair	stair
fluffy	fluff-y
ready	read-y
astray	a-stray
symp-to-matic	symp-to-mat-ic
babysit	ba-by-sit
welder	weld-er
falset-to	fal-set-to
ion-ic	i-on-ic
bul-l	bull
s-teed	steed
coun-ter-rev-o-lu-tion-ary	coun-ter-rev-o-lu-tion-ar-y
viceroy	vice-roy
painful-ly	pain-ful-ly
deroga-to-ry	de-rog-a-to-ry
de-cryp-t	de-crypt
hab-it-able	hab-it-a-ble
s-in-cer-i-ty	sin-cer-i-ty
trace-abil-i-ty	trace-a-bil-i-ty
nurs-ery	nurs-er-y
hardy	har-dy
event-ful	e-vent-ful
de-nial	de-ni-al
stil-l	still
c-on-cil-ia-tor	con-cil-i-a-tor
punter	punt-er
avarice	av-a-rice
crafty	craft-y
chom-p	chomp
ex-citable	ex-cit-a-ble
u-nimag-i-na-tive	un-im-ag-i-na-tive
thau-maturge	thau-ma-turge
pe-tit	pet-it
obey	o-bey
pri-apic	pri-ap-ic
panoram-ic	pan-o-ram-ic
elec-trol-y-sis	e-lec-trol-y-sis
mis-sy	miss-y
u-n-ac-count-able	un-ac-count-a-ble
iono-sphere	i-on-o-sphere
dotage	dot-age
nightlife	night-life
joyride	joy-ride
ex-is-ten-tial-is-m	ex-is-ten-tial-ism
chunky	chunk-y
re-phrases	re-phra-ses
bio-ta	bi-o-ta
beachy	beach-y
smithereen-s	smith-er-eens
antrum	an-trum
repli-ca-ble	rep-li-ca-ble
docile	doc-ile
semi-con-duc-tor	sem-i-con-duc-tor
in-hos-pitable	in-hos-pi-ta-ble
dis-cor-dance	dis-cord-ance
sealan-t	seal-ant
voyeuris-m	vo-yeur-ism
weasel	wea-sel
brazen	bra-zen
gal-lantry	gal-lant-ry
im-por-tan-t	im-por-tant
o-nion	on-ion
meta-mor-phic	met-a-mor-phic
in-flec-t	in-flect
steamy	steam-y
knowl-edge-able	knowl-edge-a-ble
retro	ret-ro
delic-t	de-lict
e-lo-cu-tion	el-o-cu-tion
af-fec-t	af-fect
ethanol	eth-a-nol
whiten	whit-en
teleg-ra-phy	te-leg-ra-phy
lizard	liz-ard
change-able	change-a-ble
repack-age	re-pack-age
ca-reerist	ca-reer-ist
blush-ing	blushing
api-an	a-pi-an
over-win-ter	o-ver-win-ter
pheas-an-t	pheas-ant
chem-istry	chem-is-try
gig-gling	giggling
as-so-cia-tive	as-so-ci-a-tive
talkie	talk-ie
groat-s	groats
charis-mat-ic	char-is-mat-ic
florid	flor-id
p-light	plight
re-order	re-or-der
melo-dra-mat-ic	mel-o-dra-mat-ic
fa-nati-cis-m	fa-nat-i-cism
pre-cau-tion-ary	pre-cau-tion-ar-y
jar-l	jarl
pun-y	pu-ny
monog-a-mous	mo-nog-a-mous
pelvis	pel-vis
avowed	a-vowed
gosling	gos-ling
d-well	dwell
shifty	shift-y
s-tate-men-t	state-ment
base-men-t	base-ment
quan-tifi-able	quan-ti-fi-a-ble
armpit	arm-pit
im-mutable	im-mu-ta-ble
e-n-act-men-t	en-act-ment
bar-bel-l	bar-bell
i-nane	in-ane
s-tave	stave
pharao-h	phar-aoh
s-tar-tling	star-tling
im-prison	im-pris-on
metaphor-i-cal-ly	met-a-phor-i-cal-ly
non-con-formist	non-con-form-ist
s-lap-stick	slap-stick
re-pro-cess	re-proc-ess
in-stan-ta-neous-ly	in-stan-ta-ne-ous-ly
se-questered	se-ques-tered
geno-cide	gen-o-cide
ben-der	bend-er
i-n-ap-pro-pri-ate-ly	in-ap-pro-pri-ate-ly
in-hibitor	in-hib-i-tor
e-clec-ti-cis-m	ec-lec-ti-cism
perigee	per-i-gee
lifeblood	life-blood
over-coat	o-ver-coat
di-a-bolis-m	di-ab-o-lism
over-joyed	o-ver-joyed
con-sum-able	con-sum-a-ble
syn-onym	syn-o-nym
e-t-y-mol-o-gy	et-y-mol-o-gy
saucy	sau-cy
bat-ter-ing	battering
ex-ac-t	ex-act
un-en-force-able	un-en-force-a-ble
mar-moset	mar-mo-set
satchel	satch-el
be-fud-dled	befuddled
benev-o-lence	be-nev-o-lence
cuprous	cu-prous
cy-to-tox-i-c	cy-to-tox-ic
litho-graph	lith-o-graph
g-nome	gnome
romper	romp-er
frosty	frost-y
heinous	hei-nous
phleg-m	phlegm
e-go-is-m	e-go-ism
bassist	bass-ist
zany	za-ny
gramo-phone	gram-o-phone
u-n-ac-cus-tomed	un-ac-cus-tomed
ji-u-jit-su	jiu-jit-su
ashamed	a-shamed
ar-den-t	ar-dent
gui-tarist	gui-tar-ist
rein-car-nat-ed	reincarnated
newsagen-t	news-a-gent
pearly	pearl-y
whistler	whis-tler
aplen-ty	a-plen-ty
saucepan	sauce-pan
pes-simistic	pes-si-mis-tic
fisticuff-s	fist-i-cuffs
an-titrust	an-ti-trust
at-tain-men-t	at-tain-ment
in-ward-s	in-wards
ravine	ra-vine
prison	pris-on
s-tu-pen-dous	stu-pen-dous
car-dio-vas-cu-lar	car-di-o-vas-cu-lar
s-tate-ly	state-ly
dumpling	dump-ling
un-chal-lenge-able	un-chal-lenge-a-ble
timid-i-ty	ti-mid-i-ty
memo-ri-al	me-mo-ri-al
vil-lager	vil-lag-er
par-a-sitic	par-a-sit-ic
ibis	i-bis
so-porif-ic	sop-o-rif-ic
over-head	o-ver-head
s-mell	smell
drea-r	drear
colo-nial-ist	co-lo-ni-al-ist
neu-ro-surgery	neu-ro-sur-ger-y
whoso-ev-er	who-so-ev-er
s-neer	sneer
in-struc-t	in-struct
poseur	po-seur
u-nas-sail-able	un-as-sail-a-ble
over-sim-pli-fi-ca-tion	o-ver-sim-pli-fi-ca-tion
iris	i-ris
acid	ac-id
over-pro-duc-tion	o-ver-pro-duc-tion
with-er-s	with-ers
sloven-ly	slov-en-ly
tablet	tab-let
cladding	clad-ding
k-itchen-ware	kitch-en-ware
body	bod-y
coura-geous	cou-ra-geous
ine-bri-ate	in-e-bri-ate
basin	ba-sin
serai	se-ra-i
turnout	turn-out
jugu-lar	jug-u-lar
en-tice-men-t	en-tice-ment
broc-col-i	broc-co-li
un-treat-able	un-treat-a-ble
garage	ga-rage
pup-peteer	pup-pet-eer
im-po-ten-t	im-po-tent
de-part-men-t	de-part-ment
pa-p	pap
the-atri-cal-s	the-at-ri-cals
portage	por-tage
malev-o-lence	ma-lev-o-lence
demon-stra-tive	de-mon-stra-tive
celi-bate	cel-i-bate
hussy	hus-sy
dinky	dink-y
delu-sive	de-lu-sive
over-tone	o-ver-tone
genoa	gen-o-a
frat-ri-ci-dal	frat-ri-cid-al
over-sup-ply	o-ver-sup-ply
ser-f	serf
im-pov-er-ish-men-t	im-pov-er-ish-ment
apolo-get-i-cal-ly	a-pol-o-get-i-cal-ly
dis-abil-i-ty	dis-a-bil-i-ty
tawdry	taw-dry
nonessen-tial	non-es-sen-tial
lin-i-men-t	lin-i-ment
cir-cuitous	cir-cu-i-tous
lega-to	le-ga-to
con-sis-ten-t	con-sist-ent
sim-u-lacrum	sim-u-la-crum
re-open	re-o-pen
wiz-ardry	wiz-ard-ry
boohoo	boo-hoo
wafer	wa-fer
mon-e-taris-m	mon-e-ta-rism
hooli-gan	hoo-li-gan
hoard-ed	hoarded
recharge-able	re-charge-a-ble
brunette	bru-nette
witch-ery	witch-er-y
re-alpoli-tik	re-al-po-li-tik
s-tock-ade	stock-ade
cre-osote	cre-o-sote
rock-ery	rock-er-y
beloved	be-lov-ed
n-im-bly	nim-bly
s-tud-ied	stud-ied
preg-nan-t	preg-nant
cathe-dral	ca-the-dral
lover	lov-er
harpist-s	har-pists
crim-p	crimp
in-tox-i-can-t	in-tox-i-cant
per-i	pe-ri
ax-iomat-ic	ax-i-o-mat-ic
solem-ni-ty	so-lem-ni-ty
dis-pen-sary	dis-pen-sa-ry
bark-ing	barking
in-flat-able	in-flat-a-ble
t-in-ware	tin-ware
pineal	pin-e-al
del-i-ques-cen-t	del-i-ques-cent
im-pro-vi-sa-tion	im-prov-i-sa-tion
pur-suan-t	pur-su-ant
co-rian-der	co-ri-an-der
s-teel-work-s	steel-works
tele-phone	tel-e-phone
bad-ger	badg-er
s-cold-ing	scold-ing
au-tonomous-ly	au-ton-o-mous-ly
springy	spring-y
gob-bledy-gook	gob-ble-dy-gook
in-volve-men-t	in-volve-ment
deis-m	de-ism
g-lyc-erol	glyc-er-ol
washy	wash-y
hoary	hoar-y
b-otan-i-cal	bo-tan-i-cal
re-versed	reversed
foible	foi-ble
com-mence-men-t	com-mence-ment
sus-pec-t	sus-pect
manes	ma-nes
skew-ered	skewered
som-brero	som-bre-ro
any	an-y
polem-i-cal	po-lem-i-cal
f-reak	freak
megawat-t	meg-a-watt
notepad	note-pad
bal-l	ball
molyb-de-num	mo-lyb-de-num
baguette	ba-guette
sug-ary	sug-ar-y
tri-umphal-is-m	tri-um-phal-ism
en-er-get-ic-s	en-er-get-ics
in-fi-deli-ty	in-fi-del-i-ty
s-tark-ly	stark-ly
some-body	some-bod-y
tra-cheoto-my	tra-che-ot-o-my
mul-ti-level	mul-ti-lev-el
de-po-nen-t	de-po-nent
velum	ve-lum
print-able	print-a-ble
il-lim-itable	il-lim-it-a-ble
para-sol	par-a-sol
avid-ly	av-id-ly
sole-cis-m	sol-e-cism
al-ready	al-read-y
seroneg-a-tive	se-ro-neg-a-tive
over-bear-ing	o-ver-bear-ing
cel-e-bran-t	cel-e-brant
an-nu-ity	an-nu-i-ty
s-mashed	smashed
copy-cat	cop-y-cat
sec-tar-i-an-is-m	sec-tar-i-an-ism
roofer	roof-er
al-l	all
conifer	co-ni-fer
an-tithe-sis	an-tith-e-sis
tropopause	trop-o-pause
tidy	ti-dy
taboo	ta-boo
con-ver-san-t	con-ver-sant
goulash	gou-lash
poly-gon	pol-y-gon
over-heat-ed	overheated
teleprint-er	tel-e-print-er
morsel	mor-sel
ca-su-istry	cas-u-ist-ry
unswerv-ing	un-swerv-ing
en-durance	en-dur-ance
por-ta-ble	port-a-ble
ide-al-i-ty	i-de-al-i-ty
toothy	tooth-y
piti-less	pit-i-less
lamp-lighter	lamp-light-er
con-tradis-tinc-tion	con-tra-dis-tinc-tion
p-salter	psal-ter
heather	heath-er
copy	cop-y
lam-plit	lamp-lit
translit-er-ate	trans-lit-er-ate
dairy-ing	dair-y-ing
re-cal-l	re-call
ir-re-versibly	ir-re-vers-i-bly
elec-trolyte	e-lec-tro-lyte
dis-cotheque	dis-co-theque
lauda-to-ry	laud-a-to-ry
re-us-able	re-us-a-ble
bol-stered	bolstered
s-cor-er	scor-er
deuteron	deu-ter-on
licorice	lic-o-rice
loess	lo-ess
im-par-tial-i-ty	im-par-ti-al-i-ty
un-opened	un-o-pened
lever-age	lev-er-age
ten-e-men-t	ten-e-ment
melan-cholic	mel-an-chol-ic
anony-mous-ly	a-non-y-mous-ly
with-ered	withered
busi-nesslike	busi-ness-like
cowherd	cow-herd
sovereign-ty	sov-er-eign-ty
skil-l	skill
suet	su-et
ar-range-men-t	ar-range-ment
broadsword	broad-sword
re-place-men-t	re-place-ment
im-pla-ca-ble	im-plac-a-ble
positron	pos-i-tron
plumba-go	plum-ba-go
ap-palling-ly	ap-pall-ing-ly
s-to-ry	sto-ry
flotil-la	flo-til-la
catarac-t	cat-a-ract
hy-drazine	hy-dra-zine
im-per-ti-nen-t	im-per-ti-nent
pavil-ion	pa-vil-ion
gazelle	ga-zelle
stringer	string-er
con-ven-t	con-vent
ga-mete	gam-ete
over-sam-pling	o-ver-sam-pling
in-fante	in-fan-te
slaver	slav-er
chrono-graph	chron-o-graph
emi-rate	e-mir-ate
s-ce-nari-o	sce-nar-i-o
penin-su-lar	pen-in-su-lar
penknife	pen-knife
s-teer	steer
preda-tor	pred-a-tor
mal-odor-ous	mal-o-dor-ous
d-if-fer-en-tiable	dif-fer-en-ti-a-ble
minaret	min-a-ret
pho-to-volta-ic	pho-to-vol-ta-ic
epis-temic	ep-i-ste-mic
t-ele-con-fer-ence	tel-e-con-fer-ence
velo-drome	ve-lo-drome
pro-pri-etress	pro-pri-e-tress
frigate	frig-ate
gale-na	ga-le-na
un-drink-able	un-drink-a-ble
re-trieval	re-triev-al
s-lim	slim
cafe	ca-fe
vir-tu-oso	vir-tu-o-so
livid	liv-id
spir-i-tu-al-ly	spir-it-u-al-ly
roomy	room-y
innkeep-er	inn-keep-er
to-kenis-m	to-ken-ism
necro-man-cy	nec-ro-man-cy
stereo-typ-i-cal	ster-e-o-typ-i-cal
poly-syl-lab-ic	pol-y-syl-lab-ic
in-fringe-men-t	in-fringe-ment
epis-te-mo-log-i-cal	e-pis-te-mo-log-i-cal
stipend	sti-pend
patho-log-i-cal	path-o-log-i-cal
palatal	pal-a-tal
cov-e	cove
mar-l	marl
shaky	shak-y
con-tractible	con-tract-i-ble
dimwit	dim-wit
s-calar	sca-lar
dis-ci-plinar-i-an	dis-ci-pli-nar-i-an
un-solv-able	un-solv-a-ble
v-enue	ven-ue
dis-mal-l-y	dis-mal-ly
s-toa	sto-a
racial-ly	ra-cial-ly
con-gealed	congealed
glis-ten-ing	gli-ste-ning
mono-lith	mon-o-lith
chiefly	chief-ly
pom-p	pomp
retic-u-lum	re-tic-u-lum
s-cape	scape
un-ser-vice-able	un-ser-vice-a-ble
fri-able	fri-a-ble
vi-able	vi-a-ble
brochure	bro-chure
re-in-force-men-t	re-in-force-ment
s-e-lec-tor	se-lec-tor
di-ver-sion-ary	di-ver-sion-ar-y
berry	ber-ry
rub-bery	rub-ber-y
w-hole-sale	whole-sale
crusty	crust-y
booty	boo-ty
thinker	think-er
fri-ary	fri-ar-y
as-cen-t	as-cent
pre-tex-t	pre-text
s-tub	stub
re-com-bi-nan-t	re-com-bi-nant
e-vac-uee	e-vac-u-ee
leghorn	leg-horn
arach-nid	a-rach-nid
s-phyg-mo-manome-ter	sphyg-mo-ma-nom-e-ter
retry	re-try
s-tock-bro-ker	stock-brok-er
tantrum	tan-trum
knuck-le-duster	knuck-le-dust-er
undis-mayed	un-dis-mayed
s-ince	since
un-du-lat-ing	un-du-la-ting
con-form-able	con-form-a-ble
remix	re-mix
chemise	che-mise
s-cathe	scathe
mat-te	matte
epi-gram	ep-i-gram
ir-re-mov-able	ir-re-mov-a-ble
diminu-tive	di-min-u-tive
res-ur-rec-t	res-ur-rect
pyra-can-tha	py-ra-can-tha
d-is-fran-chise	dis-fran-chise
cordage	cord-age
predilec-tion	pre-di-lec-tion
s-ten-tor	sten-tor
su-per-b	su-perb
pesky	pes-ky
dosage	dos-age
cari-bou	car-i-bou
fontanel	fon-ta-nel
uri-nary	u-ri-nar-y
marked-ly	mark-ed-ly
drafty	draft-y
ex-po-nen-t	ex-po-nent
dimer	di-mer
be-whiskered	be-whisk-ered
pe-riphrastic	per-i-phras-tic
signet	sig-net
um-bili-cus	um-bil-i-cus
speechi-fy-ing	speechifying
jit-tery	jit-ter-y
down-load-ed	downloaded
foot-baller	foot-ball-er
dispir-it-ed	dis-pir-it-ed
pream-pli-fi-er	pre-am-pli-fi-er
aza-lea	a-zal-ea
trumpery	trump-er-y
skul-l	skull
mutiny	mu-ti-ny
oxy-moron	ox-y-mo-ron
badtem-pered	bad-tem-pered
brushy	brush-y
spooky	spook-y
so-ci-olin-guis-tic-s	so-ci-o-lin-guis-tics
crum-bling	crumbling
s-tunt-man	stunt-man
thral-l	thrall
pipette	pi-pette
over-ca-pac-i-ty	o-ver-ca-pac-i-ty
s-lob	slob
quar-t	quart
vol-cano	vol-ca-no
trapeze	tra-peze
knitwear	knit-wear
s-nug-ly	snug-ly
mis-judg-men-t	mis-judg-ment
u-n-am-bigu-ous-ly	un-am-big-u-ous-ly
meso-sphere	mes-o-sphere
video-tape	vid-e-o-tape
nepo-tism	nep-o-tism
bur-geon-ing	burgeoning
shaver	shav-er
s-ta-sis	sta-sis
resid-u-al	re-sid-u-al
raster	ras-ter
zoo-plank-ton	zo-o-plank-ton
wil-lowy	wil-low-y
rosary	ro-sa-ry
elec-tron-ic-s	e-lec-tron-ics
bond-ing	bonding
b-land	bland
scrawny	scrawn-y
rani	ra-ni
holis-tic	ho-lis-tic
tar-ragon	tar-ra-gon
boudoir	bou-doir
s-mooth-ness	smooth-ness
y-outh-ful-ness	youth-ful-ness
de-featist	de-feat-ist
t-setse	tset-se
em-pow-er-men-t	em-pow-er-ment
re-new-able	re-new-a-ble
s-can-dal	scan-dal
maisonette	mai-son-ette
per-centile	per-cen-tile
mod-icum	mod-i-cum
is-suer	is-su-er
pota-to	po-ta-to
tele-pho-to	tel-e-pho-to
cos-set-ed	cosseted
e-lastin	e-las-tin
m-is-fit	mis-fit
rein-ven-t	re-in-vent
re-mark-ably	re-mark-a-bly
watch-able	watch-a-ble
prefer-ably	pref-er-a-bly
melanin	mel-a-nin
nurs-ery-men	nurs-er-y-men
un-car-ed	un-cared
anteater	ant-eat-er
quest-ing	questing
workspace	work-space
trea-sure	treas-ure
shipown-er	ship-own-er
heraldic	he-ral-dic
punc-til-ious	punc-til-i-ous
g-narl	gnarl
an-nal-s	an-nals
s-cat-o-log-i-cal	scat-o-log-i-cal
steamship	steam-ship
moral-is-tic	mor-al-is-tic
dim-pled	dimpled
s-tar-let	star-let
rodeo	ro-de-o
con-ver-gen-t	con-ver-gent
in-hibito-ry	in-hib-i-to-ry
at-trac-t	at-tract
dassie	das-sie
con-trol-lable	con-trol-la-ble
de-con-struc-t	de-con-struct
rein-tro-duc-tion	re-in-tro-duc-tion
re-fusal	re-fus-al
guardian-ship	guard-i-an-ship
lanky	lank-y
ter-m	term
flossy	floss-y
d-if-fract	dif-fract
salty	salt-y
l-it-i-gate	lit-i-gate
nowa-days	now-a-days
duo	du-o
im-pres-sion-is-m	im-pres-sion-ism
biomass	bi-o-mass
s-loop	sloop
con-fir-ma-to-ry	con-firm-a-to-ry
erased	e-rased
dum-found-ing	dumf-ound-ing
in-tra-venous-ly	in-tra-ve-nous-ly
sac-risty	sac-ris-ty
k-ern-ing	ker-ning
ex-per-i-menter	ex-per-i-ment-er
un-ques-tion-ably	un-ques-tion-a-bly
p-re-sen-ter	pre-sent-er
ob-tain-able	ob-tain-a-ble
souther-ly	south-er-ly
deben-ture	de-ben-ture
re-spon-der	re-spond-er
ine-bri-a-tion	in-e-bri-a-tion
mam-malian	mam-ma-li-an
un-de-tectable	un-de-tect-a-ble
plenum	ple-num
pogrom	po-grom
over-wrought	o-ver-wrought
raillery	rail-ler-y
s-paniel	span-iel
odor-if-er-ous	o-dor-if-er-ous
basil	bas-il
en-hancer	en-hanc-er
ex-u-ber-an-t	ex-u-ber-ant
scream-ing	screaming
elu-ci-date	e-lu-ci-date
er-r	err
over-print	o-ver-print
di-achron-ic	di-a-chron-ic
con-flic-t	con-flict
ir-re-triev-able	ir-re-triev-a-ble
provider	pro-vid-er
cer-ti-fi-able	cer-ti-fi-a-ble
roller	roll-er
howdy	how-dy
porce-lain	por-ce-lain
rosette	ro-sette
volt-meter	volt-me-ter
s-tran-gu-la-tion	stran-gu-la-tion
en-force-men-t	en-force-ment
piti-ful-ly	pit-i-ful-ly
tran-scrip-t	tran-script
rock-et-ing	rocketing
e-s-pe-cial-ly	es-pe-cial-ly
re-stroom	rest-room
s-nipe	snipe
elec-toral	e-lec-tor-al
para-pet	par-a-pet
racon-teur	rac-on-teur
o-culist	oc-u-list
hadron	had-ron
ethnog-ra-phy	eth-nog-ra-phy
au-thor-i-tar-i-an-is-m	au-thor-i-tar-i-an-ism
man-ner-is-m	man-ner-ism
crisply	crisp-ly
deco-rous	dec-o-rous
metic-u-lous-ly	me-tic-u-lous-ly
ad-d	add
in-ca-pable	in-ca-pa-ble
oc-tagon	oc-ta-gon
nour-ish-men-t	nour-ish-ment
com-modi-ous	com-mo-di-ous
pedantry	ped-ant-ry
awry	a-wry
fem-i-nis-m	fem-i-nism
fig-u-ra-tive-ly	fig-ur-a-tive-ly
s-car-i-ly	scar-i-ly
ter-rapin	ter-ra-pin
un-fore-see-able	un-fore-see-a-ble
overeat	o-ver-eat
i-n-ac-tive	in-ac-tive
fid-gety	fidg-et-y
re-sul-tan-t	re-sult-ant
tiger	ti-ger
e-d-u-ca-tion-al-ly	ed-u-ca-tion-al-ly
even-ly	e-ven-ly
su-per-in-ten-dence	su-per-in-tend-ence
i-n-ad-mis-si-ble	in-ad-mis-si-ble
diminu-tion	dim-i-nu-tion
crazi-ness	cra-zi-ness
con-fi-den-t	con-fi-dent
paramount-cy	par-a-mount-cy
arachno-pho-bi-a	a-rach-no-pho-bi-a
u-nasked	un-asked
c-on-cil-iar	con-cil-i-ar
limpid	lim-pid
over-com-pen-sate	o-ver-com-pen-sate
suf-fragette	suf-fra-gette
dumb-found-ed	dumbfounded
in-sou-ciance	in-sou-ci-ance
rad-i-cal-is-m	rad-i-cal-ism
s-ap	sap
s-mooth-ly	smooth-ly
s-nore	snore
clam-orous	clam-or-ous
melod-ic	me-lod-ic
dili-gen-t	dil-i-gent
can-nery	can-ner-y
modal-i-ty	mo-dal-i-ty
lava-to-ri-al	lav-a-to-ri-al
s-nook-er	snook-er
un-premed-i-tat-ed	un-pre-med-i-tat-ed
d-if-fer-en-t	dif-fer-ent
show-ery	show-er-y
gym-nas-tic-s	gym-nas-tics
blankly	blank-ly
calami-ty	ca-lam-i-ty
gen-uine	gen-u-ine
tragedy	trag-e-dy
s-coot	scoot
un-quench-able	un-quench-a-ble
polypep-tide	pol-y-pep-tide
erad-i-cat-ed	e-rad-i-cat-ed
good-night	goodnight
homonym	hom-o-nym
dan-druf-f	dan-druff
un-ruly	un-ru-ly
rhap-sody	rhap-so-dy
volup-tuous	vo-lup-tu-ous
chalky	chalk-y
misog-y-ny	mi-sog-y-ny
flaky	flak-y
antwer-p	antwerp
d-if-fer-ing	differing
topo-log-i-cal	top-o-log-i-cal
hostler	hos-tler
over-lay	o-ver-lay
schooner	schoon-er
s-lug-gard	slug-gard
beefy	beef-y
con-ceiv-ably	con-ceiv-a-bly
be-muse-men-t	be-muse-ment
lul-la-by	lull-a-by
ve-nial	ve-ni-al
gestalt	ge-stalt
faucet	fau-cet
gal-axy	gal-ax-y
en-vi-ron-men-t	en-vi-ron-ment
mo-torist	mo-tor-ist
ex-pect-ed	expected
pan-t	pant
rapi-er	ra-pi-er
tubu-lar	tu-bu-lar
flat-u-len-t	flat-u-lent
over-time	o-ver-time
mis-spellings	mis-spel-lings
pan-das	pan-das
in-tu-itive	in-tu-i-tive
cre-ative-ly	cre-a-tive-ly
apoc-a-lypse	a-poc-a-lypse
reaf-fir-ma-tion	re-af-fir-ma-tion
hand-bil-l	hand-bill
s-tate	state
re-ac-tan-t	re-ac-tant
as-pidis-tra	as-pi-dis-tra
cough-ing	coughing
thrilling	thrill-ing
over-ground	o-ver-ground
i-n-ac-cu-ra-cy	in-ac-cu-ra-cy
moc-casin	moc-ca-sin
leak-ing	leaking
ap-plica-tive	ap-pli-ca-tive
framer	fram-er
cross-road-s	cross-roads
s-e-lec-tive-ly	se-lec-tive-ly
baron	bar-on
con-tex-t	con-text
cleanup	clean-up
proac-tive	pro-ac-tive
millpond	mill-pond
dis-penser	dis-pens-er
s-cup-per	scup-per
height-ened	heightened
valu-able	val-u-a-ble
tol-er-an-t	tol-er-ant
covert-ly	cov-ert-ly
un-miss-able	un-miss-a-ble
dele-tion	de-le-tion
widen	wid-en
verisimil-i-tude	ver-i-si-mil-i-tude
im-agery	im-age-ry
s-e-lec-tive	se-lec-tive
u-n-ac-cept-ably	un-ac-cept-a-bly
wattage	watt-age
haver-ing	ha-ve-ring
bur-gundy	bur-gun-dy
mil-l	mill
trib-u-tary	trib-u-tar-y
mon-e-tary	mon-e-tar-y
heiress	heir-ess
s-coundrel	scoun-drel
rachis	ra-chis
cordiller-a	cor-dil-le-ra
dean-ery	dean-er-y
over-state	o-ver-state
re-uni-fy	re-u-ni-fy
good-s	goods
em-bel-lish-men-t	em-bel-lish-ment
ru-mi-nan-t	ru-mi-nant
fool-ery	fool-er-y
awak-en	a-wak-en
omis-sion	o-mis-sion
mer-ri-men-t	mer-ri-ment
crier	cri-er
pen-t	pent
s-lag	slag
u-n-afraid	un-a-fraid
stylist	styl-ist
dis-cor-dan-t	dis-cord-ant
ori-en-tal	o-ri-en-tal
elec-tri-cal-ly	e-lec-tri-cal-ly
en-dometri-um	en-do-me-tri-um
s-cone	scone
s-tupid	stu-pid
h-es-i-tate	hes-i-tate
loca-tive	loc-a-tive
s-tiff-en-ing	stiff-en-ing
over-strung	o-ver-strung
tele-ol-o-gy	tel-e-ol-o-gy
daffy	daf-fy
epi-gram-mat-ic	ep-i-gram-mat-ic
knick-er-s	knick-ers
mealy	meal-y
teenage	teen-age
necro-man-tic	nec-ro-man-tic
s-trand-ed	strand-ed
alive	a-live
grunter	grunt-er
best-seller	best-sell-er
liar	li-ar
b-i-fo-cal	bi-fo-cal
cas-sowary	cas-so-war-y
tal-c	talc
s-words-man	swords-man
easy-go-ing	eas-y-go-ing
be-wil-der-ing	bewildering
sober	so-ber
dis-cernible	dis-cern-i-ble
sub-servien-t	sub-ser-vi-ent
caprice	ca-price
there-upon	there-up-on
coral	cor-al
in-ter-atom-ic	in-ter-a-tom-ic
cen-tripetal	cen-trip-e-tal
over-pow-er	o-ver-pow-er
ir-recov-er-able	ir-re-cov-er-a-ble
synapse	syn-apse
ele-giac	el-e-gi-ac
wrestling	wres-tling
y-ou	you
elec-tor	e-lec-tor
colonic	co-lon-ic
augite	au-gite
buzzer	buzz-er
gymkhana	gym-kha-na
dis-pens-able	dis-pen-sa-ble
biosyn-the-sis	bi-o-syn-the-sis
elec-tric	e-lec-tric
p-re-sen-ta-tion	pres-en-ta-tion
l-itur-gy	lit-ur-gy
l-itany	lit-a-ny
mono-phon-ic	mon-o-phon-ic
glaciol-o-gy	gla-ci-ol-o-gy
mag-ne-sium	mag-ne-si-um
voodoo	voo-doo
dis-place-men-t	dis-place-ment
rif-f	riff
coitus	co-i-tus
paren-the-sis	pa-ren-the-sis
gun-nery	gun-ner-y
re-duc-tion-is-m	re-duc-tion-ism
guilty	guilt-y
quel-l	quell
u-nimag-in-able	un-im-ag-i-na-ble
reagen-t	re-a-gent
cologne	co-logne
melt-ed	melted
con-sid-er-ably	con-sid-er-a-bly
regi-cide	reg-i-cide
area	ar-e-a
archangel	arch-an-gel
warpath	war-path
in-ter-minable	in-ter-mi-na-ble
pathogen	path-o-gen
s-tim-u-lat-ing	stim-u-lat-ing
chap-s	chaps
in-dif-fer-en-t	in-dif-fer-ent
tru-cu-len-t	truc-u-lent
manda-to-ry	man-da-to-ry
moraine	mo-raine
sala-man-der	sal-a-man-der
s-trag-gler	strag-gler
k-ilo-wat-t	kil-o-watt
curlew	cur-lew
en-thalpy	en-thal-py
un-even	un-e-ven
repli-ca	rep-li-ca
u-n-avoid-ably	un-a-void-a-bly
per-ti-nen-t	per-ti-nent
marzi-pan	mar-zi-pan
choral	cho-ral
pala-tine	pal-a-tine
skir-mish-ing	skirmishing
sounder	sound-er
but-tered	buttered
open-er	o-pen-er
eye-bal-l	eye-ball
ar-biter	ar-bi-ter
d-u-al-is-m	du-al-ism
whether	wheth-er
rep-til-ian	rep-til-i-an
co-eval	co-e-val
nether	neth-er
apish	ap-ish
y-on	yon
karakul	kar-a-kul
weedy	weed-y
en-joy-men-t	en-joy-ment
d-weller	dwell-er
randy	rand-y
in-cor-rec-t	in-cor-rect
crofter	croft-er
lazy	la-zy
mildew	mil-dew
over-due	o-ver-due
con-so-nan-t	con-so-nant
siphon	si-phon
re-cy-cling	recycling
s-pacey	spac-ey
men-di-can-t	men-di-cant
as-cen-dan-cy	as-cend-an-cy
piety	pi-e-ty
ran-corous	ran-cor-ous
un-jus-ti-fi-able	un-jus-ti-fi-a-ble
hypocrisy	hy-poc-ri-sy
silen-t	si-lent
touris-m	tour-ism
ma-jorette	ma-jor-ette
bear-able	bear-a-ble
in-tu-ition	in-tu-i-tion
re-dun-dan-t	re-dun-dant
ref-er-en-t	ref-er-ent
e-vo-ca-tion	ev-o-ca-tion
ra-dio-ther-a-py	ra-di-o-ther-a-py
repack	re-pack
starchy	starch-y
or-di-nary	or-di-nar-y
s-tut-ter	stut-ter
athe-ist	a-the-ist
p-salm	psalm
un-set-tling	unsettling
dis-heart-ened	dis-hear-tened
astig-ma-tism	a-stig-ma-tism
g-o-nad	go-nad
fool-hardy	fool-har-dy
un-ob-serv-able	un-ob-serv-a-ble
s-tim-u-lus	stim-u-lus
hexa-dec-i-mal	hex-a-dec-i-mal
whirlpool	whirl-pool
wicked	wick-ed
s-worn	sworn
iso-bar	i-so-bar
ex-e-cutable	ex-e-cut-a-ble
protest	pro-test
s-tay	stay
pedi-gree	ped-i-gree
wor-m	worm
ar-tillery	ar-til-ler-y
ir-ri-tabil-i-ty	ir-ri-ta-bil-i-ty
re-fur-bish-men-t	re-fur-bish-ment
s-nake-skin	snake-skin
but-tery	but-ter-y
sig-nif-i-can-t	sig-nif-i-cant
s-tur-geon	stur-geon
in-suf-fi-cien-t	in-suf-fi-cient
dressy	dress-y
elec-tro-cu-tion	e-lec-tro-cu-tion
o-cean-ic	o-ce-an-ic
im-moral-i-ty	im-mo-ral-i-ty
cor-duroy	cor-du-roy
cur-ran-t	cur-rant
look-ing	looking
s-neak-ing	sneak-ing
thriller	thrill-er
s-ta-di-um	sta-di-um
nurs-ery-man	nurs-er-y-man
de-po-si-tion	dep-o-si-tion
hon-our	ho-nour
rain-swep-t	rain-swept
steplad-der	step-lad-der
radish	rad-ish
pectin	pec-tin
menagerie	me-nag-er-ie
enu-mer-a-tion	e-nu-mer-a-tion
milk-shake	milkshake
a-vian	a-vi-an
in-fin-ite-ly	in-fi-nite-ly
in-fan-t	in-fant
unin-spir-ing	un-in-spir-ing
pho-tore-cep-tor	pho-to-re-cep-tor
s-plat-ter	splat-ter
cor-po-ratism	cor-po-rat-ism
n-ev-er	nev-er
tec-ton-ic-s	tec-ton-ics
un-change-able	un-change-a-ble
spiny	spin-y
seedling	seed-ling
ju-rispru-dence	ju-ris-pru-dence
ri-fled	rifled
syn-ony-mous	syn-on-y-mous
plu-per-fec-t	plu-per-fect
ob-se-quious	ob-se-qui-ous
d-e-fi-cien-t	de-fi-cient
artist	art-ist
prodi-gal	prod-i-gal
ef-fer-en-t	ef-fer-ent
un-equal	un-e-qual
meta-mor-phosed	metamorphosed
phy-lac-tery	phy-lac-ter-y
censer	cen-ser
ni-troge-nous	ni-trog-e-nous
t-int-ed	tinted
s-pa-cious	spa-cious
transpon-der	tran-spon-der
hy-per-boloid	hy-per-bo-loid
mas-t	mast
civic-s	civ-ics
weightlift-ing	weight-lift-ing
sub-atom-ic	sub-a-tom-ic
cle-f	clef
propen-si-ty	pro-pen-si-ty
pedan-t	ped-ant
s-word	sword
tur-bocharg-er	tur-bo-charg-er
de-spi-ca-ble	des-pi-ca-ble
de-ser-ti-fi-ca-tion	de-sert-i-fi-ca-tion
s-tum-ble	stum-ble
u-nattain-able	un-at-tain-a-ble
over-ly	o-ver-ly
trum-peter	trum-pet-er
mock-ery	mock-er-y
graphite	graph-ite
pho-net-ic-s	pho-net-ics
co-ex-is-ten-t	co-ex-ist-ent
un-be-liev-able	un-be-liev-a-ble
cys-t	cyst
reap-praisal	re-ap-prais-al
in-de-pen-den-t	in-de-pend-ent
im-ped-i-men-t	im-ped-i-ment
weary-ing	wea-ry-ing
ap-pli-can-t	ap-pli-cant
re-gen-t	re-gent
s-car-let	scar-let
chalet	cha-let
bad-minton	bad-min-ton
poly-tech-nic	pol-y-tech-nic
debu-tan-t	deb-u-tant
s-trained	strained
fleshy	flesh-y
muster	mus-ter
fet-tered	fettered
hooli-gan-is-m	hoo-li-gan-ism
s-tan-chion	stan-chion
naked-ness	na-ked-ness
s-tate-less	state-less
hazy	ha-zy
over-anx-ious	o-ver-anx-ious
in-cen-di-ary	in-cen-di-ar-y
nest-ing	nesting
s-tar-tling-ly	star-tling-ly
rekin-dle	re-kin-dle
earnest-ness	ear-nest-ness
chau-vin-is-m	chau-vin-ism
un-remit-ting	un-re-mit-ting
as-tro-physi-cist	as-tro-phys-i-cist
jam-b	jamb
over-shoot	o-ver-shoot
foghorn	fog-horn
thum-b	thumb
s-tat-uette	stat-u-ette
e-cho	ech-o
s-corch-ing	scorch-ing
func-tion-al-is-m	func-tion-al-ism
sunspot	sun-spot
s-ab-o-tage	sab-o-tage
po-et-ic-s	po-et-ics
pro-ject-ed	projected
mul-ti-lat-er-al-is-m	mul-ti-lat-er-al-ism
pave-men-t	pave-ment
rack-e-teer-ing	rack-et-eer-ing
fault-ing	faulting
in-dis-tin-guish-able	in-dis-tin-guish-a-ble
antonym	an-to-nym
despo-tism	des-pot-ism
wealthy	wealth-y
gra-di-en-t	gra-di-ent
ger-m	germ
rent-ed	rented
salaried	sal-a-ried
se-mi	sem-i
w-hole-saler	whole-sal-er
man-age-men-t	man-age-ment
s-cowl	scowl
lit-toral	lit-to-ral
tri-umphant-ly	tri-um-phant-ly
demigod	dem-i-god
tele-phon-ist	te-leph-o-nist
tenet	ten-et
s-lip-ping	slipping
muti-nous	mu-ti-nous
in-farc-t	in-farct
reroute	re-route
spec-troscopy	spec-tros-co-py
lethar-gic	le-thar-gic
p-re-serve	pre-serve
auburn	au-burn
de-ter-mi-nan-t	de-ter-mi-nant
ide-o-log-i-cal-ly	i-de-o-log-i-cal-ly
rec-ti-lin-ear	rec-ti-lin-e-ar
parochial-is-m	pa-ro-chi-al-ism
kalei-do-scop-ic	ka-lei-do-scop-ic
co-terie	co-te-rie
there-after	there-af-ter
ure-thane	u-re-thane
cor-po-ratist	cor-po-rat-ist
ex-trac-t	ex-tract
seclu-sion	se-clu-sion
free-lancer	free-lanc-er
valance	val-ance
read-just	re-ad-just
l-la-ma	lla-ma
re-al-is-m	re-al-ism
loft-ed	lofted
seabed	sea-bed
chore-a	cho-re-a
reaper	reap-er
u-nan-swer-able	un-an-swer-a-ble
wall-flower	wall-flow-er
gur-gling	gurgling
re-ceiver-ship	re-ceiv-er-ship
con-vict-ed	convicted
ori-en-tate	o-ri-en-tate
gal-l	gall
irid-i-um	i-rid-i-um
moody	mood-y
or-ga-nize	or-gan-ize
cliquey	cli-quey
s-trate-gic	stra-te-gic
un-record-ed	un-re-cord-ed
ra-tio-nal	ra-tion-al
causal-i-ty	cau-sal-i-ty
damper	damp-er
pati-na-tion	pat-i-na-tion
col-lec-tivist	col-lec-tiv-ist
s-ly-ly	sly-ly
re-cruiter	re-cruit-er
teth-er-ing	tethering
duchess	duch-ess
pres-ti-gious	pres-tig-ious
ar-bi-trari-ness	ar-bi-trar-i-ness
cedil-la	ce-dil-la
heron-ry	her-on-ry
readap-t	re-a-dapt
achieve	a-chieve
pil-l	pill
grad-u-al-is-m	grad-u-al-ism
tur-bocharged	turbocharged
melan-choly	mel-an-chol-y
s-pas-tic	spas-tic
ob-scu-ran-tist	ob-scu-rant-ist
ple-beian	ple-be-ian
im-pass-able	im-pass-a-ble
rein-vest	re-in-vest
e-c-u-menis-m	ec-u-me-nism
punchy	punch-y
un-mea-sur-able	un-meas-ur-a-ble
rem-nan-t	rem-nant
quintessen-tial-ly	quin-tes-sen-tial-ly
jin-go-is-m	jin-go-ism
over-throw	o-ver-throw
side-re-al	si-de-re-al
beg-gary	beg-gar-y
pi-o-n	pi-on
tac-t	tact
ri-ot-ing	ri-o-ting
na-tion-al-is-m	na-tion-al-ism
view-able	view-a-ble
mushy	mush-y
eye-d	eyed
periglacial	per-i-gla-cial
vig-i-lan-t	vig-i-lant
in-erad-i-ca-ble	in-e-rad-i-ca-ble
un-event-ful	un-e-vent-ful
restart	re-start
beaver	bea-ver
at-tribute	at-trib-ute
necrophil-i-a	nec-ro-phil-i-a
avail-able	a-vail-a-ble
over-es-ti-mate	o-ver-es-ti-mate
ar-c	arc
coastal	coast-al
deli	del-i
un-count-able	un-count-a-ble
con-fi-den-tial-i-ty	con-fi-den-ti-al-i-ty
per-ineum	per-i-ne-um
ex-em-plary	ex-em-pla-ry
im-peri-um	im-pe-ri-um
cav-ernous	cav-ern-ous
trous-er	trou-ser
un-frozen	un-fro-zen
elu-ci-da-tion	e-lu-ci-da-tion
swingy	swing-y
duet	du-et
ex-tra-or-di-nary	ex-traor-di-nar-y
s-e-lec-tiv-i-ty	se-lec-tiv-i-ty
be-wil-dered	bewildered
para-noid	par-a-noid
tu-mul-tuous	tu-mul-tu-ous
Words with errors: 2230
Words with incorrect number of syllables: 2044
Total evluated: 6500
Perfect accuracy: 0.66
Number of syllables accuracy: 0.69
Average Levenshtein Distance(across incorrect words): 1.22
