Attempt	Real
re-cy-cling	recycling
n-ev-er	nev-er
hal-ibut	hal-i-but
read-mis-sion	re-ad-mis-sion
any-ways	an-y-ways
chalet	cha-let
springy	spring-y
hotspot	hot-spot
eter-nal-ly	e-ter-nal-ly
s-mack-er	smack-er
us-able	us-a-ble
un-abat-ed	un-a-bat-ed
satir-i-cal	sa-tir-i-cal
s-cor-pi-on	scor-pi-on
im-munoas-say	im-mu-no-as-say
doubter	doubt-er
em-piri-cist	em-pir-i-cist
swarm-ing	swarming
healthi-ly	health-i-ly
s-targaz-er	star-gaz-er
coro-nal	cor-o-nal
cor-re-spon-den-t	cor-re-spond-ent
in-n	inn
neo-phyte	ne-o-phyte
fo-men-t	fo-ment
en-gi-neered	engineered
per-centile	per-cen-tile
s-ly	sly
s-teer-age	steer-age
garage	ga-rage
dis-abuse	dis-a-buse
s-loop	sloop
s-tool	stool
puffy	puf-fy
greedy	greed-y
fetid	fet-id
salien-t	sa-li-ent
re-im-burse-men-t	re-im-burse-ment
chro-matog-ra-phy	chro-ma-tog-ra-phy
re-uni-fi-ca-tion	re-u-ni-fi-ca-tion
po-litesse	pol-i-tesse
record-ed	re-cor-ded
s-capu-la	scap-u-la
winnable	win-na-ble
in-stru-men-t	in-stru-ment
co-gen-t	co-gent
hye-na	hy-e-na
s-niff-in-g	sniffing
cur-tail-men-t	cur-tail-ment
gofer	go-fer
gro-cery	gro-cer-y
hunter	hunt-er
re-design	re-de-sign
in-ten-t	in-tent
frailty	frail-ty
psy-cho-me-t-ric	psy-cho-met-ric
video	vid-e-o
l-o-gis-ti-cal-ly	lo-gis-ti-cal-ly
kook-abur-ra	kook-a-bur-ra
turntable	turn-ta-ble
easy	eas-y
foot-light-s	foot-lights
basin	ba-sin
apoth-e-o-sis	a-poth-e-o-sis
con-fi-dan-t	con-fi-dant
record-ing	re-cord-ing
resur-face	re-sur-face
unin-spired	un-in-spired
ten-able	ten-a-ble
fusty	fus-ty
con-tex-t	con-text
pester	pes-ter
over-ween-ing	o-ver-ween-ing
un-der-de-vel-ope-d	un-der-de-vel-oped
de-cam-p	de-camp
sub-con-ti-nen-t	sub-con-ti-nent
par-venu	par-ve-nu
cre-ativ-i-ty	cre-a-tiv-i-ty
teapot	tea-pot
pro-mul-gate	prom-ul-gate
poly-mor-phous	pol-y-mor-phous
hy-dro-dy-nam-ic-s	hy-dro-dy-nam-ics
syn-onymy	syn-on-y-my
hy-gien-e	hy-giene
crevice	crev-ice
epis-co-pate	e-pis-co-pate
gra-nary	gra-na-ry
seclu-sion	se-clu-sion
parochial-is-m	pa-ro-chi-al-ism
b-lis-ter-ing	blis-ter-ing
t-elecom-mu-ni-ca-tion	tel-e-com-mu-ni-ca-tion
iron-work-s	i-ron-works
b-room	broom
hawser	haw-ser
sign-er-s	sign-ers
volt-meter	volt-me-ter
t-wo	two
tra-verse	trav-erse
signet	sig-net
pol-lard-ed	pollarded
tiler	til-er
but-t	butt
cheater	cheat-er
modal-i-ty	mo-dal-i-ty
b-liss-ful-ly	bliss-ful-ly
tachy-on	tach-y-on
p-re-s-e-lec-t	pre-se-lect
cyn-i-cis-m	cyn-i-cism
fid-get	fidg-et
lim-b	limb
i-ambus	i-am-bus
over-val-ue	o-ver-val-ue
gaze-bo	ga-ze-bo
s-pat-u-la	spat-u-la
lyri-cis-m	lyr-i-cism
bereft	be-reft
re-peater	re-peat-er
k-ilo-ton	kil-o-ton
re-spectabil-i-ty	re-spect-a-bil-i-ty
drom-e-dary	drom-e-dar-y
taster	tast-er
bathos	ba-thos
in-dis-putably	in-dis-put-a-bly
de-crepit	de-crep-it
sharply	sharp-ly
mic-turi-tion	mic-tu-ri-tion
dis-avow-al	dis-a-vow-al
brazen	bra-zen
briskly	brisk-ly
dactyl	dac-tyl
in-dige-nous	in-dig-e-nous
chas-ten-ing	chastening
im-moral-i-ty	im-mo-ral-i-ty
pold-er	pol-der
gallery	gal-ler-y
un-nec-es-sary	un-nec-es-sar-y
up-fron-t	up-front
cam-corder	cam-cord-er
u-nas-signed	un-as-signed
fin-ery	fin-er-y
pushy	push-y
me-te-oric	me-te-or-ic
tru-cu-len-t	truc-u-lent
s-ter-ile	ster-ile
sar-i	sa-ri
as-p	asp
undis-mayed	un-dis-mayed
sup-plan-t	sup-plant
s-played	splayed
mem-o-rable	mem-o-ra-ble
en-tropy	en-tro-py
pre-pon-der-an-t	pre-pon-der-ant
habit	hab-it
s-po-radic	spo-rad-ic
grand-par-en-t	grand-par-ent
n-od-dy	nod-dy
pyra-mid	pyr-a-mid
steamy	steam-y
in-abil-i-ty	in-a-bil-i-ty
wor-m	worm
catarac-t	cat-a-ract
ge-neti-cist	ge-net-i-cist
crazi-ly	cra-zi-ly
over-run	o-ver-run
s-plash-down	splash-down
in-fras-truc-tural	in-fra-struc-tur-al
desul-to-ry	des-ul-to-ry
s-tam-pede	stam-pede
pre-de-ter-mined	predetermined
mo-men-t	mo-ment
s-tiffly	stiff-ly
spongy	spon-gy
key-boardis-t	key-board-ist
grandiose	gran-di-ose
billing	bil-ling
erot-i-ca	e-rot-i-ca
id-iomat-ic	id-i-o-mat-ic
tai-lorable	tai-lor-a-ble
re-spectably	re-spect-a-bly
coulom-b	cou-lomb
con-duc-t	con-duct
stapes	sta-pes
cretin	cre-tin
rounder-s	round-ers
fri-able	fri-a-ble
en-force-men-t	en-force-ment
un-set-tling	unsettling
en-rich-men-t	en-rich-ment
mono-pole	mon-o-pole
over-anx-ious	o-ver-anx-ious
spokes-woman	spokes-wom-an
s-lap-dash	slap-dash
com-pe-ten-t	com-pe-tent
to-tal-i-tar-i-an-is-m	to-tal-i-tar-i-an-ism
enu-mer-a-tor	e-nu-mer-a-tor
plu-per-fec-t	plu-per-fect
l-it-i-gan-t	lit-i-gant
body-guard	bod-y-guard
in-duc-t	in-duct
tweedy	tweed-y
de-vel-op-men-t	de-vel-op-ment
do-h	doh
s-later	slat-er
serene	se-rene
grinder	grind-er
e-spres-so	es-pres-so
e-co-log-i-cal-ly	ec-o-log-i-cal-ly
fairy	fair-y
costar	co-star
dol-drum-s	dol-drums
en-vi-ron-men-tal-is-m	en-vi-ron-men-tal-ism
d-eficit	def-i-cit
rap-proche-men-t	rap-proche-ment
aver	a-ver
trencher	trench-er
in-dis-putable	in-dis-put-a-ble
mil-ligram	mil-li-gram
s-to-ry-telling	sto-ry-tell-ing
rip-pling	rippling
stipend	sti-pend
dither	dith-er
overuse	o-ver-use
coral	cor-al
tiling	til-ing
ne-go-tiable	ne-go-ti-a-ble
e-quidis-tan-t	e-qui-dis-tant
unswerv-ing	un-swerv-ing
palmy	palm-y
basal	ba-sal
sacral	sa-cral
break-able	break-a-ble
ves-ti-gial	ves-tig-i-al
cut-lery	cut-ler-y
an-swer-able	an-swer-a-ble
unlov-ing	un-lov-ing
base-bal-l	base-ball
un-in-for-ma-tive	un-in-form-a-tive
avi-ate	a-vi-ate
busy-body	bus-y-bod-y
de-mo-li-tion	dem-o-li-tion
episod-ic	ep-i-sod-ic
im-pri-matur	im-pri-ma-tur
satchel	satch-el
tele-vi-sion	tel-e-vi-sion
an-te-dilu-vian	an-te-di-lu-vi-an
boast-ing	boas-ting
un-de-cid-able	un-de-cid-a-ble
s-tu-den-t	stu-dent
lu-mi-nary	lu-mi-nar-y
d-ab-bing	dab-bing
avert	a-vert
brandy	bran-dy
emi-rate	e-mir-ate
enor-mous-ly	e-nor-mous-ly
over-board	o-ver-board
bo-som	bos-om
bolero	bo-le-ro
flab-ber-gast-ed	flabbergasted
even-tu-al	e-ven-tu-al
re-deemer	re-deem-er
penol-o-gy	pe-nol-o-gy
fil-l	fill
elec-tric-i-ty	e-lec-tric-i-ty
brutish	brut-ish
peep-s	peeps
e-m-anate	em-a-nate
reval-u-a-tion	re-val-u-a-tion
moth-bal-l	moth-ball
leav-ened	leavened
dis-burse-men-t	dis-burse-ment
re-silience	re-sil-ience
c-om-men-da-tion	com-men-da-tion
mort-gagor	mort-ga-gor
o-culist	oc-u-list
monomolec-u-lar	mon-o-mo-lec-u-lar
iso-la-tion	i-so-la-tion
ringlet	ring-let
mud-dling	muddling
s-moth-ered	smothered
pec-toral	pec-to-ral
sophist	soph-ist
e-s-pe-cial	es-pe-cial
in-fin-ite-ly	in-fi-nite-ly
lemon-ade	lem-on-ade
id-io-cy	id-i-o-cy
grid-iron	grid-i-ron
table-land	ta-ble-land
tute-lage	tu-te-lage
con-certi-na	con-cer-ti-na
squashy	squash-y
cox-com-b	cox-comb
devo-tee	dev-o-tee
n-od-ule	nod-ule
metro	met-ro
loafer	loaf-er
geri-atric	ger-i-at-ric
mandible	man-di-ble
over-ac-t	o-ver-act
antler	ant-ler
au-dio	au-di-o
spon-sored	sponsored
sunspot	sun-spot
in-ter-vie-wee	in-ter-view-ee
pass-able	pass-a-ble
posse	pos-se
sanc-tu-ary	sanc-tu-ar-y
planter	plant-er
be-fud-dling	befuddling
pre-fab-ri-cat-ed	prefabricated
couloir	cou-loir
tele-work-ing	teleworking
s-ta-sis	sta-sis
car-roty	car-rot-y
rein-ven-t	re-in-vent
pom-p	pomp
rhodi-um	rho-di-um
dan-druf-f	dan-druff
re-luc-tan-t	re-luc-tant
s-tain	stain
chromi-um	chro-mi-um
cretinous	cre-tin-ous
nifty	nif-ty
s-traight-away	straight-a-way
colo-nial-ist	co-lo-ni-al-ist
fluffy	fluff-y
in-ter-change-able	in-ter-change-a-ble
opin-ion-at-ed	o-pin-ion-at-ed
gan-g-ly	gan-gly
monog-a-mous	mo-nog-a-mous
s-lum	slum
poseur	po-seur
fem-i-nis-m	fem-i-nism
ca-cao	ca-ca-o
loutish	lout-ish
frilli-er	fril-li-er
ar-gen-t	ar-gent
pan-the-is-m	pan-the-ism
vis-ual	vis-u-al
re-as-sur-ing	reassuring
trade-marked	trademarked
s-nip-pet	snip-pet
kudu	ku-du
ar-chi-pel-ago	ar-chi-pel-a-go
s-mug	smug
im-mutable	im-mu-ta-ble
mu-nif-i-cen-t	mu-nif-i-cent
s-cant	scant
ri-boflavin	ri-bo-fla-vin
in-com-bustible	in-com-bus-ti-ble
bailout	bail-out
f-reaky	freak-y
dul-l	dull
pa-pyrus	pa-py-rus
palmist	palm-ist
blowup	blow-up
pre-dictably	pre-dict-a-bly
handy-man	hand-y-man
steplad-der	step-lad-der
tor-ren-t	tor-rent
elec-tri-fi-ca-tion	e-lec-tri-fi-ca-tion
meta-phys-i-cal	met-a-phys-i-cal
shoplifter	shop-lift-er
laugh-ably	laugh-a-bly
trans-plan-t	trans-plant
ques-tion-able	ques-tion-a-ble
bre-viary	bre-vi-ar-y
at-tack-ing	attacking
arabesque	ar-a-besque
u-n-ac-cept-ably	un-ac-cept-a-bly
bar-bar-ian	bar-bar-i-an
pi-anis-si-mo	pi-a-nis-si-mo
symp-to-matic	symp-to-mat-ic
buoy-an-t	buoy-ant
d-u-al-is-m	du-al-ism
in-tu-ition	in-tu-i-tion
craven	cra-ven
wolfish	wolf-ish
dessert	des-sert
sinew	sin-ew
bitchy	bitch-y
elec-tive	e-lec-tive
re-pro-ducibly	re-pro-duc-i-bly
e-mery	em-er-y
bean-ery	bean-er-y
land-fal-l	land-fall
shiv-er-ing	shivering
ranch-ing	ranching
break-away	break-a-way
s-nub	snub
apex	a-pex
usurp	u-surp
em-body	em-bod-y
re-new-able	re-new-a-ble
con-for-m	con-form
az-imuth	az-i-muth
misog-y-nist	mi-sog-y-nist
ra-dio-graph-ic	ra-di-o-graph-ic
sub-stan-dard	sub-stand-ard
land-for-m	land-form
per-cip-i-en-t	per-cip-i-ent
ar-bi-trary	ar-bi-trar-y
nightin-gale	night-in-gale
syco-phan-tic	syc-o-phan-tic
u-nion-i-sa-tion	un-ion-i-sa-tion
an-tibi-ot-ic	an-ti-bi-ot-ic
spiny	spin-y
un-demon-stra-tive	un-de-mon-stra-tive
propo-si-tion	prop-o-si-tion
s-tates-man-ship	states-man-ship
mimicry	mim-ic-ry
mi-mosa	mi-mo-sa
mer-ce-nary	mer-ce-nar-y
in-quiry	in-quir-y
de-mount-able	de-mount-a-ble
forte	for-te
tawdry	taw-dry
fly-away	fly-a-way
preda-to-ry	pred-a-to-ry
archer	arch-er
despo-tism	des-pot-ism
s-cat-tered	scattered
re-newed	renewed
potable	po-ta-ble
s-laugh-ter-house	slaugh-ter-house
un-der-stand-ably	un-der-stand-a-bly
fir-m	firm
pre-dictabil-i-ty	pre-dict-a-bil-i-ty
grater	grat-er
i-nan-i-mate	in-an-i-mate
stretchy	stretch-y
seis-mome-ter	seis-mom-e-ter
l-itur-gi-cal	li-tur-gi-cal
re-doubtable	re-doubt-a-ble
mushy	mush-y
as-para-gus	as-par-a-gus
sub-ter-ranean	sub-ter-ra-ne-an
dis-senter	dis-sent-er
non-con-for-mi-ty	non-con-form-i-ty
as-segai	as-se-gai
diplo-mat-ic	dip-lo-mat-ic
screwy	screw-y
ex-cep-t	ex-cept
medic-i-nal	me-dic-i-nal
s-teel	steel
cal-care-ous	cal-car-e-ous
pre-dictable	pre-dict-a-ble
frag-men-t	frag-ment
s-cal-a-bil-i-ty	scal-a-bil-i-ty
re-sent-men-t	re-sent-ment
defuse	de-fuse
as-cen-dan-t	as-cend-ant
epi-gram-mat-ic	ep-i-gram-mat-ic
toluene	tol-u-ene
d-well	dwell
avoid	a-void
i-n-alien-able	in-al-ien-a-ble
mela-tonin	mel-a-to-nin
burn-ings	bur-nings
s-teeple-jack	stee-ple-jack
par-si-mo-nious	par-si-mo-ni-ous
pro-cure-men-t	pro-cure-ment
metaphor	met-a-phor
mas-tery	mas-ter-y
doc-tor-ing	doctoring
can-dlelit	can-dle-lit
oper-a	o-pe-ra
in-frared	in-fra-red
s-tat-uette	stat-u-ette
s-caf-fold	scaf-fold
gable	ga-ble
k-ilo-hertz	kil-o-hertz
pro-ject-ing	projecting
pig-gery	pig-ger-y
mis-chievous	mis-chie-vous
grandios-i-ty	gran-di-os-i-ty
post-mod-ernist	post-mod-ern-ist
metronome	met-ro-nome
epig-ra-phy	e-pig-ra-phy
de-for-m	de-form
frontal	fron-tal
im-mi-nen-t	im-mi-nent
docile	doc-ile
rein-vig-o-rate	re-in-vig-or-ate
de-crepi-tude	de-crep-i-tude
sisal	si-sal
psy-chother-a-py	psy-cho-ther-a-py
sacra-men-tal	sac-ra-men-tal
para-phrase	par-a-phrase
in-spec-t	in-spect
manda-to-ry	man-da-to-ry
samu-rai	sam-u-rai
polem-i-cal	po-lem-i-cal
dolomite	do-lo-mite
gelati-nous	ge-lat-i-nous
c-on-cil-iar	con-cil-i-ar
foot-balling	foot-ball-ing
punky	punk-y
treat-men-t	treat-ment
im-pu-den-t	im-pu-dent
sedi-tious	se-di-tious
satyr	sa-tyr
over-rate	o-ver-rate
literati	lit-e-ra-ti
timid	tim-id
cheru-bic	che-ru-bic
en-graver	en-grav-er
cine	cin-e
en-tre-pre-neur-ial	en-tre-pre-neur-i-al
iso-la-tion-is-m	i-so-la-tion-ism
par-tici-ple	par-ti-ci-ple
t-suna-mi	tsu-na-mi
seg-ment-ed	seg-men-ted
s-mut	smut
ret-i-cen-t	ret-i-cent
el-e-men-t	el-e-ment
gan-glion	gan-gli-on
meta-mor-phis-m	met-a-mor-phism
over-haul	o-ver-haul
un-con-ge-nial	un-con-gen-ial
plat-i-tudi-nous	plat-i-tu-di-nous
meta-physic-s	met-a-phys-ics
grenadier	gren-a-dier
s-cout	scout
bawdy	bawd-y
de-scen-t	de-scent
do-lor-ous	dol-or-ous
com-ple-men-tary	com-ple-men-ta-ry
sier-ra	si-er-ra
paci-fy	pac-i-fy
sel-l	sell
de-cryp-t	de-crypt
randy	rand-y
chimera	chi-me-ra
tra-chea	tra-che-a
showjumper-s	show-jum-pers
suprema-cy	su-prem-a-cy
joyrid-ing	joy-rid-ing
usurer	u-su-rer
at-tribute	at-trib-ute
tempter	tempt-er
fragili-ty	fra-gil-i-ty
rata-touille	ra-ta-touille
white-washed	whitewashed
unlov-able	un-lov-a-ble
en-joy-men-t	en-joy-ment
fel-la-tio	fel-la-ti-o
high-lighter	high-ligh-ter
s-cu-ba	scu-ba
cheva-lier	chev-a-lier
k-i-lo	ki-lo
hobo	ho-bo
seraph-ic	se-raph-ic
dogged	dog-ged
ivy	i-vy
where-about-s	where-a-bouts
s-par-row	spar-row
trans-plant-ed	transplanted
dis-con-ti-nu-ity	dis-con-ti-nu-i-ty
va-grancy	va-gran-cy
cor-nu-copi-a	cor-nu-co-pi-a
archival	ar-chi-val
raider	raid-er
cen-tipede	cen-ti-pede
s-now-fal-l	snow-fall
seaborne	sea-borne
teenaged	teen-aged
bio-met-ric	bi-o-met-ric
unabridged	un-a-bridged
heretic	her-e-tic
sabra	sa-bra
u-p-land	up-land
re-assem-ble	re-as-sem-ble
hefty	heft-y
mega-lo-ma-ni-a	meg-a-lo-ma-ni-a
ex-citable	ex-cit-a-ble
shifty	shift-y
beanstalk	bean-stalk
u-n-a-mused	un-a-mused
mil-lenar-i-an	mil-le-nar-i-an
de-tec-t	de-tect
u-n-ad-dressed	un-ad-dressed
chim-p	chimp
place-men-t	place-ment
d-if-fer-en-tial-ly	dif-fer-en-tial-ly
poly-tech-nic	pol-y-tech-nic
hear-ken	heark-en
undis-cov-ered	un-dis-cov-ered
rhubar-b	rhu-barb
roguery	ro-guer-y
over-fly	o-ver-fly
glassy	glass-y
tena-cious-ly	te-na-cious-ly
debu-tante	deb-u-tante
pan-das	pan-das
gen-uine	gen-u-ine
s-trait	strait
wit-ti-cis-m	wit-ti-cism
galling	gall-ing
fa-nati-cis-m	fa-nat-i-cism
razzmataz-z	razz-ma-tazz
s-can-ner	scan-ner
fa-ther-ing	fathering
re-gen-t	re-gent
with-ered	withered
res-cuer	res-cu-er
re-vival-is-m	re-viv-al-ism
un-healthy	un-health-y
flaky	flak-y
ar-chaeopteryx	ar-chae-op-ter-yx
glam-orous	glam-or-ous
tro-po-sphere	trop-o-sphere
s-cab	scab
over-draw	o-ver-draw
castof-f	cast-off
hermeneu-tic-s	her-me-neu-tics
cuf-f	cuff
re-in-force-men-t	re-in-force-ment
pass-ably	pass-a-bly
poly-mor-phis-m	pol-y-mor-phism
me-nial	me-ni-al
pe-tit	pet-it
poly-thene	pol-y-thene
bear-able	bear-a-ble
un-bear-ably	un-bear-a-bly
nadir	na-dir
kayak	kay-ak
en-chan-t	en-chant
ori-en-t	o-ri-ent
c-on-cil-i-a-tion	con-cil-i-a-tion
ir-re-versible	ir-re-vers-i-ble
onyx	on-yx
tragedy	trag-e-dy
s-caf-fold-ing	scaf-fold-ing
jalopy	ja-lop-y
un-pre-dictably	un-pre-dict-a-bly
cur-tained	curtained
parox-ys-m	par-ox-ysm
cur-ricu-lum	cur-ric-u-lum
artiste	ar-tiste
flutist	flut-ist
tiny	ti-ny
wail-ing	wailing
g-lut-tony	glut-ton-y
par-ent-ing	parenting
s-low-ness	slow-ness
u-n-ap-pre-ci-at-ed	un-ap-pre-ci-at-ed
vizier	vi-zier
morale	mo-rale
hy-acinth	hy-a-cinth
deli	del-i
repos-i-to-ry	re-pos-i-to-ry
buoy	bu-oy
de-lin-eate	de-lin-e-ate
g-lid-ing	glid-ing
there-after	there-af-ter
cru-ci-for-m	cru-ci-form
s-corch-ing	scorch-ing
mesca-line	mes-ca-line
re-plan-t	re-plant
hy-drochlo-ride	hy-dro-chlo-ride
u-topi-an	u-to-pi-an
abroad	a-broad
macaw	ma-caw
em-bez-zle-men-t	em-bez-zle-ment
dauber	daub-er
ho-mo-gene-ity	ho-mo-ge-ne-i-ty
y-achts-man	yachts-man
s-ten-tor	sten-tor
undis-ci-plined	un-dis-ci-plined
vel-veteen	vel-vet-een
covenan-t	cov-e-nant
in-for-man-t	in-form-ant
emul-sion	e-mul-sion
de-moun-t	de-mount
nar-cis-sis-m	nar-cis-sism
stetho-scope	steth-o-scope
melan-cholic	mel-an-chol-ic
sup-ple-men-tary	sup-ple-men-ta-ry
bather	bath-er
un-event-ful	un-e-vent-ful
phi-lan-thropist	phi-lan-thro-pist
paramount-cy	par-a-mount-cy
petro-chem-i-cal	pet-ro-chem-i-cal
swindler	swin-dler
bulky	bulk-y
s-plin-t	splint
sunken	sunk-en
mantrap	man-trap
dugout	dug-out
pun-ish-able	pun-ish-a-ble
dero-gate	der-o-gate
lithi-um	lith-i-um
cursed	curs-ed
herbal-is-m	her-bal-ism
lisp-ing	lis-ping
s-loth	sloth
dishar-mo-ny	dis-har-mo-ny
liken	lik-en
naive-ly	na-ive-ly
con-flu-en-t	con-flu-ent
sali-vary	sal-i-var-y
valise	va-lise
retic-u-lat-ed	re-tic-u-lat-ed
di-ure-sis	di-u-re-sis
d-if-fu-sion	dif-fu-sion
con-vivial	con-viv-i-al
projec-t	proj-ect
s-to-ry-teller	sto-ry-tell-er
gospel	gos-pel
gen-uine-ness	gen-u-ine-ness
sleepi-ness	sleep-i-ness
s-lot	slot
par-a-bola	pa-rab-o-la
d-if-fer-ent-ly	dif-fer-ent-ly
trea-son-able	trea-son-a-ble
pizze-ri-a	piz-ze-ri-a
squally	squal-ly
tyran-ni-cal	ty-ran-ni-cal
dis-penser	dis-pens-er
geo-chem-istry	ge-o-chem-is-try
gal-lan-t	gal-lant
mus-cle-d	mus-cled
blue-bel-l	blue-bell
u-n-ap-proved	un-ap-proved
mi-crowave	mi-cro-wave
molec-u-lar	mo-lec-u-lar
codling	cod-ling
ru-inous	ru-in-ous
fly-over	fly-o-ver
defe-cate	def-e-cate
cylin-der	cyl-in-der
ful-l	full
s-can-dal	scan-dal
bar-baris-m	bar-ba-rism
mis-align-men-t	mis-a-lign-ment
pho-to-copy	pho-to-cop-y
over-pro-duc-tion	o-ver-pro-duc-tion
pre-dict-ed	predicted
os-tracis-m	os-tra-cism
gavotte	ga-votte
in-hala-tion	in-ha-la-tion
shad-owy	shad-ow-y
over-sup-ply	o-ver-sup-ply
fussy	fuss-y
u-nim-por-tance	un-im-por-tance
abaft	a-baft
con-flic-t	con-flict
friendlily	friend-li-ly
my-opi-a	my-o-pi-a
melo-di-ous	me-lo-di-ous
aor-tic	a-or-tic
recog-ni-tion	rec-og-ni-tion
ran-corous	ran-cor-ous
vi-o-len-t	vi-o-lent
nymp-holep-sy	nym-pho-lep-sy
plat-for-m	plat-form
ap-pendage	ap-pend-age
poly-glot	pol-y-glot
wom-ankind	wom-an-kind
ex-porter	ex-port-er
rafter	raft-er
ex-piry	ex-pi-ry
in-cor-rupt-ible	in-cor-rupt-i-ble
steam-roller	steam-roll-er
chivvy	chiv-vy
an-thro-pocen-tric	an-thro-po-cen-tric
cider	ci-der
irid-i-um	i-rid-i-um
sain-t	saint
me-thio-n-ine	me-thi-o-nine
okapi	o-ka-pi
beamy	beam-y
tele-gram	tel-e-gram
in-ter-molec-u-lar	in-ter-mo-lec-u-lar
s-nap-shot	snap-shot
hosepipe	hose-pipe
onus	o-nus
wave-for-m	wave-form
chemist	chem-ist
award	a-ward
man-i-festo	man-i-fes-to
mealie	meal-ie
co-pra	cop-ra
un-fath-ome-d	un-fath-omed
ra-dio-g-ra-pher	ra-di-og-ra-pher
eosin	e-o-sin
s-now-stor-m	snow-storm
s-mug-gler	smug-gler
b-lench	blench
cesspit	cess-pit
pro-nounce-men-t	pro-nounce-ment
jeal-ousy	jeal-ous-y
pe-ri-as-tron	per-i-as-tron
derelic-t	der-e-lict
dis-obe-di-en-t	dis-o-be-di-ent
hia-tus	hi-a-tus
even	e-ven
in-flat-able	in-flat-a-ble
naval	na-val
mayflow-er	may-flow-er
beeswax	bees-wax
makeshift	make-shift
heavy-weight	heav-y-weight
edit-ed	edited
s-pace	space
op-por-tunis-m	op-por-tun-ism
con-sul-tan-cy	con-sult-an-cy
vestal	ves-tal
hon-our	ho-nour
mono-ton-ic	mon-o-ton-ic
paramour	par-a-mour
hazel	ha-zel
await	a-wait
aro-ma	a-ro-ma
un-in-tel-li-gen-t	un-in-tel-li-gent
plumy	plum-y
trea-sure	treas-ure
tenon	ten-on
navy	na-vy
guinea	guin-ea
d-if-fi-dence	dif-fi-dence
book-stal-l	book-stall
vanil-la	va-nil-la
siphon	si-phon
cousin	cous-in
r-eread	re-read
precipice	prec-i-pice
chi-canery	chi-can-er-y
buz-z	buzz
ex-trem-is-m	ex-trem-ism
loca-tive	loc-a-tive
par-adis-e	par-a-dise
s-mashed	smashed
humbly	hum-bly
musty	mus-ty
an-throp-ic	an-thro-pic
creaky	creak-y
car-cino-gen-e-sis	car-cin-o-gen-e-sis
mer-chan-t	mer-chant
sa-tanis-m	sa-tan-ism
ex-e-cutable	ex-e-cut-a-ble
s-cut-tle	scut-tle
gui-tarist	gui-tar-ist
h-m-m	hmm
im-munol-o-gy	im-mu-nol-o-gy
pre-cau-tion-ary	pre-cau-tion-ar-y
s-tun	stun
in-sec-t	in-sect
zigza-g	zig-zag
in-com-men-su-rable	in-com-men-su-ra-ble
renter	rent-er
un-rol-l	un-roll
bistro	bis-tro
n-erve	nerve
skele-ton	skel-e-ton
prefer-ably	pref-er-a-bly
semi-con-scious	sem-i-con-scious
glas-nos-t	glas-nost
sub-con-trac-t	sub-con-tract
prairie	prai-rie
cation	cat-i-on
by-stander	by-stand-er
chateau	cha-teau
facile	fac-ile
triplet	tri-plet
whisker	whisk-er
s-abo-teur	sab-o-teur
un-in-ter-pretable	un-in-ter-pret-a-ble
maser	ma-ser
nor-m	norm
in-tegri-ty	in-teg-ri-ty
busi-ly	bus-i-ly
in-de-ter-minable	in-de-ter-mi-na-ble
peri-patet-ic	per-i-pa-tet-ic
prepara-to-ry	pre-par-a-to-ry
sepul-chral	se-pul-chral
ap-point-men-t	ap-point-ment
t-ele-con-fer-ence	tel-e-con-fer-ence
bal-moral	bal-mor-al
climber	climb-er
war-m	warm
un-no-tice-able	un-no-tice-a-ble
church-war-den	church-ward-en
precinc-t	pre-cinct
s-tu-dious-ly	stu-di-ous-ly
panache	pa-nache
poignan-t	poign-ant
ex-u-ber-an-t	ex-u-ber-ant
busty	bust-y
re-fin-ery	re-fin-er-y
u-n-avoid-able	un-a-void-a-ble
pi-quan-t	pi-quant
con-tin-gen-t	con-tin-gent
quizzi-cal	quiz-zi-cal
hin-t	hint
u-n-am-bigu-ous-ly	un-am-big-u-ous-ly
heather	heath-er
look-ing	looking
over-spill	o-ver-spill
verisimil-i-tude	ver-i-si-mil-i-tude
sar-cas-m	sar-casm
jam-boree	jam-bo-ree
pun-gen-t	pun-gent
rapi-er	ra-pi-er
ef-fi-cien-t	ef-fi-cient
stylis-tic	sty-lis-tic
arthro-pod	ar-thro-pod
odome-ter	o-dom-e-ter
mover	mov-er
s-cold	scold
metal-lic	me-tal-lic
swar-m	swarm
un-war-rantable	un-war-rant-a-ble
s-low-poke	slow-poke
dandy	dan-dy
hy-dran-t	hy-drant
bubon-ic	bu-bon-ic
com-pact-ed	compacted
mam-malian	mam-ma-li-an
myx-o-mato-sis	myx-o-ma-to-sis
pre-or-dained	preordained
tremu-lous	trem-u-lous
l-it-i-gate	lit-i-gate
n-im-bus	nim-bus
fed-er-al-is-m	fed-er-al-ism
syn-di-cal-is-m	syn-di-cal-ism
phys-iog-no-my	phys-i-og-no-my
arum	ar-um
rat-tlesnake	rat-tle-snake
myelin	my-e-lin
cameo	cam-e-o
trashy	trash-y
comet	com-et
comi-ty	com-i-ty
leucine	leu-cine
s-melly	smell-y
ei-de-t-ic	ei-det-ic
an-tipodes	an-tip-o-des
emit	e-mit
a-pos-tolic	ap-os-tol-ic
mar-itime	mar-i-time
blus-ter-ing	blustering
barefaced	bare-faced
con-denser	con-dens-er
s-tom-p	stomp
in-sol-ven-t	in-sol-vent
wispy	wisp-y
d-win-dling	dwindling
metonymy	me-ton-y-my
falset-to	fal-set-to
pathol-o-gy	pa-thol-o-gy
for-cep-s	for-ceps
di-aphanous	di-aph-a-nous
apoc-ryphal	a-poc-ry-phal
over-load	o-ver-load
oblige	o-blige
sup-ple-men-t	sup-ple-ment
sulky	sulk-y
skul-l	skull
sumo	su-mo
s-cab-by	scab-by
repa-tri-a-tion	re-pa-tri-a-tion
liveli-hood	live-li-hood
igua-na	i-gua-na
sero-tonin	ser-o-to-nin
ir-re-proach-able	ir-re-proach-a-ble
cur-tilage	cur-ti-lage
rewritable	re-writ-a-ble
per-ilous-ly	per-il-ous-ly
speechi-fy-ing	speechifying
whiskey	whis-key
xenon	xe-non
rosin	ros-in
dis-abil-i-ty	dis-a-bil-i-ty
pun-t	punt
silage	si-lage
bal-alai-ka	bal-a-lai-ka
dis-in-fec-tan-t	dis-in-fect-ant
rustler	rus-tler
s-tran-gles	stran-gles
milliner	mil-li-ner
over-ripe	o-ver-ripe
peafowl	pea-fowl
dusky	dusk-y
adult	a-dult
unchris-tian	un-chris-tian
overop-ti-mistic	o-ver-op-ti-mis-tic
s-laugh-ter	slaugh-ter
in-can-t	in-cant
cor-po-ratism	cor-po-rat-ism
be-wil-der-ing	bewildering
capri-cious	ca-pri-cious
re-assess-men-t	re-as-sess-ment
u-nion-ist	un-ion-ist
de-ten-t	de-tent
alive	a-live
geo-ther-mal	ge-o-ther-mal
in-con-ceiv-able	in-con-ceiv-a-ble
shilling	shil-ling
rack-e-teer-ing	rack-et-eer-ing
dis-tric-t	dis-trict
bony	bon-y
va-porous	va-por-ous
en-trail-s	en-trails
fever-ish	fe-ver-ish
s-peak	speak
per-cep-t	per-cept
raven-ing	rav-en-ing
ful-mi-nan-t	ful-mi-nant
d-if-fi-den-t	dif-fi-dent
s-cat-o-log-i-cal	scat-o-log-i-cal
s-can	scan
bivouac	biv-ou-ac
hu-manoid	hu-man-oid
read-able	read-a-ble
monotony	mo-not-o-ny
scrupu-lous-ly	scru-pu-lous-ly
ex-is-ten-t	ex-ist-ent
s-lug	slug
mistype	mis-type
mar-que	marque
spir-i-tu-al-ist	spir-it-u-al-ist
colan-der	col-an-der
ashamed	a-shamed
lyri-cal	lyr-i-cal
sen-hor	se-nhor
ar-ro-gan-t	ar-ro-gant
ir-ri-tabil-i-ty	ir-ri-ta-bil-i-ty
freck-led	freckled
fig-u-ra-tive	fig-ur-a-tive
zany	za-ny
s-plin-ter	splin-ter
antwer-p	antwerp
melanin	mel-a-nin
soli-taire	sol-i-taire
bal-loon-ist	balloonist
crack-er-s	crack-ers
cherub	cher-ub
margina-li-a	mar-gi-na-li-a
shopfron-t	shop-front
con-vert-ible	con-vert-i-ble
over-look	o-ver-look
un-de-tectable	un-de-tect-a-ble
gra-tu-itous-ly	gra-tu-i-tous-ly
atom-ic-i-ty	at-o-mic-i-ty
harpist	har-pist
weapon	weap-on
toothy	tooth-y
bullfinch	bull-finch
makeover	make-o-ver
s-tar-tle	star-tle
in-cisor	in-ci-sor
u-n-aes-thet-ic	un-aes-thet-ic
omi-nous	om-i-nous
delux-e	de-luxe
soli-tary	sol-i-tar-y
uterus	u-ter-us
hy-draulic-s	hy-drau-lics
of-f	off
ure-thane	u-re-thane
calo-rie	cal-o-rie
breath-able	breath-a-ble
hand-bel-l	hand-bell
tel-l	tell
dis-pens-able	dis-pen-sa-ble
ir-re-versibly	ir-re-vers-i-bly
elec-tro-dy-nam-ic-s	e-lec-tro-dy-nam-ics
tenac-i-ty	te-nac-i-ty
s-limy	slim-y
babysit-ting	babysitting
e-u-pho-nious	eu-pho-ni-ous
aqua-naut	aq-ua-naut
s-paghet-ti	spa-ghet-ti
vest-men-t	vest-ment
techno-pho-bic	tech-no-pho-bic
s-trate-gi-cal-ly	stra-te-gi-cal-ly
the-is-m	the-ism
s-tock-pile	stock-pile
s-nick	snick
bal-lis-tic-s	bal-lis-tics
strol-l	stroll
in-com-press-ible	in-com-press-i-ble
coax-i-al	co-ax-i-al
s-lug-gard	slug-gard
e-quip-men-t	e-quip-ment
mono-rail	mon-o-rail
f-rigid	frig-id
hauler	haul-er
vari-ate	var-i-ate
turnkey	turn-key
tri-adic	tri-ad-ic
un-break-able	un-break-a-ble
s-lip-ping	slipping
de-ity	de-i-ty
un-reach-able	un-reach-a-ble
re-mark-ably	re-mark-a-bly
an-nal-s	an-nals
leg-isla-tive	leg-is-la-tive
reaper	reap-er
s-tone-ma-son	stone-ma-son
s-i-nu-soid	si-nus-oid
un-mis-tak-ably	un-mis-tak-a-bly
sub-sis-tence	sub-sist-ence
ac-cept-able	ac-cept-a-ble
stri-den-t	stri-dent
turnip	tur-nip
s-nake	snake
s-neak-i-ly	sneak-i-ly
epi-der-mis	ep-i-der-mis
mono-lin-gual	mon-o-lin-gual
s-ta-tus	sta-tus
con-struc-tivis-m	con-struc-tiv-ism
oakum	oa-kum
cen-tripetal	cen-trip-e-tal
pres-bytery	pres-by-ter-y
dis-join-t	dis-joint
geisha	gei-sha
sinis-tral	sin-is-tral
de-plorable	de-plor-a-ble
shim-mer-ing	shimmering
cannabis	can-na-bis
an-tide-pres-san-t	an-ti-de-pres-sant
ibis	i-bis
ivory	i-vo-ry
over-in-flat-ed	o-ver-in-flat-ed
mono-phon-ic	mon-o-phon-ic
fifty	fif-ty
s-narl	snarl
body-build-ing	bod-y-build-ing
bour-geoisie	bour-geoi-sie
fu-ner-ary	fu-ner-ar-y
in-ter-lock-ing	in-ter-loc-king
y-ou	you
bur-glary	bur-gla-ry
eat-able	eat-a-ble
mores	mo-res
plat-inum	plat-i-num
spinach	spin-ach
test-ing	testing
cop-pery	cop-per-y
ge-nial	ge-ni-al
techno-pho-bi-a	tech-no-pho-bia
s-lice	slice
clair-voy-an-t	clair-voy-ant
o-ver-seer	o-ver-se-er
poly-math	pol-y-math
cel-ery	cel-er-y
e-vo-ca-tion	ev-o-ca-tion
pim-p	pimp
re-ver-ber-an-t	re-ver-ber-ant
su-per-natan-t	su-per-na-tant
in-con-solable	in-con-sol-a-ble
bi-modal	bi-mod-al
boathouse	boat-house
pres-tidig-i-ta-tion	pres-ti-dig-i-ta-tion
dullard	dull-ard
elec-tro-stat-ic-s	e-lec-tro-stat-ics
he-li-copter	hel-i-cop-ter
regress	re-gress
navvy	nav-vy
ool-o-gy	o-ol-o-gy
elec-tro-mo-tive	e-lec-tro-mo-tive
dosage	dos-age
e-t-y-mo-log-i-cal	et-y-mo-log-i-cal
s-traight-for-ward-ly	straight-for-ward-ly
lin-gerie	lin-ge-rie
om-nipo-ten-t	om-nip-o-tent
s-cape-goat	scape-goat
s-noop	snoop
en-list-men-t	en-list-ment
hoard-ed	hoarded
pectin	pec-tin
ex-tend-able	ex-tend-a-ble
tav-er-na	ta-ver-na
resur-gen-t	re-sur-gent
vivi-sec-tion	viv-i-sec-tion
sadis-tic	sa-dis-tic
p-tarmi-gan	ptar-mi-gan
aun-t	aunt
over-pay	o-ver-pay
s-lap-stick	slap-stick
in-ter-locu-to-ry	in-ter-loc-u-to-ry
ima-go	i-ma-go
op-ti-misti-cal-ly	op-ti-mis-ti-cal-ly
forego	fore-go
chrono-log-i-cal	chron-o-log-i-cal
in-de-pen-dence	in-de-pend-ence
mis-sy	miss-y
s-pa-tial-ly	spa-tial-ly
miser	mi-ser
perime-ter	pe-rim-e-ter
dis-rep-utable	dis-rep-u-ta-ble
plan-t	plant
inkwell	ink-well
con-vect-ed	convected
t-elecom-mut-ing	te-le-com-mu-ting
be-wil-dered	bewildered
sym-bol-is-m	sym-bol-ism
sim-plis-m	sim-plism
di-ana	di-an-a
steady-ing	steadying
over-joyed	o-ver-joyed
in-ex-haustible	in-ex-haust-i-ble
glaciol-o-gy	gla-ci-ol-o-gy
repack	re-pack
un-der-state-men-t	un-der-state-ment
io-dide	i-o-dide
g-nat	gnat
ter-m	term
fatu-ous	fat-u-ous
prefer-men-t	pre-fer-ment
ranker	rank-er
s-teeply	steep-ly
soft-bal-l	soft-ball
im-pinge-men-t	im-pinge-ment
squalor	squal-or
de-sir-abil-i-a	de-si-ra-bi-li-a
are-na	a-re-na
choral	cho-ral
chamomile	cham-o-mile
im-p	imp
as-pec-t	as-pect
woody	wood-y
so-porif-ic	sop-o-rif-ic
mer-cury	mer-cu-ry
stere-o	ster-e-o
may-oral	may-or-al
em-bed-dable	em-bed-da-ble
soapy	soap-y
over-load-ed	overloaded
jan-u-ary	jan-u-ar-y
stenog-ra-phy	ste-nog-ra-phy
in-cur-able	in-cur-a-ble
duress	du-ress
katy-did	ka-ty-did
nud-is-t	nud-ist
mi-cro-farad	mi-cro-far-ad
bac-teri-um	bac-te-ri-um
brain-stor-m	brain-storm
sibyl	sib-yl
s-plash	splash
plan-gen-t	plan-gent
mi-cro-bial	mi-cro-bi-al
nether-most	neth-er-most
tanker	tank-er
re-minder	re-mind-er
pom-padour	pom-pa-dour
shady	shad-y
saline	sa-line
clat-ter-ing	cla-tter-ing
ure-thra	u-re-thra
trunk-s	trunks
tri-umvi-rate	tri-um-vi-rate
fruition	fru-i-tion
caseload	case-load
tangy	tang-y
urol-o-gist	u-rol-o-gist
banker	bank-er
pre-dic-t	pre-dict
catchy	catch-y
non-pay-men-t	non-pay-ment
s-trait-ened	strait-ened
re-jec-t	re-ject
re-strain-ing	restraining
plumba-go	plum-ba-go
con-so-nan-t	con-so-nant
im-per-turbable	im-per-turb-a-ble
epi-demi-o-log-i-cal	ep-i-de-mi-o-log-i-cal
coro-na-tion	cor-o-na-tion
pe-rusal	pe-rus-al
p-ith	pith
painful	pain-ful
layper-son	lay-per-son
over-draft	o-ver-draft
durable	du-ra-ble
pewter	pew-ter
peren-ni-al	per-en-ni-al
nu-tri-men-t	nu-tri-ment
tele-graph-ic	tel-e-graph-ic
e-lastin	e-las-tin
elec-tron	e-lec-tron
hon-esty	hon-es-ty
pogo	po-go
ex-cel-len-t	ex-cel-lent
despot	des-pot
de-signed-ly	de-sign-ed-ly
diplo-mat	dip-lo-mat
weasel	wea-sel
pig-men-t	pig-ment
clien-tele	cli-en-tele
ex-pand-able	ex-pand-a-ble
ig-neous	ig-ne-ous
aper-ture	ap-er-ture
soror-i-ty	so-ror-i-ty
s-tand	stand
bacil-lus	ba-cil-lus
bar-tender	bar-tend-er
res-onator	res-o-na-tor
in-ge-nious-ly	in-gen-ious-ly
ganger	gang-er
catholic	cath-o-lic
s-tratig-ra-phy	stra-tig-ra-phy
face-tious	fa-ce-tious
evening	eve-ning
lifeblood	life-blood
joyride	joy-ride
warhorse	war-horse
dud-geon	dudg-eon
un-easi-ness	un-eas-i-ness
c-ityscape	cit-y-scape
mis-man-age-men-t	mis-man-age-ment
japan	ja-pan
slaver	slav-er
fi-brob-last	fi-bro-blast
poignan-cy	poign-an-cy
il-lim-itable	il-lim-it-a-ble
egress	e-gress
s-tature	stat-ure
s-cis-sor	scis-sor
slav-ery	slav-er-y
ar-rester	ar-rest-er
s-traight-for-ward	straight-for-ward
linkup	link-up
s-cam	scam
sum-mery	sum-mer-y
shindig	shin-dig
per-me-able	per-me-a-ble
easel	ea-sel
tum-bled	tumbled
bion-ic	bi-on-ic
hoary	hoar-y
porta-bil-i-ty	port-a-bil-i-ty
sonorous	so-no-rous
tran-scrip-t	tran-script
decagon	dec-a-gon
crony	cro-ny
mis-treat-men-t	mis-treat-ment
aro-mather-a-py	a-ro-ma-ther-a-py
o-nion	on-ion
iono-sphere	i-on-o-sphere
de-sir-able	de-sir-a-ble
boudoir	bou-doir
podi-um	po-di-um
su-perla-tive	su-per-la-tive
tri-umphan-t	tri-um-phant
dancer	danc-er
re-pel-len-t	re-pel-lent
re-sul-tan-t	re-sult-ant
loosen	loos-en
gazette	ga-zette
tena-cious	te-na-cious
lam-plit	lamp-lit
reser-voir	res-er-voir
gos-samer	gos-sa-mer
rhetor-i-cal	rhe-tor-i-cal
ve-loci-pede	ve-loc-i-pede
g-narl	gnarl
iron-ic	i-ron-ic
cov-e	cove
ex-pec-t	ex-pect
s-care	scare
por-phyry	por-phy-ry
over-bear-ing	o-ver-bear-ing
flashy	flash-y
in-ter-fer-e	in-ter-fere
dis-putable	dis-put-a-ble
re-arrange-ment	re-ar-range-ment
eye-bal-l	eye-ball
doubtless-ly	doubt-less-ly
carmine	car-mine
vari-cose	var-i-cose
cleaver	cleav-er
imag-ine	im-ag-ine
rai-men-t	rai-ment
dis-may-ing	dismaying
s-lur	slur
s-pank	spank
ex-ult-ing	exulting
zenith	ze-nith
tes-ta-men-t	tes-ta-ment
tonedeaf	tone-deaf
poly-merase	pol-y-mer-ase
retel-l	re-tell
cir-cum-lo-cu-to-ry	cir-cum-loc-u-to-ry
in-for-m	in-form
wag-gery	wag-ger-y
calorif-ic	cal-o-rif-ic
cus-tom-ary	cus-tom-ar-y
de-file-men-t	de-file-ment
di-uret-ic	di-u-ret-ic
coinage	coin-age
t-wang	twang
bi-car-bon-ate	bi-car-bo-nate
sa-van-t	sa-vant
roast-ed	roasted
con-gealed	congealed
schis-m	schism
switchgear	switch-gear
edgy	edg-y
lega-tee	leg-a-tee
e-van-ge-lis-m	e-van-ge-lism
or-gan-is-m	or-gan-ism
apolo-get-i-cal-ly	a-pol-o-get-i-cal-ly
coun-terof-fen-sive	coun-ter-of-fen-sive
ranter	rant-er
fe-lic-i-ta-tion-s	fe-lic-i-ta-tions
e-u-phemisti-cal-ly	eu-phe-mis-ti-cal-ly
poignant-ly	poign-ant-ly
over-state-men-t	o-ver-state-ment
re-in-state-men-t	re-in-state-ment
polysac-cha-ride	pol-y-sac-cha-ride
read-just-men-t	re-ad-just-ment
un-stop-pable	un-stop-pa-ble
eigen-func-tion	ei-gen-func-tion
s-nuff-box	snuff-box
meta-mor-phose	met-a-mor-phose
join-ery	join-er-y
car-dioid	car-di-oid
in-tol-er-an-t	in-tol-er-ant
s-teel-work-er	steel-work-er
el-e-men-tary	el-e-men-ta-ry
s-tormer	storm-er
tonal-i-ty	to-nal-i-ty
n-od	nod
skul-dug-gery	skul-dug-ger-y
platy-pus	plat-y-pus
w-hole-wheat	wholewheat
penance	pen-ance
kamikaze	ka-mi-ka-ze
u-nashamed-ly	un-a-sham-ed-ly
s-lide	slide
s-nig-ger	snig-ger
ad-d	add
ir-rel-e-van-t	ir-rel-e-vant
u-nas-so-ci-at-ed	un-as-so-ci-at-ed
plea-sure	pleas-ure
repack-age	re-pack-age
over-time	o-ver-time
con-nect-ing	con-nec-ting
charis-ma	cha-ris-ma
colosto-my	co-los-to-my
pa-tien-t	pa-tient
vicarage	vic-ar-age
de-press-ing	de-pres-sing
wafer	wa-fer
s-neer	sneer
qui-etus	qui-e-tus
ori-en-tal-is-m	o-ri-en-tal-ism
re-cov-ery	re-cov-er-y
leviathan	le-vi-a-than
b-liss-ful	bliss-ful
missal	mis-sal
weav-ing	weaving
pathogen	path-o-gen
s-woon	swoon
para-troop-s	par-a-troops
joey	jo-ey
s-jam-bok	sjam-bok
mal-leable	mal-le-a-ble
in-tel-li-gen-t	in-tel-li-gent
preda-tor	pred-a-tor
nephew	neph-ew
s-mog	smog
u-n-ap-pre-cia-tive	un-ap-pre-ci-a-tive
in-su-lan-t	in-su-lant
re-spon-den-t	re-spond-ent
sala-man-der	sal-a-man-der
s-lash-ing	slash-ing
io-dine	i-o-dine
u-nipo-lar	u-ni-po-lar
k-lick	klick
l-iti-gious	li-ti-gious
tiger	ti-ger
meta-bol-ic	met-a-bol-ic
epic	ep-ic
rein-sur-ance	re-in-sur-ance
man-darin	man-da-rin
per-fec-t	per-fect
laden	lad-en
prosce-ni-um	pro-sce-ni-um
i-n-ad-mis-si-ble	in-ad-mis-si-ble
iso-tope	i-so-tope
phos-pho-r	phos-phor
floozy	floo-zy
yel-l	yell
bound-ary	bound-a-ry
forest-ed	forested
leo-tard	le-o-tard
na-iad	nai-ad
mis-rep-re-sen-t	mis-rep-re-sent
in-spec-torate	in-spec-tor-ate
ex-pan-sion-is-m	ex-pan-sion-ism
anoin-t	a-noint
pa-pery	pa-per-y
pho-to-genic	pho-to-gen-ic
im-mun-od-e-fi-cien-cy	im-mu-no-de-fi-cien-cy
polyg-y-ny	po-lyg-y-ny
elec-trophore-sis	e-lec-tro-pho-re-sis
un-equal	un-e-qual
pro-pri-etor-ship	pro-pri-e-tor-ship
pala-tine	pal-a-tine
beau-teous	beau-te-ous
fisticuff-s	fist-i-cuffs
u-n-al-lo-cat-ed	un-al-lo-cat-ed
mid-ship-s	mid-ships
des-orp-tion	de-sorp-tion
i-n-ac-tion	in-ac-tion
p-salm	psalm
e-d-u-cat-ed	ed-u-cat-ed
con-for-mance	con-form-ance
s-tom-ach	stom-ach
rar-efied	rar-e-fied
dis-uni-ty	dis-u-ni-ty
good-s	goods
re-de-vel-op-men-t	re-de-vel-op-ment
polyp	pol-yp
fruity	fruit-y
dis-gust-ed	disgusted
s-car-i-fy	scar-i-fy
sed-i-men-t	sed-i-ment
con-stituen-cy	con-stit-u-en-cy
detox	de-tox
epis-tle	e-pis-tle
whether	wheth-er
forcibly	for-ci-bly
lanky	lank-y
er-ran-t	er-rant
beg-gary	beg-gar-y
in-dex-ing	indexing
sub-jec-tivis-m	sub-jec-tiv-ism
piton	pi-ton
per-man-ganate	per-man-ga-nate
holis-m	ho-lism
hov-e	hove
any-body	an-y-bod-y
con-fi-den-t	con-fi-dent
en-slave-men-t	en-slave-ment
k-nack-er	knack-er
parochial	pa-ro-chi-al
elo-quen-t	el-o-quent
prof-i-teer-ing	profiteering
tri-umphant-ly	tri-um-phant-ly
pol-lu-tan-t	pol-lu-tant
toil-s	toils
u-ni-tary	u-ni-tar-y
ruler	rul-er
s-lake	slake
para-chute	par-a-chute
fundrais-er	fund-rais-er
echid-na	e-chid-na
duchess	duch-ess
ori-en-tal	o-ri-en-tal
pinafore	pin-a-fore
clam-p	clamp
refuge	ref-uge
n-ode	node
k-er-nel	ker-nel
cuboid	cu-boid
reat-temp-t	re-at-tempt
in-elas-tic	in-e-las-tic
punch-able	punch-a-ble
vig-i-lante	vig-i-lan-te
ra-tio-nal	ra-tion-al
ple-b	pleb
ju-di-cia-ry	ju-di-ci-ar-y
as-siduity	as-si-du-i-ty
fetishist	fet-ish-ist
polygamy	po-lyg-a-my
over-worked	overworked
click-ing	clicking
un-even-ly	un-e-ven-ly
cre-ation-is-m	cre-a-tion-ism
case-men-t	case-ment
mil-i-tan-t	mil-i-tant
rain-fal-l	rain-fall
ban-ish-men-t	ban-ish-ment
par-alin-guis-tic	par-a-lin-guis-tic
mag-nil-o-quen-t	mag-nil-o-quent
biorhyth-m	bi-o-rhythm
bug-gered	buggered
lessor	les-sor
rudi-men-ta-ry	ru-di-men-ta-ry
pid-gin	pidg-in
raga-muf-fin	rag-a-muf-fin
ar-range-men-t	ar-range-ment
un-linked	unlinked
hair-spray	hairspray
prov-ably	prov-a-bly
con-vict-ed	convicted
di-lata-tion	dil-a-ta-tion
in-ter-na-tion-al-is-m	in-ter-na-tion-al-ism
s-e-lec-tor	se-lec-tor
bio-ta	bi-o-ta
chesty	chest-y
s-log	slog
bal-cony	bal-co-ny
mono-lith-ic	mon-o-lith-ic
in-tu-itive	in-tu-i-tive
en-abled	e-na-bled
chico-ry	chic-o-ry
carotene	car-o-tene
celandine	cel-an-dine
im-por-tan-t	im-por-tant
com-pan-ion-able	com-pan-ion-a-ble
com-mand-men-t	com-mand-ment
col-lec-tivis-m	col-lec-tiv-ism
courtship	court-ship
oafish	oaf-ish
re-len-t	re-lent
u-niden-ti-fied	un-i-den-ti-fied
s-melt-ing	smelting
is-lander	is-land-er
be-muse-men-t	be-muse-ment
cli-toris	clit-o-ris
wil-lowy	wil-low-y
coau-thor	co-au-thor
e-d-u-ca-tion	ed-u-ca-tion
im-pair-men-t	im-pair-ment
teething	teeth-ing
en-chant-ed	enchanted
as-sen-t	as-sent
cres-cen-t	cres-cent
in-no-cen-t	in-no-cent
ide-ol-o-gy	i-de-ol-o-gy
dowry	dow-ry
zealotry	zeal-ot-ry
poly-chrome	pol-y-chrome
chan-t	chant
best-seller	best-sell-er
kil-n	kiln
litho-sphere	lith-o-sphere
dotage	dot-age
seashore	sea-shore
bul-letin	bul-le-tin
chaf-f	chaff
sep-a-ratist	sep-a-ra-tist
dyestuff	dye-stuff
s-carce-ly	scarce-ly
over-view	o-ver-view
marathon	mar-a-thon
tele-vi-su-al	tel-e-vis-u-al
iron-ing	i-ron-ing
ax-olotl	ax-o-lotl
er-r	err
s-toep	stoep
mar-ketable	mar-ket-a-ble
misog-y-ny	mi-sog-y-ny
mis-in-for-m	mis-in-form
p-re-set	pre-set
is-suance	is-su-ance
d-in-gle	din-gle
colour	co-lour
prophe-cy	proph-e-cy
servile	ser-vile
col-lec-tivist	col-lec-tiv-ist
s-pac-er	spac-er
weari-ness	wea-ri-ness
builder	build-er
set-tle-men-t	set-tle-ment
above	a-bove
genome	ge-nome
tidal	tid-al
i-n-ad-e-quate	in-ad-e-quate
crawler	crawl-er
vestibu-lar	ves-tib-u-lar
sur-vivor	sur-vi-vor
whaler	whal-er
around	a-round
steno-sis	ste-no-sis
qui-es-cen-t	qui-es-cent
basil-i-ca	ba-sil-i-ca
de-riso-ry	de-ri-so-ry
dais	da-is
un-mis-tak-able	un-mis-tak-a-ble
s-tar-ry	star-ry
b-land-ly	bland-ly
ex-ploita-tion	ex-ploi-ta-tion
holo-caust	hol-o-caust
hauli-er	haul-ier
wilder-ness	wil-der-ness
tele-scop-ic	tel-e-scop-ic
leaflet	leaf-let
lot-tery	lot-ter-y
aven-s	av-ens
bire-frin-gen-t	bi-re-frin-gent
dis-tur-b	dis-turb
lessee	les-see
elixir	e-lix-ir
com-mon-s	com-mons
bio-di-ver-si-ty	bi-o-di-ver-si-ty
giro	gi-ro
exe-un-t	ex-e-unt
sub-trac-t	sub-tract
bish-opric	bish-op-ric
dili-gent-ly	dil-i-gent-ly
voca-tive	voc-a-tive
de-gauss-ing	degaussing
cred-it-wor-thy	cred-it-worth-y
catheter	cath-e-ter
mo-lesta-tion	mo-les-ta-tion
s-ten-to-ri-an	sten-to-ri-an
s-trap-ping	strap-ping
poly-mor-phic	pol-y-mor-phic
quotable	quot-a-ble
kelvin	kel-vin
residu-um	re-sid-u-um
ero-sion	e-ro-sion
rein-tro-duc-tion	re-in-tro-duc-tion
ma-te-ri-al-is-m	ma-te-ri-al-ism
s-cup-per	scup-per
c-it-ron	cit-ron
an-tag-o-nis-m	an-tag-o-nism
un-bear-able	un-bear-a-ble
un-fet-tered	unfettered
imag-i-na-tion	im-ag-i-na-tion
un-de-ni-able	un-de-ni-a-ble
burn-t	burnt
lachry-mose	lach-ry-mose
arith-metic	a-rith-me-tic
s-lith-er	slith-er
dis-cor-dan-t	dis-cord-ant
micro-organ-ism	mi-cro-or-gan-ism
sober-ly	so-ber-ly
sewage	sew-age
over-hang	o-ver-hang
smoky	smok-y
cedil-la	ce-dil-la
pinkie	pink-ie
in-signif-i-can-t	in-sig-nif-i-cant
sub-servien-t	sub-ser-vi-ent
swasti-ka	swas-ti-ka
com-men-t	com-ment
doughty	dough-ty
prom-is-sory	prom-is-so-ry
s-tock-room	stock-room
melee	me-lee
re-order	re-or-der
s-teel-work-s	steel-works
prodi-gal	prod-i-gal
de-struc-t	de-struct
por-ta-ble	port-a-ble
sen-ti-men-t	sen-ti-ment
id-i-olec-t	id-i-o-lect
sub-si-dence	sub-sid-ence
epi-cure	ep-i-cure
mirac-u-lous	mi-rac-u-lous
frat-ri-ci-dal	frat-ri-cid-al
firmware	firm-ware
s-tun-ner	stun-ner
gen-eros-i-ty	gen-er-os-i-ty
opi-ate	o-pi-ate
s-low-ly	slow-ly
re-union	re-un-ion
renowned	re-nowned
even-tu-al-i-ty	e-ven-tu-al-i-ty
over-write	o-ver-write
recipe	rec-i-pe
for-giv-able	for-giv-a-ble
s-tark-ly	stark-ly
isother-mal	i-so-ther-mal
racon-teur	rac-on-teur
un-com-fort-ably	un-com-fort-a-bly
in-evitabil-i-ty	in-ev-i-ta-bil-i-ty
bla-tan-t	bla-tant
artist	art-ist
scintig-ra-phy	scin-tig-ra-phy
e-pochal	ep-och-al
copy-right	cop-y-right
e-mer-ald	em-er-ald
s-pawn	spawn
fes-ter-ing	festering
hazel-nut	ha-zel-nut
clemen-cy	clem-en-cy
fibu-la	fib-u-la
gravy	gra-vy
lin-guis-tic-s	lin-guis-tics
con-strict-ed	constricted
un-trans-lat-able	un-trans-lat-a-ble
over-lord	o-ver-lord
minute	mi-nute
degra-da-tion	deg-ra-da-tion
stil-l	still
anvil	an-vil
a-p-a-thet-ic	ap-a-thet-ic
hypocrisy	hy-poc-ri-sy
bristling	bris-tling
over-done	o-ver-done
avi-a-tion	a-vi-a-tion
ex-ploita-tive	ex-ploit-a-tive
vol-canic	vol-can-ic
school-teacher	school-teach-er
kaiser	kai-ser
mon-e-tary	mon-e-tar-y
col-lec-tivi-sa-tion	col-lec-ti-vi-sa-tion
fiz-z	fizz
con-strain-t	con-straint
har-mo-nious	har-mo-ni-ous
cin-e-matog-ra-pher	cin-e-ma-tog-ra-pher
overt-ly	o-vert-ly
moral-i-ty	mo-ral-i-ty
mis-ery	mis-er-y
chaffinch	chaf-finch
marked-ly	mark-ed-ly
cryo-gen-ic-s	cry-o-gen-ics
ex-po-nen-t	ex-po-nent
condi-men-t	con-di-ment
cy-to-tox-i-c	cy-to-tox-ic
jokey	jok-ey
monog-a-mous-ly	mo-nog-a-mous-ly
re-trieval	re-triev-al
s-peak-er	speak-er
re-pen-tance	re-pent-ance
t-int-ed	tinted
cle-f	clef
en-fee-bled	enfeebled
hon-orif-ic	hon-or-if-ic
buck-min-ster-fullerene	buck-min-ster-ful-ler-ene
im-pov-er-ish-men-t	im-pov-er-ish-ment
in-ves-tiga-tive	in-ves-ti-ga-tive
augite	au-gite
con-queror	con-quer-or
s-tim-u-lat-ing	stim-u-lat-ing
swarthy	swarth-y
in-valu-able	in-val-u-a-ble
but-tery	but-ter-y
re-in-stal-l	re-in-stall
rani	ra-ni
s-ludge	sludge
con-fec-tionery	con-fec-tion-er-y
turpi-tude	tur-pi-tude
pe-riph-ery	pe-riph-er-y
de-scend-ing	descending
de-ify	de-i-fy
calorime-ter	cal-o-rim-e-ter
par-enter-al	par-en-ter-al
madam	mad-am
flagon	flag-on
jour-nalese	jour-nal-ese
in-fre-quen-t	in-fre-quent
s-word	sword
laud-ed	lauded
method-ol-o-gy	meth-od-ol-o-gy
en-thu-si-as-m	en-thu-si-asm
sa-k-i	sa-ki
bel-liger-en-t	bel-lig-er-ent
phys-io-ther-a-py	phys-i-o-ther-a-py
ileum	il-e-um
pro-pa-gan-da	prop-a-gan-da
ex-tra-galac-tic	ex-tra-ga-lac-tic
met-ric-s	met-rics
a-vian	a-vi-an
area	ar-e-a
dread-lock-s	dread-locks
trumpery	trump-er-y
hide-away	hide-a-way
floater	float-er
copy	cop-y
at-tempt-ed	at-temp-ted
l-it-mus	lit-mus
lov-able	lov-a-ble
creamy	cream-y
b-e-fit	be-fit
cafe-te-ri-a	caf-e-te-ri-a
nurs-ery-men	nurs-er-y-men
treaty	trea-ty
ban-ter-ing	bantering
in-ter-change-ably	in-ter-change-a-bly
be-fal-l	be-fall
lancet	lan-cet
ashore	a-shore
sec-ondary	sec-ond-ar-y
her-i-ta-ble	her-it-a-ble
drink-able	drink-a-ble
postal	post-al
over-shad-ow	o-ver-shad-ow
faucet	fau-cet
l-itur-gy	lit-ur-gy
u-nas-sum-ing	un-as-sum-ing
deuteron	deu-ter-on
benefice	ben-e-fice
fevered	fe-vered
decor	de-cor
es-tu-ary	es-tu-ar-y
s-tar-va-tion	star-va-tion
over-whelm-ing-ly	o-ver-whelm-ing-ly
hero-ine	her-o-ine
mo-lasses	mo-las-ses
con-sor-tium	con-sor-ti-um
windswep-t	wind-swept
s-cen-t	scent
re-moval	re-mov-al
u-n-avoid-ably	un-a-void-a-bly
wormy	worm-y
doyen	doy-en
monochro-mat-ic	mon-o-chro-mat-ic
s-traight-en	straight-en
in-fir-m	in-firm
un-der-study	un-der-stud-y
pa-tri-o-tism	pa-tri-ot-ism
d-e-fi-cien-cy	de-fi-cien-cy
elu-ci-da-tion	e-lu-ci-da-tion
s-pleen	spleen
s-mooth	smooth
canal	ca-nal
biosyn-the-sis	bi-o-syn-the-sis
plea-sur-able	pleas-ur-a-ble
notepa-per	note-pa-per
phrasal	phras-al
in-co-her-en-t	in-co-her-ent
cre-ation	cre-a-tion
pi-rat-ed	pirated
cra-nial	cra-ni-al
to-po-graph-ic	top-o-graph-ic
s-lant-ing	slant-ing
er-ro-neous	er-ro-ne-ous
hyp-nother-a-py	hyp-no-ther-a-py
ine-bri-ate	in-e-bri-ate
io-ta	i-o-ta
nineti-eth	nine-ti-eth
stron-groom	strong-room
ar-ti-fi-cial-i-ty	ar-ti-fi-ci-al-i-ty
s-lip	slip
cigar	ci-gar
neon	ne-on
fury	fu-ry
colos-sal	co-los-sal
back-bencher	back-bench-er
d-if-fer-en-ti-ate	dif-fer-en-ti-ate
s-coff	scoff
s-cant-y	scant-y
con-sti-tu-tion-al-is-m	con-sti-tu-tion-al-ism
u-ni-for-mi-ty	u-ni-form-i-ty
propul-sion	pro-pul-sion
prospec-tus	pro-spec-tus
par-tic-u-lar-is-m	par-tic-u-lar-ism
s-cores	scores
over-pay-men-t	o-ver-pay-ment
sub-lu-nary	sub-lu-nar-y
su-per-fi-cial-i-ty	su-per-fi-ci-al-i-ty
repli-cate	rep-li-cate
tourni-quet	tour-ni-quet
flat-u-len-t	flat-u-lent
garbage	gar-bage
in-ter-jec-t	in-ter-ject
ef-fer-ves-cen-t	ef-fer-ves-cent
propin-quity	pro-pin-qui-ty
as-tro-physi-cist	as-tro-phys-i-cist
nonessen-tial	non-es-sen-tial
discog-ra-phy	dis-cog-ra-phy
bio-engi-neer-ing	bi-o-en-gi-neer-ing
phono-log-i-cal	pho-no-log-i-cal
bil-liard-s	bil-liards
pari-etal	pa-ri-e-tal
basilisk	bas-i-lisk
night-fal-l	night-fall
bedrock	bed-rock
pesti-len-t	pes-ti-lent
fever-ish-ly	fe-ver-ish-ly
a-t-ro-phy	at-ro-phy
cast-away	cast-a-way
leath-ery	leath-er-y
com-paction	com-pac-tion
rigid-i-fy	ri-gid-i-fy
sycamore	syc-a-more
stinger	sting-er
un-rea-son-ably	un-rea-son-a-bly
strug-gling	struggling
a-gree-men-t	a-gree-ment
macro-cos-m	mac-ro-cosm
reap-pear-ance	re-ap-pear-ance
epi-graph	ep-i-graph
mis-spellings	mis-spel-lings
recre-ation	rec-re-a-tion
philoso-pher	phi-los-o-pher
talon	tal-on
propane	pro-pane
trendy	trend-y
s-cathe	scathe
stripy	strip-y
medi-um	me-di-um
mini-bar	min-i-bar
ex-hi-bi-tion-is-m	ex-hi-bi-tion-ism
steamship	steam-ship
piety	pi-e-ty
con-fir-ma-to-ry	con-firm-a-to-ry
con-sumerist	con-sum-er-ist
enor-mous	e-nor-mous
caliper	cal-i-per
lun-cheon	lunch-eon
palatal	pal-a-tal
s-tum-ble	stum-ble
souther-ly	south-er-ly
over-do	o-ver-do
trace-abil-i-ty	trace-a-bil-i-ty
di-aphrag-m	di-a-phragm
con-duc-tance	con-duct-ance
chemise	che-mise
ra-tio-nal-ist	ra-tion-al-ist
o-ri-gin	or-i-gin
phoenix	phoe-nix
takeover	take-o-ver
syrup	syr-up
hayloft	hay-loft
detri-men-t	det-ri-ment
woodsmoke	wood-smoke
i-nani-ty	in-an-i-ty
telethon	tel-e-thon
serendip-i-ty	ser-en-dip-i-ty
s-lump	slump
d-weller	dwell-er
por-ous	po-rous
floury	flour-y
calami-ty	ca-lam-i-ty
polyester	pol-y-es-ter
s-tim-u-late	stim-u-late
pigsty	pig-sty
mono-plane	mon-o-plane
math-e-mat-ic-s	math-e-mat-ics
el-dest	eld-est
in-sur-mount-able	in-sur-mount-a-ble
ex-is-tence	ex-ist-ence
d-if-fer-en-ti-a-tion	dif-fer-en-ti-a-tion
buf-fer	buff-er
birdie	bird-ie
corky	cork-y
staphy-lo-coc-cus	staph-y-lo-coc-cus
over-head	o-ver-head
kestrel	kes-trel
d-i-nar	di-nar
tat-ter-s	tat-ters
un-in-hab-it-able	un-in-hab-it-a-ble
gener-ic	ge-ner-ic
nightlife	night-life
dumb-bel-l	dumb-bell
bes-tial-i-ty	bes-ti-al-i-ty
theos-o-phy	the-os-o-phy
cru-cible	cru-ci-ble
trans-for-ma-tive	trans-form-a-tive
cele-b	ce-leb
chid-ing	chiding
re-porter	re-port-er
s-tub-by	stub-by
s-tock-ist	stock-ist
ar-ranger	ar-rang-er
mil-i-tary	mil-i-tar-y
in-cor-rec-t	in-cor-rect
con-cor-dance	con-cord-ance
s-traw-ber-ry	straw-ber-ry
u-nan-swered	un-an-swered
in-fect-ed	in-fec-ted
stripling	strip-ling
vari-a-tion	var-i-a-tion
re-al-ness	real-ness
ketchup	ketch-up
k-er-atin	ker-a-tin
or-ga-ni-za-tion	or-gan-i-za-tion
tepid	tep-id
frown-ing	frowning
restart	re-start
hang-over	hang-o-ver
an-ti-body	an-ti-bod-y
con-temp-t	con-tempt
poly-the-is-tic	pol-y-the-is-tic
virtue	vir-tue
drowsy	drow-sy
mo-men-tary	mo-men-tar-y
propo-si-tion-al	prop-o-si-tion-al
sur-fac-tan-t	sur-fac-tant
forepaw	fore-paw
hit-table	hit-ta-ble
un-read-able	un-read-a-ble
h-es-i-tant-ly	hes-i-tant-ly
t-in-foil	tin-foil
de-con-struc-tive	deconstructive
method	meth-od
un-hope-d	un-hoped
con-cur-ren-t	con-cur-rent
florin	flor-in
hy-drangea	hy-dran-gea
respire	re-spire
s-tore	store
deben-ture	de-ben-ture
leafy	leaf-y
fizzy	fizz-y
ra-dia-tive	ra-di-a-tive
kneecap	knee-cap
miniskirt	min-i-skirt
s-nap-per	snap-per
mono-syl-la-ble	mon-o-syl-la-ble
s-park	spark
riv-ier-a	riv-i-er-a
unglazed	un-glazed
ger-m	germ
ship-men-t	ship-ment
fig-men-t	fig-ment
crumbly	crum-bly
punchy	punch-y
pheas-an-t	pheas-ant
aware	a-ware
s-chem-ing	schem-ing
avoid-able	a-void-a-ble
dero-ga-tion	der-o-ga-tion
misty	mist-y
coali-tion	co-a-li-tion
groundswell	ground-swell
mori-bund	mor-i-bund
cordiller-a	cor-dil-le-ra
creak-ing	creaking
in-sulin	in-su-lin
erec-tion	e-rec-tion
k-itch-enette	kitch-en-ette
bene-fac-tress	ben-e-fac-tress
bur-p	burp
retroac-tive	ret-ro-ac-tive
pesky	pes-ky
lethal-i-ty	le-thal-i-ty
hu-morist	hu-mor-ist
gam-bling	gam-bling
co-her-en-t	co-her-ent
chalky	chalk-y
placid	plac-id
le-gal-is-m	le-gal-ism
stuff-in-g	stuff-ing
iron-stone	i-ron-stone
s-nook-er	snook-er
per-me-abil-i-ty	per-me-a-bil-i-ty
mod-esty	mod-es-ty
ex-tru-sion-s	ex-tru-sions
s-tun-ning	stun-ning
cud-gel	cudg-el
sum-mon-s	sum-mons
donor	do-nor
stylist	styl-ist
dra-mat-ic-s	dra-mat-ics
hack-able	hack-a-ble
coralline	cor-al-line
tightrope	tight-rope
spiky	spik-y
s-plurge	splurge
mag-netron	mag-ne-tron
ex-ecu-tor	ex-ec-u-tor
dry-s-tone	dry-stone
weightlift-ing	weight-lift-ing
reach-able	reach-a-ble
ra-dio-gram	ra-di-o-gram
out-sel-l	out-sell
im-pe-ri-al-is-m	im-pe-ri-al-ism
rein-car-na-tion	re-in-car-na-tion
enu-mer-a-tion	e-nu-mer-a-tion
em-bar-rass-men-t	em-bar-rass-ment
Words with errors: 2150
Words with incorrect number of syllables: 1941
Total evluated: 6500
Perfect accuracy: 0.67
Number of syllables accuracy: 0.70
Average Levenshtein Distance(across incorrect words): 1.23
