Attempt	Real
foam-ing	foaming
strate-gy	strat-e-gy
inoc-u-late	in-oc-u-late
las-ci-v-i-ous	las-civ-i-ous
jur-ist	ju-rist
churchyard	church-yard
pubes-cent	pu-bes-cent
phe-no-men-o-log-i-cal	phe-nom-e-no-log-i-cal
du-bious	du-bi-ous
bob-bed	bobbed
lag-er	la-ger
le-gate	leg-ate
fum-bling	fumbling
fu-n-er-ar-y	fu-ner-ar-y
nai-vete	naivete
chos-en	cho-sen
pro-duct	prod-uct
ad-vertis-ing	ad-ver-tis-ing
whom-soev-er	whom-so-ev-er
de-for-mi-ty	de-form-i-ty
tub-er	tu-ber
bi-noc-u-lars	bin-oc-u-lars
typist	typ-ist
sus-pend-ed	sus-pen-ded
coy-ote	coy-o-te
walk-o-v-er	walk-o-ver
om-ni-d-i-rec-tion-al	om-ni-di-rec-tion-al
vip-er	vi-per
su-per-int-end	su-per-in-tend
verd-ant	ver-dant
mor-ass	mo-rass
ex-port-a-bil-i-ty	ex-por-ta-bi-li-ty
tab-le-w-are	ta-ble-ware
mar-k-up	mark-up
eva-cuee	e-vac-u-ee
un-u-s-u-al-ly	un-u-su-al-ly
zool-o-gist	zo-ol-o-gist
toil-et	toi-let
dode-ca-hed-ron	do-dec-a-he-dron
broadsword	broad-sword
naked-ness	na-ked-ness
empty	emp-ty
pe-rime-ter	pe-rim-e-ter
pro-prie-tress	pro-pri-e-tress
col-our	co-lour
ta-bles-poon	ta-ble-spoon
twofold	two-fold
dogged	dog-ged
sed-i-men-ta-r-y	sed-i-men-ta-ry
sim-pering	simpering
hor-sey	hors-ey
culpa-ble	cul-pa-ble
poet-ics	po-et-ics
slal-om	sla-lom
gen-er-ic	ge-ner-ic
foreknowledge	fore-knowl-edge
con-vales-cence	con-va-les-cence
pol-lard-ed	pollarded
tru-cu-lent	truc-u-lent
cori-an-d-er	co-ri-an-der
pe-trel	pet-rel
stan-dard	stand-ard
awash	a-wash
dec-or-ous	dec-o-rous
vine-gar	vin-e-gar
div-ers	di-vers
ex-cav-a-tor	ex-ca-va-tor
ho-ver-craft	hov-er-craft
pros-pec-tus	pro-spec-tus
re-fer-ee	ref-er-ee
worst-ed	wor-sted
bras-si-ere	bras-siere
stoi-c-ism	sto-i-cism
plac-a-to-ry	pla-ca-to-ry
ascend-ing	as-cend-ing
a-rum	ar-um
blueprint	blue-print
de-sic-ca-tor	des-ic-ca-tor
us-ur-per	u-surp-er
un-ed-i-fying	un-ed-i-fy-ing
res-on-ance	res-o-nance
sym-biont	sym-bi-ont
trav-esty	trav-es-ty
neu-ral-gi-a	neu-ral-gia
haugh-t-y	haugh-ty
se-ven-tieth	sev-en-ti-eth
ra-pine	rap-ine
gin-gham	ging-ham
si-m-ul-ta-ne-ous	si-mul-ta-ne-ous
moor-h-en	moor-hen
th-wart	thwart
har-p-ist	har-pist
hec-tor-ing	hectoring
pathos	pa-thos
lone-l-i-ness	lone-li-ness
vo-lume	vol-ume
thank-sgiv-ing	thanks-giv-ing
gra-nar-y	gra-na-ry
easter-ly	east-er-ly
ba-sil	bas-il
ho-nest	hon-est
blush-ing	blushing
di-a-bol-ism	di-ab-o-lism
mush-room-ing	mushrooming
es-ca-p-ist	es-cap-ist
leer-ing	leering
cach-et	ca-chet
pa-ren-ter-al	par-en-ter-al
ex-acting	ex-act-ing
river-side	riv-er-side
ma-tri-lin-e-al	mat-ri-lin-e-al
retri-bu-tion	ret-ri-bu-tion
disheart-en-ing	dis-hear-te-ning
om-ni-po-tence	om-nip-o-tence
hip-po-d-rome	hip-po-drome
ki-n-et-ic	ki-net-ic
me-lon	mel-on
kat-y-did	ka-ty-did
com-ple-men-ta-r-y	com-ple-men-ta-ry
be-wildered	bewildered
yester-day	yes-ter-day
sovere-ign	sov-er-eign
pha-raoh	phar-aoh
over-ac-ting	overacting
im-prov-i-sa-to-ry	im-pro-vi-sa-to-ry
rock-e-try	rock-et-ry
liquor-ish	liq-uor-ish
throug-hout	through-out
pre-bend	preb-end
rei-fy	re-i-fy
naugh-t-y	naugh-ty
de-b-it	deb-it
fold-ing	folding
poult-ry	poul-try
ca-cao	ca-ca-o
si-b-yl	sib-yl
us-u-al-ly	u-su-al-ly
tran-sa-t-lan-tic	trans-at-lan-tic
chill-ing	chilling
phys-ique	phy-sique
hol-ism	ho-lism
ser-vant	serv-ant
vi-car-age	vic-ar-age
the-re-on	there-on
dairy-ing	dair-y-ing
prop-y-lene	pro-pyl-ene
he-r-oine	her-o-ine
su-gar-y	sug-ar-y
re-con-cil-a-ble	rec-on-cil-a-ble
back-pe-dal	back-ped-al
pu-n-y	pu-ny
pri-mar-i-ly	pri-ma-ri-ly
lit-er-ati	lit-e-ra-ti
go-b-let	gob-let
ti-d-al	tid-al
cle-men-cy	clem-en-cy
based	based
in-choate	in-cho-ate
tyr-an-ni-cide	ty-ran-ni-cide
con-tour-ing	con-touring
rant-ing	ranting
pro-gramming	pro-gram-ming
gla-mour	glam-our
spee-dom-e-ter	speed-om-e-ter
chi-ef-tain	chief-tain
sinew	sin-ew
succeed	suc-ceed
ni-c-o-tine	nic-o-tine
creamy	cream-y
jour-nalese	jour-nal-ese
reas-sure	re-as-sure
bay-on-et	bay-o-net
qua-train	quat-rain
grie-vous	griev-ous
poe-tess	po-et-ess
eater-y	eat-er-y
in-si-d-i-ous-ly	in-sid-i-ous-ly
re-la-tiv-ism	rel-a-tiv-ism
trust-ed	trusted
bras-ser-ie	bras-se-rie
ra-di-on-u-clide	ra-di-o-nu-clide
verac-i-ty	ve-rac-i-ty
ant-werp	antwerp
rec-i-tal	re-cit-al
her-bal-ist	herb-al-ist
vis-ion	vi-sion
tri-b-al	trib-al
im-pen-etra-ble	im-pen-e-tra-ble
no-d-al	nod-al
tam-bourine	tam-bou-rine
tum-bled	tumbled
krieg-spi-el	krieg-spiel
em-broid-er	em-broi-der
kal-ei-do-scope	ka-lei-do-scope
dis-cred-it-ed	discredited
re-scue	res-cue
ren-e-go-ti-a-tion	re-ne-go-ti-a-tion
hege-mon-ic	heg-e-mon-ic
cabri-ol-et	cab-ri-o-let
nit-ro-gen	ni-tro-gen
ar-chene-my	arch-en-e-my
pre-mise	prem-ise
se-rif	ser-if
bulg-ing	bulging
treat-y	trea-ty
whome-v-er	whom-ev-er
con-juror	con-ju-ror
di-a-me-ter	di-am-e-ter
laz-i-ness	la-zi-ness
simil-i-tude	si-mil-i-tude
per-su-a-sion	per-sua-sion
sun-burned	sunburned
bi-er	bier
no-ve-lis-tic	nov-el-is-tic
u-p-roar	up-roar
man-a-ger	man-ag-er
a-vens	av-ens
coul-oir	cou-loir
clim-a-tol-o-gy	cli-ma-tol-o-gy
le-gend	leg-end
clas-si-fying	clas-si-fy-ing
re-tro	ret-ro
mul-ti-m-il-lion	mul-ti-mil-lion
ba-th-et-ic	ba-thet-ic
tit-ter-ing	tittering
pap-a-cy	pa-pa-cy
blund-er	blun-der
min-e-strone	min-e-stro-ne
or-de-al	or-deal
re-vision-ist	re-vi-sion-ist
ar-ro-whead	ar-row-head
thorough	thor-ough
un-i-form-ly	u-ni-form-ly
her-me-neutic	her-me-neu-tic
un-chartered	un-char-tered
wretched	wretch-ed
bur-gun-d-y	bur-gun-dy
rep-ro-duc-tion	re-pro-duc-tion
hur-ri-ed-ly	hur-ried-ly
blas-t-er	blast-er
hem-is-phere	hem-i-sphere
fi-n-is	fin-is
un-wav-er-ing	un-wa-ver-ing
blanketing	blan-ket-ing
un-der-cloth-es	un-der-clothes
skew-ered	skewered
ro-tar-y	ro-ta-ry
y-o-gi	yo-gi
cog-no-scen-ti	co-gno-scen-ti
eb-o-ny	eb-on-y
boa	bo-a
in-vi-ol-a-ble	in-vi-o-la-ble
tim-et-a-ble	time-ta-ble
fing-er	fin-ger
bi-noc-u-lar	bin-oc-u-lar
di-e-hard	die-hard
wad-i	wa-di
pan-a-cea	pan-a-ce-a
hun-t-er	hunt-er
be-wil-d-er-ment	be-wil-der-ment
of-fhand	off-hand
spon-sored	sponsored
na-t-u-ral	nat-u-ral
askew	a-skew
dumb-found-ed	dumbfounded
pos-tal	post-al
pro-ject-ed	projected
chasten-ing	chastening
une-qual	un-e-qual
vag-ue	vague
halfheart-ed	half-heart-ed
in-debted-ness	in-debt-ed-ness
poet-i-cal	po-et-i-cal
zo-o-p-lank-ton	zo-o-plank-ton
fo-ray	for-ay
doing	do-ing
re-v-el	rev-el
ex-pi-r-a-to-ry	ex-pir-a-to-ry
western-er	west-ern-er
esp-y	es-py
crescent	cres-cent
col-le-gial	col-le-gi-al
pre-ju-di-cial	prej-u-di-cial
char-i-t-a-ble	char-i-ta-ble
spi-rit-u-al-i-ty	spir-it-u-al-i-ty
lazy-bones	la-zy-bones
steam-rol-ler	steam-roll-er
cou-sin	cous-in
upright-ness	up-right-ness
o-b-lit-er-a-tion	ob-lit-er-a-tion
qui-e-ten	qui-et-en
yeti	yet-i
chem-ise	che-mise
sub-si-dence	sub-sid-ence
reve-la-tion	rev-e-la-tion
om-ni-po-tent	om-nip-o-tent
pe-ri-gee	per-i-gee
husk-y	hus-ky
wed-nesday	wednes-day
im-prisoned	im-pris-oned
hy-per-mark-et	hy-per-mar-ket
ex-pen-di-ture	ex-pend-i-ture
nin-e-ty	nine-ty
beav-er	bea-ver
scam-per	scamp-er
duet	du-et
sea-so-nal-i-ty	sea-son-al-i-ty
in-vi-d-i-ous	in-vid-i-ous
mus-ic	mu-sic
pea-ch-y	peach-y
reas-sess	re-as-sess
cubit	cu-bit
poig-nan-cy	poign-an-cy
ger-ry-man-d-er	ger-ry-man-der
coin-cide	co-in-cide
ca-ta-ma-r-an	cat-a-ma-ran
phon-o-log-i-cal	pho-no-log-i-cal
ren-de-zvous	ren-dez-vous
wat-tage	watt-age
plumage	plum-age
shattering	shat-ter-ing
cle-ver-ness	clev-er-ness
sun-tanned	suntanned
vag-ue-ly	vague-ly
for-sy-thi-a	for-syth-i-a
mil-lin-er	mil-li-ner
un-fathomed	un-fath-omed
coin-ci-dent	co-in-ci-dent
de-fend-ing	defending
cos-tar	co-star
mil-a-dy	mi-la-dy
re-strain-ing	restraining
sof-theart-ed	soft-heart-ed
em-bellish	em-bel-lish
cor-ny	corn-y
fright-ening	fright-en-ing
com-pres-s-i-bil-i-ty	com-pres-si-bil-i-ty
no-b-le-man	no-ble-man
block-bus-t-er	block-bust-er
wrong-doer	wrong-do-er
cipher	ci-pher
spin-nak-er	spin-na-ker
ar-bi-trary	ar-bi-trar-y
pep-pered	peppered
preach-ing	preaching
prol-onged	pro-longed
per-su-a-sive-ly	per-sua-sive-ly
un-go-vern-a-ble	un-gov-ern-a-ble
as-lant	a-slant
sto-ve-pipe	stove-pipe
mai-d-en	maid-en
lu-nat-ic	lu-na-tic
mar-ri-age-a-ble	mar-riage-a-ble
weathered	weath-ered
swelter-ing	swel-ter-ing
toge-ther-ness	to-geth-er-ness
bar-oque	ba-roque
e-lec-to-ral	e-lec-tor-al
prair-ie	prai-rie
puree	pu-ree
voy-eu-ris-tic	voy-eur-is-tic
spark-ly	spar-kly
per-so-nal-i-ty	per-son-al-i-ty
mo-r-aine	mo-raine
cal-yp-so	ca-lyp-so
sine-wy	sin-ew-y
war-drobe	ward-robe
beach-com-ber	beach-comb-er
wat-er	wa-ter
wo-men-folk	wom-en-folk
step-fath-er	step-fa-ther
hool-i-gan	hoo-li-gan
be-de-vil	be-dev-il
nam-e-plate	name-plate
theat-ri-cals	the-at-ri-cals
dis-con-ti-nued	dis-con-tin-ued
hon-our	ho-nour
mag-ne-t-ism	mag-net-ism
ab-an-don-ment	a-ban-don-ment
san-der	sand-er
pap-er	pa-per
nav-el	na-vel
flus-tered	flustered
bor-on	bo-ron
sub-mer-s-i-ble	sub-mers-i-ble
ul-tra-vi-ol-et	ul-tra-vi-o-let
un-ex-ploded	un-ex-plod-ed
im-measur-a-bly	im-meas-ur-a-bly
je-o-par-dy	jeop-ard-y
pro-prie-tar-y	pro-pri-e-tar-y
pe-nal-ty	pen-al-ty
pen-i-ten-ti-ar-y	pen-i-ten-tia-ry
pamph-let	pam-phlet
fil-mic	film-ic
thereu-pon	there-up-on
in-sis-tence	in-sist-ence
ci-ta-del	cit-a-del
an-nih-i-la-tion	an-ni-hi-la-tion
tur-na-bout	turn-a-bout
im-palpa-ble	im-pal-pa-ble
im-pro-per-ly	im-prop-er-ly
shopkeep-er	shop-keep-er
draper-y	dra-per-y
ki-l-o-hertz	kil-o-hertz
chlor-o-phyll	chlo-ro-phyll
th-wack	thwack
vel-o-c-i-pede	ve-loc-i-pede
pread-oles-cent	pre-ad-o-les-cent
guar-di-an-ship	guard-i-an-ship
snows-torm	snow-storm
longhand	long-hand
un-sat-is-fying	un-sat-is-fy-ing
prem-o-lar	pre-mo-lar
he-reto-fore	here-to-fore
re-f-u-ta-tion	ref-u-ta-tion
pream-pli-fi-er	pre-am-pli-fi-er
gha-na	ghana
cate-chist	cat-e-chist
sup-er	su-per
pome-lo	pom-e-lo
nutshell	nut-shell
betwixt	be-twixt
con-ni-vance	con-niv-ance
in-gra-tiat-ing	in-gra-ti-at-ing
man-i-cured	ma-ni-cured
cle-ment	clem-ent
ne-cro-po-lis	ne-crop-o-lis
su-per-posed	superposed
pean-ut	pea-nut
in-frared	in-fra-red
mo-m-en-tar-y	mo-men-tar-y
legged	leg-ged
pi-ca-resque	pic-a-resque
outs-mart	out-smart
in-ter-ro-g-a-tive	in-ter-rog-a-tive
stolid	stol-id
corgi	cor-gi
ran-co-r-ous	ran-cor-ous
starling	star-ling
her-bi-cide	herb-i-cide
con-demned	condemned
in-ter-re-lated-ness	in-ter-re-lat-ed-ness
un-er-ring	un-err-ing
har-an-gue	ha-rangue
o-ver-staffed	overstaffed
rem-it-tance	re-mit-tance
re-pre-hend	rep-re-hend
de-vil	dev-il
com-pell-ing	com-pel-ling
tsetse	tset-se
ware-housing	ware-hous-ing
pigeon	pi-geon
res-on-ant	res-o-nant
ap-pal-l-ing-ly	ap-pall-ing-ly
sec-on-dar-y	sec-ond-ar-y
vel-o-drome	ve-lo-drome
freewheel-ing	free-wheel-ing
tur-bo-charged	turbocharged
guar-droom	guard-room
pic-turesque	pic-tur-esque
doom-sday	dooms-day
ma-l-aise	ma-laise
gig-gling	giggling
sec-re-cy	se-cre-cy
gor-ge-ous	gor-geous
dang-er	dan-ger
teacup	tea-cup
grav-y	gra-vy
lin-ger-ie	lin-ge-rie
cam-e-r-a	cam-er-a
di-l-a-ta-tion	dil-a-ta-tion
cover-ing	cov-er-ing
swimming	swim-ming
per-is-cope	per-i-scope
ex-hil-ar-ate	ex-hil-a-rate
sca-l-ene	sca-lene
pro-n-oun	pro-noun
slaugh-t-er	slaugh-ter
winning	win-ning
go-ver-nor	gov-er-nor
mouth-water-ing	mouth-wa-ter-ing
maraud-ing	ma-raud-ing
fool-scap	fools-cap
lop-sided	lop-sid-ed
fev-er	fe-ver
prose-cu-tor	pros-e-cu-tor
cet-a-cean	ce-ta-cean
pla-g-i-ar-ism	pla-gia-rism
co-p-y	cop-y
bar-bar-ism	bar-ba-rism
titil-lat-ing	tit-il-lat-ing
hav-er-ing	ha-ve-ring
pe-r-ox-ide	per-ox-ide
trade-marked	trademarked
trim-ar-an	tri-ma-ran
lad-y-like	la-dy-like
cris-p-y	crisp-y
reve-nant	rev-e-nant
scoun-d-rel	scoun-drel
gly-cer-ol	glyc-er-ol
herald-ic	he-ral-dic
poet-i-cal-ly	po-et-i-cal-ly
do-min-i-on	do-min-ion
palt-ry	pal-try
nau-seat-ing	nau-se-at-ing
va-sec-to-my	vas-ec-to-my
pad-ded	padded
boathouse	boat-house
renew-a-ble	re-new-a-ble
com-prom-is-ing	com-pro-mis-ing
pre-da-tor	pred-a-tor
un-for-tun-ate-ly	un-for-tu-nate-ly
ti-t-il-late	tit-il-late
up-lift-ed	uplifted
od-dly	odd-ly
tailored	tai-lored
re-cord-ed	re-cor-ded
ce-d-il-la	ce-dil-la
mus-ke-teer	mus-ket-eer
over-use	o-ver-use
high-lan-d-er	high-lan-der
div-i-sive-ness	di-vi-sive-ness
bludg-e-on	bludg-eon
re-lig-ion	re-li-gion
evanes-cent	ev-a-nes-cent
res-pi-r-a-to-ry	res-pi-ra-to-ry
fre-quent-ed	frequented
mit-i-gat-ing	mitigating
pesk-y	pes-ky
mea-t-y	meat-y
provid-ing	pro-vid-ing
boar-d-room	board-room
prot-o-type	pro-to-type
coch-lea	coch-le-a
boutique	bou-tique
cheval-i-er	chev-a-lier
cho-c-o-late	choc-o-late
cris-p-ly	crisp-ly
ex-oskel-e-ton	ex-o-skel-e-ton
stoic	sto-ic
forest-ed	forested
com-pa-nion-ship	com-pan-ion-ship
cloa-ca	clo-a-ca
naked	na-ked
laud-ed	lauded
sa-tir-ist	sat-i-rist
for-t-y	for-ty
kin-dli-ness	kind-li-ness
im-po-lit-ic	im-pol-i-tic
val-ise	va-lise
bag-uette	ba-guette
gang-ly	gan-gly
me-tal	met-al
godhead	god-head
pas-trami	pas-tra-mi
un-trust-worth-y	un-trust-wor-thy
equid-is-tant	e-qui-dis-tant
pas-s-port	pass-port
secede	se-cede
a-p-len-ty	a-plen-ty
raven-ing	rav-en-ing
is-o-stat-ic	i-so-stat-ic
lin-gu-al	lin-gual
hos-pit-a-ble	hos-pi-ta-ble
cap-er	ca-per
spider-y	spi-der-y
take-o-v-er	take-o-ver
pro-tec-to-rate	pro-tec-tor-ate
zen-ith	ze-nith
com-muter	com-mut-er
col-lap-si-ble	col-laps-i-ble
fem-in-ism	fem-i-nism
nift-y	nif-ty
nine-tieth	nine-ti-eth
ar-rester	ar-rest-er
dis-in-fec-tant	dis-in-fect-ant
re-f-er	re-fer
tre-mo-lo	trem-o-lo
de-brief-ing	debriefing
gadge-try	gadg-et-ry
bis-ex-u-al-i-ty	bi-sex-u-al-i-ty
ro-sy	ros-y
bab-el	ba-bel
quick-silv-er	quick-sil-ver
sidestep	side-step
earthen-ware	earth-en-ware
pig-ment-ed	pig-men-ted
prowess	prow-ess
coco-nut	co-co-nut
sto-ny	ston-y
zeal-o-try	zeal-ot-ry
penk-nife	pen-knife
mo-n-au-ral	mon-au-ral
han-d-i-craft	hand-i-craft
oc-tog-e-nar-i-an	oc-to-ge-nar-i-an
lab-yrinth	lab-y-rinth
mim-i-cry	mim-ic-ry
in-ter-vie-wee	in-ter-view-ee
un-re-pen-tant	un-re-pent-ant
rock-ing	rocking
smat-tering	smat-ter-ing
story-book	sto-ry-book
pej-or-a-tive	pe-jo-ra-tive
mo-der-nist	mod-ern-ist
righ-teous	right-eous
bride-s-maid	brides-maid
kin-der-gart-en	kin-der-gar-ten
pe-k-an	pek-an
pas-seng-er	pas-sen-ger
sin-u-soid-al	si-nus-oi-dal
break-wat-er	break-wa-ter
mo-no-chro-mat-ic	mon-o-chro-mat-ic
im-pe-r-il	im-per-il
isom-er	i-so-mer
phy-log-e-net-ic	phy-lo-ge-net-ic
lamb-swool	lambs-wool
e-s-o-ter-i-ca	es-o-ter-i-ca
con-ser-va-tive	con-serv-a-tive
pos-top-er-a-tive	post-op-er-a-tive
pres-er-v-a-tive	pre-serv-a-tive
min-uet	min-u-et
tran-sac-tion	trans-ac-tion
ces-spit	cess-pit
water-y	wa-ter-y
gangland	gang-land
dis-con-ti-nue	dis-con-tin-ue
ca-vi-ar	cav-i-ar
i-ni-tial	in-i-tial
le-thar-gy	leth-ar-gy
embed	em-bed
ni-hi-l-is-tic	ni-hil-is-tic
cen-tripe-tal	cen-trip-e-tal
kin-swom-an	kins-wom-an
humming-bird	hum-ming-bird
im-pressed	impressed
in-cle-ment	in-clem-ent
stapes	sta-pes
foot-balling	foot-ball-ing
ca-mouflage	cam-ou-flage
clan-de-stine	clan-des-tine
proge-ny	prog-e-ny
ex-plora-to-ry	ex-plor-a-to-ry
pro-tean	pro-te-an
thin-n-er	thin-ner
leisure-ly	lei-sure-ly
a-po-stol-ic	ap-os-tol-ic
lin-e-up	line-up
stetho-scope	steth-o-scope
sul-t-ry	sul-try
squa-lor	squal-or
un-it-ed	u-nit-ed
rede-ploy	re-de-ploy
hide-ous	hid-e-ous
parsec	par-sec
squan-d-er	squan-der
re-tiree	re-tir-ee
an-ticli-max	an-ti-cli-max
glos-sary	glos-sa-ry
sy-no-vi-al	syn-o-vi-al
sa-m-o-var	sam-o-var
gela-tin	gel-a-tin
ex-che-quer	ex-cheq-uer
rem-e-d-y	rem-e-dy
id-ly	i-dly
reis-sue	re-is-sue
de-vil-ment	dev-il-ment
en-thalp-y	en-thal-py
det-ri-tus	de-tri-tus
o-pales-cent	o-pal-es-cent
ran-t-er	rant-er
gir-lish	girl-ish
sar-i	sa-ri
reas-sume	re-as-sume
sniff-ing	sniffing
im-ple-men-ter	im-ple-ment-er
con-sider-ing	con-sid-er-ing
slan-d-er	slan-der
cur-ly	curl-y
no-nethe-less	none-the-less
kindheart-ed	kind-heart-ed
fid-g-et	fidg-et
min-der	mind-er
in-a-de-quate	in-ad-e-quate
there-aft-er	there-af-ter
sa-tur-nine	sat-ur-nine
fra-tric-i-dal	frat-ri-cid-al
driver-less	driv-er-less
par-si-mo-nious	par-si-mo-ni-ous
de-s-ir-a-bil-i-a	de-si-ra-bi-li-a
ver-an-da	ve-ran-da
billing	bil-ling
dul-lard	dull-ard
poem	po-em
de-ter-mina-ble	de-ter-mi-na-ble
hy-dro-phob-ic	hy-dro-pho-bic
e-clec-tic	ec-lec-tic
blinkered	blink-ered
e-leva-tor	el-e-va-tor
sup-ple-men-ta-r-y	sup-ple-men-ta-ry
pur-suer	pur-su-er
a-vo-ca-do	av-o-ca-do
om-ni-pre-sence	om-ni-pres-ence
il-li-quid	il-liq-uid
chor-al	cho-ral
a-n-o-ma-ly	a-nom-a-ly
pan-ties	pant-ies
de-spot	des-pot
woods-moke	wood-smoke
li-tot-es	li-to-tes
ba-c-on	ba-con
twosome	two-some
toil-e-tries	toi-let-ries
un-in-tel-lig-i-ble	un-in-tel-li-gi-ble
milde-w-y	mil-dew-y
click-ing	clicking
ca-s-i-no	ca-si-no
pul-lov-er	pull-o-ver
sup-por-tive	sup-port-ive
sush-i	su-shi
reit-er-ate	re-it-er-ate
crooked	crook-ed
six-tieth	six-ti-eth
dogsbod-y	dogs-bod-y
tiger-ish	ti-ger-ish
in-e-luct-a-ble	in-e-luc-ta-ble
be-wilder-ing	bewildering
bever-age	bev-er-age
in-can-de-scent	in-can-des-cent
gask-et	gas-ket
prede-fined	pre-de-fined
aor-ta	a-or-ta
in-hos-pi-t-a-ble	in-hos-pi-ta-ble
un-map-ped	un-mapped
whimper	whim-per
trans-cend-ent	tran-scend-ent
tran-sceiv-er	trans-ceiv-er
es-ca-pee	es-cap-ee
broad-cas-ter	broad-cast-er
lam-plight-er	lamp-light-er
cha-p-lain	chap-lain
dei-ty	de-i-ty
in-tel-lig-i-ble	in-tel-li-gi-ble
cir-cui-try	cir-cuit-ry
tas-ter	tast-er
de-od-or-ant	de-o-dor-ant
flood-ing	flooding
ther-e-to	there-to
bi-osphere	bi-o-sphere
re-sis-tance	re-sist-ance
temp-er	tem-per
sho-g-un	sho-gun
iso-bar	i-so-bar
steward-ess	stew-ard-ess
test-y	tes-ty
flaut-ist	flau-tist
cam-a-ra-de-rie	ca-ma-ra-de-rie
un-nerv-ing	unnerving
lisp-ing	lis-ping
joey	jo-ey
so-lemn	sol-emn
ce-le-ri-ac	ce-ler-i-ac
mul-ti-proces-sor	mul-ti-proc-es-sor
in-a-de-quate-ly	in-ad-e-quate-ly
meander-ing	me-an-der-ing
grena-di-er	gren-a-dier
scor-pion	scor-pi-on
rem-it	re-mit
bri-g-ade	bri-gade
bas-i-cal-ly	ba-si-cal-ly
dis-qui-eting	dis-qui-et-ing
transverse	trans-verse
salvage	sal-vage
proceed-ings	pro-ceed-ings
prec-on-di-tion	pre-con-di-tion
me-lo-d-ra-mat-ic	mel-o-dra-mat-ic
pu-e-rile	pu-er-ile
ma-ta-dor	mat-a-dor
o-ver-load-ed	overloaded
goph-er	go-pher
ba-lance	bal-ance
fet-tered	fettered
ide-al-ism	i-de-al-ism
em-ployed	employed
ob-nox-i-ous	ob-nox-ious
re-troac-tive-ly	ret-ro-ac-tive-ly
mi-croor-gan-ism	mi-cro-or-gan-ism
unt-wist	un-twist
sta-tue	stat-ue
bu-si-ness-wom-an	busi-ness-wom-an
dom-ineer	dom-i-neer
in-ter-ro-g-a-tor	in-ter-ro-ga-tor
quest-ing	questing
e-clec-ti-cism	ec-lec-ti-cism
bootleg	boot-leg
pol-yest-er	pol-y-es-ter
sel-fish-ness	self-ish-ness
plenar-y	ple-na-ry
son-or-ous	so-no-rous
me-ri-di-an	me-rid-i-an
per-son-i-f-i-ca-tion	per-son-i-fi-ca-tion
re-com-mend	rec-om-mend
wash-er-wo-m-an	wash-er-wom-an
re-com-men-da-tion	rec-om-men-da-tion
neces-sar-i-ly	nec-es-sar-i-ly
su-per-mark-et	su-per-mar-ket
ruin-ous	ru-in-ous
reas-sign	re-as-sign
tonal-i-ty	to-nal-i-ty
les-s-en	less-en
om-nis-ci-ence	om-nis-cience
in-spec-to-rate	in-spec-tor-ate
ne-ver-the-less	nev-er-the-less
ser-ene-ly	se-rene-ly
me-tho-do-log-i-cal	meth-od-o-log-i-cal
ge-no-c-i-dal	gen-o-cid-al
bould-er	boul-der
hoor-ay	hoo-ray
bailout	bail-out
an-ti-de-pressant	an-ti-de-pres-sant
whosoev-er	who-so-ev-er
iso-mor-phic	i-so-mor-phic
bun-gal-ow	bun-ga-low
in-com-men-sur-a-ble	in-com-men-su-ra-ble
pe-rine-um	per-i-ne-um
me-tal-lur-gy	met-al-lur-gy
por-thole	port-hole
psy-cho-s-o-mat-ic	psy-cho-so-mat-ic
auger	au-ger
vehi-cle	ve-hi-cle
metha-nol	meth-a-nol
tri-lin-gu-al	tri-lin-gual
mas-er	ma-ser
mye-lin	my-e-lin
trop-o-s-phere	trop-o-sphere
e-r-ot-ic	e-rot-ic
pro-blem	prob-lem
ax-olotl	ax-o-lotl
as-tro-naut-ics	as-tro-nau-tics
il-me-n-ite	il-men-ite
as-tron-o-m-er	as-tron-o-mer
re-la-tive-ly	rel-a-tive-ly
colan-d-er	col-an-der
o-ver-writ-ing	overwriting
cycling	cy-cling
con-sul-tan-cy	con-sult-an-cy
rostrum	ros-trum
cos-seted	cosseted
pot-a-ble	po-ta-ble
a-p-o-plex-y	ap-o-plex-y
ri-fled	rifled
nin-e-teen	nine-teen
no-vice	nov-ice
sawy-er	saw-yer
div-i-sive	di-vi-sive
mil-i-tar-is-tic	mil-i-ta-ris-tic
re-al-ness	real-ness
steward	stew-ard
su-per-bly	su-perb-ly
om-ni-pre-sent	om-ni-pres-ent
slo-ven-ly	slov-en-ly
e-cho	ech-o
su-per-fluity	su-per-flu-i-ty
burgeon-ing	burgeoning
con-for-mance	con-form-ance
a-po-lo-gi-a	ap-o-lo-gi-a
en-fee-bled	enfeebled
te-q-ui-la	te-qui-la
pan-das	pan-das
sta-tuette	stat-u-ette
he-li-osphere	he-li-o-sphere
dry-s-tone	dry-stone
cal-o-rime-ter	cal-o-rim-e-ter
diseased	dis-eased
me-d-al	med-al
psy-choan-al-y-sis	psy-cho-a-nal-y-sis
sea-b-ird	sea-bird
transves-tite	trans-ves-tite
mis-nom-er	mis-no-mer
no-v-el	nov-el
ex-tre-m-ist	ex-trem-ist
thread-ed	threaded
im-pe-d-ance	im-ped-ance
ho-m-o-ge-ne-ous	ho-mo-ge-ne-ous
em-ble-mat-ic	em-blem-at-ic
me-narche	men-ar-che
bon-an-za	bo-nan-za
gal-leon	gal-le-on
steeple-jack	stee-ple-jack
thorough-ness	thor-ough-ness
pol-yun-sat-u-rat-ed	pol-y-un-sat-u-rat-ed
ide-ol-ogue	i-de-o-logue
nos-tal-gi-a	nos-tal-gia
de-vour-ing	devouring
me-tal-work	met-al-work
re-joind-er	re-join-der
car-ri-age-way	car-riage-way
in-con-gru-ity	in-con-gru-i-ty
lem-o-nade	lem-on-ade
eon	e-on
u-pon	up-on
man-slaugh-t-er	man-slaugh-ter
par-am-e-ter	pa-ram-e-ter
bis-ex-u-al	bi-sex-u-al
rhe-tor-ic	rhet-o-ric
hom-o-pho-bi-a	ho-mo-pho-bi-a
twis-ter	twist-er
no-t-i-fi-ca-tion	no-ti-fi-ca-tion
fuse-lage	fu-se-lage
ha-track	hat-rack
li-mo	lim-o
bart-er	bar-ter
chiv-es	chives
un-ta-lent-ed	un-tal-ent-ed
wil-ling-ness	will-ing-ness
fever-ish	fe-ver-ish
nu-cleus	nu-cle-us
ref-er-eeing	re-fe-ree-ing
bu-si-ly	bus-i-ly
be-re-ave	be-reave
per-mit-ting	permitting
prin-t-er	print-er
ep-i-th-et	ep-i-thet
ca-len-dar	cal-en-dar
reu-ni-f-i-ca-tion	re-u-ni-fi-ca-tion
posse	pos-se
slumb-er	slum-ber
dis-fi-gure-ment	dis-fig-ure-ment
sol-di-er-y	sol-dier-y
na-v-al	na-val
gu-a-nine	gua-nine
pro-vided	pro-vid-ed
hob-go-blin	hob-gob-lin
ma-ho-g-a-ny	ma-hog-a-ny
ever-y	eve-ry
un-com-prom-is-ing	un-com-pro-mis-ing
va-lue-less	val-ue-less
cru-ci-al	cru-cial
e-r-ec-tile	e-rec-tile
poet	po-et
sphyg-mom-a-nom-e-ter	sphyg-mo-ma-nom-e-ter
can-oeing	ca-noe-ing
thirt-y	thir-ty
disheart-ened	dis-hear-tened
char-wo-man	char-wom-an
ty-pog-ra-phers	ty-po-gra-phers
squir-e-ar-chy	squire-ar-chy
chrom-ite	chro-mite
country-wide	coun-try-wide
mon-olo-gue	mon-o-logue
re-gis-trar	reg-is-trar
network-ing	networking
com-mer-ci-al-ism	com-mer-cial-ism
seas-cape	sea-scape
of-fend-ing	of-fen-ding
aor-tic	a-or-tic
wizened	wiz-ened
dim-pled	dimpled
glim-mering	glim-mer-ing
marshy	marsh-y
darkened	dar-kened
mer-chand-is-ing	mer-chan-dis-ing
pro-ta-g-on-ist	pro-tag-o-nist
blis-tered	blistered
bou-gain-vil-lea	bou-gain-vil-le-a
a-r-ouse	a-rouse
bo-log-na	bo-lo-gna
a-no-m-a-lous	a-nom-a-lous
handrail	hand-rail
spel-l-er	spell-er
god-fath-er	god-fa-ther
clov-er	clo-ver
re-troac-tive	ret-ro-ac-tive
mul-ti-lin-gu-al	mul-ti-lin-gual
cack-ling	cackling
sil-age	si-lage
un-mu-s-i-cal	un-mu-si-cal
ar-i-a	a-ri-a
swarm-ing	swarming
per-su-a-sive	per-sua-sive
steeple-chase	stee-ple-chase
dis-est-a-b-lish	dis-es-tab-lish
her-i-t-age	her-it-age
rec-a-pit-u-late	re-ca-pit-u-late
whiskey	whis-key
mer-cury	mer-cu-ry
car-bo-nyl	car-bon-yl
un-a-wakened	un-a-wak-ened
trum-per-y	trump-er-y
in-fect-ed	in-fec-ted
an-teat-er	ant-eat-er
o-live	ol-ive
sten-o-sis	ste-no-sis
de-stined	des-tined
place-bo	pla-ce-bo
an-x-ie-ty	anx-i-e-ty
usur-er	u-su-rer
ri-pen	rip-en
bi-vou-ac	biv-ou-ac
fath-er	fa-ther
in-ter-lin-gu-al	in-ter-lin-gual
pro-vo-ca-tive-ly	pro-voc-a-tive-ly
coast-ing	coasting
proff-er	prof-fer
pos-thu-mous	post-hu-mous
com-par-a-bil-i-ty	com-pa-ra-bil-i-ty
har-d-y	har-dy
cog-nac	co-gnac
pre-s-uma-bly	pre-sum-a-bly
pries-thood	priest-hood
over-in-flat-ed	o-ver-in-flat-ed
spi-rit-u-al-ist	spir-it-u-al-ist
de-con-struc-tive	deconstructive
eg-ot-ist	e-go-tist
bao-bab	ba-o-bab
mul-ti-ch-an-nel	mul-ti-chan-nel
bases	ba-ses
hawthorn	haw-thorn
re-freshed	refreshed
de-f-er	de-fer
spi-rit-u-al-ism	spir-it-u-al-ism
straigh-t-a-way	straight-a-way
spi-rit-u-al	spir-it-u-al
ir-is	i-ris
cret-i-nous	cre-tin-ous
in-feas-i-ble	in-fea-si-ble
con-for-mi-ty	con-form-i-ty
par-li-a-men-ta-r-y	par-lia-men-ta-ry
el-e-men-ta-r-y	el-e-men-ta-ry
cat-as-tro-phe	ca-tas-tro-phe
con-verter	con-vert-er
ne-go-tia-ble	ne-go-ti-a-ble
un-molest-ed	un-mo-lest-ed
as-sai-lant	as-sail-ant
be-fud-dled	befuddled
go-r-y	gor-y
stoa	sto-a
ton-ight	to-night
phy-s-i-cian	phy-si-cian
stin-gray	sting-ray
sab-er	sa-ber
ven-tril-oquy	ven-tril-o-quy
in-con-sis-tent	in-con-sist-ent
soli-cit-ing	soliciting
im-a-gin-ings	im-ag-in-ings
glas-shouse	glass-house
a-to-nal	a-ton-al
u-ni-on	un-ion
div-erge	di-verge
teleph-o-ny	te-leph-o-ny
re-cog-nize	rec-og-nize
in-ter-lo-c-u-tor	in-ter-loc-u-tor
payee	pay-ee
good-night	goodnight
troubling	trou-bling
bis-ect	bi-sect
li-tur-gy	lit-ur-gy
statis-ti-cian	stat-is-ti-cian
ex-em-plar-y	ex-em-pla-ry
devas-tat-ing-ly	dev-as-tat-ing-ly
ar-chiv-ist	ar-chi-vist
mut-ter-ing	muttering
pam-phle-teer	pam-phlet-eer
wrink-ly	wrin-kly
han-go-v-er	hang-o-ver
en-thrall-ing	en-thral-ling
vi-o-l-ence	vi-o-lence
she-k-el	shek-el
sty-m-ie	sty-mie
prosp-er	pros-per
frui-tion	fru-i-tion
blasphe-my	blas-phe-my
ar-ro-wroot	ar-row-root
re-per-to-ry	rep-er-to-ry
beyond	be-yond
as-tride	a-stride
puf-f-er	puff-er
philh-ar-mon-ic	phil-har-mon-ic
but-tered	buttered
sci-ent-ist	sci-en-tist
eigh-teenth	eight-eenth
pro-prie-tor-ship	pro-pri-e-tor-ship
cre-vice	crev-ice
mores	mo-res
stab-le-mate	sta-ble-mate
dram-at-ist	dram-a-tist
trip-od	tri-pod
tint-ed	tinted
re-mu-n-er-ate	re-mu-ner-ate
pi-rouette	pir-ou-ette
roguish	ro-guish
bot-tled	bottled
cro-zi-er	cro-zier
com-pul-sor-i-ly	com-pul-so-ri-ly
shar-p-en	sharp-en
con-fir-ma-to-ry	con-firm-a-to-ry
a-phro-di-si-ac	aph-ro-dis-i-ac
plu-my	plum-y
dish-wat-er	dish-wa-ter
worth-y	wor-thy
an-yth-ing	an-y-thing
dis-gust-ed	disgusted
e-vil-d-oer	e-vil-do-er
e-pi-ph-e-nom-e-non	ep-i-phe-nom-e-non
whim-s-y	whim-sy
in-trau-te-rine	in-tra-u-ter-ine
can-on-ic	ca-non-ic
trag-ed-y	trag-e-dy
theism	the-ism
her-ma-phro-dite	her-maph-ro-dite
ci-tron	cit-ron
con-testant	con-test-ant
uni-den-ti-fied	un-i-den-ti-fied
in-gen-u-i-ty	in-ge-nu-i-ty
pe-r-i-phras-tic	per-i-phras-tic
stu-dy	stud-y
chantry	chan-try
chin-ois-er-ie	chi-noi-se-rie
tur-no-v-er	turn-o-ver
silver	sil-ver
ea-ves-drop	eaves-drop
a-per-ture	ap-er-ture
nos-talg-ic	nos-tal-gic
cas-sowar-y	cas-so-war-y
ack-nowledge	ac-knowl-edge
pri-mar-y	pri-ma-ry
weav-ing	weaving
re-par-tee	rep-ar-tee
ex-cel-sior	ex-cel-si-or
mo-der-nism	mod-ern-ism
shiv-ering	shivering
dis-sonant	dis-so-nant
post-mo-dern-ist	post-mod-ern-ist
du-opo-ly	du-op-o-ly
blue-b-ird	blue-bird
ref-i-nance	re-fi-nance
cen-tri-fu-gal	cen-trif-u-gal
im-pecc-a-ble	im-pec-ca-ble
un-cre-d-it-ed	un-cred-it-ed
theat-ri-cal	the-at-ri-cal
im-pri-s-on-ment	im-pris-on-ment
pas-s-a-bly	pass-a-bly
se-lec-tee	se-lect-ee
punch-line	punchline
un-flatter-ing	un-flat-ter-ing
demol-ish	de-mol-ish
in-ter-go-v-ern-men-tal	in-ter-gov-ern-men-tal
si-len-cer	si-lenc-er
genre	gen-re
cate-gor-i-cal-ly	cat-e-gor-i-cal-ly
in-a-de-q-ua-cy	in-ad-e-qua-cy
dis-cre-pan-cy	dis-crep-an-cy
fri-vol	friv-ol
splin-t-er	splin-ter
doork-nob	door-knob
cerise	ce-rise
glob-e-trotting	globe-trot-ting
lus-ti-ly	lust-i-ly
lib-er-o	li-be-ro
ep-is-tle	e-pis-tle
dee-p-ly	deep-ly
phys-i-o-ther-ap-ist	phys-i-o-ther-a-pist
eer-ie	ee-rie
pro-tease	pro-te-ase
rent-ed	rented
lo-goff	log-off
fun-er-al	fu-ner-al
erup-tive	e-rup-tive
pol-y-car-bo-nate	pol-y-car-bon-ate
mam-mal-i-an	mam-ma-li-an
en-trea-ty	en-treat-y
suet	su-et
bee-troot	beet-root
viz-i-er	vi-zier
soph-is-try	soph-ist-ry
in-si-d-i-ous	in-sid-i-ous
re-dhead	red-head
mon-o-ma-n-i-a	mon-o-ma-ni-a
ex-pect-ed	expected
bri-g-and	brig-and
blessed-ness	bless-ed-ness
kal-ei-do-scop-ic	ka-lei-do-scop-ic
mar-chioness	mar-chion-ess
rem-iss	re-miss
par-tic-i-ple	par-ti-ci-ple
un-en-light-ening	un-en-light-en-ing
pi-an-o-la	pi-a-no-la
shorthand	short-hand
cat-ter-y	cat-te-ry
prol-o-gue	pro-logue
phos-phorescence	phos-pho-res-cence
fer-v-ent-ly	fer-vent-ly
bat-tlesh-ip	bat-tle-ship
jaz-zy	jazz-y
iri-descent	ir-i-des-cent
spe-ci-al-ist	spe-cial-ist
so-ci-al-ist	so-cial-ist
frenzied	fren-zied
hy-draul-ics	hy-drau-lics
sa-tire	sat-ire
lo-c-a-tive	loc-a-tive
cab-le-way	ca-ble-way
veg-et-a-ble	veg-e-ta-ble
petri-fied	pet-ri-fied
un-pro-v-en	un-prov-en
leg-en-dar-y	leg-end-ar-y
re-sis-tant	re-sist-ant
re-scuer	res-cu-er
pi-on-eer-ing	pi-o-neer-ing
in-sep-ar-a-ble	in-sep-a-ra-ble
cool-ing	cooling
tract-a-ble	trac-ta-ble
in-de-c-o-r-ous	in-dec-o-rous
bril-li-ance	bril-liance
dec-i-sive-ness	de-ci-sive-ness
mar-gi-nal	mar-gin-al
iv-y	i-vy
stasis	sta-sis
un-an-i-mous-ly	u-nan-i-mous-ly
demer-it	de-mer-it
resi-due	res-i-due
fon-tan-el	fon-ta-nel
un-bridled	un-bri-dled
dol-o-mite	do-lo-mite
flims-y	flim-sy
hav-en	ha-ven
tap-er	ta-per
sole-cism	sol-e-cism
sal-ty	salt-y
in-ex-or-a-ble	in-ex-o-ra-ble
Words with errors: 1229
Words with incorrect number of syllables: 673
Total evluated: 6500
Perfect accuracy: 0.81
Number of syllables accuracy: 0.90
Average Levenshtein Distance(across incorrect words): 1.14
