Attempt	Real
gadge-try	gadg-et-ry
neon	ne-on
en-cy-clo-ped-ic	en-cy-clo-pe-dic
re-p-ro-cess	re-proc-ess
stupe-fy	stu-pe-fy
re-l-ic	rel-ic
mem-or-a-bil-i-a	mem-o-ra-bil-i-a
harbing-er	har-bin-ger
gangling	gan-gling
vantage	van-tage
pro-sper-i-ty	pros-per-i-ty
pris-s-y	pris-sy
fat-a-l-is-tic	fa-tal-is-tic
de-c-o-rum	de-co-rum
fro-lic-some	frol-ic-some
ca-ra-v-el	car-a-vel
be-drid-den	bed-rid-den
em-broid-er-y	em-broi-der-y
es-ca-l-a-tor	es-ca-la-tor
i-d-i-o-syn-cra-sy	id-i-o-syn-cra-sy
quad-rup-ly	quad-ru-ply
worthi-ness	wor-thi-ness
per-so-n-al-i-ty	per-son-al-i-ty
pros-t-a-glan-din	pros-ta-glan-din
sub-sid-y	sub-si-dy
un-ex-amined	un-ex-am-ined
spi-rit-u-al-ly	spir-it-u-al-ly
com-pa-r-i-son	com-par-i-son
cere-bel-lum	cer-e-bel-lum
in-audi-ble	in-au-di-ble
ras-py	rasp-y
coas-tal	coast-al
hye-na	hy-e-na
by-pro-duct	by-prod-uct
fem-in-ism	fem-i-nism
ham-p-er	ham-per
sui-tor	suit-or
hel-l-ish	hell-ish
rack-e-teer-ing	rack-et-eer-ing
vo-la-tile	vol-a-tile
postage	post-age
tricy-cle	tri-cy-cle
ni-co-tine	nic-o-tine
selfless-ly	self-less-ly
pen-al-t-y	pen-al-ty
o-th-er-ness	oth-er-ness
ca-gey	cag-ey
plebis-cite	pleb-i-scite
thaw-ing	thawing
fore-ign-er	for-eign-er
post-mo-dern-ist	post-mod-ern-ist
me-te-o-rol-o-gy	me-te-or-ol-o-gy
phy-log-e-net-ic	phy-lo-ge-net-ic
e-bul-li-ence	e-bul-lience
in-dus-t-ry	in-dus-try
o-ve-re-at	o-ver-eat
crea-tive-ly	cre-a-tive-ly
ra-cy	rac-y
nai-vete	naivete
con-fi-den-tial-i-ty	con-fi-den-ti-al-i-ty
chap-e-r-one	chap-er-one
ev-er-y	eve-ry
ban-krupt	bank-rupt
cub-it	cu-bit
no-vel-ty	nov-el-ty
un-a-dapted	un-a-dapt-ed
hand-picked	handpicked
un-mol-est-ed	un-mo-lest-ed
ban-k-note	bank-note
skirm-ish-ing	skirmishing
forest-ed	forested
guaca-mole	gua-ca-mo-le
tran-sac-tion-al	trans-ac-tion-al
cru-ise	cruise
quav-er	qua-ver
bi-o-che-mist	bi-o-chem-ist
fos-t-er	fos-ter
re-s-cuer	res-cu-er
a-te-li-er	at-el-ier
su-g-ar-y	sug-ar-y
un-fa-shion-a-ble	un-fash-ion-a-ble
laun-d-ress	laun-dress
pro-phet	proph-et
mas-o-chist	mas-och-ist
time-t-a-ble	time-ta-ble
toge-ther-ness	to-geth-er-ness
in-di-ca-tive	in-dic-a-tive
de-m-o-graph-ics	dem-o-graph-ics
haber-dash-er-y	hab-er-dash-er-y
ow-n-er-ship	own-er-ship
ex-tram-u-ral	ex-tra-mu-ral
un-reg-istered	un-reg-is-tered
bishop	bish-op
sou-p-y	soup-y
cham-pion-ship	cham-pi-on-ship
frail-t-y	frail-ty
chiseled	chis-eled
fun-drais-ing	fund-rais-ing
im-prov-i-sa-to-ry	im-pro-vi-sa-to-ry
busin-ess-like	busi-ness-like
dig-i-ta-l-is	dig-i-tal-is
le-gume	leg-ume
minted	mint-ed
fore-ster	for-est-er
transcon-ti-nen-tal	trans-con-ti-nen-tal
reas-sess	re-as-sess
ure-thane	u-re-thane
re-stroom	rest-room
per-en-nial-ly	per-en-ni-al-ly
in-ter-pre-ter	in-ter-pret-er
the-re-in	there-in
com-plaisant	com-plai-sant
mat-er	ma-ter
me-tal	met-al
ho-no-rif-ic	hon-or-if-ic
li-l-ac	li-lac
startling	star-tling
prob-le-mat-ic	prob-lem-at-ic
col-lap-si-ble	col-laps-i-ble
tech-no-cra-cy	tech-noc-ra-cy
mas-ca-ra	mas-car-a
ca-tas-tro-phic	cat-a-stroph-ic
a-qual-ung	aq-ua-lung
mag-net-o-hy-dro-dy-nam-ics	mag-ne-to-hy-dro-dy-nam-ics
pi-vot	piv-ot
fu-ner-a-r-y	fu-ner-ar-y
pose-ur	po-seur
i-conog-ra-phy	i-co-nog-ra-phy
or-bi-ter	or-bit-er
here-sy	her-e-sy
waf-er	wa-fer
re-al-ness	real-ness
spon-sored	sponsored
eg-o-cen-tric	e-go-cen-tric
hip-po-po-ta-mus	hip-po-pot-a-mus
wel-com-ing	wel-co-ming
re-c-la-ma-tion	rec-la-ma-tion
hi-erar-chi-cal	hi-er-ar-chi-cal
en-fee-bled	enfeebled
dar-k-room	dark-room
on-going	on-go-ing
clov-er	clo-ver
cos-tar	co-star
son-a-ta	so-na-ta
pes-sim-ism	pes-si-mism
ant-werp	antwerp
gub-er-na-to-ri-al	gu-ber-na-to-ri-al
lo-zenge	loz-enge
dod-gem	dodg-em
be-ginn-ing	be-gin-ning
fril-ly	frill-y
han-gar	hang-ar
mo-dern-ism	mod-ern-ism
pet-ro-le-um	pe-tro-le-um
dis-si-d-ent	dis-si-dent
de-s-ign-er	de-sign-er
por-traitist	por-trait-ist
oak-um	oa-kum
i-ridi-um	i-rid-i-um
pi-les	piles
phos-pho-re-scence	phos-pho-res-cence
re-stive	res-tive
sing-ly	sin-gly
pleas-an-t-ry	pleas-ant-ry
par-ap-sy-chol-o-gy	par-a-psy-chol-o-gy
oi-ly	oil-y
steeple-chase	stee-ple-chase
spi-rit-u-al-ism	spir-it-u-al-ism
re-as-su-r-ance	re-as-sur-ance
ther-mos-tat	ther-mo-stat
deca-pod	dec-a-pod
strato-sphere	strat-o-sphere
ap-praisal	ap-prais-al
bi-oen-gineer-ing	bi-o-en-gi-neer-ing
un-it-ed	u-nit-ed
ditch-ing	ditching
vine-gar	vin-e-gar
syl-la-ba-ry	syl-la-bar-y
en-ig-ma	e-nig-ma
coin-cide	co-in-cide
my-ri-ad	myr-i-ad
drom-e-da-r-y	drom-e-dar-y
sa-les-girl	sales-girl
gla-ci-er	gla-cier
pot-a-ble	po-ta-ble
jour-na-lese	jour-nal-ese
clank-ing	clan-king
varn-ish	var-nish
sus-cept-i-ble	sus-cep-ti-ble
ve-n-ous	ve-nous
sal-mon	salm-on
a-r-o-mat-ic	ar-o-mat-ic
iso-late	i-so-late
tel-e-com-mut-ing	te-le-com-mu-ting
how-d-y	how-dy
nau-seate	nau-se-ate
a-n-y-body	an-y-bod-y
spe-c-if-i-cal-ly	spe-cif-i-cal-ly
fore-going	fore-go-ing
worth-y	wor-thy
fun-drais-er	fund-rais-er
cra-tered	cratered
graphite	graph-ite
fi-erce	fierce
roast-ed	roasted
jiffy	jif-fy
vin-yl	vi-nyl
derail-ment	de-rail-ment
fore-ign	for-eign
wea-pon	weap-on
con-ge-ni-al	con-gen-ial
sam-u-ra-i	sam-u-rai
mi-ra-cle	mir-a-cle
du-opo-ly	du-op-o-ly
ne-go-tia-ble	ne-go-ti-a-ble
iso-lat-ed	i-so-lat-ed
scan-t-y	scant-y
wi-dow-er	wid-ow-er
boa	bo-a
sur-real	sur-re-al
based	based
bar-ba-r-i-an	bar-bar-i-an
pe-trel	pet-rel
o-do-rous	o-dor-ous
e-le-ven	e-lev-en
im-por-tu-n-i-ty	im-por-tu-ni-ty
prer-og-a-tive	pre-rog-a-tive
mul-tid-i-men-sion-al	mul-ti-di-men-sion-al
ru-di-men-ta-r-y	ru-di-men-ta-ry
tri-po-li	trip-o-li
snig-ger-ing	sniggering
quart-zite	quartz-ite
cam-pa-nile	cam-pa-ni-le
can-dlel-it	can-dle-lit
vitreous	vit-re-ous
un-re-pentant	un-re-pent-ant
monau-ral	mon-au-ral
un-de-livered	un-de-liv-ered
mischief	mis-chief
hos-t-ler	hos-tler
band-wa-gon	band-wag-on
male-fac-tor	mal-e-fac-tor
penin-su-lar	pen-in-su-lar
doc-tor-ing	doctoring
ow-let	owl-et
pen-thouse	pent-house
bon-an-za	bo-nan-za
prestige	pres-tige
lique-fy	liq-ue-fy
chal-et	cha-let
un-go-vern-a-ble	un-gov-ern-a-ble
sain-thood	saint-hood
cashew	cash-ew
ar-ches	arch-es
un-per-su-a-sive	un-per-sua-sive
with-ered	withered
in-cor-rig-i-ble	in-cor-ri-gi-ble
sub-ser-vient	sub-ser-vi-ent
moth-er-stobe	mo-ther-stobe
swelter-ing	swel-ter-ing
manom-e-ter	ma-nom-e-ter
sa-t-an-ism	sa-tan-ism
un-an-i-mous	u-nan-i-mous
church-goer	church-go-er
ev-er-ything	eve-ry-thing
va-sec-to-my	vas-ec-to-my
ner-vous	nerv-ous
im-per-tur-ba-ble	im-per-turb-a-ble
diges-tive	di-ges-tive
goer	go-er
ma-lad-min-is-tra-tion	mal-ad-min-is-tra-tion
vi-car	vic-ar
ha-voc	hav-oc
de-ser-ti-fi-ca-tion	de-sert-i-fi-ca-tion
co-l-ogne	co-logne
forte	for-te
brok-er	bro-ker
un-derling	un-der-ling
nove-lette	nov-el-ette
buf-fer	buff-er
hard-i-ness	har-di-ness
as-su-age	as-suage
dandy	dan-dy
o-ver-seer	o-ver-se-er
someth-ing	some-thing
clim-a-tol-o-gy	cli-ma-tol-o-gy
a-po-gee	ap-o-gee
mag-ne-si-a	mag-ne-sia
el-fin	elf-in
meand-er	me-an-der
car-cino-ma	car-ci-no-ma
dis-hearten-ing	dis-hear-te-ning
re-ne-wal	re-new-al
welling-ton	wel-ling-ton
forever	for-ev-er
e-ma-ciat-ed	e-ma-ci-at-ed
hi-e-rat-ic	hi-er-at-ic
ward-en	war-den
cya-nide	cy-a-nide
re-cre-a-tion	rec-re-a-tion
un-det-onat-ed	un-det-o-nat-ed
de-f-i-cien-cy	de-fi-cien-cy
shiv-er-ing	shivering
as-su-rance	as-sur-ance
con-trac-t-i-ble	con-tract-i-ble
cowherd	cow-herd
in-tre-pid	in-trep-id
gen-e-r-os-i-ty	gen-er-os-i-ty
poet-ics	po-et-ics
re-cog-ni-tion	rec-og-ni-tion
a-toll	at-oll
pro-spect	pros-pect
a-queous	a-que-ous
dy-nam-ism	dy-na-mism
min-iskirt	min-i-skirt
in-ac-cessi-ble	in-ac-ces-si-ble
ne-ver-the-less	nev-er-the-less
pon-ti-fi-cate	pon-tif-i-cate
re-l-a-bel	re-la-bel
re-q-ui-si-tion	req-ui-si-tion
was-t-age	wast-age
re-com-mend-ed	recommended
gor-ge-ous	gor-geous
mol-es-ter	mo-lest-er
reg-e-late	re-ge-late
re-routes	re-routes
ca-cao	ca-ca-o
be-tok-en	be-to-ken
de-t-o-na-tion	det-o-na-tion
e-tha-nol	eth-a-nol
not-a-ble	no-ta-ble
ho-n-ey-bee	hon-ey-bee
fa-cet	fac-et
fu-tu-r-is-tic	fu-tur-is-tic
discharge	dis-charge
in-ge-n-ious	in-gen-ious
in-con-ve-ni-ent	in-con-ven-ient
gent-ly	gen-tly
me-l-od-ra-mat-ic	mel-o-dra-mat-ic
ri-ot-ing	ri-o-ting
res-o-n-ate	res-o-nate
zool-o-gy	zo-ol-o-gy
com-pli-men-ta-r-y	com-pli-men-ta-ry
the-re-u-pon	there-up-on
ope-n-er	o-pen-er
brok-en	bro-ken
mel-ee	me-lee
cour-a-geous	cou-ra-geous
re-dhead	red-head
ir-re-par-a-ble	ir-rep-a-ra-ble
som-bre-r-o	som-bre-ro
jokey	jok-ey
seal-ing	sealing
worst-ed	wor-sted
ty-pew-ri-t-er	type-writ-er
un-fet-tered	unfettered
krieg-spi-el	krieg-spiel
ran-co-rous	ran-cor-ous
hal-lel-u-jah	hal-le-lu-jah
cav-er-nous	cav-ern-ous
wander-ing	wan-der-ing
epis-tem-ic	ep-i-ste-mic
sa-cro-sanct	sac-ro-sanct
dyad	dy-ad
ir-re-s-ist-i-ble	ir-re-sist-i-ble
bab-y-sit-ter	ba-by-sit-ter
liqueur	li-queur
ga-l-op	gal-op
se-quen-cer	se-quenc-er
do-zen	doz-en
stra-teg-i-cal-ly	stra-te-gi-cal-ly
rig-o-rous	rig-or-ous
o-do-rif-er-ous	o-dor-if-er-ous
cyan	cy-an
ref-i-nance	re-fi-nance
professed	pro-fessed
sain-tli-ness	saint-li-ness
un-likel-i-hood	un-like-li-hood
ner-vy	nerv-y
pub-lished	published
fin-ite	fi-nite
stoic	sto-ic
glimmer-ing	glim-mer-ing
re-s-is-tive	re-sis-tive
un-burdened	un-bur-dened
strang-les	stran-gles
shipown-er	ship-own-er
reso-lute-ly	res-o-lute-ly
hier-o-glyph	hi-er-o-glyph
un-in-for-m-a-tive	un-in-form-a-tive
wad-i	wa-di
un-credit-ed	un-cred-it-ed
de-con-struc-tive	deconstructive
rel-o-cate	re-lo-cate
faul-ty	fault-y
car-rion	car-ri-on
scan-ti-ness	scant-i-ness
hei-fer	heif-er
cine	cin-e
py-ram-id	pyr-a-mid
castoff	cast-off
symptom	symp-tom
do-cile	doc-ile
sy-no-vi-al	syn-o-vi-al
mit-i-gat-ing	mitigating
fa-cile	fac-ile
drift-ing	drif-ting
a-za-le-a	a-zal-ea
a-que-duct	aq-ue-duct
com-mandant	com-man-dant
mis-chie-v-ous	mis-chie-vous
mortga-gor	mort-ga-gor
pa-t-en	pat-en
prep-a-r-a-tive	pre-par-a-tive
roy-alt-y	roy-al-ty
straitened	strait-ened
phlogis-ton	phlo-gis-ton
glo-bule	glob-ule
un-glam-o-rous	un-glam-or-ous
pre-s-ti-gious	pres-tig-ious
steal-th-y	stealth-y
strate-gist	strat-e-gist
wa-tershed	wa-ter-shed
men-s-wear	mens-wear
sleaz-y	slea-zy
pre-dict-ed	predicted
a-rum	ar-um
specta-cle	spec-ta-cle
phi-lan-throp-ic	phil-an-throp-ic
pon-y-tail	po-ny-tail
real	re-al
a-to-mic-i-ty	at-o-mic-i-ty
stew-ardess	stew-ard-ess
starf-ish	star-fish
coex-ist	co-ex-ist
in-sipid	in-sip-id
de-sponden-cy	de-spond-en-cy
fem-in-ist	fem-i-nist
proofread	proof-read
hi-jack-ing	hi-jac-king
re-a-son-a-bly	rea-son-a-bly
pol-lard-ed	pollarded
ar-ch-er	arch-er
treat-y	trea-ty
splendid-ly	splen-did-ly
be-spectacled	be-spec-ta-cled
sland-er	slan-der
muscled	mus-cled
bluster-ing	blustering
heroi-cal-ly	he-ro-i-cal-ly
ther-ap-ist	ther-a-pist
cheet-ah	chee-tah
sold-er	sol-der
xe-n-on	xe-non
louis	lou-is
coo-kie	cook-ie
tran-sac-tion	trans-ac-tion
sa-mo-var	sam-o-var
cal-la-ble	call-a-ble
hol-l-er	hol-ler
libe-r-o	li-be-ro
in-ter-lo-p-er	in-ter-lop-er
hand-i-cap-ped	hand-i-capped
u-nus-a-ble	un-us-a-ble
punch-line	punchline
baronet	bar-on-et
tear-oom	tea-room
ic-i-cle	i-ci-cle
pain-stak-ing	pains-tak-ing
ca-th-e-dral	ca-the-dral
oc-tog-e-nar-i-an	oc-to-ge-nar-i-an
perme-a-ble	per-me-a-ble
te-le-ph-o-to	tel-e-pho-to
statu-esque	stat-u-esque
bour-ge-oi-sie	bour-geoi-sie
worsen	wors-en
sup-ple-men-ta-r-y	sup-ple-men-ta-ry
ven-tu-re-some	ven-ture-some
fil-mic	film-ic
ta-blet	tab-let
ex-pi-ra-to-ry	ex-pir-a-to-ry
mis-aligned	mis-a-ligned
se-s-ame	ses-a-me
gui-d-ance	guid-ance
de-spot-ic	des-pot-ic
plan-ter	plant-er
en-ta-bla-ture	en-tab-la-ture
re-pri-sal	re-pris-al
shelt-er	shel-ter
wa-ter-me-lon	wa-ter-mel-on
mi-di	mid-i
su-per-posed	superposed
mi-n-ute	mi-nute
si-l-i-co-sis	sil-i-co-sis
mi-cro-com-put-er	mi-cro-com-pu-ter
scan-ti-ly	scant-i-ly
ele-ment	el-e-ment
rec-y-cle	re-cy-cle
mis-nom-er	mis-no-mer
de-faul-ter	de-fault-er
o-ver-la-den	o-ver-lad-en
chry-s-an-the-mum	chry-san-the-mum
coor-di-nate	co-or-di-nate
frien-d-li-ly	friend-li-ly
metha-nol	meth-a-nol
ruin-ous	ru-in-ous
sto-n-y	ston-y
sur-rog-a-cy	sur-ro-ga-cy
prophe-cy	proph-e-cy
road-worthy	road-wor-thy
cret-i-nous	cre-tin-ous
e-quid-is-tant	e-qui-dis-tant
tick-et-ed	ticketed
un-ob-ser-vant	un-ob-serv-ant
a-r-o-ma-th-er-a-py	a-ro-ma-ther-a-py
com-pell-ing	com-pel-ling
o-ver-flow-ing	o-ver-flo-wing
sculp-tural	sculp-tur-al
heart-brok-en	heart-bro-ken
ar-m-y	ar-my
sum-mar-y	sum-ma-ry
as-tray	a-stray
pro-create	pro-cre-ate
ba-ron	bar-on
ob-stin-a-cy	ob-sti-na-cy
lus-ti-ly	lust-i-ly
sole-noid	so-le-noid
im-provised	im-pro-vised
su-per-flui-ty	su-per-flu-i-ty
le-gend-a-r-y	leg-end-ar-y
ge-o-mag-net-i-cal-ly	ge-o-mag-ne-ti-cal-ly
ren-ter	rent-er
han-di-work	hand-i-work
in-feas-i-ble	in-fea-si-ble
re-cru-it-er	re-cruit-er
pus-s-y	pus-sy
un-real	un-re-al
detached	de-tached
con-son-ance	con-so-nance
syna-gogue	syn-a-gogue
de-cade	dec-ade
fort-ress	for-tress
tax-i-dermist	tax-i-der-mist
gleam-ing	gleaming
kill-er	kil-ler
ex-cla-ma-to-ry	ex-clam-a-to-ry
can-tile-vered	cantilevered
re-versed	reversed
rhi-no-cer-os	rhi-noc-er-os
shoestring	shoe-string
de-sul-to-ry	des-ul-to-ry
cros-so-ver	cross-o-ver
dis-rep-ut-a-ble	dis-rep-u-ta-ble
sport-s-wear	sports-wear
gam-bling	gam-bling
profess-ed-ly	pro-fess-ed-ly
has-ti-ly	hast-i-ly
pro-v-id-ed	pro-vid-ed
so-b-ri-quet	so-bri-quet
seeing	see-ing
slip-ping	slipping
dairy-man	dair-y-man
so-ci-al-ist	so-cial-ist
pin-kie	pink-ie
tele-vised	televised
clerg-y	cler-gy
pol-y-an-d-ry	pol-y-an-dry
phea-s-ant	pheas-ant
dis-tracting	dis-tract-ing
scur-ri-lous	scur-ril-ous
homo-mor-phism	ho-mo-mor-phism
ho-mo-gene-i-ty	ho-mo-ge-ne-i-ty
dinghy	din-ghy
com-pa-r-a-tive	com-par-a-tive
pro-tease	pro-te-ase
un-der-stu-d-y	un-der-stud-y
batten-ing	bat-ten-ing
un-derfed	un-der-fed
do-deca-he-dron	do-dec-a-he-dron
un-e-v-en-ly	un-e-ven-ly
com-pli-c-it	com-plic-it
de-for-mi-ty	de-form-i-ty
ma-n-i-ac	ma-ni-ac
order	or-der
pan-ties	pant-ies
dan-de-lion	dan-de-li-on
nur-sery-man	nurs-er-y-man
un-cer-e-mo-nious-ly	un-cer-e-mo-ni-ous-ly
mon-og-a-my	mo-nog-a-my
fla-gon	flag-on
hind-quart-ers	hind-quar-ters
a-pa-thet-ic	ap-a-thet-ic
harem	har-em
megas-tar	meg-a-star
sur-fer	surf-er
rant-ing	ranting
gen-tri-fied	gentrified
disused	dis-used
con-trol-l-er	con-trol-ler
trin-k-et	trin-ket
prol-e-tar-i-an	pro-le-tar-i-an
frown-ing	frowning
ty-pe-set	type-set
en-chant-ed	enchanted
ve-l-our	ve-lour
gan-glion	gan-gli-on
thre-ad-bare	thread-bare
mis-er-ly	mi-ser-ly
bet-wixt	be-twixt
the-o-cra-cy	the-oc-ra-cy
cursed	curs-ed
sur-real-ism	sur-re-al-ism
in-de-fen-s-i-ble	in-de-fen-si-ble
an-x-ious	anx-ious
un-a-wakened	un-a-wak-ened
ga-lax-y	gal-ax-y
pro-tec-to-rate	pro-tec-tor-ate
son-ar	so-nar
coc-o-nut	co-co-nut
mil-i-eu	mi-lieu
ante	an-te
ras-per	rasp-er
re-a-son-a-ble	rea-son-a-ble
pa-ci-f-ic	pa-cif-ic
pro-phe-tess	proph-et-ess
mul-time-ter	mul-tim-e-ter
un-impeded	un-im-ped-ed
wreck-ing	wrecking
ex-hi-la-rate	ex-hil-a-rate
me-teor	me-te-or
meas-ly	mea-sly
brand-ing	branding
cir-cu-m-lo-cu-tion	cir-cum-lo-cu-tion
mes-sy	mess-y
twil-it	twi-lit
hy-dran-ge-a	hy-dran-gea
fir-sthand	first-hand
her-bal	herb-al
re-gistra-ble	reg-is-tra-ble
pol-yga-my	po-lyg-a-my
li-ve-l-i-ness	live-li-ness
mal-ig-nant	ma-lig-nant
peda-gogue	ped-a-gogue
dis-k-ette	disk-ette
heart-en-ing	heartening
stunn-ing-ly	stun-ning-ly
harp-ists	har-pists
in-de-ter-mina-ble	in-de-ter-mi-na-ble
crotchet	crotch-et
brand-ish	bran-dish
spil-lage	spill-age
mo-ral-ism	mor-al-ism
pro-mis-cu-i-ty	prom-is-cu-i-ty
diver	div-er
an-ti-bo-dy	an-ti-bod-y
re-fuge	ref-uge
co-ven	cov-en
char-cu-ter-ie	char-cu-te-rie
rev-i-val-ism	re-viv-al-ism
leav-ened	leavened
a-p-oc-a-lypse	a-poc-a-lypse
trea-s-ur-er	treas-ur-er
cine-ma	cin-e-ma
di-v-i-der	di-vid-er
de-t-o-nate	det-o-nate
di-a-pha-nous	di-aph-a-nous
me-gal-o-ma-ni-a	meg-a-lo-ma-ni-a
neu-ro-nal	neu-ron-al
de-mon-stra-tion	dem-on-stra-tion
cat-al-ep-sy	cat-a-lep-sy
borough	bor-ough
me-l-an-cho-ly	mel-an-chol-y
who-du-n-it	who-dun-it
mi-crose-cond	mi-cro-sec-ond
char-i-o-teer	char-i-ot-eer
bes-tiar-y	bes-ti-ar-y
pu-mice	pum-ice
or-bi-tal	or-bit-al
larce-ny	lar-ce-ny
em-broidered	em-broi-dered
ce-re-m-o-ny	cer-e-mo-ny
bu-oy-an-cy	buoy-an-cy
cat-er	ca-ter
jeal-ou-s-y	jeal-ous-y
car-ro-ty	car-rot-y
du-ke-dom	duke-dom
vex-ing	vexing
scat-tered	scattered
ho-ney-suck-le	hon-ey-suck-le
loy-alt-y	loy-al-ty
con-vo-l-ut-ed	con-vo-lut-ed
blood-thirsty	blood-thirst-y
a-v-o-ca-do	av-o-ca-do
ex-ult-ing	exulting
mon-ot-o-ny	mo-not-o-ny
ex-pect-ed	expected
strate-gy	strat-e-gy
pha-ra-oh	phar-aoh
si-len-cer	si-lenc-er
bot-an-ist	bot-a-nist
bal-ler-i-na	bal-le-ri-na
dis-play-a-ble	displayable
fluid	flu-id
an-tis-tat-ic	an-ti-stat-ic
ex-pla-na-to-ry	ex-plan-a-to-ry
bee-feat-er	beef-eat-er
a-noma-ly	a-nom-a-ly
cura-to-ri-al	cu-ra-to-ri-al
a-qua-naut	aq-ua-naut
be-au-ti-ful	beau-ti-ful
lithi-um	lith-i-um
change-o-v-er	change-o-ver
her-mi-tage	her-mit-age
sil-age	si-lage
ca-n-a-r-y	ca-nar-y
sun-glas-ses	sun-glass-es
ci-t-y	cit-y
lo-ve-l-i-ness	love-li-ness
joey	jo-ey
o-be-dient-ly	o-be-di-ent-ly
un-ba-l-ance	un-bal-ance
flick-er-ing	flickering
nap-k-in	nap-kin
palt-ry	pal-try
bicy-cle	bi-cy-cle
rap-tu-rous	rap-tur-ous
os-teo-pa-thy	os-te-op-a-thy
dea-co-ness	dea-con-ess
re-tin-i-tis	ret-i-ni-tis
crystal-line	crys-tal-line
a-vens	av-ens
dis-ad-vant-age	dis-ad-van-tage
steal-thi-ly	stealth-i-ly
quick-silv-er	quick-sil-ver
li-mou-sine	lim-ou-sine
sa-tur-nine	sat-ur-nine
po-lym-er-ase	pol-y-mer-ase
se-rai	se-ra-i
wrestler	wres-tler
ginseng	gin-seng
re-l-a-t-i-vis-tic	rel-a-tiv-is-tic
var-i-e-ty	va-ri-e-ty
pus-sy-cat	pussycat
hard-y	har-dy
leg-a-l-is-tic	le-gal-is-tic
met-as-ta-sis	me-tas-ta-sis
coor-di-na-tor	co-or-di-na-tor
pro-fit	prof-it
prot-o-type	pro-to-type
titter-ing	tittering
bes-mirch	be-smirch
vo-ci-f-er-ous	vo-cif-er-ous
bosom	bos-om
frau-du-lent	fraud-u-lent
un-coordi-nat-ed	un-co-or-di-nat-ed
mis-al-ign-ment	mis-a-lign-ment
con-cord-at	con-cor-dat
ga-th-er-er	gath-er-er
foghorn	fog-horn
so-ci-al-ite	so-cial-ite
in-ex-or-a-bly	in-ex-o-ra-bly
stunt-ed	stunted
di-vot	div-ot
sil-ho-u-ette	sil-hou-ette
monkey	mon-key
stri-d-ent	stri-dent
hy-drome-chan-ics	hy-dro-me-chan-ics
spinning	spin-ning
heal-thi-ly	health-i-ly
fealt-y	fe-al-ty
clayey	clay-ey
tri-en-nial	tri-en-ni-al
dep-o-nent	de-po-nent
col-lab-o-r-a-tive	col-lab-o-ra-tive
dairy-ing	dair-y-ing
step-mo-th-er	step-moth-er
reu-n-ion	re-un-ion
ho-min-id	hom-i-nid
harshen	harsh-en
in-su-rance	in-sur-ance
pas-ser	pass-er
fidg-e-ty	fidg-et-y
in-de-clina-ble	in-de-clin-a-ble
po-tash	pot-ash
com-men-ter	com-ment-er
se-lec-tee	se-lect-ee
do-n-ate	do-nate
govern-men-tal	gov-ern-men-tal
mistyp-ings	mis-ty-pings
as-y-lum	a-sy-lum
in-ad-ver-tent-ly	in-ad-vert-ent-ly
fifteenth	fif-teenth
com-mis-sioned	commissioned
re-com-pense	rec-om-pense
stur-ge-on	stur-geon
tas-ty	tast-y
count-y	coun-ty
trans-for-ma-tive	trans-form-a-tive
women-folk	wom-en-folk
un-sel-l-a-ble	un-sell-a-ble
de-m-a-gogue	dem-a-gogue
ra-t-a-toui-lle	ra-ta-touille
in-er-ti-a	in-er-tia
me-l-on	mel-on
leeward	lee-ward
dis-figure-ment	dis-fig-ure-ment
as-trad-dle	a-strad-dle
as-tig-ma-tism	a-stig-ma-tism
rep-re-hens-i-ble	rep-re-hen-si-ble
le-gend	leg-end
strang-er	stran-ger
nox-i-ous	nox-ious
ha-lon	hal-on
me-te-o-rite	me-te-or-ite
ta-p-er	ta-per
in-tram-u-ral	in-tra-mu-ral
swarm-ing	swarming
co-co-a	co-coa
con-vales-cence	con-va-les-cence
re-pro-duci-bil-i-ty	re-pro-duc-i-bil-i-ty
leak-ing	leaking
scream-ing	screaming
mo-l-ar	mo-lar
te-tra-he-dron	tet-ra-he-dron
spigot	spig-ot
he-ter-o-sex-u-al-i-ty	het-er-o-sex-u-al-i-ty
was-pish	wasp-ish
sir-en	si-ren
com-par-a-bly	com-pa-ra-bly
tolu-ene	tol-u-ene
o-ver-win-t-er	o-ver-win-ter
vo-lume	vol-ume
re-cepta-cle	re-cep-ta-cle
reb-u-ry	re-bur-y
nest-ing	nesting
pre-sen-ta-tion	pres-en-ta-tion
blas-ter	blast-er
om-ni-pre-sent	om-ni-pres-ent
car-bo-na-ce-ous	car-bo-na-ceous
de-ve-lop	de-vel-op
boule-vard	boul-e-vard
cor-oner	cor-o-ner
treadle	trea-dle
cunning	cun-ning
legged	leg-ged
ade-quate-ly	ad-e-quate-ly
pen-ul-ti-mate	pe-nul-ti-mate
ou-tra-geous	out-ra-geous
weal-th-y	wealth-y
look-ing	looking
cheer-ing	cheering
wes-terner	west-ern-er
un-ending	un-end-ing
ce-met-er-y	cem-e-ter-y
prof-i-t-a-bil-i-ty	prof-it-a-bil-i-ty
cro-zi-er	cro-zier
re-f-er-en-dum	ref-er-en-dum
bount-y	boun-ty
do-mi-no	dom-i-no
crav-at	cra-vat
per-cept-i-ble	per-cep-ti-ble
ghana	ghana
de-ter-mi-ner	de-ter-min-er
e-ve-ry-one	eve-ry-one
con-tume-ly	con-tu-me-ly
phe-ro-mone	pher-o-mone
bar-nyard	barn-yard
seg-ment-ed	seg-men-ted
established	es-tab-lished
widow-hood	wid-ow-hood
wa-terbed	wa-ter-bed
re-pugnant	re-pug-nant
ev-o-c-a-tive	e-voc-a-tive
cho-s-en	cho-sen
tan-gy	tang-y
pa-tro-ness	pa-tron-ess
bour-ge-ois	bour-geois
em-o-tive	e-mo-tive
sar-co-ph-a-gus	sar-coph-a-gus
wav-er	wa-ver
in-ter-lock-ing	in-ter-loc-king
bread-winn-er	bread-win-ner
mai-so-n-ette	mai-son-ette
sec-ret-ly	se-cret-ly
curlew	cur-lew
mar-ke-teer	mar-ket-eer
establish	es-tab-lish
pi-r-o-u-ette	pir-ou-ette
woman-ish	wom-an-ish
regis-tra-tion	reg-is-tra-tion
haber-dash-er	hab-er-dash-er
bould-er	boul-der
stru-d-el	stru-del
prop-a-gandist	prop-a-gan-dist
nomi-nee	nom-i-nee
no-dule	nod-ule
fer-mion	fer-mi-on
for-sy-thi-a	for-syth-i-a
me-tro-nome	met-ro-nome
rhe-tor-ic	rhet-o-ric
fa-mine	fam-ine
de-relict	der-e-lict
glut-to-ny	glut-ton-y
ne-g-li-gee	neg-li-gee
so-ber-ing	sobering
per-centage	per-cent-age
betro-thal	be-troth-al
ca-pri-ole	cap-ri-ole
budger-i-gar	budg-er-i-gar
re-p-li-ca	rep-li-ca
glut-tonous	glut-ton-ous
un-an-i-mous-ly	u-nan-i-mous-ly
de-sic-ca-tor	des-ic-ca-tor
to-p-o-log-i-cal	top-o-log-i-cal
strangle-hold	stran-gle-hold
i-do-l-a-trous	i-dol-a-trous
su-per-fi-cial-i-ty	su-per-fi-ci-al-i-ty
startled	star-tled
fel-la-tio	fel-la-ti-o
em-ble-mat-ic	em-blem-at-ic
di-s-use	dis-use
bras-si-ere	bras-siere
cough-ing	coughing
de-s-al-i-na-tion	de-sal-i-na-tion
con-spi-r-a-to-ri-al	con-spir-a-to-ri-al
tel-e-kine-sis	tel-e-ki-ne-sis
re-de-ve-l-op	re-de-vel-op
re-cord-ed	re-cor-ded
mon-op-o-list	mo-nop-o-list
un-der-clothing	un-der-cloth-ing
dis-si-d-ence	dis-si-dence
gra-phol-o-gy	graph-ol-o-gy
chi-li	chil-i
pre-j-u-di-cial	prej-u-di-cial
rem-in-is-cence	rem-i-nis-cence
sup-por-tive	sup-port-ive
un-dis-covered	un-dis-cov-ered
promp-ter	prompt-er
be-loved	be-lov-ed
men-is-cus	me-nis-cus
ne-glig-i-ble	neg-li-gi-ble
seas-cape	sea-scape
in-cre-d-u-lous-ly	in-cred-u-lous-ly
de-gaus-sing	degaussing
lem-o-nade	lem-on-ade
in-de-feas-i-ble	in-de-fea-si-ble
char-is-ma	cha-ris-ma
bal-a-laika	bal-a-lai-ka
re-al-ign-ment	re-a-lign-ment
la-rynx	lar-ynx
di-plo-mat	dip-lo-mat
un-du-lat-ing	un-du-la-ting
o-ver-sha-dow	o-ver-shad-ow
bache-lor	bach-e-lor
in-de-ciph-er-a-ble	in-de-ci-pher-a-ble
im-pen-et-ra-ble	im-pen-e-tra-ble
corner	cor-ner
maroon	ma-roon
stoi-cal	sto-i-cal
man-a-geress	man-ag-er-ess
phi-lo-so-ph-i-cal	phil-o-soph-i-cal
leo-tard	le-o-tard
con-sti-t-u-en-cy	con-stit-u-en-cy
spirant	spi-rant
deepen	deep-en
im-par-tial-i-ty	im-par-ti-al-i-ty
ob-lig-ing-ly	o-blig-ing-ly
cheese-burger	cheese-burg-er
co-mest-i-ble	co-mes-ti-ble
ben-e-fi-ciar-y	ben-e-fi-ci-ar-y
pi-er	pier
cre-scent	cres-cent
bad-tempered	bad-tem-pered
per-se-c-u-tor	per-se-cu-tor
i-sosce-les	i-sos-ce-les
go-ver-nance	gov-ern-ance
ri-ches	rich-es
u-pon	up-on
rein-vest	re-in-vest
ap-nea	ap-ne-a
strato-spher-ic	strat-o-spher-ic
bedcham-ber	bed-cham-ber
seance	se-ance
ex-che-quer	ex-cheq-uer
des-pise	de-spise
vap-o-rous	va-por-ous
lu-ke-warm	luke-warm
lac-u-na	la-cu-na
credit-worthi-ness	cred-it-wor-thi-ness
mor-gue	morgue
ri-fled	rifled
tre-m-o-lo	trem-o-lo
ta-pi-o-ca	tap-i-o-ca
poul-t-ry	poul-try
arc-ing	arcing
re-tro-ac-tive-ly	ret-ro-ac-tive-ly
bom-bar-di-er	bom-bar-dier
bea-tif-ic	be-a-tif-ic
un-tow-ard	un-to-ward
fatten-ing	fat-ten-ing
mac-a-bre	ma-ca-bre
se-tup	set-up
ha-giog-ra-phy	hag-i-og-ra-phy
sturd-y	stur-dy
bu-re-au	bu-reau
ge-noa	gen-o-a
preamp	pre-amp
uno-pened	un-o-pened
un-it	u-nit
pray-er-ful	prayer-ful
riv-al-ry	ri-val-ry
dis-son-ant	dis-so-nant
ei-d-er	ei-der
ex-ploita-tive	ex-ploit-a-tive
ar-chet-y-pal	ar-che-typ-al
mea-sure-ment	meas-ure-ment
swingeing	swinge-ing
coev-al	co-e-val
pa-p-ule	pap-ule
pe-rusal	pe-rus-al
prove-nance	prov-e-nance
scrib-bling	scribbling
liquid	liq-uid
eave-sdrop	eaves-drop
au-to-ma-ton	au-tom-a-ton
per-mit-ting	permitting
castled	cas-tled
paean	pae-an
me-ga	meg-a
per-is-cope	per-i-scope
ke-s-trel	kes-trel
sun-burned	sunburned
casket	cas-ket
pout-ing	pouting
sal-mon-el-la	sal-mo-nel-la
bewild-er	be-wil-der
be-r-et	be-ret
re-c-i-proc-i-ty	rec-i-proc-i-ty
bin-der-y	bind-er-y
po-ly-chro-mat-ic	pol-y-chro-mat-ic
sun-ken	sunk-en
sus-ten-ance	sus-te-nance
go-ry	gor-y
doer	do-er
dentist-ry	den-tis-try
ste-rile	ster-ile
place-bo	pla-ce-bo
in-fant-ry	in-fan-try
com-plain-ing	complaining
bo-le-r-o	bo-le-ro
fal-ter-ing	fal-te-ring
bi-o-g-ra-pher	bi-og-ra-pher
mus-ke-teer	mus-ket-eer
feas-i-ble	fea-si-ble
obe-lisk	ob-e-lisk
mis-sy	miss-y
mi-croor-gan-ism	mi-cro-or-gan-ism
ide-o-log-i-cal-ly	i-de-o-log-i-cal-ly
em-i-rate	e-mir-ate
re-si-d-ue	res-i-due
swimming	swim-ming
wheed-ling	wheedling
ros-a-r-y	ro-sa-ry
pi-vo-tal	piv-ot-al
lul-la-by	lull-a-by
y-o-gi	yo-gi
stripling	strip-ling
poet-ic	po-et-ic
vide-o-con-fer-enc-ing	vid-e-o-con-fer-enc-ing
pi-le-up	pile-up
car-ci-no-gen-e-sis	car-cin-o-gen-e-sis
synod-ic	syn-od-ic
re-sult-ing	resulting
burge-on-ing	burgeoning
cry-os-tat	cry-o-stat
u-n-ique	u-nique
mon-e-tar-ism	mon-e-ta-rism
bug-gered	buggered
ap-pre-cia-bly	ap-pre-ci-a-bly
con-ve-nient-ly	con-ven-ient-ly
ty-pist	typ-ist
crat-er	cra-ter
con-tem-po-ra-r-y	con-tem-po-rar-y
av-er	a-ver
gi-an-tess	gi-ant-ess
cus-to-mar-y	cus-tom-ar-y
tel-e-sa-les	tel-e-sales
des-pite	de-spite
si-de-kick	side-kick
re-im-ple-ment-ed	reimplemented
tepid	tep-id
re-furb-ish	re-fur-bish
hib-is-cus	hi-bis-cus
u-n-i-di-rec-tion-al	u-ni-di-rec-tion-al
dec-o-r-a-tor	dec-o-ra-tor
spin-al	spi-nal
bla-t-ant	bla-tant
ver-it-a-ble	ver-i-ta-ble
u-s-ur-per	u-surp-er
carol	car-ol
om-it	o-mit
i-g-u-a-na	i-gua-na
dif-fer-en-tia-ble	dif-fer-en-ti-a-ble
mortga-gee	mort-ga-gee
trade-marked	trademarked
shand-y	shan-dy
ar-cha-eol-o-gy	ar-chae-ol-o-gy
ev-ict	e-vict
pea-s-ant	peas-ant
junk-er	jun-ker
na-v-el	na-vel
sibling	sib-ling
de-vil-ish	dev-il-ish
hel-pless-ly	help-less-ly
laud-ed	lauded
dos-sier	dos-si-er
ti-a-ra	ti-ar-a
tum-bled	tumbled
sup-erb	su-perb
mi-le-stone	mile-stone
out-spok-en	out-spo-ken
la-d-y-bug	la-dy-bug
de-boned	deboned
fru-it-ful	fruit-ful
sel-l-er	sell-er
per-fu-mer-y	per-fum-er-y
tre-s-pas-ser	tres-pass-er
au-tho-ress	au-thor-ess
sus-pend-ed	sus-pen-ded
crink-ly	crin-kly
sem-i-f-i-nal-ist	sem-i-fi-nal-ist
de-signed-ly	de-sign-ed-ly
hei-ress	heir-ess
bi-got	big-ot
dat-a-base	da-ta-base
silv-er	sil-ver
re-for-ma-tion	ref-or-ma-tion
un-fa-thomed	un-fath-omed
stirring	stir-ring
u-n-i-verse	u-ni-verse
cus-tody	cus-to-dy
re-cog-nize	rec-og-nize
poin-till-ism	poin-til-lism
feas-i-bil-i-ty	fea-si-bil-i-ty
bed-clo-thes	bed-clothes
phen-o-type	phe-no-type
scan-da-lous	scan-dal-ous
synon-y-my	syn-on-y-my
moorhen	moor-hen
su-gar-ing	sug-ar-ing
pa-ge-an-t-ry	pag-eant-ry
de-stine	des-tine
lit-er-a-ti	lit-e-ra-ti
de-cile	dec-ile
suet	su-et
aun-tie	aunt-ie
le-it-mot-if	leit-mo-tif
uplift-ing	up-lift-ing
ar-d-u-ous	ar-du-ous
vin-ey-ard	vine-yard
en-cy-cli-cal	en-cyc-li-cal
dis-em-bodied	dis-em-bod-ied
sky-s-crap-er	sky-scrap-er
manage-a-ble	man-age-a-ble
be-au-ti-ful-ly	beau-ti-ful-ly
so-lu-bil-i-ty	sol-u-bil-i-ty
strol-l-er	stroll-er
bursa-ry	bur-sa-ry
mar-ke-ter	mar-ket-er
epin-e-phrine	ep-i-neph-rine
fluid-ly	flu-id-ly
beau-teous	beau-te-ous
breast-feed-ing	breastfeeding
prophe-sy	proph-e-sy
bu-re-au-crat	bu-reau-crat
du-o-mo	duo-mo
ev-ane-s-cent	ev-a-nes-cent
an-tiair-craft	an-ti-air-craft
pa-late	pal-ate
mi-suse	mis-use
se-ron-e-ga-tive	se-ro-neg-a-tive
bewil-d-er-ment	be-wil-der-ment
re-a-l-ize	re-al-ize
count-er	coun-ter
che-va-l-i-er	chev-a-lier
sec-re-cy	se-cre-cy
mer-ciless-ly	mer-ci-less-ly
wat-er	wa-ter
lam-p-light	lamp-light
im-per-cept-i-bly	im-per-cep-ti-bly
in-can-de-scent	in-can-des-cent
redo-lent	red-o-lent
mil-lise-cond	mil-li-sec-ond
pul-mon-ar-y	pul-mo-nar-y
vide-o	vid-e-o
ju-gu-lar	jug-u-lar
brack-et-ed	bracketed
stop-o-v-er	stop-o-ver
lau-reate	lau-re-ate
chlor-o-phyll	chlo-ro-phyll
an-throp-ic	an-thro-pic
tilde	til-de
per-turb-ing	perturbing
man-ure	ma-nure
po-lit-ics	pol-i-tics
lique-fac-tion	liq-ue-fac-tion
tru-cu-lent	truc-u-lent
coaster	coast-er
jux-ta-p-o-si-tion	jux-ta-po-si-tion
dis-o-ri-en-tat-ed	disorientated
per-su-a-sive	per-sua-sive
he-ro-ism	her-o-ism
de-v-as-tate	dev-as-tate
in-sou-ciance	in-sou-ci-ance
im-per-cept-i-ble	im-per-cep-ti-ble
ha-track	hat-rack
beadle	bea-dle
rei-fy	re-i-fy
Words with errors: 1218
Words with incorrect number of syllables: 684
Total evluated: 6500
Perfect accuracy: 0.81
Number of syllables accuracy: 0.89
Average Levenshtein Distance(across incorrect words): 1.15
