Attempt	Real
re-cy-cling	recycling
chalet	cha-let
scor-pion	scor-pi-on
im-mu-noas-say	im-mu-no-as-say
vag-ue-ly	vague-ly
swarm-ing	swarming
hy-dros-phere	hy-dro-sphere
re-mu-n-er-a-tion	re-mu-ner-a-tion
star-ga-z-er	star-gaz-er
vehe-mence	ve-he-mence
secede	se-cede
con-tra-v-ene	con-tra-vene
en-gi-neered	engineered
gar-age	ga-rage
puff-y	puf-fy
u-n-i-son	u-ni-son
sa-l-i-ent	sa-li-ent
bu-si-ness	busi-ness
chrom-a-tog-ra-phy	chro-ma-tog-ra-phy
ground-wa-t-er	ground-wa-ter
re-cord-ed	re-cor-ded
step-sist-er	step-sis-ter
hye-na	hy-e-na
sniff-ing	sniffing
gof-er	go-fer
in-ter-per-sonal	in-ter-per-son-al
groc-er-y	gro-cer-y
rede-sign	re-de-sign
dis-h-on-est	dis-hon-est
kooka-bur-ra	kook-a-bur-ra
precede	pre-cede
turnt-a-ble	turn-ta-ble
road-wor-th-y	road-wor-thy
precess	pre-cess
a-po-the-o-sis	a-poth-e-o-sis
po-li-cy-hold-er	pol-i-cy-hold-er
pond-er	pon-der
fus-t-y	fus-ty
pest-er	pes-ter
con-centrat-ed	con-cen-trat-ed
un-der-dev-el-oped	un-der-de-vel-oped
a-pi-ece	a-piece
pro-mul-gate	prom-ul-gate
hy-drod-y-nam-ics	hy-dro-dy-nam-ics
hy-gi-ene	hy-giene
gran-a-r-y	gra-na-ry
par-o-chi-al-ism	pa-ro-chi-al-ism
cham-b-er	cham-ber
haws-er	haw-ser
sig-ners	sign-ers
volt-me-t-er	volt-me-ter
be-re-ave	be-reave
traverse	trav-erse
pi-v-ot	piv-ot
pol-lard-ed	pollarded
orchid	or-chid
ex-ege-sis	ex-e-ge-sis
de-sic-ca-tor	des-ic-ca-tor
ta-ch-yon	tach-y-on
prese-lect	pre-se-lect
fid-get	fidg-et
can-di-dat-ures	can-di-da-tures
blust-er	blus-ter
ber-eft	be-reft
sur-rog-a-cy	sur-ro-ga-cy
ki-lo-ton	kil-o-ton
re-spec-t-a-bil-i-ty	re-spect-a-bil-i-ty
ba-th-os	ba-thos
dec-rep-it	de-crep-it
per-so-nal-ly	per-son-al-ly
dis-av-o-wal	dis-a-vow-al
braz-en	bra-zen
tre-spass	tres-pass
in-dige-nous	in-dig-e-nous
chasten-ing	chastening
pold-er	pol-der
veneer	ve-neer
pi-on-eer	pi-o-neer
car-e-tak-er	care-tak-er
o-ce-an	o-cean
proff-er	prof-fer
tech-no-c-ra-cy	tech-noc-ra-cy
u-n-i-cam-er-al	u-ni-cam-er-al
my-th-i-cal	myth-i-cal
mechan-ist	mech-a-nist
tru-cu-lent	truc-u-lent
sung-las-ses	sun-glass-es
ste-rile	ster-ile
sar-i	sa-ri
mem-or-a-ble	mem-o-ra-ble
pap-er	pa-per
py-ra-m-id	pyr-a-mid
craz-i-ly	cra-zi-ly
sea-wor-th-y	sea-wor-thy
in-fras-truc-tur-al	in-fra-struc-tur-al
de-sul-to-ry	des-ul-to-ry
prede-ter-mined	predetermined
spon-g-y	spon-gy
key-boar-d-ist	key-board-ist
was-te-ful	waste-ful
bill-ing	bil-ling
a-po-state	a-pos-tate
tail-or-a-ble	tai-lor-a-ble
stapes	sta-pes
cret-in	cre-tin
un-set-tling	unsettling
in-ex-tric-a-bly	in-ex-tri-ca-bly
blin-kered	blink-ered
e-n-u-mer-a-tor	e-nu-mer-a-tor
psyche	psy-che
new-s-reel	news-reel
body-guard	bod-y-guard
dev-el-op-ment	de-vel-op-ment
per-so-nal	per-son-al
cos-tar	co-star
dol-d-rums	dol-drums
de-fic-it	def-i-cit
av-er	a-ver
voc-al-ist	vo-cal-ist
stor-y-tell-ing	sto-ry-tell-ing
jun-kyard	junk-yard
rip-pling	rippling
stipend	sti-pend
over-use	o-ver-use
eq-uid-is-tant	e-qui-dis-tant
graf-fi-t-i	graf-fi-ti
ans-wer-a-ble	an-swer-a-ble
un-in-for-ma-tive	un-in-form-a-tive
a-v-i-ate	a-vi-ate
busy-bod-y	bus-y-bod-y
ex-a-mine	ex-am-ine
an-ted-i-lu-vian	an-te-di-lu-vi-an
boast-ing	boas-ting
un-dec-id-a-ble	un-de-cid-a-ble
brand-y	bran-dy
em-i-rate	e-mir-ate
en-or-mous-ly	e-nor-mous-ly
bo-som	bos-om
free-d-om	free-dom
com-prom-is-ing	com-pro-mis-ing
bol-e-ro	bo-le-ro
flab-ber-gast-ed	flabbergasted
penol-o-gy	pe-nol-o-gy
e-l-ec-tric-i-ty	e-lec-tric-i-ty
oc-cup-ied	oc-cu-pied
titil-lat-ing	tit-il-lat-ing
stal-ac-tite	sta-lac-tite
re-sil-i-ence	re-sil-ience
oc-u-l-ist	oc-u-list
mon-omo-lec-u-lar	mon-o-mo-lec-u-lar
is-o-la-tion	i-so-la-tion
mud-dling	muddling
smoth-ered	smothered
wov-en	wo-ven
lem-o-nade	lem-on-ade
idi-o-cy	id-i-o-cy
tu-tel-age	tu-te-lage
dev-ot-ee	dev-o-tee
ge-ri-at-ric	ger-i-at-ric
man-d-i-ble	man-di-ble
an-tler	ant-ler
mid-fi-eld-er	mid-field-er
spon-sored	sponsored
posse	pos-se
planter	plant-er
be-fud-dling	befuddling
pre-fab-ri-cat-ed	prefabricated
tele-work-ing	teleworking
in-ter-col-le-gi-ate	in-ter-col-le-giate
stasis	sta-sis
car-ro-ty	car-rot-y
cret-i-nous	cre-tin-ous
nift-y	nif-ty
cryp-tan-a-lyst	crypt-an-a-lyst
o-pin-i-on-at-ed	o-pin-ion-at-ed
poul-t-ry	poul-try
gang-ly	gan-gly
ca-cao	ca-ca-o
me-lon	mel-on
re-as-sur-ing	reassuring
trade-marked	trademarked
ar-chip-e-l-a-go	ar-chi-pel-a-go
de-stined	des-tined
rib-o-flav-in	ri-bo-fla-vin
in-com-bust-i-ble	in-com-bus-ti-ble
pe-c-u-li-ar-ly	pe-cu-liar-ly
pap-y-rus	pa-py-rus
coalesce	co-a-lesce
blowup	blow-up
un-molest-ed	un-mo-lest-ed
han-dy-man	hand-y-man
farth-ing	far-thing
laug-h-a-bly	laugh-a-bly
at-tack-ing	attacking
un-ac-cep-t-a-bly	un-ac-cept-a-bly
bar-ba-ri-an	bar-bar-i-an
pi-an-is-si-mo	pi-a-nis-si-mo
crav-en	cra-ven
al-togeth-er	al-to-geth-er
rep-ro-duc-i-bly	re-pro-duc-i-bly
shiv-er-ing	shivering
ranch-ing	ranching
res-pir-a-to-ry	res-pi-ra-to-ry
lad-y-bird	la-dy-bird
renew-a-ble	re-new-a-ble
mis-og-yn-ist	mi-sog-y-nist
sub-stan-d-ard	sub-stand-ard
per-ci-pi-ent	per-cip-i-ent
pand-er	pan-der
u-n-i-on-i-sa-tion	un-ion-i-sa-tion
pro-po-si-tion	prop-o-si-tion
mim-i-cry	mim-ic-ry
row-d-y	row-dy
in-qui-r-y	in-quir-y
forte	for-te
flya-way	fly-a-way
o-dys-sey	odyssey
scat-tered	scattered
re-newed	renewed
pot-a-ble	po-ta-ble
con-descend-ing	con-de-scend-ing
wav-er	wa-ver
plag-ue	plague
seques-tra-tion	se-ques-tra-tion
un-com-prom-is-ing	un-com-pro-mis-ing
prem-a-ture-ly	pre-ma-ture-ly
dis-sen-t-er	dis-sent-er
non-con-for-m-i-ty	non-con-form-i-ty
e-u-tec-tic	eu-tec-tic
me-dici-nal	me-dic-i-nal
gold-s-mith	gold-smith
de-ter-mi-nist	de-ter-min-ist
pol-ar	po-lar
com-pa-r-a-bly	com-pa-ra-bly
mel-a-to-n-in	mel-a-to-nin
burn-ings	bur-nings
steeple-jack	stee-ple-jack
cind-er	cin-der
fi-ef-dom	fief-dom
doc-toring	doctoring
candle-lit	can-dle-lit
thank-sgiv-ing	thanks-giv-ing
o-p-er-a	o-pe-ra
divi-sor	di-vi-sor
dipht-hong	diph-thong
in-frared	in-fra-red
rel-o-ca-tion	re-lo-ca-tion
saintli-ness	saint-li-ness
pe-ril	per-il
pro-ject-ing	projecting
mis-chiev-ous	mis-chie-vous
post-mod-ernist	post-mod-ern-ist
me-t-ro-nome	met-ro-nome
ep-ig-ra-phy	e-pig-ra-phy
sec-ta-r-i-an	sec-tar-i-an
step-daugh-t-er	step-daugh-ter
do-cile	doc-ile
re-in-vig-o-rate	re-in-vig-or-ate
freestand-ing	free-stand-ing
sis-al	si-sal
psy-choth-er-a-py	psy-cho-ther-a-py
grill-ing	grilling
bil-t-ong	bil-tong
sam-u-ra-i	sam-u-rai
helix	he-lix
dol-o-mite	do-lo-mite
re-gis-t-er	reg-is-ter
low-l-y	low-ly
misuse	mis-use
ex-cla-m-a-to-ry	ex-clam-a-to-ry
drag-oon	dra-goon
sa-t-yr	sa-tyr
lit-er-at-i	lit-e-ra-ti
cherubic	che-ru-bic
cine	cin-e
en-tre-pre-neu-ri-al	en-tre-pre-neur-i-al
is-o-la-tion-ism	i-so-la-tion-ism
par-ti-c-i-ple	par-ti-ci-ple
t-su-nam-i	tsu-na-mi
seg-ment-ed	seg-men-ted
ele-ment	el-e-ment
gan-g-li-on	gan-gli-on
shelt-er	shel-ter
un-con-ge-ni-al	un-con-gen-ial
gren-a-d-i-er	gren-a-dier
ar-chet-y-pal	ar-che-typ-al
baw-dy	bawd-y
des-cent	de-scent
com-ple-men-ta-r-y	com-ple-men-ta-ry
chim-e-ra	chi-me-ra
tra-ch-ea	tra-che-a
feasi-bil-i-ty	fea-si-bil-i-ty
bustard	bus-tard
fa-th-om	fath-om
su-pre-m-a-cy	su-prem-a-cy
u-sur-er	u-su-rer
tempter	tempt-er
rat-a-tou-ille	ra-ta-touille
white-washed	whitewashed
fel-la-tio	fel-la-ti-o
highlight-er	high-ligh-ter
chev-a-l-i-er	chev-a-lier
be-de-vil	be-dev-il
iv-y	i-vy
transplant-ed	transplanted
va-g-ran-cy	va-gran-cy
ar-chi-v-al	ar-chi-val
fu-gue	fugue
wick-etkeep-er	wick-et-keep-er
con-stit-u-tive	con-sti-tu-tive
heret-ic	her-e-tic
ba-ri-um	bar-i-um
me-gal-o-ma-ni-a	meg-a-lo-ma-ni-a
dy-n-ast	dy-nast
com-pa-ni-on-ship	com-pan-ion-ship
prestige	pres-tige
man-slaugh-t-er	man-slaugh-ter
maneuv-er	ma-neu-ver
e-n-er-gy	en-er-gy
un-dis-co-vered	un-dis-cov-ered
coup-let	cou-plet
rog-u-er-y	ro-guer-y
sea-sonal-ly	sea-son-al-ly
o-ver-f-ly	o-ver-fly
pam-p-er	pam-per
pan-das	pan-das
fanat-i-cism	fa-nat-i-cism
falter	fal-ter
fath-er-ing	fathering
with-ered	withered
hier-ar-ch-y	hi-er-ar-chy
troposphere	trop-o-sphere
dang-er	dan-ger
chees-e-burg-er	cheese-burg-er
cas-toff	cast-off
her-me-neut-ics	her-me-neu-tics
pas-s-a-bly	pass-a-bly
wond-er	won-der
nad-ir	na-dir
non-ethe-less	none-the-less
o-nyx	on-yx
trag-e-d-y	trag-e-dy
scaffold-ing	scaf-fold-ing
jal-o-py	ja-lop-y
cur-tained	curtained
flu-tist	flut-ist
se-a	sea
tin-y	ti-ny
wail-ing	wailing
disuse	dis-use
glut-to-ny	glut-ton-y
par-ent-ing	parenting
viz-i-er	vi-zier
hy-ac-inth	hy-a-cinth
de-l-i	del-i
there-af-t-er	there-af-ter
impish	imp-ish
hy-droch-lo-ride	hy-dro-chlo-ride
u-to-pian	u-to-pi-an
dau-ber	daub-er
au-tom-o-bile	au-to-mo-bile
ho-moge-ne-i-ty	ho-mo-ge-ne-i-ty
an-ten-a-tal	an-te-na-tal
un-dis-cip-lined	un-dis-ci-plined
vel-ve-teen	vel-vet-een
in-for-mant	in-form-ant
me-l-an-chol-ic	mel-an-chol-ic
sup-ple-men-ta-r-y	sup-ple-men-ta-ry
sus-ten-ance	sus-te-nance
mer-i-t-o-crat-ic	mer-i-to-crat-ic
phi-l-an-thro-pist	phi-lan-thro-pist
mul-tid-i-men-sion-al	mul-ti-di-men-sion-al
sun-k-en	sunk-en
du-gout	dug-out
lithi-um	lith-i-um
cursed	curs-ed
lisping	lis-ping
naive-ly	na-ive-ly
tan-ta-l-um	tan-ta-lum
bows-tring	bow-string
val-ise	va-lise
stably	sta-bly
for-fe-i-ture	for-fei-ture
photo-type-set-ter	pho-to-type-set-ter
pro-ject	proj-ect
sto-r-y-tell-er	sto-ry-tell-er
cli-m-a-tol-o-gy	cli-ma-tol-o-gy
genu-ine-ness	gen-u-ine-ness
pa-ra-bo-la	pa-rab-o-la
dis-pen-ser	dis-pens-er
car-ri-age-way	car-riage-way
monop-o-l-is-tic	mo-nop-o-lis-tic
ear-then-ware	earth-en-ware
micro-wave	mi-cro-wave
codling	cod-ling
ru-i-n-ous	ru-in-ous
fly-ov-er	fly-o-ver
defe-cate	def-e-cate
cy-lin-d-er	cyl-in-der
fledgling	fledg-ling
pho-toc-o-py	pho-to-cop-y
pre-dict-ed	predicted
gav-otte	ga-votte
fus-sy	fuss-y
un-im-por-t-ance	un-im-por-tance
lone-l-i-ness	lone-li-ness
au-tom-o-tive	au-to-mo-tive
fri-endli-ly	friend-li-ly
en-ticing	en-tic-ing
re-cog-ni-tion	rec-og-ni-tion
ran-co-rous	ran-cor-ous
basket	bas-ket
pro-ced-u-r-al	pro-ce-dur-al
wom-an-k-ind	wom-an-kind
em-broid-ered	em-broi-dered
ex-pir-y	ex-pi-ry
in-cor-rup-t-i-ble	in-cor-rupt-i-ble
steam-roller	steam-roll-er
chiv-v-y	chiv-vy
ex-plic-a-ble	ex-pli-ca-ble
cid-er	ci-der
i-ri-di-um	i-rid-i-um
methion-ine	me-thi-o-nine
o-kap-i	o-ka-pi
sup-er	su-per
gem-s-bok	gems-bok
dim-in-ished	di-min-ished
me-moir	mem-oir
of-f-er	of-fer
leng-th-en	length-en
hos-e-pipe	hose-pipe
chemist	chem-ist
co-pra	cop-ra
wi-dow	wid-ow
un-fa-thomed	un-fath-omed
cesspit	cess-pit
jeal-ou-s-y	jeal-ous-y
gon-do-li-er	gon-do-lier
pe-r-i-as-tron	per-i-as-tron
por-thole	port-hole
de-r-e-lict	der-e-lict
signing	sign-ing
ev-en	e-ven
wand-er	wan-der
em-bra-s-ure	em-bra-sure
na-v-al	na-val
ma-t-ric-u-la-tion	ma-tric-u-la-tion
ed-it-ed	edited
con-sul-tan-cy	con-sult-an-cy
re-furbish	re-fur-bish
hon-our	ho-nour
eg-ot-ism	e-go-tism
hazel	ha-zel
granite	gran-ite
plu-my	plum-y
trea-sure	treas-ure
te-n-on	ten-on
nav-y	na-vy
guin-e-a	guin-ea
author-ship	au-thor-ship
van-il-la	va-nil-la
cou-sin	cous-in
par-sley	pars-ley
precip-ice	prec-i-pice
ex-tre-mism	ex-trem-ism
ig-nor-a-mus	ig-no-ra-mus
phy-log-e-net-ic	phy-lo-ge-net-ic
an-throp-ic	an-thro-pic
car-ci-no-gen-e-sis	car-cin-o-gen-e-sis
cra-tered	cratered
sat-an-ism	sa-tan-ism
ex-ec-ut-a-ble	ex-e-cut-a-ble
guit-ar-ist	gui-tar-ist
mis-ma-n-age	mis-man-age
gui-dance	guid-ance
in-com-men-sur-a-ble	in-com-men-su-ra-ble
ren-t-er	rent-er
har-an-gue	ha-rangue
prair-ie	prai-rie
ca-tion	cat-i-on
bystand-er	by-stand-er
chate-au	cha-teau
fa-cile	fac-ile
trip-let	tri-plet
sa-b-o-teur	sab-o-teur
fru-it-ful	fruit-ful
lad-y-ship	la-dy-ship
mas-er	ma-ser
bu-si-ly	bus-i-ly
in-ex-pe-rienced	in-ex-pe-ri-enced
prep-ar-a-to-ry	pre-par-a-to-ry
sep-ul-chral	se-pul-chral
bal-m-o-ral	bal-mor-al
char-i-t-a-ble	char-i-ta-ble
clim-b-er	climb-er
pan-ache	pa-nache
poig-nant	poign-ant
ex-u-b-er-ant	ex-u-ber-ant
rain-fo-rest	rain-for-est
look-ing	looking
ve-r-is-i-mil-i-tude	ver-i-si-mil-i-tude
jam-boree	jam-bo-ree
se-t-up	set-up
dec-i-sive-ly	de-ci-sive-ly
rap-i-er	ra-pi-er
stylis-tic	sty-lis-tic
ex-tre-mist	ex-trem-ist
in-su-b-or-di-nate	in-sub-or-di-nate
ex-a-cer-bate	ex-ac-er-bate
mi-ra-cle	mir-a-cle
hy-p-o-thet-i-cal-ly	hy-po-thet-i-cal-ly
veg-et-a-tive	veg-e-ta-tive
foreign	for-eign
dun-ga-r-ees	dun-ga-rees
dand-y	dan-dy
don-k-ey	don-key
com-pact-ed	compacted
mam-mal-i-an	mam-ma-li-an
myx-o-mato-sis	myx-o-ma-to-sis
pre-or-dained	preordained
spid-er	spi-der
rav-e-nous	rav-en-ous
phob-ic	pho-bic
phy-si-og-no-my	phys-i-og-no-my
a-rum	ar-um
mye-lin	my-e-lin
ca-me-o	cam-e-o
comet	com-et
smel-ly	smell-y
an-ti-pod-es	an-tip-o-des
a-po-s-tol-ic	ap-os-tol-ic
bluster-ing	blustering
con-den-ser	con-dens-er
dwin-dling	dwindling
pa-th-ol-o-gy	pa-thol-o-gy
di-a-pha-nous	di-aph-a-nous
ob-lige	o-blige
brok-en	bro-ken
new-s-read-er	news-read-er
pre-jud-ice	prej-u-dice
live-l-i-hood	live-li-hood
pro-per-tied	prop-er-tied
ig-ua-na	i-gua-na
se-r-o-to-nin	ser-o-to-nin
eq-ua-to-ri-al	e-qua-to-ri-al
cur-tilage	cur-ti-lage
per-i-lous-ly	per-il-ous-ly
de-vas-tate	dev-as-tate
speechi-fy-ing	speechifying
whisk-ey	whis-key
xe-n-on	xe-non
ro-sin	ros-in
in-stiga-tor	in-sti-ga-tor
sil-age	si-lage
bal-a-laika	bal-a-lai-ka
dis-in-fec-tant	dis-in-fect-ant
fath-er-land	fa-ther-land
rust-ler	rus-tler
strang-les	stran-gles
mil-lin-er	mil-li-ner
paup-er	pau-per
slaugh-t-er	slaugh-ter
cor-po-r-atism	cor-po-rat-ism
be-wilder-ing	bewildering
filt-er	fil-ter
ge-oth-er-mal	ge-o-ther-mal
pat-er	pa-ter
shill-ing	shil-ling
racke-teer-ing	rack-et-eer-ing
e-l-as-tic-i-ty	e-las-tic-i-ty
vap-or-ous	va-por-ous
fev-er-ish	fe-ver-ish
ti-t-il-late	tit-il-late
bi-vou-ac	biv-ou-ac
hu-ma-noid	hu-man-oid
re-ad-a-ble	read-a-ble
ex-pe-rienced	ex-pe-ri-enced
fla-g-rant-ly	fla-grant-ly
glasses	glass-es
ex-istent	ex-ist-ent
gen-ie	ge-nie
widowh-ood	wid-ow-hood
spi-rit-u-al-ist	spir-it-u-al-ist
pilf-er	pil-fer
coland-er	col-an-der
un-fru-it-ful	un-fruit-ful
pro-vince	prov-ince
sen-hor	se-nhor
pro-per-ly	prop-er-ly
ir-rit-a-bil-i-ty	ir-ri-ta-bil-i-ty
freck-led	freckled
fig-u-ra-tive	fig-ur-a-tive
hyp-er-in-fla-tion	hy-per-in-fla-tion
zan-y	za-ny
splint-er	splin-ter
ant-werp	antwerp
me-l-a-n-in	mel-a-nin
e-ver-more	ev-er-more
bal-loon-ist	balloonist
col-lab-or-a-tive	col-lab-o-ra-tive
pi-er	pier
con-se-c-u-tive-ly	con-sec-u-tive-ly
mar-gi-nal-i-a	mar-gi-na-li-a
le-gend	leg-end
wea-p-on	weap-on
toot-h-y	tooth-y
scho-l-ar	schol-ar
ma-ke-ov-er	make-o-ver
ex-tras-o-lar	ex-tra-so-lar
ure-thane	u-re-thane
ca-l-o-r-ie	cal-o-rie
dis-pen-s-a-ble	dis-pen-sa-ble
e-lec-tro-d-y-nam-ics	e-lec-tro-dy-nam-ics
ten-ac-i-ty	te-nac-i-ty
bab-y-sit-ting	babysitting
outreach	out-reach
aq-uanaut	aq-ua-naut
he-p-at-ic	he-pat-ic
spaghet-ti	spa-ghet-ti
tech-no-phob-ic	tech-no-pho-bic
stra-teg-i-cal-ly	stra-te-gi-cal-ly
to-o-tle	too-tle
un-bothered	un-both-ered
in-com-pres-s-i-ble	in-com-press-i-ble
coax-i-al	co-ax-i-al
pha-rynx	phar-ynx
author-ing	au-thor-ing
turn-k-ey	turn-key
slip-ping	slipping
de-i-t-y	de-i-ty
parab-o-loid	pa-rab-o-loid
brog-ue	brogue
con-formist	con-form-ist
sin-u-soid	si-nus-oid
fat-al-is-tic	fa-tal-is-tic
sub-sis-t-ence	sub-sist-ence
ac-cep-t-a-ble	ac-cept-a-ble
tail-or-ing	tai-lor-ing
fri-end-li-ness	friend-li-ness
com-mo-nal-i-ty	com-mon-al-i-ty
man-i-a-cal	ma-ni-a-cal
oak-um	oa-kum
cen-tripe-tal	cen-trip-e-tal
gei-sh-a	gei-sha
pro-per-ty	prop-er-ty
sy-r-inge	sy-ringe
shim-mer-ing	shimmering
an-tide-pres-sant	an-ti-de-pres-sant
i-b-is	i-bis
i-vo-r-y	i-vo-ry
ov-er-in-flat-ed	o-ver-in-flat-ed
fift-y	fif-ty
body-build-ing	bod-y-build-ing
bour-geoi-s-ie	bour-geoi-sie
chiro-prac-tic	chi-ro-prac-tic
vi-o-linist	vi-o-lin-ist
lo-com-o-tive	lo-co-mo-tive
in-ter-lock-ing	in-ter-loc-king
com-pli-men-ta-r-y	com-pli-men-ta-ry
bur-g-lar-y	bur-gla-ry
mores	mo-res
wes-tern-most	west-ern-most
pla-t-i-num	plat-i-num
test-ing	testing
tech-no-pho-bi-a	tech-no-pho-bia
o-ver-seer	o-ver-se-er
car-niv-or-ous	car-niv-o-rous
co-dicil	cod-i-cil
tu-ne-ful	tune-ful
pre-oc-cupy	pre-oc-cu-py
bi-modal	bi-mod-al
dul-lard	dull-ard
nav-v-y	nav-vy
ta-proom	tap-room
e-ty-mo-log-i-cal	et-y-mo-log-i-cal
tar-n-ish	tar-nish
ba-n-al	ba-nal
in-si-d-i-ous-ly	in-sid-i-ous-ly
hoard-ed	hoarded
layer-ing	lay-er-ing
nat-urist	na-tur-ist
ta-v-er-na	ta-ver-na
sad-is-tic	sa-dis-tic
heart-brok-en	heart-bro-ken
mis-sy	miss-y
mis-er	mi-ser
dish-wa-t-er	dish-wa-ter
per-ime-ter	pe-rim-e-ter
dis-rep-ut-a-ble	dis-rep-u-ta-ble
bi-got-ed	big-ot-ed
in-k-well	ink-well
haird-ress-ing	hair-dress-ing
con-vect-ed	convected
tel-e-com-mut-ing	te-le-com-mu-ting
be-wildered	bewildered
cand-y	can-dy
di-a-na	di-an-a
stead-y-ing	steadying
mo-t-i-vate	mo-ti-vate
gaily	gai-ly
shant-y	shan-ty
squa-l-or	squal-or
de-s-ir-a-bil-i-a	de-si-ra-bi-li-a
are-na	a-re-na
chor-al	cho-ral
cha-mo-mile	cham-o-mile
de-vas-tat-ing-ly	dev-as-tat-ing-ly
for-sa-ken	for-sak-en
un-tow-ard	un-to-ward
stere-o	ster-e-o
may-o-ral	may-or-al
in-iqui-tous	in-iq-ui-tous
o-ver-load-ed	overloaded
sten-og-ra-phy	ste-nog-ra-phy
mo-t-i-va-tor	mo-ti-va-tor
kat-y-did	ka-ty-did
nu-dist	nud-ist
mi-cro-fa-rad	mi-cro-far-ad
si-byl	sib-yl
dim-in-ish	di-min-ish
phot-o-syn-the-sis	pho-to-syn-the-sis
clo-set	clos-et
re-min-d-er	re-mind-er
clat-ter-ing	cla-tter-ing
u-re-th-ra	u-re-thra
toil-et	toi-let
tri-um-vi-r-ate	tri-um-vi-rate
per-cep-t-i-ble	per-cep-ti-ble
tan-gy	tang-y
larce-ny	lar-ce-ny
straitened	strait-ened
prol-apsed	pro-lapsed
re-strain-ing	restraining
un-cor-rob-or-at-ed	un-cor-rob-o-rat-ed
per-u-sal	pe-rus-al
pro-mise	prom-ise
dura-ble	du-ra-ble
pewt-er	pew-ter
con-si-der-ing	con-sid-er-ing
de-spot	des-pot
de-signed-ly	de-sign-ed-ly
streng-th-en	strength-en
weasel	wea-sel
ob-nox-i-ous	ob-nox-ious
a-per-ture	ap-er-ture
mag-net-osphere	mag-ne-to-sphere
bar-rist-er	bar-ris-ter
in-ge-ni-ous-ly	in-gen-ious-ly
tas-te-ful-ly	taste-ful-ly
school-d-ays	school-days
cath-ol-ic	cath-o-lic
strat-ig-ra-phy	stra-tig-ra-phy
even-ing	eve-ning
city-s-cape	cit-y-scape
mis-ma-nage-ment	mis-man-age-ment
fi-brob-last	fi-bro-blast
ca-mouflage	cam-ou-flage
com-men-su-r-ate	com-men-su-rate
poig-nan-cy	poign-an-cy
il-lim-i-t-a-ble	il-lim-it-a-ble
sta-ture	stat-ure
lin-kup	link-up
shind-ig	shin-dig
un-com-pli-men-ta-r-y	un-com-pli-men-ta-ry
tum-bled	tumbled
ru-de-ness	rude-ness
liber-tine	lib-er-tine
por-ta-bil-i-ty	port-a-bil-i-ty
son-or-ous	so-no-rous
aro-math-er-a-py	a-ro-ma-ther-a-py
o-ni-on	on-ion
i-on-osphere	i-on-o-sphere
un-i-sex	u-ni-sex
prac-tica-bil-i-ty	prac-ti-ca-bil-i-ty
boud-oir	bou-doir
re-sul-t-ant	re-sult-ant
loosen	loos-en
le-prous	lep-rous
lam-plit	lamp-lit
re-ser-voir	res-er-voir
whip-ped	whipped
prose-cu-tion	pros-e-cu-tion
por-phyr-y	por-phy-ry
in-debted	in-debt-ed
im-a-gine	im-ag-ine
rai-m-ent	rai-ment
dis-may-ing	dismaying
ex-ult-ing	exulting
tone-de-af	tone-deaf
po-lym-er-ase	pol-y-mer-ase
coun-t-y	coun-ty
cus-to-mar-y	cus-tom-ar-y
sav-ant	sa-vant
roast-ed	roasted
not-ice	no-tice
con-gealed	congealed
edgy	edg-y
leg-a-t-ee	leg-a-tee
e-van-gel-ism	e-van-ge-lism
poig-nant-ly	poign-ant-ly
pol-y-saccha-r-ide	pol-y-sac-cha-ride
read-just-ment	re-ad-just-ment
el-e-men-tar-y	el-e-men-ta-ry
re-ju-vena-tion	re-ju-ve-na-tion
to-n-al-i-ty	to-nal-i-ty
skul-d-ug-ger-y	skul-dug-ger-y
peruse	pe-ruse
whole-wheat	wholewheat
kam-i-kaze	ka-mi-ka-ze
un-a-shamed-ly	un-a-sham-ed-ly
ex-u-b-er-ance	ex-u-ber-ance
ir-rel-ev-ant	ir-rel-e-vant
shellf-ish	shell-fish
plea-sure	pleas-ure
con-nect-ing	con-nec-ting
char-is-ma	cha-ris-ma
vin-eyard	vine-yard
shib-boleth	shib-bo-leth
vic-a-r-age	vic-ar-age
de-press-ing	de-pres-sing
wafer	wa-fer
glim-pse	glimpse
plen-t-y	plen-ty
de-uce	deuce
yes-ter-y-ear	yes-ter-year
le-vi-ath-an	le-vi-a-than
weav-ing	weaving
an-o-th-er	an-oth-er
pre-da-tor	pred-a-tor
nephew	neph-ew
e-q-ui-li-b-ri-um	e-qui-lib-ri-um
in-su-l-ant	in-su-lant
u-nip-o-lar	u-ni-po-lar
cru-ise	cruise
sui-tor	suit-or
li-tig-ious	li-ti-gious
ma-r-i-na	ma-ri-na
ti-g-er	ti-ger
pros-ce-ni-um	pro-sce-ni-um
mis-chiev-ous-ly	mis-chie-vous-ly
is-o-tope	i-so-tope
ma-ch-o	ma-cho
cine-ma	cin-e-ma
pos-thu-mous	post-hu-mous
phos-p-hor	phos-phor
flooz-y	floo-zy
teen-y	tee-ny
boun-dar-y	bound-a-ry
naiad	nai-ad
in-spec-to-rate	in-spec-tor-ate
u-p-roa-r-i-ous	up-roar-i-ous
anoint	a-noint
pap-er-y	pa-per-y
phot-o-gen-ic	pho-to-gen-ic
im-mu-nod-e-fi-cien-cy	im-mu-no-de-fi-cien-cy
pol-y-gy-ny	po-lyg-y-ny
e-lec-tro-phore-sis	e-lec-tro-pho-re-sis
is-o-mor-ph-ic	i-so-mor-phic
fis-ti-cuffs	fist-i-cuffs
tran-s-cribe	tran-scribe
con-for-mance	con-form-ance
sto-mach	stom-ach
rare-fied	rar-e-fied
di-s-u-ni-ty	dis-u-ni-ty
pro-p-i-ti-ate	pro-pi-ti-ate
re-dev-el-op-ment	re-de-vel-op-ment
frui-ty	fruit-y
dis-gust-ed	disgusted
an-ter-oom	an-te-room
ep-is-tle	e-pis-tle
pad-ded	padded
in-ex-tric-a-ble	in-ex-tri-ca-ble
in-dex-ing	indexing
sole-noid	so-le-noid
wat-er	wa-ter
hol-ism	ho-lism
ap-plica-bil-i-ty	ap-pli-ca-bil-i-ty
pa-r-o-chial	pa-ro-chi-al
rel-a-bel	re-la-bel
po-li-ce-wo-man	po-lice-wom-an
dam-n-ing	damn-ing
prof-i-teer-ing	profiteering
co-vet	cov-et
li-eu	lieu
op-pro-b-ri-um	op-pro-bri-um
u-n-i-tar-y	u-ni-tar-y
fun-d-rais-er	fund-rais-er
re-bel-li-ous	re-bel-lious
canoe-ing	ca-noe-ing
con-descend	con-de-scend
re-fuge	ref-uge
tripod	tri-pod
cub-oid	cu-boid
main-tenance	main-te-nance
di-atribe	di-a-tribe
dis-cipline	dis-ci-pline
vig-i-lante	vig-i-lan-te
ju-di-ciar-y	ju-di-ci-ar-y
po-l-y-ga-my	po-lyg-a-my
o-ver-worked	overworked
click-ing	clicking
un-e-v-en-ly	un-e-ven-ly
yog-i	yo-gi
in-sec-tiv-or-ous	in-sec-tiv-o-rous
bi-or-hythm	bi-o-rhythm
clust-er	clus-ter
bug-gered	buggered
gasket	gas-ket
ru-di-men-tar-y	ru-di-men-ta-ry
pid-gin	pidg-in
ye-o-man-ry	yeo-man-ry
un-linked	unlinked
semen	se-men
hair-spray	hairspray
con-vict-ed	convicted
ches-t-y	chest-y
im-pe-ril	im-per-il
joystick	joy-stick
en-a-bled	e-na-bled
chiseled	chis-eled
chi-c-o-ry	chic-o-ry
ce-lan-dine	cel-an-dine
com-pani-on-a-ble	com-pan-ion-a-ble
un-mot-i-vat-ed	un-mo-ti-vat-ed
smelt-ing	smelting
un-der-car-ri-age	un-der-car-riage
im-palpa-ble	im-pal-pa-ble
temper	tem-per
sterling	ster-ling
coaut-hor	co-au-thor
word-s-mith	word-smith
bi-er	bier
en-chant-ed	enchanted
ze-al-o-t-ry	zeal-ot-ry
lith-osphere	lith-o-sphere
sea-sh-ore	sea-shore
bul-le-t-in	bul-le-tin
sep-ar-atist	sep-a-ra-tist
dis-cip-lined	dis-ci-plined
sto-ep	stoep
mis-o-gy-ny	mi-sog-y-ny
em-broid-er	em-broi-der
with-dra-w-al	with-draw-al
prophe-c-y	proph-e-cy
weari-ness	wea-ri-ness
ge-n-ome	ge-nome
ti-dal	tid-al
hom-o-phob-ic	ho-mo-pho-bic
sur-vi-v-or	sur-vi-vor
sten-o-sis	ste-no-sis
quies-cent	qui-es-cent
der-i-so-ry	de-ri-so-ry
dais	da-is
ex-plo-i-ta-tion	ex-ploi-ta-tion
hau-li-er	haul-ier
wild-er-ness	wil-der-ness
lea-flet	leaf-let
a-v-ens	av-ens
bire-frin-gent	bi-re-frin-gent
foreleg	fore-leg
de-s-eg-re-ga-tion	de-seg-re-ga-tion
re-tri-eve	re-trieve
res-pi-r-a-tor	res-pi-ra-tor
bisho-p-ric	bish-op-ric
eg-o-cen-tric	e-go-cen-tric
non-vi-ol-ence	non-vi-o-lence
de-gauss-ing	degaussing
groc-er	gro-cer
green-groc-er	green-gro-cer
cre-dit-wor-th-y	cred-it-worth-y
cath-et-er	cath-e-ter
mol-e-s-ta-tion	mo-les-ta-tion
brigand	brig-and
bulg-ing	bulging
pol-y-mor-ph-ic	pol-y-mor-phic
ta-bles-poon	ta-ble-spoon
ci-t-ron	cit-ron
an-tag-on-ism	an-tag-o-nism
un-fet-tered	unfettered
i-mag-i-na-tion	im-ag-i-na-tion
a-rith-met-ic	a-rith-me-tic
ri-v-al	ri-val
mi-croor-gan-ism	mi-cro-or-gan-ism
pre-mi-ere	pre-miere
pin-kie	pink-ie
vi-ca-r-i-ous-ly	vi-car-i-ous-ly
brand-ish	bran-dish
pro-m-is-so-ry	prom-is-so-ry
la-c-u-na	la-cu-na
re-ord-er	re-or-der
wi-dow-er	wid-ow-er
re-c-ur-rence	re-cur-rence
sup-por-tive	sup-port-ive
sub-si-dence	sub-sid-ence
pre-face	pref-ace
frat-ric-i-dal	frat-ri-cid-al
bun-dling	bundling
con-scien-tious-ness	con-sci-en-tious-ness
slow-l-y	slow-ly
re-u-nion	re-un-ion
wor-th-y	wor-thy
pan-th-er	pan-ther
re-cipe	rec-i-pe
doom-sday	dooms-day
is-o-ther-mal	i-so-ther-mal
ra-con-teur	rac-on-teur
in-ev-it-a-bil-i-ty	in-ev-i-ta-bil-i-ty
blat-ant	bla-tant
ar-tist	art-ist
ep-o-chal	ep-och-al
fes-ter-ing	festering
hazel-nut	ha-zel-nut
cle-men-cy	clem-en-cy
grav-y	gra-vy
con-strict-ed	constricted
mi-n-ute	mi-nute
bristling	bris-tling
a-v-i-a-tion	a-vi-a-tion
glis-t-en	glis-ten
glo-r-y	glo-ry
ma-them-a-ti-cian	math-e-ma-ti-cian
kais-er	kai-ser
col-lec-tiv-i-sa-tion	col-lec-ti-vi-sa-tion
life-s-tyle	life-style
cin-em-a-tog-ra-pher	cin-e-ma-tog-ra-pher
me-t-rop-o-l-is	me-trop-o-lis
un-der-wa-t-er	un-der-wa-ter
mar-ked-ly	mark-ed-ly
mean-der-ing	me-an-der-ing
jok-e-y	jok-ey
monog-a-mous-ly	mo-nog-a-mous-ly
re-tri-ev-al	re-triev-al
cav-a-li-er	cav-a-lier
tint-ed	tinted
en-fee-bled	enfeebled
hon-o-rif-ic	hon-or-if-ic
buck-min-ster-ful-ler-e-ne	buck-min-ster-ful-ler-ene
vill-age	vil-lage
in-ves-tig-a-tive	in-ves-ti-ga-tive
psych-ic	psy-chic
con-que-r-or	con-quer-or
swar-th-y	swarth-y
rost-er	ros-ter
ran-i	ra-ni
ul-tra-vi-o-l-et	ul-tra-vi-o-let
per-i-ph-er-y	pe-riph-er-y
de-scend-ing	descending
deif-y	de-i-fy
ord-er	or-der
cal-o-rime-ter	cal-o-rim-e-ter
pa-r-en-ter-al	par-en-ter-al
ma-d-am	mad-am
pla-c-a-to-ry	pla-ca-to-ry
fla-gon	flag-on
jour-na-lese	jour-nal-ese
six-tieth	six-ti-eth
laud-ed	lauded
meth-o-dol-o-gy	meth-od-ol-o-gy
sak-i	sa-ki
physi-o-ther-a-py	phys-i-o-ther-a-py
ex-trag-a-lac-tic	ex-tra-ga-lac-tic
are-a	ar-e-a
trum-per-y	trump-er-y
hid-e-a-way	hide-a-way
co-py	cop-y
at-tempt-ed	at-temp-ted
cafe-te-r-i-a	caf-e-te-ri-a
nurser-y-men	nurs-er-y-men
treat-y	trea-ty
ban-ter-ing	bantering
lim-e-light	lime-light
sec-on-dar-y	sec-ond-ar-y
trespass-er	tres-pass-er
pos-tal	post-al
dec-i-sive-ness	de-ci-sive-ness
li-t-ur-gy	lit-ur-gy
de-u-ter-on	deu-ter-on
fevered	fe-vered
phen-o-type	phe-no-type
phot-o-syn-thet-i-cal-ly	pho-to-syn-thet-i-cal-ly
quisling	quis-ling
he-roine	her-o-ine
un-spok-en	un-spo-ken
mol-as-ses	mo-las-ses
varn-ish	var-nish
con-sor-tium	con-sor-ti-um
gub-er-na-to-ri-al	gu-ber-na-to-ri-al
re-mo-val	re-mov-al
wor-m-y	worm-y
mon-ochro-mat-ic	mon-o-chro-mat-ic
can-al	ca-nal
note-p-a-per	note-pa-per
in-de-bted-ness	in-debt-ed-ness
phra-sal	phras-al
chip-ped	chipped
crea-tion	cre-a-tion
pi-rat-ed	pirated
hyp-noth-er-a-py	hyp-no-ther-a-py
buz-zing	buzzing
nin-e-tieth	nine-ti-eth
haird-ress-er	hair-dress-er
stron-groom	strong-room
un-ta-lent-ed	un-tal-ent-ed
dec-i-sive	de-ci-sive
se-ba-ce-ous	se-ba-ceous
togeth-er-ness	to-geth-er-ness
un-i-for-m-i-ty	u-ni-form-i-ty
pre-si-di-um	pre-sid-i-um
thirt-y	thir-ty
bi-oen-gi-neer-ing	bi-o-en-gi-neer-ing
phon-o-log-i-cal	pho-no-log-i-cal
noodle	noo-dle
bil-li-ards	bil-liards
pa-r-i-e-tal	pa-ri-e-tal
bas-il-isk	bas-i-lisk
un-wear-ied	un-wea-ried
be-drock	bed-rock
fev-er-ish-ly	fe-ver-ish-ly
cas-ta-way	cast-a-way
sub-t-ly	sub-tly
e-dit	ed-it
stinger	sting-er
seeth-ing	seething
strug-gling	struggling
misspell-ings	mis-spel-lings
comp-troll-er	comp-trol-ler
re-cre-a-tion	rec-re-a-tion
ta-l-on	tal-on
stripy	strip-y
oc-cu-p-i-er	oc-cu-pi-er
at-ri-um	a-tri-um
con-fir-ma-to-ry	con-firm-a-to-ry
coales-cence	co-a-les-cence
en-or-mous	e-nor-mous
lun-che-on	lunch-eon
di-aphragm	di-a-phragm
con-duc-tance	con-duct-ance
o-rigin	or-i-gin
phoenix	phoe-nix
ta-ke-ov-er	take-o-ver
sy-r-up	syr-up
se-r-en-dip-i-ty	ser-en-dip-i-ty
divi-sive	di-vi-sive
ig-nor-ance	ig-no-rance
ca-len-dar	cal-en-dar
por-ous	po-rous
flou-ry	flour-y
pol-yest-er	pol-y-es-ter
pos-til-i-on	pos-til-ion
fe-c-und	fe-cund
ex-tram-u-ral	ex-tra-mu-ral
el-se-wh-ere	else-where
bir-die	bird-ie
sta-phyl-o-coc-cus	staph-y-lo-coc-cus
di-n-ar	di-nar
ge-n-er-ic	ge-ner-ic
trans-for-ma-tive	trans-form-a-tive
mish-ear	mis-hear
chid-ing	chiding
web-bed	webbed
hib-er-nate	hi-ber-nate
un-answered	un-an-swered
in-fect-ed	in-fec-ted
bi-got	big-ot
stripling	strip-ling
re-al-ness	real-ness
ket-chup	ketch-up
ker-at-in	ker-a-tin
frown-ing	frowning
han-g-o-v-er	hang-o-ver
pe-o-ple	peo-ple
ty-pist	typ-ist
drows-y	drow-sy
det-es-ta-tion	de-tes-ta-tion
mom-en-tar-y	mo-men-tar-y
pro-po-si-tion-al	prop-o-si-tion-al
hes-itant-ly	hes-i-tant-ly
croch-et	cro-chet
scho-l-ar-ly	schol-ar-ly
re-cu-p-er-a-tion	re-cu-per-a-tion
sold-er	sol-der
de-con-struc-tive	deconstructive
method	meth-od
cus-hioned	cush-ioned
daugh-t-er	daugh-ter
flo-rin	flor-in
hy-dran-ge-a	hy-dran-gea
in-ef-f-a-ble	in-ef-fa-ble
prem-o-lar	pre-mo-lar
ir-re-lig-ious	ir-re-li-gious
de-portee	de-por-tee
fiz-z-y	fizz-y
min-is-kirt	min-i-skirt
ri-v-i-er-a	riv-i-er-a
re-joind-er	re-join-der
dis-ad-van-t-age	dis-ad-van-tage
pro-pell-er	pro-pel-ler
mis-ty	mist-y
cor-dil-ler-a	cor-dil-le-ra
creak-ing	creaking
kit-ch-en-ette	kitch-en-ette
re-troac-tive	ret-ro-ac-tive
pesk-y	pes-ky
gam-bling	gam-bling
leg-al-ism	le-gal-ism
mod-esty	mod-es-ty
sol-di-er-ly	sol-dier-ly
ruf-fian	ruf-fi-an
un-i-di-rec-tion-al	u-ni-di-rec-tion-al
cud-g-el	cudg-el
don-or	do-nor
dra-m-at-ics	dra-mat-ics
mar-ri-age	mar-riage
fluid	flu-id
ex-e-cu-tor	ex-ec-u-tor
drys-tone	dry-stone
trip-lane	tri-plane
im-pen-et-ra-ble	im-pen-e-tra-ble
e-n-u-mer-a-tion	e-nu-mer-a-tion
Words with errors: 1219
Words with incorrect number of syllables: 667
Total evluated: 6500
Perfect accuracy: 0.81
Number of syllables accuracy: 0.90
Average Levenshtein Distance(across incorrect words): 1.15
