Attempt	Real
smel-ly	smell-y
pe-nin-su-la	pen-in-su-la
chaos	cha-os
waistline	waist-line
im-prison	im-pris-on
con-figure	con-fig-ure
pes-sim-ist	pes-si-mist
par-li-a-ment	par-lia-ment
craz-i-ness	cra-zi-ness
newlywed	new-ly-wed
hau-li-er	haul-ier
renew-a-ble	re-new-a-ble
wag-er	wa-ger
le-gis-la-tive	leg-is-la-tive
in-ter-pol-ata-ble	in-ter-po-la-ta-ble
chrysal-is	chrys-a-lis
her-bi-cide	herb-i-cide
an-throp-o-mor-phism	an-thro-po-mor-phism
tas-t-y	tast-y
coo-lant	cool-ant
posse	pos-se
gask-et	gas-ket
tou-ris-tic	tour-is-tic
fo-ray	for-ay
dam-per	damp-er
manes	ma-nes
glut-to-nous	glut-ton-ous
wreck-ing	wrecking
disheart-ened	dis-hear-tened
wily	wil-y
gaze-lle	ga-zelle
ta-vern	tav-ern
chi-ropody	chi-rop-o-dy
par-li-a-men-tar-y	par-lia-men-ta-ry
mar-kup	mark-up
wes-ter-ly	west-er-ly
coex-ten-sive	co-ex-ten-sive
ar-riv-al	ar-ri-val
tick-et-ed	ticketed
un-a-dapted	un-a-dapt-ed
pol-y-cyc-lic	pol-y-cy-clic
diverge	di-verge
trans-pond-er	tran-spon-der
chi-v-al-ry	chiv-al-ry
hy-po-crite	hyp-o-crite
pot-a-ble	po-ta-ble
cin-em-a-tog-ra-pher	cin-e-ma-tog-ra-pher
sed-an	se-dan
pad-ded	padded
mis-creant	mis-cre-ant
titled	ti-tled
ni-co-tine	nic-o-tine
de-served-ly	de-serv-ed-ly
em-er-gent	e-mer-gent
feathered	feath-ered
proto-col	pro-to-col
par-li-a-men-tari-an	par-lia-men-tar-i-an
in-con-ve-ni-ence	in-con-ven-ience
feather-ing	feath-er-ing
ge-op-o-lit-i-cal	ge-o-po-lit-i-cal
pos-y	po-sy
me-diev-al	me-di-e-val
an-tithe-sis	an-tith-e-sis
un-feas-i-ble	un-fea-si-ble
fender	fend-er
dur-a-ble	du-ra-ble
em-er-gence	e-mer-gence
flan-ne-lette	flan-nel-ette
dep-o-nent	de-po-nent
men-arche	men-ar-che
hear-thrug	hearth-rug
groom-ing	grooming
xylo-phone	xy-lo-phone
casting	cast-ing
ti-mel-i-ness	time-li-ness
skirm-ish	skir-mish
pals-y	pal-sy
publish	pub-lish
be-wildered	bewildered
quin-ine	qui-nine
her-me-ne-u-t-ic	her-me-neu-tic
re-versi-ble	re-vers-i-ble
un-wear-ied	un-wea-ried
chor-is-t-er	chor-is-ter
mes-sy	mess-y
golfer	golf-er
va-li-ant-ly	val-iant-ly
cal-cium	cal-ci-um
gra-phite	graph-ite
un-developed	un-de-vel-oped
eu-ka-ry-ote	eu-kar-y-ote
nak-ed-ness	na-ked-ness
pre-sence	pres-ence
cat-a-r-act	cat-a-ract
bire-frin-gent	bi-re-frin-gent
prophy-lac-tic	pro-phy-lac-tic
fer-mion	fer-mi-on
pro-tago-n-ist	pro-tag-o-nist
pa-r-en-ter-al	par-en-ter-al
beg-ga-r-y	beg-gar-y
tilde	til-de
ka-r-ate	ka-ra-te
stapler	sta-pler
lul-la-by	lull-a-by
di-ath-er-my	di-a-ther-my
im-por-tu-n-i-ty	im-por-tu-ni-ty
sale-sper-son	sales-per-son
synon-y-mous	syn-on-y-mous
scalene	sca-lene
jin-gois-tic	jin-go-is-tic
sun-burned	sunburned
eer-i-ly	ee-ri-ly
tasting	tast-ing
fore-cas-ter	fore-cast-er
stifling	sti-fling
mon-op-o-lis-tic	mo-nop-o-lis-tic
divid-er	di-vid-er
kill-er	kil-ler
pre-t-end	pre-tend
dam-ning	damn-ing
pro-ced-ur-al	pro-ce-dur-al
di-plo-mat-ic	dip-lo-mat-ic
ca-ch-et	ca-chet
bulg-ing	bulging
larynxes	la-rynx-es
haik-u	hai-ku
trip-od	tri-pod
pre-f-a-to-ry	pref-a-to-ry
spa-gh-et-ti	spa-ghet-ti
tre-mor	trem-or
tute-lage	tu-te-lage
poly-and-ry	pol-y-an-dry
provok-ing	pro-vok-ing
recom-pile	re-com-pile
ri-b-ald	rib-ald
ro-sin	ros-in
me-ri-di-an	me-rid-i-an
flab-ber-gasted	flabbergasted
dais-y	dai-sy
coun-ter-rev-o-lu-tion-ary	coun-ter-rev-o-lu-tion-ar-y
vo-ca-tive	voc-a-tive
bar-o-net	bar-on-et
grater	grat-er
tob-og-gan	to-bog-gan
dyna-mite	dy-na-mite
mil-lin-er-y	mil-li-ner-y
res-troom	rest-room
pin-cushion	pin-cush-ion
budge-tar-y	budg-et-ar-y
a-larmed	alarmed
un-crea-tive	un-cre-a-tive
em-physe-ma	em-phy-se-ma
geom-e-ter	ge-om-e-ter
pos-tal	post-al
ravening	rav-en-ing
but-terf-ly	but-ter-fly
ante	an-te
di-ar-y	di-a-ry
a-vens	av-ens
u-p-hill	up-hill
sturd-y	stur-dy
ran-i	ra-ni
re-spite	res-pite
par-o-chi-al-ism	pa-ro-chi-al-ism
gla-di-o-lus	glad-i-o-lus
lad-y-bug	la-dy-bug
mas-thead	mast-head
vap-o-rous	va-por-ous
se-same	ses-a-me
eag-er-ly	ea-ger-ly
breast-feed-ing	breastfeeding
o-r-ange	or-ange
o-ver-writ-ing	overwriting
vant-age	van-tage
sac-ch-ar-in	sac-cha-rin
he-re-in-af-ter	here-in-af-ter
thirt-y	thir-ty
cath-e-d-ral	ca-the-dral
fer-al	fe-ral
clif-fhang-er	cliff-hang-er
dis-coth-eque	dis-co-theque
e-tymo-log-i-cal	et-y-mo-log-i-cal
dubbing	dub-bing
trans-cend-ence	tran-scend-ence
galling	gall-ing
moun-tai-nous	moun-tain-ous
beav-er	bea-ver
sa-tire	sat-ire
libret-tist	li-bret-tist
batten-ing	bat-ten-ing
mis-nom-er	mis-no-mer
bol-er-o	bo-le-ro
sim-per-ing	simpering
mul-time-ter	mul-tim-e-ter
lu-nat-ic	lu-na-tic
in-con-gruit-y	in-con-gru-i-ty
panz-er	pan-zer
qua-ter-nion	qua-ter-ni-on
py-ram-id	pyr-a-mid
va-let	val-et
pep-pered	peppered
cockeyed	cock-eyed
phy-si-o-log-i-cal-ly	phys-i-o-log-i-cal-ly
cou-sin	cous-in
guit-ar-ist	gui-tar-ist
baob-ab	ba-o-bab
gib-ber-ing	gibbering
launder	laun-der
dis-a-bling	disabling
pap-er-y	pa-per-y
tele-work-ing	teleworking
aug-er	au-ger
dis-ciplined	dis-ci-plined
churlish	churl-ish
fon-tan-el	fon-ta-nel
sold-er	sol-der
look-ing	looking
hor-monal	hor-mo-nal
place-bo	pla-ce-bo
ever-lasting	ev-er-last-ing
im-per-cep-t-i-ble	im-per-cep-ti-ble
franchi-see	fran-chi-see
in-fect-ed	in-fec-ted
rare-fac-tion	rar-e-fac-tion
quad-ruped	quad-ru-ped
fevered	fe-vered
redo-lent	red-o-lent
chan-geov-er	change-o-ver
retro-spect	ret-ro-spect
re-pro-cess	re-proc-ess
grid-ded	gridded
mer-in-gue	me-ringue
strident-ly	stri-dent-ly
ar-sen-ic	ar-se-nic
un-licensed	un-li-censed
par-sley	pars-ley
ev-er-y-bod-y	eve-ry-bod-y
ro-mancer	ro-manc-er
con-troll-er	con-trol-ler
no-vice	nov-ice
obe-di-ent	o-be-di-ent
cate-chist	cat-e-chist
gal-e-na	ga-le-na
en-du-r-ance	en-dur-ance
mourner	mourn-er
pa-late	pal-ate
cand-id-ly	can-did-ly
crav-en	cra-ven
bala-cla-va	bal-a-cla-va
wad-i	wa-di
holl-er	hol-ler
cere-al	ce-re-al
hedon-ist	he-don-ist
pan-t-ry	pan-try
motif	mo-tif
in-hos-pit-a-ble	in-hos-pi-ta-ble
fluf-fy	fluff-y
so-phis-try	soph-ist-ry
o-cean-ic	o-ce-an-ic
dairy-man	dair-y-man
pronounced	pro-nounced
pue-rile	pu-er-ile
en-a-bled	e-na-bled
rea-wak-en	re-a-wak-en
cur-ly	curl-y
xe-r-og-ra-phy	xe-rog-ra-phy
con-volut-ed	con-vo-lut-ed
spil-lage	spill-age
coun-t-ry	coun-try
i-m-ag-i-na-tion	im-ag-i-na-tion
nat-u-r-ist	na-tur-ist
mi-cro-com-put-er	mi-cro-com-pu-ter
mil-lise-cond	mil-li-sec-ond
gov-ern-ing	governing
rel-o-ca-tion	re-lo-ca-tion
diver-gence	di-ver-gence
fluid	flu-id
ar-gua-ble	ar-gu-a-ble
melt-ed	melted
grin-der	grind-er
swimm-ing-ly	swim-ming-ly
prob-a-tive	pro-ba-tive
can-dlelit	can-dle-lit
drug-ged	drugged
is-o-late	i-so-late
palpa-bly	pal-pa-bly
be-wild-er	be-wil-der
ga-se-ous	gas-e-ous
ex-cep-ting	ex-cept-ing
sere-nade	ser-e-nade
hatred	ha-tred
fal-lout	fall-out
ban-ter-ing	bantering
bi-noc-u-lar	bin-oc-u-lar
fre-quent-ed	frequented
seabed	sea-bed
bigot-ed	big-ot-ed
ti-til-lat-ing	tit-il-lat-ing
de-scend-ing	descending
fem-i-n-ist	fem-i-nist
ba-lance	bal-ance
hide-ous-ly	hid-e-ous-ly
win-der	wind-er
ood-les	oo-dles
shoestring	shoe-string
not-i-fy	no-ti-fy
temp-ter	tempt-er
in-kling	ink-ling
in-ter-viewee	in-ter-view-ee
apo-stol-ic	ap-os-tol-ic
su-per-intend	su-per-in-tend
ele-men-tar-y	el-e-men-ta-ry
river-side	riv-er-side
propor-tioned	pro-por-tioned
braw-n-y	brawn-y
tel-epa-thy	te-lep-a-thy
mea-sure	meas-ure
glu-t-en	glu-ten
un-mot-i-vat-ed	un-mo-ti-vat-ed
re-la-tivis-tic	rel-a-tiv-is-tic
ca-thol-ic	cath-o-lic
en-thrall-ing	en-thral-ling
re-alm	realm
in-de-struc-t-i-ble	in-de-struct-i-ble
poly-a-tom-ic	pol-y-a-tom-ic
vil-l-a-ger	vil-lag-er
ma-tins	mat-ins
bimonth-ly	bi-month-ly
pamph-le-teer	pam-phlet-eer
nor-thern	north-ern
a-v-er	a-ver
woebe-gone	woe-be-gone
flooz-y	floo-zy
as-tern	a-stern
wes-tern-most	west-ern-most
bal-a-laika	bal-a-lai-ka
pa-t-en	pat-en
senate	sen-ate
flagel-late	flag-el-late
un-ac-com-modat-ing	un-ac-com-mo-dat-ing
vital	vi-tal
ex-a-cer-ba-tion	ex-ac-er-ba-tion
un-heal-thy	un-health-y
con-demned	condemned
re-al-ness	real-ness
dul-cim-er	dul-ci-mer
em-it-ter	e-mit-ter
dem-er-it	de-mer-it
eid-er	ei-der
un-learned	un-learn-ed
cas-ser-ole	cas-se-role
around	a-round
im-ag-er-y	im-age-ry
id-ly	i-dly
test-ing	testing
re-dun-d-ant	re-dun-dant
lightheart-ed	light-heart-ed
an-tiv-i-r-al	an-ti-vi-ral
me-tab-olism	me-tab-o-lism
a-rith-met-ic	a-rith-me-tic
des-pite	de-spite
hair-spray	hairspray
frees-tyle	free-style
crit-ique	cri-tique
bagu-ette	ba-guette
per-jur-y	per-ju-ry
dig-ni-tary	dig-ni-tar-y
cun-nil-in-gus	cun-ni-lin-gus
per-i-he-lion	per-i-he-li-on
mar-gi-nal	mar-gin-al
pharm-a-cy	phar-ma-cy
thank-sgiv-ing	thanks-giv-ing
jun-kyard	junk-yard
tran-scon-ti-nen-tal	trans-con-ti-nen-tal
deni-zen	den-i-zen
min-der	mind-er
mog-ul	mo-gul
un-cor-relat-ed	un-cor-re-lat-ed
wun-derkind	wun-der-kind
cos-tar	co-star
ra-re-bit	rare-bit
apos-tro-phe	a-pos-tro-phe
mo-torist	mo-tor-ist
cli-t-o-ris	clit-o-ris
fish-mong-er	fish-mon-ger
spor-t-y	sport-y
gut-sy	guts-y
se-ven-tieth	sev-en-ti-eth
vig-i-lante	vig-i-lan-te
bur-gund-y	bur-gun-dy
re-s-tau-ra-teur	res-tau-ra-teur
proc-re-a-tion	pro-cre-a-tion
shi-pload	ship-load
white-washed	whitewashed
pur-suant	pur-su-ant
boob-y	boo-by
rasper	rasp-er
di-agonal-ly	di-ag-o-nal-ly
mo-no	mon-o
hy-ph-e-nate	hy-phen-ate
di-choto-mous	di-chot-o-mous
gud-geon	gudg-eon
cyto-plasm	cy-to-plasm
slander	slan-der
prevue	pre-vue
en-riched	enriched
som-brer-o	som-bre-ro
bar-o-ness	bar-on-ess
chame-leon	cha-me-le-on
pa-ge-an-try	pag-eant-ry
pri-es-tess	priest-ess
bet-ween	be-tween
vibra-to-ry	vi-bra-to-ry
mo-vie	mov-ie
ho-ol-i-gan	hoo-li-gan
ex-che-quer	ex-cheq-uer
des-cent	de-scent
re-p-a-tri-ate	re-pa-tri-ate
ogre	o-gre
bi-vou-ac	biv-ou-ac
re-q-ui-site	req-ui-site
sig-n-er	sign-er
in-sa-ti-a-ble	in-sa-tia-ble
tes-ta-ble	test-a-ble
fid-get	fidg-et
has-t-en	has-ten
han-di-craft	hand-i-craft
pre-sent-ly	pres-ent-ly
is-o-la-tion-ist	i-so-la-tion-ist
crick-eter	crick-et-er
mem-ora-bil-i-a	mem-o-ra-bil-i-a
un-lament-ed	un-la-ment-ed
brav-a-do	bra-va-do
cor-o-na	co-ro-na
predeter-mined	predetermined
pa-lace	pal-ace
clov-en	clo-ven
par-ap-sy-chol-o-gy	par-a-psy-chol-o-gy
gene-al-o-gy	ge-ne-al-o-gy
re-vel-ry	rev-el-ry
ragged	rag-ged
con-i-fer	co-ni-fer
ap-pro-val	ap-prov-al
pan-theon	pan-the-on
dis-com-fort-ing	discomforting
pa-ra-bo-la	pa-rab-o-la
ear-then	earth-en
desir-a-ble	de-sir-a-ble
char-is-ma	cha-ris-ma
cud-g-el	cudg-el
pre-dict-ed	predicted
bi-om-etry	bi-om-e-try
bask-et	bas-ket
phyto-plank-ton	phy-to-plank-ton
sa-far-i	sa-fa-ri
un-bothered	un-both-ered
stronghold	strong-hold
ene-my	en-e-my
vin-ey-ard	vine-yard
in-tert-wine	in-ter-twine
par-ser	pars-er
pri-est	priest
retro-spec-tive	ret-ro-spec-tive
su-per-nu-m-er-ar-y	su-per-nu-mer-ar-y
ho-oli-gan-ism	hoo-li-gan-ism
cor-por-a-tism	cor-po-rat-ism
cushion	cush-ion
ca-b-in	cab-in
slant-ed	slanted
im-mu-noas-say	im-mu-no-as-say
as-pirin	as-pi-rin
pol-ys-ty-rene	pol-y-sty-rene
re-alt-y	re-al-ty
arch-de-a-con-ry	arch-dea-con-ry
roguer-y	ro-guer-y
pain-ter	paint-er
hy-pothe-sis	hy-poth-e-sis
pro-tec-to-rate	pro-tec-tor-ate
im-medi-a-cy	im-me-di-a-cy
ca-vi-ar	cav-i-ar
pro-prie-tar-y	pro-pri-e-tar-y
ir-re-con-cil-a-ble	ir-rec-on-cil-a-ble
blust-er	blus-ter
phi-loso-phy	phi-los-o-phy
iv-y	i-vy
ico-sa-he-dron	i-co-sa-he-dron
be-lit-tling	belittling
tri-tium	trit-i-um
her-ma-phro-dite	her-maph-ro-dite
bung-ling	bungling
prep-a-r-a-to-ry	pre-par-a-to-ry
re-as-sur-ing	reassuring
ord-er	or-der
bes-mirch	be-smirch
closet	clos-et
te-q-ui-la	te-qui-la
ex-pec-tant-ly	ex-pect-ant-ly
ar-mis-tice	ar-mi-stice
sob-er-ly	so-ber-ly
tur-nov-er	turn-o-ver
pleat-ed	pleated
prophe-sy	proph-e-sy
feasi-ble	fea-si-ble
de-vil-ry	dev-il-ry
eer-ie	ee-rie
smirk-ing	smirking
di-plo-mat-i-cal-ly	dip-lo-mat-i-cal-ly
mis-er	mi-ser
ca-thode	cath-ode
fi-du-ciar-y	fi-du-ci-ar-y
sal-mo-n-el-la	sal-mo-nel-la
an-ta-cid	ant-ac-id
re-p-u-blish	re-pub-lish
op-ti-m-ism	op-ti-mism
tor-toisesh-ell	tor-toise-shell
un-neces-sar-y	un-nec-es-sar-y
an-thropo-mor-phic	an-thro-po-mor-phic
guine-a	guin-ea
item	i-tem
ca-n-ine	ca-nine
con-ve-nient-ly	con-ven-ient-ly
cunning-ly	cun-ning-ly
ex-tram-u-ral	ex-tra-mu-ral
ar-o-ma	a-ro-ma
brethren	breth-ren
may-a	ma-ya
rui-na-tion	ru-in-a-tion
cere-bel-lum	cer-e-bel-lum
minute-ly	mi-nute-ly
re-ser-va-tion	res-er-va-tion
ween-y	wee-ny
steve-dore	ste-ve-dore
trel-lised	trellised
brok-en	bro-ken
rooster	roost-er
com-pre-hens-i-ble	com-pre-hen-si-ble
bik-i-ni	bi-ki-ni
cra-tered	cratered
bicy-cle	bi-cy-cle
ti-dal	tid-al
stra-teg-i-cal-ly	stra-te-gi-cal-ly
read-mit	re-ad-mit
min-ce-meat	mince-meat
tran-s-lit-er-ate	trans-lit-er-ate
un-derfed	un-der-fed
hothouse	hot-house
bey-ond	be-yond
swam-p-y	swamp-y
ex-eunt	ex-e-unt
cand-les-tick	can-dle-stick
spok-es-man	spokes-man
bour-geois-ie	bour-geoi-sie
booster	boost-er
gen-tri-fied	gentrified
nur-ser-y	nurs-er-y
blunder-ing	blundering
con-flic-ting	con-flict-ing
fidd-ly	fid-dly
di-su-nion	dis-un-ion
re-for-ma-tion	ref-or-ma-tion
lemur	le-mur
pur-po-sive	pur-pos-ive
shi-pown-er	ship-own-er
county	coun-ty
ok-a-pi	o-ka-pi
quo-ti-ent	quo-tient
foun-dling	found-ling
ey-e-piece	eye-piece
ta-bloid	tab-loid
ar-ro-whead	ar-row-head
fa-cet	fac-et
dec-or-ous	dec-o-rous
ner-vous	nerv-ous
un-e-at-en	un-eat-en
re-sil-i-ence	re-sil-ience
ka-raoke	kar-a-o-ke
war-thog	wart-hog
eider-down	ei-der-down
pu-mice	pum-ice
bes-tir	be-stir
o-ther-ness	oth-er-ness
calum-ny	cal-um-ny
scra-pyard	scrap-yard
leg-a-lese	le-gal-ese
bur-sar-y	bur-sa-ry
must-y	mus-ty
come-di-an	co-me-di-an
man-i-cured	ma-ni-cured
li-eu	lieu
cod-ex	co-dex
stal-ag-mite	sta-lag-mite
bar-bar-ism	bar-ba-rism
free-d-om	free-dom
ti-bi-a	tib-i-a
re-minder	re-mind-er
spon-g-y	spon-gy
leisure	lei-sure
dig-ital-is	dig-i-tal-is
se-ven-ty	sev-en-ty
die-lec-tric	di-e-lec-tric
ho-nest	hon-est
per-soni-fi-ca-tion	per-son-i-fi-ca-tion
a-n-on	a-non
step-sist-er	step-sis-ter
pal-m-is-try	palm-is-try
bromine	bro-mine
ten-ured	tenured
gar-age	ga-rage
im-mu-no-com-prom-ised	im-mu-no-com-pro-mised
pap-a-cy	pa-pa-cy
hy-gien-ic	hy-gi-en-ic
glis-ten-ing	gli-ste-ning
im-por-tunate	im-por-tu-nate
ine-bri-a-tion	in-e-bri-a-tion
tri-gly-c-er-ide	tri-glyc-er-ide
de-brief-ing	debriefing
path-finder	path-find-er
pro-mon-to-ry	prom-on-to-ry
mis-er-ly	mi-ser-ly
iso-tope	i-so-tope
bar-rist-er	bar-ris-ter
un-ap-pre-ciat-ed	un-ap-pre-ci-at-ed
ele-venth	e-lev-enth
pol-e-cat	pole-cat
pro-state	pros-tate
in-trave-nous	in-tra-ve-nous
fif-tieth	fif-ti-eth
poster	post-er
di-s-il-lu-sion	dis-il-lu-sion
biweek-ly	bi-week-ly
lam-plight-er	lamp-light-er
larce-ny	lar-ce-ny
dis-content-ed	dis-con-tent-ed
fault-ing	faulting
ki-lo-ton	kil-o-ton
presum-a-bly	pre-sum-a-bly
start-ling-ly	star-tling-ly
hor-ser-ad-ish	horse-rad-ish
stere-o-typ-i-cal	ster-e-o-typ-i-cal
psy-choth-er-a-py	psy-cho-ther-a-py
fatten-ing	fat-ten-ing
rea-gent	re-a-gent
san-der	sand-er
no-v-el	nov-el
delu-sive	de-lu-sive
ca-taly-sis	ca-tal-y-sis
neu-ro-phy-si-ol-o-gy	neu-ro-phys-i-ol-o-gy
quick-silv-er	quick-sil-ver
par-tici-ple	par-ti-ci-ple
genre	gen-re
cas-ta-way	cast-a-way
out-moded	out-mod-ed
data-base	da-ta-base
le-ghorn	leg-horn
ver-an-da	ve-ran-da
ca-n-ard	ca-nard
ha-track	hat-rack
roast-ed	roasted
pasting	past-ing
trimming	trim-ming
sole-noid	so-le-noid
jagged	jag-ged
pro-fit-less	prof-it-less
eg-o-tist	e-go-tist
ci-ta-del	cit-a-del
hy-per-market	hy-per-mar-ket
im-pla-ca-ble	im-plac-a-ble
min-ute	mi-nute
pois-on	poi-son
com-ba-tive	com-bat-ive
fogey	fo-gey
e-stranged	es-tranged
e-bul-li-ent	e-bul-lient
per-for-ate	per-fo-rate
cour-a-geous-ly	cou-ra-geous-ly
two-s-ome	two-some
buffet-ing	buf-fet-ing
lawy-er	law-yer
chas-ten-ing	chastening
ap-pa-ra-tus	ap-pa-rat-us
an-thropo-log-i-cal	an-thro-po-log-i-cal
ger-ry-mander	ger-ry-man-der
mar-ginal-ly	mar-gin-al-ly
shant-y	shan-ty
saus-age	sau-sage
bin-der-y	bind-er-y
in-au-gur-al	in-au-gu-ral
prove-nance	prov-e-nance
com-bina-to-ri-al	com-bi-na-to-ri-al
a-te-li-er	at-el-ier
mag-ne-tite	mag-net-ite
erad-i-cat-ed	e-rad-i-cat-ed
re-volt-ed	revolted
becom-ing	be-com-ing
u-terine	u-ter-ine
ma-ri-on-ette	mar-i-on-ette
haz-el	ha-zel
fuch-si-a	fuch-sia
pro-prie-to-ri-al	pro-pri-e-to-ri-al
counter	coun-ter
u-phol-ster-y	up-hol-ster-y
swar-th-y	swarth-y
neo-prene	ne-o-prene
spaces-u-it	space-suit
cas-toff	cast-off
cong-er	con-ger
re-ti-ree	re-tir-ee
hori-zon	ho-ri-zon
ter-rorist	ter-ror-ist
in-a-lien-a-ble	in-al-ien-a-ble
pre-sen-ta-tion	pres-en-ta-tion
co-ha-bit	co-hab-it
cu-n-ei-form	cu-ne-i-form
fuz-zy	fuzz-y
im-po-lit-ic	im-pol-i-tic
sty-l-ish-ly	styl-ish-ly
con-sor-tium	con-sor-ti-um
mar-quet-ry	mar-que-try
flood-ing	flooding
pren-a-tal	pre-na-tal
can-tilevered	cantilevered
con-ni-vance	con-niv-ance
mi-g-ra-to-ry	mi-gra-to-ry
mes-s-eng-er	mes-sen-ger
pa-geant	pag-eant
strid-ent	stri-dent
ne-ver-the-less	nev-er-the-less
in-vig-o-rat-ing	in-vig-or-at-ing
pi-er	pier
cog-nac	co-gnac
u-p-riv-er	up-riv-er
cor-dil-ler-a	cor-dil-le-ra
so-ci-a-l-ite	so-cial-ite
gof-er	go-fer
brok-er-age	bro-ker-age
fri-ca-tive	fric-a-tive
un-lac-ing	un-lacing
philo-soph-i-cal-ly	phil-o-soph-i-cal-ly
bun-dling	bundling
serif	ser-if
possi-bly	pos-si-bly
grill-ing	grilling
ci-trate	cit-rate
pos-thu-mous-ly	post-hu-mous-ly
mot-i-va-tion-al	mo-ti-va-tion-al
deplor-a-ble	de-plor-a-ble
mo-nom-o-lec-u-lar	mon-o-mo-lec-u-lar
ge-om-ag-net-i-cal-ly	ge-o-mag-ne-ti-cal-ly
is-o-trop-ic	i-so-trop-ic
re-s-o-nant	res-o-nant
in-ad-ver-tent	in-ad-vert-ent
bot-tled	bottled
dev-astating-ly	dev-as-tat-ing-ly
towered	tow-ered
cor-morant	cor-mo-rant
lon-ghand	long-hand
poem	po-em
naive	na-ive
boar-droom	board-room
sa-tir-ist	sat-i-rist
in-tract-a-ble	in-trac-ta-ble
dino-saur	di-no-saur
busy-bod-y	bus-y-bod-y
scho-lar	schol-ar
lack-a-dais-i-cal	lack-a-dai-si-cal
laz-i-ness	la-zi-ness
trav-esty	trav-es-ty
pro-ject	proj-ect
man-ik-in	man-i-kin
lif-toff	lift-off
il-li-quid	il-liq-uid
fir-sthand	first-hand
prim-o-gen-i-ture	pri-mo-gen-i-ture
rom-per	romp-er
no-b-ly	no-bly
ex-cel-sior	ex-cel-si-or
un-di-plo-mat-ic	un-dip-lo-mat-ic
creak-ing	creaking
ven-al	ve-nal
ca-noeing	ca-noe-ing
in-deb-t-ed-ness	in-debt-ed-ness
mufti	muf-ti
neith-er	nei-ther
gent-ly	gen-tly
vide-o-tape	vid-e-o-tape
ovi-duct	o-vi-duct
un-nerv-ing	unnerving
how-itzer	how-itz-er
in-ex-or-a-ble	in-ex-o-ra-ble
riveting	riv-et-ing
pe-r-ox-ide	per-ox-ide
step-fath-er	step-fa-ther
leak-ing	leaking
po-ten-tial-i-ty	po-ten-ti-al-i-ty
high-lander	high-lan-der
dress-age	dres-sage
clow-n-ish	clown-ish
u-nipo-lar	u-ni-po-lar
re-scue	res-cue
cate-go-ry	cat-e-go-ry
based	based
tok-en	to-ken
com-pa-nion	com-pan-ion
mo-l-yb-de-num	mo-lyb-de-num
gub-er-na-to-ri-al	gu-ber-na-to-ri-al
ap-pa-r-ent	ap-par-ent
ep-is-tem-ic	ep-i-ste-mic
mom-en-tar-i-ly	mo-men-tar-i-ly
has-ti-ly	hast-i-ly
gleam-ing	gleaming
em-broid-ered	em-broi-dered
pa-pay-a	pa-pa-ya
shog-un	sho-gun
in-dic-ta-ble	in-dict-a-ble
me-tal-lur-gy	met-al-lur-gy
as-tonished	as-ton-ished
eth-er	e-ther
re-tro-ac-tive	ret-ro-ac-tive
stif-fen	stiff-en
sur-real	sur-re-al
misog-ynis-tic	mi-sog-y-nis-tic
lib-i-do	li-bi-do
lev-i-a-than	le-vi-a-than
squeegee	squee-gee
vin-yl	vi-nyl
re-pu-bli-ca-tion	re-pub-li-ca-tion
ma-cro	mac-ro
ta-blet	tab-let
up-he-av-al	up-heav-al
ma-caro-ni	mac-a-ro-ni
tri-v-i-a	triv-i-a
mis-er-li-ness	mi-ser-li-ness
metal	met-al
un-rep-re-sen-ta-tive	un-rep-re-sent-a-tive
py-ri-dine	pyr-i-dine
retro-spec-tive-ly	ret-ro-spec-tive-ly
o-ve-reat	o-ver-eat
ju-gu-lar	jug-u-lar
vi-s-ion-ar-y	vi-sion-ar-y
figure	fig-ure
duik-er	dui-ker
mar-chi-o-ness	mar-chion-ess
dand-y	dan-dy
ev-er-y-th-ing	eve-ry-thing
in-de-pendent	in-de-pend-ent
man-a-g-er	man-ag-er
ang-er	an-ger
un-dec-id-a-ble	un-de-cid-a-ble
fealt-y	fe-al-ty
u-n-i-on-ism	un-ion-ism
brand-ish	bran-dish
chid-ing	chiding
ser-vant	serv-ant
hy-droch-lo-ride	hy-dro-chlo-ride
au-top-i-lot	au-to-pi-lot
e-lec-trom-ag-net	e-lec-tro-mag-net
u-n-i-corn	u-ni-corn
as-si-d-u-i-ty	as-si-du-i-ty
cor-ti-cos-ter-oid	cor-ti-co-ster-oid
ma-s-er	ma-ser
gherkin	gher-kin
ad-vant-age	ad-van-tage
lo-g-an-ber-ry	lo-gan-ber-ry
leo-tard	le-o-tard
ranch-ing	ranching
erase	e-rase
proph-y-lax-is	pro-phy-lax-is
delim-it-ed	delimited
hege-mo-ny	he-gem-o-ny
spind-ly	spin-dly
cur-vy	curv-y
in-ad-eq-ua-cy	in-ad-e-qua-cy
be-fud-dled	befuddled
pa-g-er	pag-er
knighthood	knight-hood
in-de-pen-dent-ly	in-de-pend-ent-ly
sul-ta-na	sul-tan-a
trackbed	track-bed
my-th-o-log-i-cal	myth-o-log-i-cal
broad-caster	broad-cast-er
moun-taineer	moun-tain-eer
bond-ing	bonding
pup-pe-teer	pup-pet-eer
fore-igner	for-eign-er
rip-pling	rippling
rast-er	ras-ter
dawning	dawn-ing
bung-ler	bun-gler
div-id-end	div-i-dend
tap-estry	tap-es-try
cus-tod-y	cus-to-dy
mish-ear	mis-hear
as-trad-dle	a-strad-dle
im-pacted	im-pact-ed
new-s-reel	news-reel
dis-honest-ly	dis-hon-est-ly
new-s-print	news-print
e-r-ect	e-rect
u-n-i-ty	u-ni-ty
cid-er	ci-der
poly-est-er	pol-y-es-ter
brigand	brig-and
redi-rect	re-di-rect
seven-fold	sev-en-fold
hal-lel-u-jah	hal-le-lu-jah
coch-lea	coch-le-a
ev-o-ca-tive	e-voc-a-tive
par-ent-ing	parenting
er-stwhile	erst-while
tid-i-ness	ti-di-ness
go-r-y	gor-y
cu-b-ic	cu-bic
anyone	an-y-one
pilf-er	pil-fer
grand-pa-r-ent	grand-par-ent
swarm-ing	swarming
sou-p-y	soup-y
paj-a-mas	pa-ja-mas
ex-per-i-men-ter	ex-per-i-ment-er
pro-pell-er	pro-pel-ler
tar-n-ish	tar-nish
po-lym-er-ase	pol-y-mer-ase
ca-cao	ca-ca-o
fil-th-y	filth-y
suc-cinctly	suc-cinct-ly
know-ledge-a-ble	knowl-edge-a-ble
clim-ber	climb-er
pa-r-en-tal	pa-ren-tal
foun-dry	found-ry
ap-er-it-if	a-pe-ri-tif
brom-ide	bro-mide
un-con-trol-l-a-ble	un-con-trol-la-ble
coy-ote	coy-o-te
re-dun-d-an-cy	re-dun-dan-cy
ca-co-pho-nous	ca-coph-o-nous
in-dus-t-ry	in-dus-try
dis-con-tinue	dis-con-tin-ue
od-di-ty	odd-i-ty
wicked	wick-ed
dis-temper	dis-tem-per
li-mo	lim-o
iron-stone	i-ron-stone
tri-bes-peo-ple	tribes-peo-ple
pro-tracted	pro-tract-ed
huf-fy	huff-y
venere-al	ve-ne-re-al
chem-ise	che-mise
dere-lict	der-e-lict
stu-p-id-ly	stu-pid-ly
zool-o-gist	zo-ol-o-gist
un-ob-ser-vant	un-ob-serv-ant
fath-er-less	fa-ther-less
fly-ov-er	fly-o-ver
con-testant	con-test-ant
ar-senal	ar-se-nal
ear-th-y	earth-y
phy-si-og-no-my	phys-i-og-no-my
ny-a-la	nya-la
phar-m-a-col-o-gy	phar-ma-col-o-gy
de-stined	des-tined
cloistered	clois-tered
de-luge	del-uge
clam-o-rous	clam-or-ous
el-as-tic-i-ty	e-las-tic-i-ty
stably	sta-bly
tigh-trope	tight-rope
seas-cape	sea-scape
weary-ing	wea-ry-ing
desir-ous	de-sir-ous
var-i-e-tal	va-ri-e-tal
an-tide-pres-s-ant	an-ti-de-pres-sant
il-lim-i-ta-ble	il-lim-it-a-ble
priv-a-teer	pri-va-teer
seag-ull	sea-gull
fila-ment	fil-a-ment
sove-reignt-y	sov-er-eign-ty
molester	mo-lest-er
create	cre-ate
ranter	rant-er
decon-struct	de-con-struct
reus-a-ble	re-us-a-ble
de-value	de-val-ue
in-cor-porat-ed	in-cor-po-rat-ed
hoard-ed	hoarded
pro-vo-ca-tive	pro-voc-a-tive
sa-t-in	sat-in
di-a-b-olism	di-ab-o-lism
vis-a	vi-sa
brainchild	brain-child
vig-nette	vi-gnette
lyrist	lyr-ist
be-reaved	bereaved
loft-ed	lofted
for-e-taste	fore-taste
stop-ov-er	stop-o-ver
bee-feat-er	beef-eat-er
hos-tess	host-ess
desi-ra-bil-i-ty	de-sir-a-bil-i-ty
prol-e-tar-i-at	pro-le-tar-i-at
iron-work	i-ron-work
fril-lier	fril-li-er
draf-tee	draft-ee
eb-o-ny	eb-on-y
her-o	he-ro
til-lage	till-age
ma-te-r-i-al-is-tic	ma-te-ri-al-is-tic
keb-ab	ke-bab
lai-t-y	la-i-ty
doing	do-ing
dis-sent-ing	dissenting
de-line-ate	de-lin-e-ate
develop-men-tal-ly	de-vel-op-men-tal-ly
ele-ment	el-e-ment
cos-monaut	cos-mo-naut
ca-r-at	car-at
sum-mar-y	sum-ma-ry
hour-g-lass	hour-glass
tail-or-ing	tai-lor-ing
story-book	sto-ry-book
spi-rit-u-al-ism	spir-it-u-al-ism
cet-a-cean	ce-ta-cean
con-tem-porar-y	con-tem-po-rar-y
someth-ing	some-thing
ma-ta-dor	mat-a-dor
nin-e-ty	nine-ty
hyp-er-in-fla-tion	hy-per-in-fla-tion
bu-re-au-crat	bu-reau-crat
en-chanter	en-chant-er
ty-pe-set	type-set
pag-a-n-ism	pa-gan-ism
te-le-o-log-i-cal	tel-e-o-log-i-cal
de-s-truc-tion	de-struc-tion
zigzag	zig-zag
loo-phole	loop-hole
rel-o-cate	re-lo-cate
un-der-powered	un-der-pow-ered
ra-cist	rac-ist
o-do-rif-er-ous	o-dor-if-er-ous
wiz-ar-dry	wiz-ard-ry
re-q-ui-si-tion	req-ui-si-tion
wild-er-ness	wil-der-ness
desira-bil-i-a	de-si-ra-bi-li-a
a-p-er-y	ap-er-y
seam-an-ship	sea-man-ship
milk-shake	milkshake
cal-der-a	cal-de-ra
yok-el	yo-kel
in-fante	in-fan-te
re-port-ed	reported
un-cor-rupted	un-cor-rupt-ed
a-mu-s-ing	a-mus-ing
u-pend-ed	upended
foot-balling	foot-ball-ing
per-ci-pi-ent	per-cip-i-ent
en-chan-tress	en-chant-ress
oc-tog-e-nar-i-an	oc-to-ge-nar-i-an
dis-son-ance	dis-so-nance
za-n-y	za-ny
no-nen-ti-ty	non-en-ti-ty
tra-des-peo-ple	trades-peo-ple
lavend-er	lav-en-der
sar-ong	sa-rong
han-dout	hand-out
spani-el	span-iel
rib-bed	ribbed
in-defin-a-ble	in-de-fin-a-ble
hav-en	ha-ven
saunter	saun-ter
shunter	shunt-er
freel-y	free-ly
strate-gist	strat-e-gist
pi-ty	pit-y
in-ju-r-y	in-ju-ry
wes-tern	west-ern
de-s-cend-ant	de-scend-ant
yel-lowed	yellowed
neces-sar-i-ly	nec-es-sar-i-ly
jaunty	jaun-ty
mourning	mourn-ing
va-r-i-ate	var-i-ate
lith-og-ra-phy	li-thog-ra-phy
hun-g-ry	hun-gry
decom-press	de-com-press
da-hli-a	dahl-ia
mil-i-tar-is-tic	mil-i-ta-ris-tic
husk-y	hus-ky
of-fhand	off-hand
so-ci-o-e-co-nom-ic	so-ci-o-ec-o-nom-ic
cin-em-a-tog-ra-phy	cin-e-ma-tog-ra-phy
ul-c-er	ul-cer
dar-ter	dart-er
ga-te-au	ga-teau
ran-co-r-ous	ran-cor-ous
un-fa-mil-i-ar	un-fa-mil-iar
groc-er-y	gro-cer-y
stapes	sta-pes
bache-lor	bach-e-lor
fra-gile	frag-ile
splend-id	splen-did
so-phist	soph-ist
obelisk	ob-e-lisk
es-ca-pee	es-cap-ee
ba-sil	bas-il
lit-tor-al	lit-to-ral
fri-gate	frig-ate
ar-chaism	ar-cha-ism
mani-a-cal	ma-ni-a-cal
dis-quiet-ing	dis-qui-et-ing
com-ple-men-tar-y	com-ple-men-ta-ry
in-ad-ver-tent-ly	in-ad-vert-ent-ly
ju-di-ciar-y	ju-di-ci-ar-y
a-w-ry	a-wry
cougar	cou-gar
gin-gham	ging-ham
in-val-id	in-va-lid
cas-tling	castling
ruin	ru-in
lich-en	li-chen
put-rid	pu-trid
beater	beat-er
han-gar	hang-ar
notepa-per	note-pa-per
thursday	thurs-day
balus-ter	bal-us-ter
ga-m-y	gam-y
in-cor-rup-ti-ble	in-cor-rupt-i-ble
im-pas-s-a-ble	im-pass-a-ble
an-ten-a-tal	an-te-na-tal
cheer-ing	cheering
noti-fi-ca-tion	no-ti-fi-ca-tion
clink-ing	clin-king
y-es-ter-year	yes-ter-year
vi-s-ion	vi-sion
wes-tern-er	west-ern-er
mot-i-va-tion	mo-ti-va-tion
ex-port-a-bil-i-ty	ex-por-ta-bi-li-ty
pea-sant	peas-ant
o-ran-gu-tan	o-rang-u-tan
fawning	fawn-ing
rubbing	rub-bing
tar-an-tu-la	ta-ran-tu-la
so-lid	sol-id
micro-phone	mi-cro-phone
jal-o-py	ja-lop-y
tran-sa-tlan-tic	trans-at-lan-tic
harp-ists	har-pists
heart-brok-en	heart-bro-ken
rhe-tor-ic	rhet-o-ric
iron-works	i-ron-works
tsetse	tset-se
ab-a-lone	ab-a-lo-ne
ex-per-i-en-tial	ex-pe-ri-en-tial
e-s-cape-ment	es-cape-ment
boarder	board-er
pal-e-face	pale-face
pa-lette	pal-ette
hy-droelec-tric	hy-dro-e-lec-tric
uni-formed	u-ni-formed
in-nov-a-tive	in-no-va-tive
cour-troom	court-room
de-faulter	de-fault-er
sawy-er	saw-yer
bon-an-za	bo-nan-za
cru-el-t-y	cru-el-ty
rheostat	rhe-o-stat
san-d-y	sand-y
bab-y-sit-ting	babysitting
sibling	sib-ling
han-di-cap	hand-i-cap
sen-ti-n-el	sen-ti-nel
pigsty	pig-sty
gos-si-py	gos-sip-y
ver-ita-ble	ver-i-ta-ble
in-fras-truc-tur-al	in-fra-struc-tur-al
re-pro-bate	rep-ro-bate
ox-y-moron	ox-y-mo-ron
trib-u-nal	tri-bu-nal
su-p-erb	su-perb
a-qualung	aq-ua-lung
ga-lax-y	gal-ax-y
fingering	fin-ger-ing
plaintiff	plain-tiff
furn-ish	fur-nish
ber-eft	be-reft
develop-ment	de-vel-op-ment
nuis-ance	nui-sance
ar-tist	art-ist
ther-a-peu-t-ic	ther-a-peu-tic
se-ren-dip-i-tous	ser-en-dip-i-tous
sce-na-r-i-o	sce-nar-i-o
quer-y	que-ry
boa	bo-a
ki-n-ase	ki-nase
bid-i-rec-tion-al	bi-di-rec-tion-al
protest-er	pro-test-er
prosthe-sis	pros-the-sis
ex-cava-tor	ex-ca-va-tor
lac-u-na	la-cu-na
are-na	a-re-na
ep-i-tome	e-pit-o-me
neon	ne-on
un-bu-ried	un-bur-ied
eo-sin	e-o-sin
pro-mul-gate	prom-ul-gate
un-detonat-ed	un-det-o-nat-ed
per-sec-u-tor	per-se-cu-tor
phenol	phe-nol
bili-ar-y	bil-i-ar-y
dumb-found-ed	dumbfounded
philo-so-ph-er	phi-los-o-pher
seeth-ing	seething
sissy	sis-sy
daf-fod-il	daf-fo-dil
dais	da-is
el-d-est	eld-est
belie	be-lie
fet-tered	fettered
cour-tyard	court-yard
nai-vete	naivete
tri-vi-al	triv-i-al
laz-i-ly	la-zi-ly
psy-cho-an-alyst	psy-cho-an-a-lyst
di-ame-ter	di-am-e-ter
ep-o-chal	ep-och-al
priss-y	pris-sy
un-lady-like	un-la-dy-like
min-is-kirt	min-i-skirt
a-ph-o-r-ism	aph-o-rism
men-swear	mens-wear
un-waver-ing	un-wa-ver-ing
cre-dul-i-ty	cre-du-li-ty
ty-pe-set-ter	type-set-ter
zer-o	ze-ro
minke	min-ke
e-lig-i-bil-i-ty	el-i-gi-bil-i-ty
budget	budg-et
hockey	hock-ey
net-work-ing	networking
mis-beg-ot-ten	mis-be-got-ten
cor-duroy	cor-du-roy
a-sym-metry	a-sym-me-try
li-o-ness	li-on-ess
piv-o-tal	piv-ot-al
legume	leg-ume
coi-tus	co-i-tus
Words with errors: 1245
Words with incorrect number of syllables: 676
Total evluated: 6500
Perfect accuracy: 0.81
Number of syllables accuracy: 0.90
Average Levenshtein Distance(across incorrect words): 1.16
