Attempt	Real
par-i-ah	pa-ri-ah
trust-ed	trusted
ine-scap-a-bly	in-es-cap-a-bly
dul-lard	dull-ard
cas-u-is-try	cas-u-ist-ry
me-t-al-work	met-al-work
ev-er-y-day	eve-ry-day
li-ber-ty	lib-er-ty
phy-s-i-o-ther-a-py	phys-i-o-ther-a-py
eth-er	e-ther
coin-ci-dent	co-in-ci-dent
ci-ty-scape	cit-y-scape
fu-n-er-al	fu-ner-al
wor-m-y	worm-y
un-varnished	un-var-nished
un-du-lat-ing	un-du-la-ting
ban-krupt-cy	bank-rupt-cy
un-a-wakened	un-a-wak-ened
se-cond-ly	sec-ond-ly
me-chan-ist	mech-a-nist
de-fend-ing	defending
gam-bling	gam-bling
un-bek-nown	un-be-known
fo-releg	fore-leg
ar-gua-ble	ar-gu-a-ble
ni-t-ro-gen	ni-tro-gen
haph-a-zard-ly	hap-haz-ard-ly
wa-pi-ti	wap-i-ti
mul-ti-pro-cess-ing	mul-ti-proc-ess-ing
dis-yl-lab-ic	di-syl-lab-ic
i-d-i-ot-ic	id-i-ot-ic
in-tel-li-g-i-ble	in-tel-li-gi-ble
gai-l-y	gai-ly
fel-la-tio	fel-la-ti-o
me-d-al	med-al
con-su-mer-ist	con-sum-er-ist
bis-hop	bish-op
in-ter-col-le-gi-ate	in-ter-col-le-giate
po-ly-a-tom-ic	pol-y-a-tom-ic
pi-les	piles
pe-nin-su-lar	pen-in-su-lar
i-ni-tial	in-i-tial
un-pre-dic-t-a-bil-i-ty	un-pre-dict-a-bil-i-ty
shand-y	shan-dy
un-gla-mor-ous	un-glam-or-ous
wa-tershed	wa-ter-shed
darling	dar-ling
se-r-ai	se-ra-i
ly-rist	lyr-ist
stan-dard	stand-ard
neu-ro-nal	neu-ron-al
hy-ph-e-nate	hy-phen-ate
wimpy	wimp-y
re-com-pense	rec-om-pense
cha-rac-ter-ful	char-ac-ter-ful
hai-r-y	hair-y
trans-cend	tran-scend
dat-a-base	da-ta-base
un-leavened	un-leav-ened
ta-lon	tal-on
may-o-ral	may-or-al
chamo-mile	cham-o-mile
pre-sen-ta-tion-al	pres-en-ta-tion-al
ye-o-man	yeo-man
pro-p-el	pro-pel
phra-sal	phras-al
re-col-lect	rec-ol-lect
bi-shop-ric	bish-op-ric
me-gas-tar	meg-a-star
pro-per-ty	prop-er-ty
o-ver-f-ly	o-ver-fly
blame-worth-y	blame-wor-thy
as-kew	a-skew
rel-o-cate	re-lo-cate
i-ras-c-i-ble	i-ras-ci-ble
su-b-arc-tic	sub-arc-tic
eon	e-on
au-tho-ress	au-thor-ess
uned-i-fy-ing	un-ed-i-fy-ing
be-wild-er	be-wil-der
pleat-ed	pleated
trum-per-y	trump-er-y
bit-u-men	bi-tu-men
ma-t-ri-arch	ma-tri-arch
dis-sen-t-er	dis-sent-er
se-lec-tee	se-lect-ee
a-rum	ar-um
promp-ter	prompt-er
in-debted-ness	in-debt-ed-ness
un-set-tling	unsettling
wispy	wisp-y
philo-soph-i-cal	phil-o-soph-i-cal
pold-er	pol-der
ruling	rul-ing
lac-teal	lac-te-al
quiet-ness	qui-et-ness
sto-r-age	stor-age
dif-fer-ing	differing
dais	da-is
bleat-ing	bleating
re-ta-li-a-tion	re-tal-i-a-tion
in-de-f-i-nite-ly	in-def-i-nite-ly
de-mo-crat	dem-o-crat
cour-tyard	court-yard
reu-ni-fy	re-u-ni-fy
bi-o-de-grada-ble	bi-o-de-grad-a-ble
de-s-ig-na-tion	des-ig-na-tion
slal-om	sla-lom
nuclear	nu-cle-ar
per-se-c-u-tor	per-se-cu-tor
strug-gling	struggling
cus-to-mar-y	cus-tom-ar-y
bys-tand-er	by-stand-er
laz-y-bo-nes	la-zy-bones
rutt-ed	rut-ted
playth-ing	play-thing
her-i-ta-bil-i-ty	her-it-a-bil-i-ty
o-var-y	o-va-ry
dan-c-er	danc-er
me-g-a-l-o-ma-ni-a	meg-a-lo-ma-ni-a
so-l-u-bil-i-ty	sol-u-bil-i-ty
cog-no-scen-ti	co-gno-scen-ti
pe-o-ple	peo-ple
gramo-phone	gram-o-phone
voy-e-ur	vo-yeur
res-tau-r-ant	res-tau-rant
heat-wave	heatwave
leng-thy	length-y
e-s-prit	es-prit
pan-das	pan-das
cor-ny	corn-y
late-co-m-er	late-com-er
un-ne-ces-sar-i-ly	un-nec-es-sar-i-ly
e-so-ter-ic	es-o-ter-ic
brunette	bru-nette
lap-el	la-pel
sul-ta-na	sul-tan-a
dis-o-ri-ent-ed	disoriented
gi-v-en	giv-en
tril-o-bite	tri-lo-bite
chan-ge-o-v-er	change-o-ver
gos-si-py	gos-sip-y
fuch-si-a	fuch-sia
so-l-e-cism	sol-e-cism
lemming	lem-ming
wear-i-ly	wea-ri-ly
repre-sen-ta-tion	rep-re-sen-ta-tion
pro-phet	proph-et
u-n-i-den-ti-fi-a-ble	un-i-den-ti-fi-a-ble
proo-fread-er	proof-read-er
pre-cip-ice	prec-i-pice
ar-bore-tum	ar-bo-re-tum
ces-spit	cess-pit
claus-tro-phob-ic	claus-tro-pho-bic
leer-ing	leering
ci-d-er	ci-der
post-mo-dern	post-mod-ern
he-roi-cal-ly	he-ro-i-cal-ly
ir-re-du-c-i-ble	ir-re-duc-i-ble
se-n-a-tor	sen-a-tor
i-co-n-o-clasm	i-con-o-clasm
un-da-maged	un-dam-aged
e-s-trange-ment	es-trange-ment
flinch-ing	flin-ching
in-de-feas-i-ble	in-de-fea-si-ble
clim-ber	climb-er
turg-id	tur-gid
spi-got	spig-ot
pre-vious-ly	pre-vi-ous-ly
re-sis-tance	re-sist-ance
coa-l-es-cence	co-a-les-cence
tur-nar-ound	turn-a-round
sa-fa-r-i	sa-fa-ri
dis-cre-pan-cy	dis-crep-an-cy
bey-ond	be-yond
ti-bi-a	tib-i-a
stran-gled	strangled
di-plom-a-cy	di-plo-ma-cy
ka-leid-o-scop-ic	ka-lei-do-scop-ic
pi-car-esque	pic-a-resque
en-riched	enriched
wherewi-thal	where-with-al
be-devil	be-dev-il
so-n-ar	so-nar
bunk-er	bun-ker
fro-lic-some	frol-ic-some
chal-len-ger	chal-leng-er
in-con-ve-ni-ent	in-con-ven-ient
ragged	rag-ged
in-her-i-t-a-ble	in-her-it-a-ble
se-ron-e-g-a-tive	se-ro-neg-a-tive
tun-ic	tu-nic
de-cor-a-tive	dec-o-ra-tive
eas-tern-most	east-ern-most
vi-t-ri-ol-ic	vit-ri-ol-ic
raven-ing	rav-en-ing
tribe-speo-ple	tribes-peo-ple
si-mile	sim-i-le
un-an-i-mous	u-nan-i-mous
bro-ch-ure	bro-chure
so-loist	so-lo-ist
an-tler	ant-ler
fren-z-y	fren-zy
tran-s-duc-er	trans-duc-er
cham-pion	cham-pi-on
ar-chan-gel	arch-an-gel
ven-tu-re-some	ven-ture-some
tel-e-ph-o-ny	te-leph-o-ny
prese-lect	pre-se-lect
nonex-is-tence	non-ex-ist-ence
con-temp-ti-ble	con-tempt-i-ble
au-tar-ch-y	au-tar-chy
i-n-iq-ui-tous	in-iq-ui-tous
qui-n-ine	qui-nine
cris-is	cri-sis
laches	lach-es
mis-chiev-ous-ly	mis-chie-vous-ly
ban-k-rupt	bank-rupt
blasphe-mous	blas-phe-mous
cu-tout	cut-out
mil-i-eu	mi-lieu
elon-gat-ed	e-lon-gat-ed
in-gra-tiat-ing	in-gra-ti-at-ing
vi-gil	vig-il
spin-nak-er	spin-na-ker
quo-ti-ent	quo-tient
chinois-e-r-ie	chi-noi-se-rie
sat-is-fac-tor-i-ly	sat-is-fac-to-ri-ly
pe-t-rel	pet-rel
mo-le-cule	mol-e-cule
guil-t-y	guilt-y
fe-m-ur	fe-mur
bulg-ing	bulging
re-sili-ence	re-sil-ience
bar-bit-u-rate	bar-bi-tu-rate
trust-wor-th-y	trust-wor-thy
spin-al	spi-nal
perme-a-ble	per-me-a-ble
ha-ber-dash-er-y	hab-er-dash-er-y
pur-port-ed	purported
dea-f-en	deaf-en
whisker	whisk-er
de-signed-ly	de-sign-ed-ly
cul-tu-ral	cul-tur-al
arch-dea-c-on-ry	arch-dea-con-ry
e-ven-ing	eve-ning
in-vert-ed	inverted
per-chl-o-rate	per-chlo-rate
su-per-com-puter	su-per-com-put-er
fo-re-ign-er	for-eign-er
do-pey	dope-y
ca-v-a-li-er	cav-a-lier
cloist-er	clois-ter
her-me-neut-ic	her-me-neu-tic
ca-thode	cath-ode
erupt	e-rupt
de-reg-u-la-tion	de-reg-u-lation
cap-a-bly	ca-pa-bly
in-fir-m-i-ty	in-fir-mi-ty
bra-dawl	brad-awl
dig-i-t-a-l-is	dig-i-tal-is
hero	he-ro
ye-ti	yet-i
psyche	psy-che
han-di-ly	hand-i-ly
o-b-late	ob-late
prop-o-nent	pro-po-nent
fri-ca-tive	fric-a-tive
bag-u-ette	ba-guette
mis-nom-er	mis-no-mer
fore-fath-er	fore-fa-ther
co-ron-er	cor-o-ner
ven-tri-l-o-quy	ven-tril-o-quy
de-m-o-nol-o-gy	de-mon-ol-o-gy
bowstring	bow-string
lam-plit	lamp-lit
gon-do-li-er	gon-do-lier
vi-de-o-tape	vid-e-o-tape
brok-er	bro-ker
in-a-deq-ua-cy	in-ad-e-qua-cy
gran-ary	gra-na-ry
athe-ism	a-the-ism
jeer-ing	jeering
in-di-ges-t-i-ble	in-di-gest-i-ble
sa-cer-do-tal	sac-er-do-tal
bu-re-au	bu-reau
ren-e-go-ti-ate	re-ne-go-ti-ate
leth-al-ly	le-thal-ly
te-net	ten-et
jej-u-num	je-ju-num
weav-ing	weaving
clash-ing	clashing
at-tri-bute	at-trib-ute
ri-v-i-er-a	riv-i-er-a
coin-cide	co-in-cide
char-wo-m-an	char-wom-an
se-nior	sen-ior
earthling	earth-ling
rare-fied	rar-e-fied
ban-g-er	bang-er
pat-terned	patterned
par-li-a-men-tar-i-an	par-lia-men-tar-i-an
u-p-lift	up-lift
ges-talt	ge-stalt
be-fud-dled	befuddled
a-s-crip-tion	as-crip-tion
shor-t-age	short-age
cus-to-m-er	cus-tom-er
sol-di-er-y	sol-dier-y
yes-ter-y-ear	yes-ter-year
bal-o-ney	ba-lo-ney
val-i-d-ly	val-id-ly
in-ex-haus-t-i-ble	in-ex-haust-i-ble
ge-os-ta-tion-ar-y	ge-o-sta-tion-ar-y
ho-t-el	ho-tel
rast-er	ras-ter
re-crea-tion-al	rec-re-a-tion-al
pe-r-i-ne-um	per-i-ne-um
pea-s-ant	peas-ant
ce-met-er-y	cem-e-ter-y
an-ything	an-y-thing
por-ta-bil-i-ty	port-a-bil-i-ty
rogu-ish	ro-guish
in-kling	ink-ling
coas-tal	coast-al
co-lan-d-er	col-an-der
a-po-the-o-sis	a-poth-e-o-sis
suet	su-et
le-mon	lem-on
cus-to-mar-i-ly	cus-tom-ar-i-ly
be-d-room	bed-room
rele-vant	rel-e-vant
ex-is-tent	ex-ist-ent
ma-c-a-roon	mac-a-roon
hol-i-ness	ho-li-ness
u-prise	up-rise
chry-s-a-lis	chrys-a-lis
co-l-o-bus	col-o-bus
treat-ise	trea-tise
cine	cin-e
sacred	sa-cred
lam-plight	lamp-light
ne-verth-e-less	nev-er-the-less
hid-e-out	hide-out
dis-til-ler-y	dis-till-er-y
embed	em-bed
mi-m-ick-er	mim-ick-er
glit-zy	glitz-y
post-mo-der-nist	post-mod-ern-ist
de-cay-ing	decaying
gerund	ger-und
an-ta-go-nism	an-tag-o-nism
handed-ness	hand-ed-ness
bun-gled	bungled
stoi-cal	sto-i-cal
bo-log-na	bo-lo-gna
level-head-ed	lev-el-head-ed
vis-ion-ar-y	vi-sion-ar-y
tri-p-let	tri-plet
rese-lect	re-se-lect
u-ne-mo-tion-al	un-e-mo-tion-al
de-spot	des-pot
con-descend	con-de-scend
sa-ta-nism	sa-tan-ism
li-ber-tar-i-an	lib-er-tar-i-an
reit-er-a-tion	re-it-er-a-tion
ex-e-cu-tor	ex-ec-u-tor
so-mer-sault	som-er-sault
dam-pen	damp-en
ci-tron	cit-ron
pre-dic-t-a-bil-i-ty	pre-dict-a-bil-i-ty
melanch-o-ly	mel-an-chol-y
whomev-er	whom-ev-er
reu-ni-fi-ca-tion	re-u-ni-fi-ca-tion
pa-tois	pat-ois
pleas-an-try	pleas-ant-ry
mil-i-ta-r-is-tic	mil-i-ta-ris-tic
seg-ment-ed	seg-men-ted
i-n-ef-fi-cient	in-ef-fi-cient
dang-er	dan-ger
com-pa-nion	com-pan-ion
vip-er	vi-per
par-snip	pars-nip
jum-per	jump-er
sep-a-ratism	sep-a-ra-tism
ex-tre-m-ism	ex-trem-ism
crosstalk	cross-talk
hy-drau-l-ic	hy-drau-lic
pal-u-dal	pa-lu-dal
gooey	goo-ey
sub-si-dence	sub-sid-ence
a-wes-truck	awe-struck
in-e-quit-a-ble	in-eq-ui-ta-ble
cros-so-v-er	cross-o-ver
es-pion-age	es-pi-o-nage
rede-ploy	re-de-ploy
sol-i-cit-ing	soliciting
un-cha-r-ac-ter-is-tic	un-char-ac-ter-is-tic
wa-ter-me-lon	wa-ter-mel-on
yel-lowed	yellowed
pater	pa-ter
may-a	ma-ya
tai-l-or	tai-lor
ne-ces-sar-i-ly	nec-es-sar-i-ly
bet-wixt	be-twixt
kin-der-gart-en	kin-der-gar-ten
blasphe-my	blas-phe-my
fif-tieth	fif-ti-eth
guin-e-a	guin-ea
es-tablished	es-tab-lished
mar-ri-age-a-ble	mar-riage-a-ble
in-cura-ble	in-cur-a-ble
pa-pay-a	pa-pa-ya
so-cioe-co-nom-ic	so-ci-o-ec-o-nom-ic
pi-rat-ed	pirated
a-to-nal	a-ton-al
e-lec-to-rate	e-lec-tor-ate
re-for-ma-tion	ref-or-ma-tion
ran-i	ra-ni
reor-d-er	re-or-der
ho-oli-gan	hoo-li-gan
ves-ti-gial	ves-tig-i-al
fil-i-bus-t-er	fil-i-bus-ter
in-ter-ci-ty	in-ter-cit-y
ro-man-cer	ro-manc-er
open-er	o-pen-er
ap-pa-r-ent-ly	ap-par-ent-ly
reca-pit-u-late	re-ca-pit-u-late
gi-antism	gi-ant-ism
co-vet	cov-et
do-m-i-no	dom-i-no
u-n-e-quiv-o-cal	un-e-quiv-o-cal
au-to-ma-ton	au-tom-a-ton
ar-sen-ic	ar-se-nic
an-ni-ver-sary	an-ni-ver-sa-ry
ta-pi-o-ca	tap-i-o-ca
her-bal	herb-al
por-thole	port-hole
un-linked	unlinked
devas-tat-ing-ly	dev-as-tat-ing-ly
cryp-ta-na-lyst	crypt-an-a-lyst
per-so-nal-ly	per-son-al-ly
freew-heel-ing	free-wheel-ing
du-gout	dug-out
mus-ic	mu-sic
cog-nac	co-gnac
strid-ent	stri-dent
mir-ror-ing	mirroring
hy-drome-chan-ics	hy-dro-me-chan-ics
com-plain-ing	complaining
groom-ing	grooming
co-ter-ie	co-te-rie
ac-cep-ta-ble	ac-cept-a-ble
lad-y-ship	la-dy-ship
bes-tiar-y	bes-ti-ar-y
re-gis-tra-tion	reg-is-tra-tion
sovere-ign	sov-er-eign
hard-y	har-dy
smoth-ered	smothered
pa-na-cea	pan-a-ce-a
glori-fied	glo-ri-fied
nestling	nest-ling
pho-n-o-log-i-cal	pho-no-log-i-cal
crin-k-led	crinkled
an-nui-ty	an-nu-i-ty
sine-wy	sin-ew-y
un-der-priv-ileged	un-der-priv-i-leged
prose-cu-tion	pros-e-cu-tion
culp-a-ble	cul-pa-ble
be-longings	be-long-ings
i-s-o-ton-ic	i-so-ton-ic
lack-a-dais-i-cal	lack-a-dai-si-cal
reu-nion	re-un-ion
wea-pon	weap-on
in-ter-ro-ga-tive	in-ter-rog-a-tive
ar-m-hole	arm-hole
de-gauss-ing	degaussing
ste-plad-der	step-lad-der
her-e-u-pon	here-up-on
bes-tir	be-stir
el-evat-ed	el-e-vat-ed
de-sic-ca-tor	des-ic-ca-tor
en-cy-cli-cal	en-cyc-li-cal
star-k-ly	stark-ly
frow-ard	fro-ward
e-co-n-o-met-rics	e-con-o-met-rics
tawny	taw-ny
charac-ter-is-ti-cal-ly	char-ac-ter-is-ti-cal-ly
whe-re-in	where-in
op-a-les-cent	o-pal-es-cent
thum-bnail	thumb-nail
der-ail-ment	de-rail-ment
kis-ser	kiss-er
clav-i-ch-ord	clav-i-chord
un-di-plo-mat-ic	un-dip-lo-mat-ic
il-li-quid	il-liq-uid
va-l-ance	val-ance
broad-cas-t-er	broad-cast-er
myope	my-ope
yo-k-el	yo-kel
clever-ness	clev-er-ness
de-p-re-da-tion	dep-re-da-tion
read-mis-sion	re-ad-mis-sion
ro-s-a-r-y	ro-sa-ry
fo-re-clo-sure	fore-clo-sure
rea-wak-en	re-a-wak-en
en-tour-age	en-tou-rage
here-sy	her-e-sy
ex-ul-tant	ex-ult-ant
un-ob-ser-vant	un-ob-serv-ant
requi-si-tion	req-ui-si-tion
til-l-er	till-er
ar-d-u-ous	ar-du-ous
ant-werp	antwerp
vil-lai-ny	vil-lain-y
cu-nei-form	cu-ne-i-form
cle-ment	clem-ent
se-quen-c-er	se-quenc-er
a-ba-cus	ab-a-cus
con-duct-ed	conducted
bi-got-ed	big-ot-ed
brazen-ly	bra-zen-ly
si-m-ul-ta-ne-ous	si-mul-ta-ne-ous
coursing	cours-ing
pro-b-o-scis	pro-bos-cis
be-r-ate	be-rate
nones-sen-tial	non-es-sen-tial
i-d-i-om	id-i-om
ev-er-y	eve-ry
un-fet-tered	unfettered
out-si-d-er	out-sid-er
py-roly-sis	py-rol-y-sis
junk-er	jun-ker
sa-t-in	sat-in
pro-c-la-ma-tion	proc-la-ma-tion
foun-dry	found-ry
in-trau-ter-ine	in-tra-u-ter-ine
pon-ti-f-i-cal	pon-tif-i-cal
fa-mine	fam-ine
su-per-her-o	su-per-he-ro
stam-mer-ing	stammering
ter-tiar-y	ter-ti-ar-y
bu-y-out	buy-out
ge-o-mag-net-i-cal-ly	ge-o-mag-ne-ti-cal-ly
bould-er	boul-der
ool-o-gy	o-ol-o-gy
ar-chene-my	arch-en-e-my
maj-o-rette	ma-jor-ette
dei-ty	de-i-ty
gla-ci-er	gla-cier
tradespe-o-ple	trades-peo-ple
li-ber-o	li-be-ro
un-prec-edent-ed	un-prec-e-dent-ed
bi-nar-y	bi-na-ry
per-so-nal-i-ty	per-son-al-i-ty
ra-con-teur	rac-on-teur
starl-ing	star-ling
mes-sy	mess-y
funding	fund-ing
as-tride	a-stride
busk-ing	busking
e-v-er-y-where	eve-ry-where
or-bi-ter	or-bit-er
ar-chip-e-l-a-go	ar-chi-pel-a-go
waver-ing	wavering
cafe-te-ri-a	caf-e-te-ri-a
com-me-mor-a-tive	com-mem-o-ra-tive
strang-er	stran-ger
hon-esty	hon-es-ty
un-de-m-o-crat-ic	un-dem-o-crat-ic
as-tro-no-mer	as-tron-o-mer
fi-nis	fin-is
vel-o-drome	ve-lo-drome
louis	lou-is
veget-a-tive	veg-e-ta-tive
cru-sa-der	cru-sad-er
thirt-y	thir-ty
pesk-y	pes-ky
van-il-la	va-nil-la
ineffa-ble	in-ef-fa-ble
pa-late	pal-ate
ex-tra-g-a-lac-tic	ex-tra-ga-lac-tic
mau-l-er	maul-er
ta-vern	tav-ern
re-sis-tant	re-sist-ant
ma-cro	mac-ro
moie-ty	moi-e-ty
stapes	sta-pes
re-tiree	re-tir-ee
need-le-work	nee-dle-work
po-lit-ic	pol-i-tic
eq-ua-nim-i-ty	e-qua-nim-i-ty
scam-per	scamp-er
cav-er-nous	cav-ern-ous
ma-n-i-ac	ma-ni-ac
od-di-ty	odd-i-ty
u-pon	up-on
e-v-en	e-ven
bee-fy	beef-y
il-li-c-it	il-lic-it
vil-la-ger	vil-lag-er
foundling	found-ling
un-sel-l-a-ble	un-sell-a-ble
mo-nochro-mat-ic	mon-o-chro-mat-ic
tri-p-o-li	trip-o-li
e-ner-gy	en-er-gy
theist	the-ist
quiv-er-ing	quivering
vehe-mence	ve-he-mence
pro-duct	prod-uct
courte-sy	cour-te-sy
dis-play-a-ble	displayable
per-i-pher-y	pe-riph-er-y
dyad	dy-ad
pul-lo-v-er	pull-o-ver
se-den-ta-ry	sed-en-tar-y
fa-thom	fath-om
so-lid	sol-id
moorhen	moor-hen
a-symp-tote	as-ymp-tote
troubling	trou-bling
homi-n-id	hom-i-nid
em-bo-som	em-bos-om
doom-sday	dooms-day
de-cade	dec-ade
lad-y-bird	la-dy-bird
hast-en	has-ten
sa-tel-lite	sat-el-lite
rum-pled	rumpled
re-port-ed	reported
pos-tal	post-al
de-con-struc-tive	deconstructive
han-do-v-er	hand-o-ver
prof-i-teer-ing	profiteering
bal-ler-i-na	bal-le-ri-na
as-su-r-ance	as-sur-ance
pur-s-er	purs-er
ka-rate	ka-ra-te
dis-hon-esty	dis-hon-es-ty
espy	es-py
for-th-right	forth-right
mogul	mo-gul
con-demned	condemned
maiso-nette	mai-son-ette
gir-der	gird-er
trib-un-al	tri-bu-nal
rat-tles-nake	rat-tle-snake
u-p-riv-er	up-riv-er
stal-ag-mite	sta-lag-mite
in-hos-pi-t-a-ble	in-hos-pi-ta-ble
ex-ci-t-a-ble	ex-cit-a-ble
hi-er-ar-ch-y	hi-er-ar-chy
marshland	marsh-land
rese-lect-ed	re-se-lected
rack-e-teer-ing	rack-et-eer-ing
gur-gling	gurgling
fo-rest-er	for-est-er
se-con-dar-y	sec-ond-ar-y
temp-tress	tempt-ress
bol-stered	bolstered
vehe-ment	ve-he-ment
viz-i-er	vi-zier
coo-lant	cool-ant
mar-gi-nal	mar-gin-al
pilf-er	pil-fer
e-quit-a-bly	eq-ui-ta-bly
bewitch-ing	bewitching
pon-ti-f-i-cate	pon-tif-i-cate
trapeze	tra-peze
sac-cha-r-in	sac-cha-rin
ex-hila-rat-ing	ex-hil-a-rat-ing
tele-vised	televised
til-lage	till-age
sup-por-tive	sup-port-ive
stor-y-line	sto-ry-line
pho-to-vol-taic	pho-to-vol-ta-ic
snoop-ing	snooping
reab-sorb	re-ab-sorb
ed-gy	edg-y
in-frared	in-fra-red
smold-er	smol-der
pi-vot	piv-ot
pe-k-an	pek-an
drap-er-y	dra-per-y
leisure-wear	lei-sure-wear
cle-men-cy	clem-en-cy
in-qui-ry	in-quir-y
fat-a-lis-tic	fa-tal-is-tic
hoth-ouse	hot-house
koo-ka-bur-ra	kook-a-bur-ra
u-ni-for-mi-ty	u-ni-form-i-ty
com-plais-ant	com-plai-sant
ine-scap-a-ble	in-es-cap-a-ble
a-v-id	av-id
cur-vi-li-n-e-ar	cur-vi-lin-e-ar
han-gar	hang-ar
prepared-ness	pre-par-ed-ness
har-an-gue	ha-rangue
a-sh-y	ash-y
prospect	pros-pect
sa-cris-ty	sac-ris-ty
con-cussed	concussed
vine-gar	vin-e-gar
erup-tive	e-rup-tive
ne-phew	neph-ew
drows-y	drow-sy
nur-ser-y-men	nurs-er-y-men
gla-mour	glam-our
e-po-chal	ep-och-al
snift-er	snif-ter
sil-vered	silvered
be-loved	be-lov-ed
as-sai-lant	as-sail-ant
boule-vard	boul-e-vard
moun-tai-n-e-er	moun-tain-eer
co-vet-ed	coveted
strat-o-spher-i-cal-ly	stratospherically
em-broid-er-y	em-broi-der-y
de-bo-nair	deb-o-nair
wa-f-er	wa-fer
grinding	grind-ing
con-toured	contoured
cor-re-spon-d-ent	cor-re-spond-ent
scan-ti-ly	scant-i-ly
de-r-i-va-tive	de-riv-a-tive
boast-ing	boas-ting
know-ledge-a-ble	knowl-edge-a-ble
hu-ma-noid	hu-man-oid
an-th-er	an-ther
cross-bo-nes	cross-bones
cutler	cut-ler
hos-t-ess	host-ess
cli-to-ral	clit-o-ral
tu-me-scent	tu-mes-cent
u-nu-su-al	un-u-su-al
he-reinaf-t-er	here-in-af-ter
re-no-va-tion	ren-o-va-tion
de-ter-mi-nis-tic	de-ter-min-is-tic
for-ce-ful	force-ful
bu-re-au-crat-ic	bu-reau-crat-ic
ma-ke-o-v-er	make-o-ver
scler-o-sis	scle-ro-sis
sniff-ing	sniffing
in-ex-or-a-bly	in-ex-o-ra-bly
ma-keup	make-up
front-ed	fronted
o-live	ol-ive
pa-r-a-bo-la	pa-rab-o-la
oi-ly	oil-y
pread-o-les-cent	pre-ad-o-les-cent
gra-d-i-ent	gra-di-ent
mis-typ-ings	mis-ty-pings
warthog	wart-hog
im-port-ed	imported
ki-n-et-ics	ki-net-ics
re-ar-guard	rear-guard
hair-styl-ing	hairstyling
pen-et-ra-ble	pen-e-tra-ble
me-nu	men-u
nob-o-dy	no-bod-y
trans-pa-r-en-cy	trans-par-en-cy
dog-sbod-y	dogs-bod-y
dis-tri-b-u-tor	dis-trib-u-tor
lea-flet	leaf-let
cre-dit-wor-th-i-ness	cred-it-wor-thi-ness
tran-slit-er-ate	trans-lit-er-ate
sub-scri-ber	sub-scrib-er
haz-y	ha-zy
sim-per-ing	simpering
un-fa-mi-l-i-ar	un-fa-mil-iar
pap-a-cy	pa-pa-cy
so-l-i-cit	so-lic-it
frees-tyle	free-style
un-mis-sa-ble	un-miss-a-ble
co-y-ote	coy-o-te
the-re-in	there-in
palp-a-bly	pal-pa-bly
diphthong	diph-thong
cutting	cut-ting
pho-tore-cep-tor	pho-to-re-cep-tor
vo-ca-tive	voc-a-tive
meander	me-an-der
strin-g-y	string-y
sush-i	su-shi
pa-ge-an-try	pag-eant-ry
cli-to-ris	clit-o-ris
ci-trus	cit-rus
buck-min-ster-ful-ler-e-ne	buck-min-ster-ful-ler-ene
su-per-int-end	su-per-in-tend
ter-ro-r-ist	ter-ror-ist
ci-ph-er	ci-pher
palp-a-ble	pal-pa-ble
ket-chup	ketch-up
crotch-e-ty	crotch-et-y
bug-gered	buggered
ci-ta-del	cit-a-del
i-g-loo	ig-loo
psy-cho-kin-e-sis	psy-cho-ki-ne-sis
lam-plight-er	lamp-light-er
batten-ing	bat-ten-ing
no-v-el	nov-el
teas-poon	tea-spoon
ap-palling-ly	ap-pall-ing-ly
pothole	pot-hole
ha-giog-ra-phy	hag-i-og-ra-phy
haz-el	ha-zel
le-prous	lep-rous
lin-kup	link-up
ele-ment	el-e-ment
candles-tick	can-dle-stick
ta-lent	tal-ent
com-ber	comb-er
cre-scent	cres-cent
as-cen-dan-cy	as-cend-an-cy
strid-ent-ly	stri-dent-ly
suf-frag-ist	suf-fra-gist
subu-nit	sub-u-nit
un-pa-la-t-a-ble	un-pal-at-a-ble
car-ous-el	car-ou-sel
hy-dro-phob-ic	hy-dro-pho-bic
a-pho-r-ism	aph-o-rism
re-crea-tion	rec-re-a-tion
hear-tache	heart-ache
lin-ge-r-ie	lin-ge-rie
col-la-bor-a-tive	col-lab-o-ra-tive
un-sol-i-cit-ed	un-so-lic-it-ed
pub-ic	pu-bic
hor-ser-ad-ish	horse-rad-ish
un-wea-r-ied	un-wea-ried
in-fe-r-i-or	in-fe-ri-or
cathar-sis	ca-thar-sis
li-ber-tar-i-an-ism	lib-er-tar-i-an-ism
cas-toff	cast-off
pen-i-ten-tiar-y	pen-i-ten-tia-ry
oa-sis	o-a-sis
sy-nod	syn-od
harp-si-ch-ord	harp-si-chord
re-im-ple-ment-ed	reimplemented
breast-feed	breastfeed
e-nact	en-act
flounder	floun-der
fal-len	fall-en
phy-s-i-og-no-my	phys-i-og-no-my
pres-tid-ig-i-ta-tion	pres-ti-dig-i-ta-tion
sche-dule	sched-ule
re-qui-site	req-ui-site
ap-o-lit-i-cal	a-po-lit-i-cal
cos-tar	co-star
im-pre-sar-i-o	im-pre-sa-ri-o
spi-rit-u-al-ism	spir-it-u-al-ism
fus-i-ble	fu-si-ble
tu-tel-age	tu-te-lage
con-ser-va-tive	con-serv-a-tive
smelt-ing	smelting
laz-y	la-zy
can-di-d-ly	can-did-ly
i-sosce-les	i-sos-ce-les
zool-o-gist	zo-ol-o-gist
dis-e-qui-l-i-bri-um	dis-e-qui-lib-ri-um
ho-n-our	ho-nour
de-duc-t-i-ble	de-duct-i-ble
buf-f-er	buff-er
ruf-fian	ruf-fi-an
co-met	com-et
philan-thro-py	phi-lan-thro-py
qua-drat-ic	quad-rat-ic
freestand-ing	free-stand-ing
whee-l-ie	wheel-ie
pear-ly	pearl-y
cor-re-spon-dence	cor-re-spond-ence
fool-hardy	fool-har-dy
re-per-to-ire	rep-er-toire
hun-g-ri-ly	hun-gri-ly
sau-ce-pan	sauce-pan
flood-ing	flooding
ru-le-book	rule-book
trackbed	track-bed
vi-de-o-taped	videotaped
steal-th-i-ly	stealth-i-ly
len-d-er	lend-er
mis-ma-nage-ment	mis-man-age-ment
le-gend	leg-end
i-s-o-met-ric	i-so-met-ric
de-pen-d-en-cy	de-pend-en-cy
pe-ri-as-tron	per-i-as-tron
brand-ed	bran-ded
togeth-er	to-geth-er
de-nim	den-im
brok-er-age	bro-ker-age
ther-mos-tat	ther-mo-stat
synon-y-mous	syn-on-y-mous
con-sul-tan-cy	con-sult-an-cy
fa-cul-ty	fac-ul-ty
ther-a-peut-ic	ther-a-peu-tic
bet-ween	be-tween
in-ter-mar-ri-age	in-ter-mar-riage
pa-ro-chial-ism	pa-ro-chi-al-ism
pro-bab-i-lis-tic	prob-a-bi-lis-tic
re-vi-val	re-viv-al
cat-er	ca-ter
con-trast-ing	contrasting
tract-a-ble	trac-ta-ble
de-scant	des-cant
rel-o-ca-tion	re-lo-ca-tion
plac-a-to-ry	pla-ca-to-ry
flo-r-ist	flo-rist
brack-et-ed	bracketed
ri-v-al	ri-val
darkened	dar-kened
pre-late	prel-ate
buz-zing	buzzing
brand-ish	bran-dish
phos-phore-scence	phos-pho-res-cence
gas-troin-tes-ti-nal	gas-tro-in-tes-ti-nal
dis-in-fec-tant	dis-in-fect-ant
i-m-ag-er-y	im-age-ry
parkland	park-land
mer-cur-ic	mer-cu-ric
lo-goff	log-off
god-for-sa-k-en	god-for-sak-en
un-cer-e-mo-nious-ly	un-cer-e-mo-ni-ous-ly
ca-rat	car-at
e-vildo-er	e-vil-do-er
blood-thir-sty	blood-thirst-y
phon-o-graph	pho-no-graph
jagged	jag-ged
fluid	flu-id
in-ter-nuclear	in-ter-nu-cle-ar
preschool	pre-school
mo-dest	mod-est
a-r-is-toc-ra-cy	ar-is-toc-ra-cy
cursed	curs-ed
pro-ject-ing	projecting
im-per-cep-t-i-ble	im-per-cep-ti-ble
chi-co-ry	chic-o-ry
pi-vo-tal	piv-ot-al
phooey	phoo-ey
pro-pi-on-ate	pro-pi-o-nate
eu-cal-yp-tus	eu-ca-lyp-tus
ma-n-ure	ma-nure
quick-silv-er	quick-sil-ver
al-tog-e-th-er	al-to-geth-er
re-solvent	re-sol-vent
han-di-craft	hand-i-craft
un-fast-en	un-fas-ten
mot-i-va-tor	mo-ti-va-tor
bom-bshell	bomb-shell
treat-y	trea-ty
grav-y	gra-vy
pol-y-prop-y-lene	pol-y-pro-pyl-ene
ca-r-e-er-ist	ca-reer-ist
gib-ber-ing	gibbering
trans-pa-r-ent	trans-par-ent
pot-a-ble	po-ta-ble
loo-k-out	look-out
re-fuge	ref-uge
pu-tre-scent	pu-tres-cent
mo-d-ern	mod-ern
pael-la	pa-el-la
an-noun-c-er	an-nounc-er
gu-nite	gun-ite
par-sley	pars-ley
tre-spass-er	tres-pass-er
de-m-o-crat-i-cal-ly	dem-o-crat-i-cal-ly
de-clama-to-ry	de-clam-a-to-ry
cash-i-er	cash-ier
re-sult-ing	resulting
fev-er-ish	fe-ver-ish
ris-ot-to	ri-sot-to
bej-ew-el	be-jew-el
lag-er	la-ger
tribune	trib-une
in-vig-o-rate	in-vig-or-ate
mag-ni-fi-cence	mag-nif-i-cence
tur-bo-ch-arger	tur-bo-charg-er
them-sel-ves	them-selves
ra-ch-is	ra-chis
bi-w-eek-ly	bi-week-ly
nonex-is-tent	non-ex-ist-ent
sen-hor	se-nhor
blunder	blun-der
ex-eg-e-sis	ex-e-ge-sis
seagull	sea-gull
polk-a	pol-ka
ka-leid-o-scope	ka-lei-do-scope
de-mo-lish	de-mol-ish
re-fores-ta-tion	re-for-est-a-tion
di-p-lo-mat-ic	dip-lo-mat-ic
ty-ran-ny	tyr-an-ny
mon-ar-chi-cal	mo-nar-chi-cal
roun-da-bout	round-a-bout
par-al-lel-e-piped	par-al-lel-e-pi-ped
ex-por-ta-bil-i-ty	ex-por-ta-bi-li-ty
fal-lout	fall-out
nau-seat-ing	nau-se-at-ing
se-ven-teenth	sev-en-teenth
silv-er	sil-ver
phy-loge-net-ic	phy-lo-ge-net-ic
bur-nished	burnished
sui-ci-dal	su-i-cid-al
jaz-zy	jazz-y
tren-chant-ly	trench-ant-ly
de-caf-fei-nate	de-caf-fein-ate
pres-byt-er-y	pres-by-ter-y
lisp-ing	lis-ping
ta-bles-poon	ta-ble-spoon
ge-n-uine-ly	gen-u-ine-ly
por-t-er	por-ter
cap-i-ta-l-is-tic	cap-i-tal-is-tic
dis-puta-ble	dis-put-a-ble
per-i	pe-ri
di-s-o-bey	dis-o-bey
doc-trinal	doc-tri-nal
ge-la-tin	gel-a-tin
en-thralling	en-thral-ling
mar-ke-teer	mar-ket-eer
co-p-y-ist	cop-y-ist
prob-i-ty	pro-bi-ty
deafen-ing	deaf-en-ing
dis-ad-vant-aged	dis-ad-van-taged
paean	pae-an
cir-cling	circling
blessed	bless-ed
per-u-sal	pe-rus-al
braz-en	bra-zen
arches	arch-es
coast-ing	coasting
ri-d-ic-u-lous	ri-dic-u-lous
cam-per	camp-er
van-t-age	van-tage
die-s-el	die-sel
vi-s-ion	vi-sion
pa-r-a-bo-loid	pa-rab-o-loid
veget-a-ble	veg-e-ta-ble
u-s-ur-per	u-surp-er
e-clec-tic	ec-lec-tic
pon-y-tail	po-ny-tail
bab-y-sit-ter	ba-by-sit-ter
ga-som-e-ter	gas-om-e-ter
lo-zenge	loz-enge
pla-card	plac-ard
in-cor-rup-ti-ble	in-cor-rupt-i-ble
pap-ist	pa-pist
wrin-kled	wrinkled
dis-courte-sy	dis-cour-te-sy
fuz-zy	fuzz-y
youngish	young-ish
cuc-k-oo	cuck-oo
win-der	wind-er
ju-nior	jun-ior
va-l-en-tine	val-en-tine
pro-mis-cu-i-ty	prom-is-cu-i-ty
so-ci-a-ble	so-cia-ble
sa-b-ra	sa-bra
de-co	dec-o
gha-na	ghana
wi-geon	wig-eon
sinu-soid	si-nus-oid
re-lish	rel-ish
hy-a-c-inth	hy-a-cinth
car-ci-no-gen-e-sis	car-cin-o-gen-e-sis
ro-sy	ros-y
pus-sy-cat	pussycat
tren-chant	trench-ant
de-li	del-i
hi-e-r-arch	hi-er-arch
bis-t-a-ble	bi-sta-ble
be-v-el	bev-el
bon-dage	bond-age
sea-l-ant	seal-ant
de-ca-p-od	dec-a-pod
stu-pen-d-ous	stu-pen-dous
e-tha-nol	eth-a-nol
both-ered	bothered
sa-les-man-ship	sales-man-ship
pos-top-er-a-tive	post-op-er-a-tive
boun-t-y	boun-ty
ren-ewed	renewed
no-nen-ti-ty	non-en-ti-ty
transverse	trans-verse
graphite	graph-ite
tur-f-y	turf-y
cramming	cram-ming
i-ride-scent	ir-i-des-cent
dem-er-it	de-mer-it
guit-ar-ist	gui-tar-ist
trea-sure	treas-ure
wav-er	wa-ver
nor-th-ern	north-ern
dol-o-mite	do-lo-mite
gun-s-mith	gun-smith
sa-l-i-va	sa-li-va
ex-er-ci-ser	ex-er-cis-er
ex-a-cer-ba-tion	ex-ac-er-ba-tion
as-cen-dant	as-cend-ant
fa-cet	fac-et
new-s-reel	news-reel
o-p-er-a	o-pe-ra
modesty	mod-es-ty
dis-yl-la-ble	di-syl-la-ble
be-drid-den	bed-rid-den
me-t-a-bo-lism	me-tab-o-lism
for-sa-k-en	for-sak-en
do-m-i-ne-er	dom-i-neer
val-i-ant	val-iant
rock-e-t-ry	rock-et-ry
mean-der-ing	me-an-der-ing
in-trave-nous-ly	in-tra-ve-nous-ly
pina-fore	pin-a-fore
tel-ep-a-thy	te-lep-a-thy
shar-ply	sharp-ly
gros-s-er	gross-er
el-sew-here	else-where
re-con-cile	rec-on-cile
car-bo-nyl	car-bon-yl
com-po-ser	com-pos-er
e-na-mel	e-nam-el
re-lict	rel-ict
spyg-lass	spy-glass
ma-n-i-kin	man-i-kin
dis-plea-sure	dis-pleas-ure
pes-e-ta	pe-se-ta
ste-re-o	ster-e-o
he-r-oin	her-o-in
a-voir-du-pois	av-oir-du-pois
con-cor-d-ance	con-cord-ance
plan-t-er	plant-er
prompting	prompt-ing
mis-chiev-ous	mis-chie-vous
slant-ed	slanted
a-n-y-bo-dy	an-y-bod-y
bum-per	bump-er
de-cile	dec-ile
cris-ply	crisp-ly
tre-mo-lo	trem-o-lo
in-com-men-sur-a-ble	in-com-men-su-ra-ble
tre-mor	trem-or
pharma-cy	phar-ma-cy
the-re-on	there-on
mye-lin	my-e-lin
nutmeg	nut-meg
pre-bend	preb-end
ben-der	bend-er
rene-wal	re-new-al
hor-n-y	horn-y
suf-f-er	suf-fer
fift-y	fif-ty
port-end	por-tend
wand-er	wan-der
in-ter-pre-ter	in-ter-pret-er
ca-l-um-ni-ate	ca-lum-ni-ate
worsted	wor-sted
u-phol-ster-y	up-hol-ster-y
in-eli-g-i-ble	in-el-i-gi-ble
clink-ing	clin-king
laz-i-ness	la-zi-ness
leg-a-lis-tic	le-gal-is-tic
ap-tly	apt-ly
o-ra-to-ri-o	or-a-to-ri-o
pol-y-cry-s-tal-line	pol-y-crys-tal-line
od-dly	odd-ly
en-chan-tress	en-chant-ress
vol-tage	volt-age
e-qui-l-i-bri-um	e-qui-lib-ri-um
milk-shake	milkshake
chihu-ah-u-a	chi-hua-hua
buil-dup	build-up
un-pro-mis-ing	un-prom-is-ing
a-toll	at-oll
mul-tid-i-men-sion-al	mul-ti-di-men-sion-al
an-tiair-craft	an-ti-air-craft
hau-li-er	haul-ier
u-ni-mag-i-na-tive	un-im-ag-i-na-tive
an-tedat-ing	an-te-dat-ing
flus-tered	flustered
frid-ay	fri-day
cho-r-is-ter	chor-is-ter
hoarder	hoard-er
re-l-a-tive-ly	rel-a-tive-ly
cu-b-ic	cu-bic
cleanup	clean-up
bu-ri-al	bur-i-al
pro-tect-ed	protected
im-mu-t-a-ble	im-mu-ta-ble
cur-vy	curv-y
prop-a-gand-ist	prop-a-gan-dist
pro-fliga-cy	prof-li-ga-cy
dow-ag-er	dow-a-ger
de-od-or-ant	de-o-dor-ant
me-te-o-r-ol-o-gy	me-te-or-ol-o-gy
lim-e-rick	lim-er-ick
im-mu-n-oas-say	im-mu-no-as-say
sym-me-t-ry	sym-me-try
pho-nem-ic	pho-ne-mic
lad-y-bug	la-dy-bug
i-s-o-top-ic	i-so-top-ic
ou-t-ra-geous-ly	out-ra-geous-ly
stor-y-tell-ing	sto-ry-tell-ing
han-di-capped	hand-i-capped
glis-ten-ing	gli-ste-ning
se-q-ues-tered	se-ques-tered
beav-er	bea-ver
reit-er-ate	re-it-er-ate
con-sul-tant	con-sult-ant
tick-et-ed	ticketed
di-a-bo-lism	di-ab-o-lism
re-alt-y	re-al-ty
bene-fi-cial	ben-e-fi-cial
slouch-ing	slouching
scan-da-lous	scan-dal-ous
flo-rin	flor-in
streng-then	strength-en
fly-ov-er	fly-o-ver
sus-pen-d-ers	sus-pend-ers
shogun	sho-gun
lam-bda	lamb-da
fum-bling	fumbling
Words with errors: 1217
Words with incorrect number of syllables: 634
Total evluated: 6500
Perfect accuracy: 0.81
Number of syllables accuracy: 0.90
Average Levenshtein Distance(across incorrect words): 1.19
