Attempt	Real
col-lapsi-ble	col-laps-i-ble
catholic	cath-o-lic
binoc-u-lar	bin-oc-u-lar
pen-i-ten-tiary	pen-i-ten-tia-ry
tele-ol-o-gy	tel-e-ol-o-gy
cowslip	cow-slip
er-bium	er-bi-um
obei-sance	o-bei-sance
avalanche	av-a-lanche
negate	ne-gate
clemen-cy	clem-en-cy
blud-geon	bludg-eon
queasy	quea-sy
capy-bara	cap-y-ba-ra
mossy	mos-sy
tax-able	tax-a-ble
emo-tion-al	e-mo-tion-al
orig-i-na-tion	o-rig-i-na-tion
doc-u-men-tary	doc-u-men-ta-ry
telex	tel-ex
duo	du-o
palace	pal-ace
un-avoid-able	un-a-void-a-ble
poster	post-er
in-ter-dis-ci-pli-nary	in-ter-dis-ci-pli-nar-y
prefer-ably	pref-er-a-bly
ringlet	ring-let
re-tal-ia-to-ry	re-tal-i-a-to-ry
satire	sat-ire
un-print-able	un-print-a-ble
tri-umphal	tri-um-phal
hack-able	hack-a-ble
deluxe	de-luxe
di-ar-rhea	di-ar-rhe-a
un-ac-cept-ably	un-ac-cept-a-bly
moray	mo-ray
con-tention	con-ten-tion
me-dia	me-di-a
shiny	shin-y
tu-to-r-i-al	tu-to-ri-al
shoring	shor-ing
camshaft	cam-shaft
overview	o-ver-view
spinal	spi-nal
thyris-tor	thy-ris-tor
prepo-si-tion	prep-o-si-tion
brunette	bru-nette
cred-it-wor-thy	cred-it-worth-y
froward	fro-ward
drinker	drink-er
in-elas-tic	in-e-las-tic
midlife	mid-life
ne-ma-tode	nem-a-tode
carotene	car-o-tene
rainy	rain-y
ron-dav-el	ron-da-vel
dado	da-do
mim-ic-k-er	mim-ick-er
up-lift-ed	uplifted
gleam-ing	gleaming
over-hang	o-ver-hang
sharp-en-er	shar-pen-er
dig-ni-tary	dig-ni-tar-y
vari-cose	var-i-cose
botanist	bot-a-nist
cos-set-ed	cosseted
merid-ion-al	me-rid-i-o-nal
ar-guably	ar-gu-a-bly
balus-ter	bal-us-ter
unswerv-ing	un-swerv-ing
fifty	fif-ty
tableau	tab-leau
phil-an-thropic	phil-an-throp-ic
un-reach-able	un-reach-a-ble
bedrock	bed-rock
motet	mo-tet
soli-taire	sol-i-taire
cam-era-man	cam-er-a-man
over-see	o-ver-see
sided	sid-ed
je-junum	je-ju-num
para-med-ical	par-a-med-i-cal
boa	bo-a
car-dioid	car-di-oid
tramway	tram-way
neu-ro-science	neu-ro-sci-ence
lethar-gic	le-thar-gic
goulash	gou-lash
scraper	scrap-er
id-io-path-ic	id-i-o-path-ic
tonedeaf	tone-deaf
auto	au-to
guardian	guard-i-an
sto-ry-telling	sto-ry-tell-ing
agent	a-gent
taxi-dermy	tax-i-der-my
elo-quence	el-o-quence
sala-man-der	sal-a-man-der
iso-la-tion-ism	i-so-la-tion-ism
un-avail-ing	un-a-vail-ing
ex-pi-ra-to-ry	ex-pir-a-to-ry
pedes-tri-an	pe-des-tri-an
grad-ual	grad-u-al
med-ical-ly	med-i-cal-ly
wilder-ness	wil-der-ness
de-featist	de-feat-ist
dyad	dy-ad
awash	a-wash
dis-cernible	dis-cern-i-ble
nau-sea	nau-se-a
pharaoh	phar-aoh
cedil-la	ce-dil-la
back-bencher	back-bench-er
roast-ed	roasted
physics	phys-ics
abaft	a-baft
biped	bi-ped
swindler	swin-dler
para-dox-i-cal	par-a-dox-i-cal
syco-phancy	syc-o-phan-cy
mor-phia	mor-phi-a
cleanup	clean-up
ex-i-gency	ex-i-gen-cy
ego-ma-ni-ac	e-go-ma-ni-ac
apiece	a-piece
ri-boflavin	ri-bo-fla-vin
unan-i-mous	u-nan-i-mous
geo-chem-istry	ge-o-chem-is-try
lyri-cist	lyr-i-cist
cornea	cor-ne-a
lithi-um	lith-i-um
rocky	rock-y
sub-servience	sub-ser-vi-ence
ap-praisal	ap-prais-al
supine	su-pine
mod-esty	mod-es-ty
mic-turi-tion	mic-tu-ri-tion
oph-thalmic	oph-thal-mic
stopover	stop-o-ver
com-plaisant	com-plai-sant
mendele-vi-um	men-de-le-vi-um
ma-joli-ca	ma-jol-i-ca
pati-na-tion	pat-i-na-tion
tri-adic	tri-ad-ic
over-ac-tive	o-ver-ac-tive
cara-cal	car-a-cal
drudgery	drudg-er-y
fa-nati-cism	fa-nat-i-cism
pinafore	pin-a-fore
drap-ery	dra-per-y
psy-cho-me-t-ric	psy-cho-met-ric
pho-to-volta-ic	pho-to-vol-ta-ic
pipette	pi-pette
mayfly	may-fly
obelisk	ob-e-lisk
ir-re-solv-able	ir-re-solv-a-ble
mega	meg-a
away	a-way
im-paction	im-pac-tion
aque-ous	a-que-ous
duster	dust-er
puis-sant	pu-is-sant
me-te-o-rol-o-gist	me-te-or-ol-o-gist
foolscap	fools-cap
hooky	hook-y
polygamy	po-lyg-a-my
masochist	mas-och-ist
atom	at-om
gas-troin-testi-nal	gas-tro-in-tes-ti-nal
spi-dery	spi-der-y
spinet	spin-et
re-dis-cov-ery	re-dis-cov-er-y
evoca-tive	e-voc-a-tive
over-anx-ious	o-ver-anx-ious
pur-suance	pur-su-ance
partheno-gen-e-sis	par-the-no-gen-e-sis
in-abil-i-ty	in-a-bil-i-ty
iso-la-tion	i-so-la-tion
megabyte	meg-a-byte
os-teopath	os-te-o-path
em-piri-cism	em-pir-i-cism
blitzkrieg	blitz-krieg
liken	lik-en
arranger	ar-rang-er
colosto-my	co-los-to-my
ave	a-ve
lin-gerie	lin-ge-rie
planter	plant-er
trans-porter	trans-port-er
birdie	bird-ie
ir-repara-ble	ir-rep-a-ra-ble
trencher	trench-er
para-chutist	par-a-chut-ist
sabra	sa-bra
amount	a-mount
tom-fool-ery	tom-fool-er-y
drainage	drain-age
in-ter-op-er-abil-i-ty	in-ter-op-er-a-bil-i-ty
ex-ult-ing	exulting
scary	scar-y
hy-dropho-bic	hy-dro-pho-bic
gaiter	gait-er
rel-a-tivism	rel-a-tiv-ism
lassie	las-sie
paving	pav-ing
fiendish	fiend-ish
emu	e-mu
dual	du-al
chara-banc	char-a-banc
scampi	scam-pi
joey	jo-ey
retro-fit	ret-ro-fit
mis-er-ably	mis-er-a-bly
dis-obe-di-ence	dis-o-be-di-ence
urine	u-rine
hauler	haul-er
parish	par-ish
in-sipid	in-sip-id
weasel	wea-sel
ju-ridi-cal	ju-rid-i-cal
un-ob-tain-able	un-ob-tain-a-ble
en-docrine	en-do-crine
pho-to-elec-tric	pho-to-e-lec-tric
decre-ment	dec-re-ment
tremor	trem-or
vicin-i-ty	vi-cin-i-ty
earnest	ear-nest
au-toma-ton	au-tom-a-ton
psy-cholin-guis-tics	psy-cho-lin-guis-tics
de-mount-able	de-mount-a-ble
so-cialite	so-cial-ite
wolfhound	wolf-hound
calorime-ter	cal-o-rim-e-ter
un-al-ter-able	un-al-ter-a-ble
uni-ver-si-ty	u-ni-ver-si-ty
poignant-ly	poign-ant-ly
emer-gence	e-mer-gence
alive	a-live
de-sir-able	de-sir-a-ble
scrumhalf	scrum-half
in-evitable	in-ev-i-ta-ble
oral-ly	o-ral-ly
lifestyle	life-style
any-way	an-y-way
tantrum	tan-trum
scat-tered	scattered
caprice	ca-price
yogi	yo-gi
ex-citable	ex-cit-a-ble
signet	sig-net
liqueur	li-queur
enu-mer-a-tor	e-nu-mer-a-tor
avion-ics	a-vi-on-ics
con-t-a-m-i-nant	con-tam-i-nant
gun-nery	gun-ner-y
pur-port-ed	purported
cream-ery	cream-er-y
disin-gen-u-ous	dis-in-gen-u-ous
apothe-cary	a-poth-e-car-y
dairy	dair-y
wingspan	wing-span
brew-ery	brew-er-y
proac-tive	pro-ac-tive
qua-drat-ic	quad-rat-ic
polyun-sat-u-rat-ed	pol-y-un-sat-u-rat-ed
coast-ing	coasting
reprise	re-prise
geno-type	gen-o-type
sur-viv-able	sur-viv-a-ble
en-doge-nous	en-dog-e-nous
idio-syn-crat-ic	id-i-o-syn-crat-ic
ra-dio-met-ric	ra-di-o-met-ric
turn-about	turn-a-bout
po-litesse	pol-i-tesse
un-aware	un-a-ware
econ-o-mist	e-con-o-mist
poly-mer	pol-y-mer
tri-maran	tri-ma-ran
uni-lat-er-al-ist	u-ni-lat-er-al-ist
crotch-ety	crotch-et-y
dis-tri-b-u-tion	dis-tri-bu-tion
peanut	pea-nut
un-even-ly	un-e-ven-ly
di-gester	di-gest-er
maser	ma-ser
pre-pared-ness	pre-par-ed-ness
rekin-dle	re-kin-dle
anger	an-ger
avi-a-tor	a-vi-a-tor
pur-veyance	pur-vey-ance
sil-vered	silvered
leisure	lei-sure
flotil-la	flo-til-la
reaf-firm	re-af-firm
distaff	dis-taff
in-ter-de-pen-dent	in-ter-de-pend-ent
amuse	a-muse
fleshy	flesh-y
sav-agery	sav-age-ry
lantern	lan-tern
hayloft	hay-loft
quan-tifi-ca-tion	quan-ti-fi-ca-tion
peri-na-tal	per-i-na-tal
uniden-ti-fi-able	un-i-den-ti-fi-a-ble
dis-avow	dis-a-vow
car-rion	car-ri-on
kalei-do-scop-ic	ka-lei-do-scop-ic
pri-mar-i-ly	pri-ma-ri-ly
flinty	flint-y
polo	po-lo
wrap-around	wrap-a-round
mon-e-tarism	mon-e-ta-rism
dis-ori-ent-ed	disoriented
tetchy	tetch-y
lazi-ly	la-zi-ly
garage	ga-rage
weaver	weav-er
sym-biont	sym-bi-ont
mistle-toe	mis-tle-toe
premise	prem-ise
crispy	crisp-y
curlew	cur-lew
ap-pre-cia-bly	ap-pre-ci-a-bly
sullen	sul-len
islet	is-let
sus-tain-ably	sus-tain-a-bly
monoc-u-lar	mo-noc-u-lar
im-mutable	im-mu-ta-ble
axon	ax-on
con-for-mi-ty	con-form-i-ty
utopia	u-to-pi-a
bas-ketry	bas-ket-ry
moral	mor-al
smoother	smooth-er
chevron	chev-ron
mus-ke-teer	mus-ket-eer
reap-pear	re-ap-pear
touristy	tour-ist-y
gazetteer	gaz-et-teer
bungee	bun-gee
medusa	me-du-sa
apos-tle	a-pos-tle
any-ways	an-y-ways
babysit	ba-by-sit
imag-in-ings	im-ag-in-ings
fla-gel-late	flag-el-late
ap-plic-a-bil-i-ty	ap-pli-ca-bil-i-ty
gam-bling	gam-bling
know-able	know-a-ble
in-ves-tiga-tive	in-ves-ti-ga-tive
re-arrange	re-ar-range
eleventh	e-lev-enth
eter-nal-ly	e-ter-nal-ly
dis-pos-able	dis-pos-a-ble
test-ing	testing
prodi-gious	pro-di-gious
revenant	rev-e-nant
turnover	turn-o-ver
talkie	talk-ie
semi-cir-cu-lar	sem-i-cir-cu-lar
fluffy	fluff-y
ital-ic	i-tal-ic
cus-tomer	cus-tom-er
okapi	o-ka-pi
stratos-phere	strat-o-sphere
waspish	wasp-ish
in-nocu-ous	in-noc-u-ous
gur-gling	gurgling
antler	ant-ler
eu-phemistic	eu-phe-mis-tic
re-alpoli-tik	re-al-po-li-tik
re-ceiv-able	re-ceiv-a-ble
cy-tochrome	cy-to-chrome
dullard	dull-ard
velo-drome	ve-lo-drome
cun-nilin-gus	cun-ni-lin-gus
moun-taineer	moun-tain-eer
racy	rac-y
cen-tipede	cen-ti-pede
se-r-i-al	se-ri-al
mul-tira-cial	mul-ti-ra-cial
bur-glary	bur-gla-ry
topo-graph-i-cal	top-o-graph-i-cal
urol-o-gist	u-rol-o-gist
blowup	blow-up
shandy	shan-dy
diplo-mat	dip-lo-mat
elo-quent	el-o-quent
foot-baller	foot-ball-er
trage-di-an	tra-ge-di-an
sub-unit	sub-u-nit
coro-nal	cor-o-nal
seclu-sion	se-clu-sion
megas-tar	meg-a-star
over-ture	o-ver-ture
translit-er-ate	trans-lit-er-ate
dis-com-fort-ing	discomforting
ga-mete	gam-ete
recom-mence	re-com-mence
un-bear-able	un-bear-a-ble
hand-picked	handpicked
cour-t-house	court-house
brochure	bro-chure
re-versed	reversed
cog-nizant	cog-ni-zant
gaze-bo	ga-ze-bo
brutish	brut-ish
repli-ca-tor	rep-li-ca-tor
deputy	dep-u-ty
kinswoman	kins-wom-an
fisticuffs	fist-i-cuffs
umpteenth	ump-teenth
felony	fel-o-ny
be-lit-tling	belittling
covenant	cov-e-nant
teacup	tea-cup
gaga	ga-ga
les-bian	les-bi-an
de-pend-abil-i-ty	de-pend-a-bil-i-ty
botany	bot-a-ny
per-cu-ta-neous	per-cu-ta-ne-ous
ex-oti-cism	ex-ot-i-cism
per-fectibil-i-ty	per-fect-i-bil-i-ty
over-hand	o-ver-hand
elec-tric-i-ty	e-lec-tric-i-ty
un-re-mark-able	un-re-mark-a-ble
pho-to-genic	pho-to-gen-ic
haiku	hai-ku
coral	cor-al
species	spe-cies
grassy	grass-y
un-beat-able	un-beat-a-ble
sac-risty	sac-ris-ty
re-gency	re-gen-cy
flaky	flak-y
rein-car-nate	re-in-car-nate
berserk	ber-serk
triv-ial	triv-i-al
sphyg-mo-manome-ter	sphyg-mo-ma-nom-e-ter
util-i-ty	u-til-i-ty
newsy	news-y
over-whelm	o-ver-whelm
pep-pered	peppered
amused	a-mused
clever	clev-er
patho-log-i-cal-ly	path-o-log-i-cal-ly
ergo	er-go
econ-o-my	e-con-o-my
ob-scu-ran-tist	ob-scu-rant-ist
elixir	e-lix-ir
pecan	pe-can
habi-ta-tion	hab-i-ta-tion
sym-po-sium	sym-po-si-um
elec-tion	e-lec-tion
eosin	e-o-sin
teleme-try	te-lem-e-try
edict	e-dict
fri-ary	fri-ar-y
scathing	scath-ing
flota-tion	flo-ta-tion
fla-gel-la-tion	flag-el-la-tion
un-trans-lat-able	un-trans-lat-a-ble
halon	hal-on
sticky	stick-y
elec-trol-y-sis	e-lec-trol-y-sis
prof-itabil-i-ty	prof-it-a-bil-i-ty
pub-licly	pub-lic-ly
kerosene	ker-o-sene
lurid	lu-rid
mini-bar	min-i-bar
limpet	lim-pet
ex-tend-ing	extending
puni-tive	pu-ni-tive
ego-tism	e-go-tism
dis-uni-ty	dis-u-ni-ty
usu-al-ly	u-su-al-ly
city	cit-y
un-abashed	un-a-bashed
arch-dio-cese	arch-di-o-cese
bul-letin	bul-le-tin
avian	a-vi-an
con-cil-ia-tor	con-cil-i-a-tor
con-nect-ing	con-nec-ting
le-gionary	le-gion-ar-y
minute	mi-nute
astern	a-stern
per-jury	per-ju-ry
ge-o-mag-net-i-cal-ly	ge-o-mag-ne-ti-cal-ly
un-lucky	un-luck-y
boule-vard	boul-e-vard
rephras-es	re-phra-ses
re-uni-fi-ca-tion	re-u-ni-fi-ca-tion
vine-gar	vin-e-gar
pre-dict-ed	predicted
wrestler	wres-tler
assig-na-tion	as-sig-na-tion
grainy	grain-y
ex-em-plary	ex-em-pla-ry
award	a-ward
glo-be-trot-ting	globe-trot-ting
leather	leath-er
glacia-tion	gla-ci-a-tion
cola	co-la
in-tifa-da	in-ti-fa-da
mono-graph	mon-o-graph
over-charge	o-ver-charge
slaver	slav-er
dioce-san	di-oc-e-san
aplomb	a-plomb
parabo-la	pa-rab-o-la
table-cloth	ta-ble-cloth
cor-ti-cos-teroid	cor-ti-co-ster-oid
un-alike	un-a-like
un-der-e-d-u-cat-ed	un-der-ed-u-cat-ed
mil-i-tarist	mil-i-ta-rist
augite	au-gite
botan-i-cal	bo-tan-i-cal
unim-ped-ed	un-im-ped-ed
bitmap	bit-map
record-ing	re-cord-ing
cordite	cord-ite
chronome-ter	chro-nom-e-ter
pos-i-tivist	pos-i-tiv-ist
idea	i-de-a
geo-met-ric	ge-o-met-ric
ep-ithe-li-um	ep-i-the-li-um
psy-cho-analy-sis	psy-cho-a-nal-y-sis
re-cidi-vism	re-cid-i-vism
baby	ba-by
crazy	cra-zy
dereg-u-late	de-reg-u-late
canon-ic	ca-non-ic
recre-ation-al	rec-re-a-tion-al
iden-ti-cal	i-den-ti-cal
lethal	le-thal
cack-ling	cackling
tablet	tab-let
uten-sil	u-ten-sil
echo	ech-o
mul-ti-level	mul-ti-lev-el
necro-sis	ne-cro-sis
calum-ny	cal-um-ny
break-able	break-a-ble
hip-popota-mus	hip-po-pot-a-mus
fairy	fair-y
im-pe-cu-nious	im-pe-cu-ni-ous
para-ble	par-a-ble
punch-able	punch-a-ble
uned-i-fy-ing	un-ed-i-fy-ing
trade-marked	trademarked
rur-al	ru-ral
hy-drazine	hy-dra-zine
over-dose	o-ver-dose
skew-ered	skewered
in-sou-ciant	in-sou-ci-ant
pesti-lent	pes-ti-lent
vale-dic-tion	val-e-dic-tion
scenery	scen-er-y
saga	sa-ga
emir	e-mir
rial	ri-al
lyri-cal	lyr-i-cal
com-mend-able	com-mend-a-ble
spillage	spill-age
man-darin	man-da-rin
or-biter	or-bit-er
het-ero-sex-u-al-i-ty	het-er-o-sex-u-al-i-ty
doc-tor-ing	doctoring
di-alec-tic	di-a-lec-tic
seden-tary	sed-en-tar-y
gecko	geck-o
both-ered	bothered
ini-tial-ly	in-i-tial-ly
celandine	cel-an-dine
her-aldry	her-ald-ry
tan-nery	tan-ner-y
pold-er	pol-der
gantry	gan-try
mar-riage-able	mar-riage-a-ble
cov-et-ed	coveted
hul-la-baloo	hul-la-ba-loo
bar-racu-da	bar-ra-cu-da
over-shot	o-ver-shot
turgid	tur-gid
purga-tive	pur-ga-tive
are-na	a-re-na
saucepan	sauce-pan
un-charis-mat-ic	un-char-is-mat-ic
syn-chronic-i-ty	syn-chro-nic-i-ty
clumpy	clump-y
rev-o-lu-tion-ary	rev-o-lu-tion-ar-y
sep-a-ratism	sep-a-ra-tism
takeover	take-o-ver
pouter	pout-er
in-eluctable	in-e-luc-ta-ble
breezy	breez-y
philol-o-gy	phi-lol-o-gy
podi-um	po-di-um
eques-tri-an-ism	e-ques-tri-an-ism
tithing	tith-ing
unabridged	un-a-bridged
equiv-o-ca-tion	e-quiv-o-ca-tion
amus-ing	a-mus-ing
sickbed	sick-bed
per-man-ganate	per-man-ga-nate
along-side	a-long-side
semi-fi-nal	sem-i-fi-nal
seascape	sea-scape
open-er	o-pen-er
med-icate	med-i-cate
en-dother-mic	en-do-ther-mic
radar	ra-dar
un-able	un-a-ble
piti-less	pit-i-less
un-equiv-o-cal-ly	un-e-quiv-o-cal-ly
seroneg-a-tive	se-ro-neg-a-tive
pro-ce-du-ral-ly	pro-ce-dur-al-ly
in-ter-me-di-ary	in-ter-me-di-ar-y
jan-u-ary	jan-u-ar-y
over-pro-duced	overproduced
bene-fac-tress	ben-e-fac-tress
equiv-a-lent	e-quiv-a-lent
respire	re-spire
hypochon-dria	hy-po-chon-dri-a
punc-til-ious	punc-til-i-ous
awning	awn-ing
budgeri-gar	budg-er-i-gar
en-cycli-cal	en-cyc-li-cal
duo-logue	du-o-logue
smudgy	smudg-y
preterite	pret-er-ite
meta-mor-phosed	metamorphosed
cat-tery	cat-te-ry
mega-phone	meg-a-phone
prophe-cy	proph-e-cy
ra-tio-nal	ra-tion-al
pseudo-pod	pseu-do-pod
im-pon-der-able	im-pon-der-a-ble
de-monolo-gy	de-mon-ol-o-gy
re-assem-bly	re-as-sem-bly
in-ter-change-ably	in-ter-change-a-bly
ir-re-versible	ir-re-vers-i-ble
nurs-ery-man	nurs-er-y-man
tele-vised	televised
ide-al	i-de-al
odome-ter	o-dom-e-ter
var-ie-gat-ed	var-i-e-gat-ed
re-galia	re-ga-li-a
brand-ing	branding
re-cruiter	re-cruit-er
tem-po-rary	tem-po-rar-y
spaniel	span-iel
vagabond	vag-a-bond
no-ti-fi-able	no-ti-fi-a-ble
furtive-ly	fur-tive-ly
dra-con-ian	dra-co-ni-an
elim-i-nate	e-lim-i-nate
un-ut-ter-able	un-ut-ter-a-ble
over-step	o-ver-step
trouser	trou-ser
fran-chisee	fran-chi-see
nodal	nod-al
machis-mo	ma-chis-mo
awhile	a-while
en-v-i-ron	en-vi-ron
pen-tame-ter	pen-tam-e-ter
cherub	cher-ub
un-in-ter-pretable	un-in-ter-pret-a-ble
penum-bra	pe-num-bra
deco-rum	de-co-rum
apoplexy	ap-o-plex-y
bronchial	bron-chi-al
boyfriend	boy-friend
tenure	ten-ure
busy-body	bus-y-bod-y
mid-wifery	mid-wife-ry
in-her-i-ta-ble	in-her-it-a-ble
gen-i-talia	gen-i-ta-li-a
risot-to	ri-sot-to
tho-racic	tho-rac-ic
friendlily	friend-li-ly
flashy	flash-y
per-sis-tent-ly	per-sist-ent-ly
top-sy-turvy	top-sy-tur-vy
bil-iary	bil-i-ar-y
my-opia	my-o-pi-a
tweedy	tweed-y
undis-ci-plined	un-dis-ci-plined
re-deemable	re-deem-a-ble
re-mov-able	re-mov-a-ble
en-durance	en-dur-ance
fetishist	fet-ish-ist
vivid-ly	viv-id-ly
holis-ti-cal-ly	ho-lis-ti-cal-ly
se-nior-i-ty	sen-ior-i-ty
hys-terec-to-my	hys-ter-ec-to-my
de-posi-tary	de-pos-i-tar-y
mi-cro-farad	mi-cro-far-ad
lounger	loung-er
ex-is-tence	ex-ist-ence
in-ex-tin-guish-able	in-ex-tin-guish-a-ble
ba-ro-nial	ba-ro-ni-al
naked	na-ked
hawthorn	haw-thorn
venue	ven-ue
unadul-ter-at-ed	un-a-dul-ter-at-ed
gable	ga-ble
leisured	lei-sured
relict	rel-ict
il-menite	il-men-ite
nun-nery	nun-ner-y
lik-able	lik-a-ble
daf-fodil	daf-fo-dil
tox-i-c-i-ty	tox-ic-i-ty
en-chant-i-ng	en-chant-ing
an-techam-ber	an-te-cham-ber
mega-lo-ma-ni-ac	meg-a-lo-ma-ni-ac
unre-deemed	un-re-deemed
oboe	o-boe
para-nor-mal	par-a-nor-mal
en-counter	en-coun-ter
parochial-ism	pa-ro-chi-al-ism
undis-crim-i-nat-ing	un-dis-crim-i-nat-ing
so-cioe-co-nom-ic	so-ci-o-ec-o-nom-ic
moral-i-ty	mo-ral-i-ty
metas-ta-sis	me-tas-ta-sis
sedan	se-dan
stinker	stink-er
read-able	read-a-ble
baobab	ba-o-bab
em-bell-ish	em-bel-lish
doubtless-ly	doubt-less-ly
cretinous	cre-tin-ous
aor-tic	a-or-tic
em-ployed	employed
reaper	reap-er
sleazy	slea-zy
sacra-men-tal	sac-ra-men-tal
over-crowd	o-ver-crowd
ir-re-press-ible	ir-re-press-i-ble
mi-cro-elec-tron-ics	mi-cro-e-lec-tron-ics
dereg-u-la-tion	de-reg-u-lation
mer-cu-r-ial	mer-cu-ri-al
litotes	li-to-tes
ho-mo-ge-neous	ho-mo-ge-ne-ous
undis-guised	un-dis-guised
syl-labub	syl-la-bub
masseur	mas-seur
monau-r-al	mon-au-ral
prospec-tus	pro-spec-tus
residu-um	re-sid-u-um
toga	to-ga
lamp-lighter	lamp-light-er
raider	raid-er
pa-pyrus	pa-py-rus
porta-bil-i-ty	port-a-bil-i-ty
in-signif-i-cant	in-sig-nif-i-cant
cater	ca-ter
amaze	a-maze
limp-ing	limping
mar-keter	mar-ket-er
muster	mus-ter
fold-ing	folding
ar-cana	ar-ca-na
polemi-cist	po-lem-i-cist
tenor	ten-or
quadri-lat-er-al	quad-ri-lat-er-al
poi-so-nous	poi-son-ous
mo-lasses	mo-las-ses
ined-i-ble	in-ed-i-ble
onto	on-to
bassist	bass-ist
tirade	ti-rade
ex-cus-able	ex-cus-a-ble
legate	leg-ate
ura-ni-um	u-ra-ni-um
lisp-ing	lis-ping
translu-cent	trans-lu-cent
op-er-a-tional	op-er-a-tion-al
stonework	stone-work
ge-neti-cist	ge-net-i-cist
unglam-orous	un-glam-or-ous
asep-tic	a-sep-tic
eeri-ly	ee-ri-ly
kilo-hertz	kil-o-hertz
civic	civ-ic
pearly	pearl-y
co-gency	co-gen-cy
cur-able	cur-a-ble
coda	co-da
ca-su-istry	cas-u-ist-ry
equip	e-quip
dance-able	dance-a-ble
canon-i-cal	ca-non-i-cal
chameleon	cha-me-le-on
cys-teine	cys-te-ine
payable	pay-a-ble
an-thro-pocen-tric	an-thro-po-cen-tric
golfer	golf-er
satir-ic	sa-tir-ic
killer	kil-ler
avun-cu-lar	a-vun-cu-lar
urchin	ur-chin
damsel	dam-sel
elec-tri-cian	e-lec-tri-cian
tiger-ish	ti-ger-ish
cur-tilage	cur-ti-lage
apos-to-late	a-pos-to-late
power-boat	pow-er-boat
cation	cat-i-on
around	a-round
de-viance	de-vi-ance
per-fidy	per-fi-dy
un-wary	un-war-y
sewage	sew-age
steadi-ness	stead-i-ness
com-pelling	com-pel-ling
telling	tell-ing
over-pow-er	o-ver-pow-er
de-sali-na-tion	de-sal-i-na-tion
re-vival	re-viv-al
over-drive	o-ver-drive
odor-if-er-ous	o-dor-if-er-ous
prostate	pros-tate
whomev-er	whom-ev-er
over-man-tel	o-ver-man-tel
sophist	soph-ist
mono-plane	mon-o-plane
evan-ge-lism	e-van-ge-lism
router	rout-er
ex-cep-tion-able	ex-cep-tion-a-ble
reser-va-tion	res-er-va-tion
sober-ly	so-ber-ly
stormer	storm-er
seedbed	seed-bed
xenon	xe-non
rea-son-ably	rea-son-a-bly
temptress	tempt-ress
ool-o-gy	o-ol-o-gy
lega-tee	leg-a-tee
apoc-ryphal	a-poc-ry-phal
sen-a-to-r-i-al	sen-a-to-ri-al
telethon	tel-e-thon
breast-feed-ing	breastfeeding
irate	i-rate
framer	fram-er
nico-tine	nic-o-tine
brava-do	bra-va-do
fusil-lade	fu-sil-lade
plushy	plush-y
gelati-nous	ge-lat-i-nous
anon	a-non
bowlder	bowl-der
weighty	weight-y
in-clement	in-clem-ent
over-run	o-ver-run
undy-ing	un-dy-ing
ten-antry	ten-ant-ry
steril-i-ty	ste-ril-i-ty
undis-mayed	un-dis-mayed
snif-fer	sniff-er
com-bi-na-to-r-i-al	com-bi-na-to-ri-al
halite	hal-ite
monastery	mon-as-ter-y
bilin-gual	bi-lin-gual
stratig-ra-phy	stra-tig-ra-phy
en-durable	en-dur-a-ble
un-awak-ened	un-a-wak-ened
at-tain-able	at-tain-a-ble
bathos	ba-thos
op-eretta	op-er-et-ta
deca-dence	dec-a-dence
semi-fi-nal-ist	sem-i-fi-nal-ist
baroness	bar-on-ess
su-per-natant	su-per-na-tant
at-trib-ut-able	at-trib-ut-a-ble
un-for-giv-able	un-for-giv-a-ble
hexa-ne	hex-ane
for-syth-ia	for-syth-i-a
satirist	sat-i-rist
poly-syl-lab-ic	pol-y-syl-lab-ic
elec-tive	e-lec-tive
hy-drochlo-ride	hy-dro-chlo-ride
sparkle	spar-kle
het-ero-gene-ity	het-er-o-ge-ne-i-ty
fid-get	fidg-et
thaw-ing	thawing
count-able	count-a-ble
cu-rare	cu-ra-re
rafter	raft-er
ora-tion	o-ra-tion
ra-tio-nale	ra-tion-ale
cut-lery	cut-ler-y
reshow	re-show
re-assess	re-as-sess
rene-go-ti-ate	re-ne-go-ti-ate
seedy	seed-y
boun-teous	boun-te-ous
sexy	sex-y
septet	sep-tet
eighty	eight-y
wear-able	wear-a-ble
dis-tin-guish-able	dis-tin-guish-a-ble
tutu	tu-tu
sur-vivor	sur-vi-vor
fu-ner-ary	fu-ner-ar-y
so-lace	sol-ace
an-throp-ic	an-thro-pic
suit-ably	suit-a-bly
phle-boto-my	phle-bot-o-my
re-ori-en-ta-tion	re-o-ri-en-ta-tion
car-cino-genic	car-cin-o-gen-ic
polon-aise	pol-o-naise
lo-quaci-ty	lo-quac-i-ty
here-upon	here-up-on
crescen-do	cre-scen-do
kamikaze	ka-mi-ka-ze
surgery	sur-ger-y
no-to-ri-ety	no-to-ri-e-ty
ex-pect-ed	expected
unimag-in-able	un-im-ag-i-na-ble
manor	man-or
overindul-gence	o-ver-in-dul-gence
re-tractable	re-tract-a-ble
epi-cure	ep-i-cure
lament-ed	la-ment-ed
banker	bank-er
cere-bel-lum	cer-e-bel-lum
colon	co-lon
phil-an-thropist	phi-lan-thro-pist
eat-able	eat-a-ble
over-ride	o-ver-ride
chrysan-the-mum	chry-san-the-mum
astray	a-stray
pavil-ion	pa-vil-ion
graphol-o-gy	graph-ol-o-gy
lega-tor	le-ga-tor
discog-ra-phy	dis-cog-ra-phy
gen-uine-ly	gen-u-ine-ly
in-creduli-ty	in-cre-du-li-ty
sier-ra	si-er-ra
pro-pri-ety	pro-pri-e-ty
petrol-o-gy	pe-trol-o-gy
frilly	frill-y
dozen	doz-en
pelvic	pel-vic
in-di-vid-ual	in-di-vid-u-al
flossy	floss-y
ide-al-i-ty	i-de-al-i-ty
bases	ba-ses
uni-ver-sal-i-ty	u-ni-ver-sal-i-ty
in-former	in-form-er
uni-lat-er-al-ism	u-ni-lat-er-al-ism
post-mod-ernism	post-mod-ern-ism
ovu-la-tion	ov-u-la-tion
novice	nov-ice
achieve-ment	a-chieve-ment
any-thing	an-y-thing
aqua-naut	aq-ua-naut
pos-i-tivism	pos-i-tiv-ism
prowess	prow-ess
quotable	quot-a-ble
over-time	o-ver-time
starlight	star-light
hero-in	her-o-in
baroque	ba-roque
elec-tron-ic	e-lec-tron-ic
wun-derkind	wun-der-kind
ex-trater-ri-to-r-i-al	ex-tra-ter-ri-to-ri-al
demon-stra-bly	de-mon-stra-bly
eva-sion	e-va-sion
porter	por-ter
sub-terfuge	sub-ter-fuge
sus-pend-ed	sus-pen-ded
here-inafter	here-in-af-ter
ra-dia-tive	ra-di-a-tive
taskmas-ter	task-mas-ter
in-hab-i-tant	in-hab-it-ant
mores	mo-res
break-away	break-a-way
ici-cle	i-ci-cle
evac-u-ate	e-vac-u-ate
sar-to-r-i-al	sar-to-ri-al
promise	prom-ise
un-proven	un-prov-en
pen-tathlon	pen-tath-lon
in-di-gestible	in-di-gest-i-ble
epig-ra-phy	e-pig-ra-phy
bio-met-rics	bi-o-met-rics
en-joy-able	en-joy-a-ble
seal-ing	sealing
para-phrase	par-a-phrase
ir-ra-tional	ir-ra-tion-al
cochlea	coch-le-a
char-cu-terie	char-cu-te-rie
straight-away	straight-a-way
faceted	fac-et-ed
tes-ta-men-tary	tes-ta-men-ta-ry
uni-di-rec-tion-al	u-ni-di-rec-tion-al
gymkhana	gym-kha-na
eu-phemism	eu-phe-mism
phy-lac-tery	phy-lac-ter-y
elec-tri-fi-ca-tion	e-lec-tri-fi-ca-tion
bene-fac-tor	ben-e-fac-tor
as-pi-rant	as-pir-ant
painful	pain-ful
apart-ment	a-part-ment
snaky	snak-y
sausage	sau-sage
verisimil-i-tude	ver-i-si-mil-i-tude
dirty	dirt-y
obey	o-bey
cathar-sis	ca-thar-sis
meta-mor-phose	met-a-mor-phose
dandy	dan-dy
good-night	goodnight
polyg-a-mous	po-lyg-a-mous
pro-le-tari-at	pro-le-tar-i-at
dwin-dling	dwindling
un-read-able	un-read-a-ble
in-jury	in-ju-ry
dishy	dish-y
ap-proach-able	ap-proach-a-ble
minu-ti-ae	mi-nu-ti-ae
astride	a-stride
prefa-to-ry	pref-a-to-ry
precinct	pre-cinct
steplad-der	step-lad-der
fugi-tive	fu-gi-tive
com-fort-able	com-fort-a-ble
melt-ed	melted
defama-tion	def-a-ma-tion
mo-tocross	mo-to-cross
valid-ly	val-id-ly
kilo	ki-lo
pho-tore-cep-tor	pho-to-re-cep-tor
notepa-per	note-pa-per
over-cook	o-ver-cook
singer	sing-er
mag-ne-sium	mag-ne-si-um
mis-aligned	mis-a-ligned
steady	stead-y
electro-mechan-i-cal	e-lec-tro-me-chan-i-cal
dowdy	dow-dy
kudu	ku-du
imag-i-na-tive	im-ag-i-na-tive
stormy	storm-y
pread-o-les-cent	pre-ad-o-les-cent
sea-son-able	sea-son-a-ble
remix	re-mix
poly-phon-ic	pol-y-phon-ic
groupie	group-ie
winder	wind-er
quadru-ply	quad-ru-ply
unite	u-nite
stu-dentship	stu-dent-ship
karaoke	kar-a-o-ke
wran-gling	wrangling
wail-ing	wailing
trumpery	trump-er-y
sep-a-ratist	sep-a-ra-tist
epi-demi-ol-o-gy	ep-i-de-mi-ol-o-gy
undis-tin-guished	un-dis-tin-guished
ig-no-min-ious	ig-no-min-i-ous
mono-rail	mon-o-rail
in-de-pen-dent	in-de-pend-ent
tib-ia	tib-i-a
un-ob-ser-vant	un-ob-serv-ant
guinea	guin-ea
schemer	schem-er
dero-ga-tion	der-o-ga-tion
quirky	quirk-y
rea-son-able	rea-son-a-ble
hexa-dec-i-mal	hex-a-dec-i-mal
semi-con-scious	sem-i-con-scious
meanie	mean-ie
bluesy	blues-y
promis-cu-ity	prom-is-cu-i-ty
im-petu-ous	im-pet-u-ous
longevi-ty	lon-gev-i-ty
fil-i-buster	fil-i-bus-ter
as-tro-physi-cist	as-tro-phys-i-cist
hooli-gan	hoo-li-gan
rearm	re-arm
curly	curl-y
impi	im-pi
ex-pen-di-ture	ex-pend-i-ture
tem-pera-ment	tem-per-a-ment
dis-cre-tionary	dis-cre-tion-ar-y
switchgear	switch-gear
over-hear	o-ver-hear
lily	lil-y
pro-pa-gan-da	prop-a-gan-da
genome	ge-nome
dis-cov-ery	dis-cov-er-y
diet	di-et
rangy	rang-y
lovesick	love-sick
aton-al	a-ton-al
coax-i-al	co-ax-i-al
anony-mous-ly	a-non-y-mous-ly
able	a-ble
freighter	freight-er
seisin	sei-sin
papule	pap-ule
dacha	da-cha
pan-icky	pan-ick-y
avail	a-vail
prefer-ment	pre-fer-ment
java	ja-va
demigod	dem-i-god
encage	en-cage
ex-e-cutable	ex-e-cut-a-ble
unas-sist-ed	un-as-sist-ed
across	a-cross
verdi-gris	ver-di-gris
foxy	fox-y
ibis	i-bis
shoplifter	shop-lift-er
het-ero-ge-neous	het-er-o-ge-ne-ous
sedi-tion	se-di-tion
purview	pur-view
necro-man-tic	nec-ro-man-tic
cor-morant	cor-mo-rant
liti-gious	li-ti-gious
en-thralling	en-thral-ling
boater	boat-er
pro-pri-etor-ship	pro-pri-e-tor-ship
col-liery	col-lier-y
epis-te-mo-log-i-cal	e-pis-te-mo-log-i-cal
retell	re-tell
ap-plica-tive	ap-pli-ca-tive
docile	doc-ile
clam-p-down	clamp-down
ape-ri-od-ic	a-pe-ri-od-ic
prece-dence	prec-e-dence
nurs-ery	nurs-er-y
ine-bri-a-tion	in-e-bri-a-tion
pre-sen-ta-tion	pres-en-ta-tion
epis-to-lary	e-pis-to-lar-y
im-mea-sur-able	im-meas-ur-a-ble
ori-gin	or-i-gin
un-am-bigu-ous	un-am-big-u-ous
servi-ette	ser-vi-ette
height-ened	heightened
elab-o-rate-ly	e-lab-o-rate-ly
delict	de-lict
gaslight	gas-light
ar-rhyth-mia	ar-rhyth-mi-a
head-mistress	head-mis-tress
metatarsal	met-a-tar-sal
fig-u-ra-tive	fig-ur-a-tive
hoary	hoar-y
premis-es	prem-is-es
pari-ah	pa-ri-ah
oblique	o-blique
saucy	sau-cy
drifter	drift-er
tena-cious-ly	te-na-cious-ly
nowa-days	now-a-days
poly-he-dron	pol-y-he-dron
ob-serv-able	ob-serv-a-ble
au-toma-tion	au-to-ma-tion
woman	wom-an
essence	es-sence
wa-ver-ing	wavering
drafty	draft-y
about	a-bout
ped-a-gogy	ped-a-go-gy
chi-ropodist	chi-rop-o-dist
tawdry	taw-dry
dizzy	diz-zy
ejec-tion	e-jec-tion
ni-hilism	ni-hil-ism
im-mov-able	im-mov-a-ble
showjumpers	show-jum-pers
pro-tea	pro-te-a
bap-tismal	bap-tis-mal
de-mo-graph-ics	dem-o-graph-ics
physic	phys-ic
con-ceiv-ably	con-ceiv-a-bly
any-body	an-y-bod-y
ver-biage	ver-bi-age
over-sleep	o-ver-sleep
wicked-ness	wick-ed-ness
madri-gal	mad-ri-gal
steady-ing	steadying
duty	du-ty
starter	start-er
kosher	ko-sher
crawler	crawl-er
in-con-tro-vert-ible	in-con-tro-vert-i-ble
petal	pet-al
lazy-bones	la-zy-bones
seafront	sea-front
preser-v-a-tive	pre-serv-a-tive
rosin	ros-in
chromi-um	chro-mi-um
blither-ing	blith-er-ing
orig-i-nal-ly	o-rig-i-nal-ly
mi-crodot	mi-cro-dot
li-oness	li-on-ess
welly	wel-ly
racial	ra-cial
noisy	nois-y
gusty	gust-y
im-per-me-able	im-per-me-a-ble
crofter	croft-er
in-con-solable	in-con-sol-a-ble
phys-io-ther-a-py	phys-i-o-ther-a-py
bougainvil-lea	bou-gain-vil-le-a
overkill	o-ver-kill
fetid	fet-id
bushy	bush-y
ide-ol-o-gy	i-de-ol-o-gy
mar-itime	mar-i-time
trireme	tri-reme
tele-scop-ic	tel-e-scop-ic
iso-bar	i-so-bar
kine-mat-ics	kin-e-mat-ics
silent	si-lent
di-ver-sion-ary	di-ver-sion-ar-y
orig-i-nate	o-rig-i-nate
uni-fy	u-ni-fy
de-r-ate	de-rate
trans-fer-able	trans-fer-a-ble
mono-pole	mon-o-pole
chester-field	ches-ter-field
bindweed	bind-weed
trea-so-nous	trea-son-ous
moral-is-tic	mor-al-is-tic
key-boardist	key-board-ist
vit-ri-olic	vit-ri-ol-ic
satrap	sa-trap
fontanel	fon-ta-nel
trouper	troup-er
pro-tec-torate	pro-tec-tor-ate
con-sis-tent	con-sist-ent
icon-o-clast	i-con-o-clast
stringer	string-er
dele-tion	de-le-tion
semi-de-tached	sem-i-de-tached
poly-styrene	pol-y-sty-rene
cousin	cous-in
elope	e-lope
avid-i-ty	a-vid-i-ty
emo-tion	e-mo-tion
diskette	disk-ette
over-done	o-ver-done
growler	growl-er
stager	stag-er
roomy	room-y
hi-jack-ing	hi-jac-king
aloud	a-loud
pornog-ra-phy	por-nog-ra-phy
muti-nous	mu-ti-nous
blus-ter-ing	blustering
mogul	mo-gul
postal	post-al
flamin-go	fla-min-go
callable	call-a-ble
quiv-er-ing	quivering
memo-r-i-al	me-mo-ri-al
un-ques-tion-ably	un-ques-tion-a-bly
dri-ve-way	drive-way
valen-tine	val-en-tine
edi-tion	e-di-tion
the-atri-cal	the-at-ri-cal
peas-antry	peas-ant-ry
im-puni-ty	im-pu-ni-ty
deci-bel	dec-i-bel
couloir	cou-loir
artis-tic	ar-tis-tic
crevice	crev-ice
un-abashed-ly	un-a-bash-ed-ly
unim-pres-sive	un-im-pres-sive
abuse	a-buse
ego-tist	e-go-tist
vinyl	vi-nyl
garbage	gar-bage
con-t-a-m-i-na-tion	con-tam-i-na-tion
propul-sive	pro-pul-sive
pedant	ped-ant
in-com-bustible	in-com-bus-ti-ble
iden-ti-fi-able	i-den-ti-fi-a-ble
over-val-ue	o-ver-val-ue
nec-es-sary	nec-es-sar-y
en-fee-bled	enfeebled
navel	na-vel
coro-na-tion	cor-o-na-tion
snob-bery	snob-ber-y
res-onate	res-o-nate
broody	brood-y
puerile	pu-er-ile
trilin-gual	tri-lin-gual
bak-ery	bak-er-y
politi-cian	pol-i-ti-cian
every	eve-ry
every-where	eve-ry-where
undiplo-mat-ic	un-dip-lo-mat-ic
stock-bro-ker	stock-brok-er
meta-physics	met-a-phys-ics
hon-esty	hon-es-ty
domi-cil-iary	dom-i-cil-i-ar-y
bad-ger	badg-er
lacy	lac-y
copla-nar	co-pla-nar
frat-ri-ci-dal	frat-ri-cid-al
bidi-rec-tion-al	bi-di-rec-tion-al
midriff	mid-riff
aor-ta	a-or-ta
pout-ing	pouting
bul-gy	bulg-y
re-order	re-or-der
causative	caus-a-tive
show-ery	show-er-y
falset-to	fal-set-to
blessed	bless-ed
pho-tog-ra-ph-er	pho-tog-ra-pher
pover-ty	pov-er-ty
azure	az-ure
into	in-to
paraf-fin	par-af-fin
shindig	shin-dig
silli-ness	sil-li-ness
flagon	flag-on
homi-cide	hom-i-cide
ho-n-our	ho-nour
scarab	scar-ab
emen-da-tion	e-men-da-tion
pe-tit	pet-it
monothe-is-tic	mon-o-the-is-tic
iron-works	i-ron-works
un-promis-ing	un-prom-is-ing
su-per-nu-mer-ary	su-per-nu-mer-ar-y
para-dox-i-cal-ly	par-a-dox-i-cal-ly
epi-dem-ic	ep-i-dem-ic
fever-ish-ly	fe-ver-ish-ly
painful-ly	pain-ful-ly
oblige	o-blige
breath-able	breath-a-ble
gala	ga-la
equal-i-ty	e-qual-i-ty
prodi-gy	prod-i-gy
over-pro-duc-tion	o-ver-pro-duc-tion
con-tradis-tinc-tion	con-tra-dis-tinc-tion
vari-a-tion	var-i-a-tion
cashier	cash-ier
goer	go-er
seafood	sea-food
un-ac-count-able	un-ac-count-a-ble
over-growth	o-ver-growth
ban-ter-ing	bantering
read-mit	re-ad-mit
rein-vent	re-in-vent
dis-tiller	dis-till-er
glaciat-ed	gla-ci-at-ed
gen-eros-i-ty	gen-er-os-i-ty
sporty	sport-y
pu-ri-tanism	pu-ri-tan-ism
brack-et-ed	bracketed
chronol-o-gy	chro-nol-o-gy
decile	dec-ile
cityscape	cit-y-scape
cygnet	cyg-net
mousy	mous-y
ar-madil-lo	ar-ma-dil-lo
beady	bead-y
cir-cling	circling
vi-su-al-ly	vis-u-al-ly
pop-ulist	pop-u-list
postlude	post-lude
hindquar-ters	hind-quar-ters
bio-mass	bi-o-mass
de-caf-feinate	de-caf-fein-ate
temer-i-ty	te-mer-i-ty
any-how	an-y-how
wel-com-ing	wel-co-ming
holis-tic	ho-lis-tic
gan-g-ly	gan-gly
nugget	nug-get
bonobo	bo-no-bo
re-spectably	re-spect-a-bly
crunchy	crunch-y
resin	res-in
machi-na-tion	mach-i-na-tion
in-ge-nu-ity	in-ge-nu-i-ty
eval-u-a-tive	e-val-u-a-tive
va-ri-ety	va-ri-e-ty
pro-peller	pro-pel-ler
throw-away	throw-a-way
cadet	ca-det
fur-rowed	furrowed
fidu-cia-ry	fi-du-ci-ar-y
moc-casin	moc-ca-sin
deca-dent	dec-a-dent
sa-fari	sa-fa-ri
dodger	dodg-er
spir-i-tu-al-ist	spir-it-u-al-ist
un-ordered	un-or-dered
un-en-force-able	un-en-force-a-ble
con-sumerism	con-sum-er-ism
school-teacher	school-teach-er
biotech-nol-o-gy	bi-o-tech-nol-o-gy
rhea	rhe-a
oblig-a-tion	ob-li-ga-tion
para-sol	par-a-sol
tumes-cent	tu-mes-cent
ge-ot-her-mal	ge-o-ther-mal
rein-car-na-tion	re-in-car-na-tion
mauler	maul-er
melee	me-lee
sewing	sew-ing
brasserie	bras-se-rie
macrophage	mac-ro-phage
sum-mery	sum-mer-y
pizzi-ca-to	piz-zi-ca-to
link-able	link-a-ble
avow	a-vow
literati	lit-e-ra-ti
prompter	prompt-er
di-a-bolism	di-ab-o-lism
read-abil-i-ty	read-a-bil-i-ty
rock-etry	rock-et-ry
valid	val-id
aver	a-ver
reroutes	re-routes
mili-tia	mi-li-tia
egre-gious	e-gre-gious
ever-green	ev-er-green
cas-sowary	cas-so-war-y
reac-qui-si-tion	re-ac-qui-si-tion
con-tigu-ous	con-tig-u-ous
dy-namo	dy-na-mo
fre-quent-ed	frequented
aplen-ty	a-plen-ty
iden-ti-fi-ca-tion	i-den-ti-fi-ca-tion
in-ca-pable	in-ca-pa-ble
chanter	chant-er
ridicu-lous-ness	ri-dic-u-lous-ness
crooked	crook-ed
choral	cho-ral
reread	re-read
bather	bath-er
im-prison	im-pris-on
dis-ori-en-tat-ed	disorientated
un-healthy	un-health-y
mar-ketabil-i-ty	mar-ket-a-bil-i-ty
cognoscen-ti	co-gno-scen-ti
atoll	at-oll
teatime	tea-time
di-elec-tric	di-e-lec-tric
de-mo-li-tion	dem-o-li-tion
re-sis-tant	re-sist-ant
pom-padour	pom-pa-dour
despo-tism	des-pot-ism
navvy	nav-vy
veg-etable	veg-e-ta-ble
over-stretch	o-ver-stretch
in-suf-fer-able	in-suf-fer-a-ble
over-staffed	overstaffed
video	vid-e-o
etui	e-tui
breathy	breath-y
copi-er	cop-i-er
porky	pork-y
nat-ur-al	nat-u-ral
filthy	filth-y
bologna	bo-lo-gna
gloat-ing	gloating
unique-ly	u-nique-ly
glut-to-nous	glut-ton-ous
jumper	jump-er
throaty	throat-y
vari-abil-i-ty	var-i-a-bil-i-ty
hos-pitable	hos-pi-ta-ble
aba-cus	ab-a-cus
per-son-able	per-son-a-ble
in-deco-rous	in-dec-o-rous
trapeze	tra-peze
be-fud-dling	befuddling
gratic-ule	grat-i-cule
de-nial	de-ni-al
teleg-ra-phy	te-leg-ra-phy
bistable	bi-sta-ble
im-agery	im-age-ry
lex-i-cog-ra-ph-er	lex-i-cog-ra-pher
gelig-nite	gel-ig-nite
arise	a-rise
remap	re-map
blos-som-ing	blossoming
propo-si-tion-al	prop-o-si-tion-al
deu-teri-um	deu-te-ri-um
an-ti-quary	an-ti-quar-y
grantee	gran-tee
unar-tic-u-lat-ed	un-ar-tic-u-lat-ed
ca-nary	ca-nar-y
beryl-li-um	be-ryl-li-um
ha-rass-ing	harassing
reval-ue	re-val-ue
turn-around	turn-a-round
un-con-trol-lable	un-con-trol-la-ble
im-ple-menter	im-ple-ment-er
mas-tery	mas-ter-y
la-ryn-geal	la-ryn-ge-al
ax-il-lary	ax-il-lar-y
emit-ter	e-mit-ter
in-hala-tion	in-ha-la-tion
pan-theon	pan-the-on
for-giv-able	for-giv-a-ble
re-seller	re-sell-er
hear-ken	heark-en
ne-go-tiable	ne-go-ti-a-ble
xeno-phobe	xen-o-phobe
un-in-hab-it-able	un-in-hab-it-a-ble
tubu-lar	tu-bu-lar
coxswain	cox-swain
wiring	wir-ing
topaz	to-paz
valiant	val-iant
mae-stro	maes-tro
hy-dros-phere	hy-dro-sphere
re-lax-ation	re-lax-a-tion
teleprint-er	tel-e-print-er
sago	sa-go
emo-tion-less	e-mo-tion-less
briskly	brisk-ly
cleavers	cleav-ers
sounder	sound-er
erupt	e-rupt
thriller	thrill-er
uni-form	u-ni-form
seren-i-ty	se-ren-i-ty
aca-d-e-m-ic	ac-a-dem-ic
in-con-sid-er-able	in-con-sid-er-a-ble
procla-ma-tion	proc-la-ma-tion
delin-quent	de-lin-quent
em-bryo	em-bry-o
bola	bo-la
dis-qui-etude	dis-qui-e-tude
teacher	teach-er
tarot	ta-rot
bi-car-bon-ate	bi-car-bo-nate
coralline	cor-al-line
over-reach	o-ver-reach
hy-dro-sta-t-ic	hy-dro-stat-ic
un-de-mo-c-ra-t-ic	un-dem-o-crat-ic
anorex-ic	an-o-rex-ic
bistro	bis-tro
causal-ly	caus-al-ly
polem-i-cal	po-lem-i-cal
pilchard	pil-chard
unar-guable	un-ar-gu-a-ble
calorif-ic	cal-o-rif-ic
un-lac-ing	un-lacing
dusty	dust-y
sesame	ses-a-me
gerund	ger-und
en-vi-able	en-vi-a-ble
glut-tony	glut-ton-y
any	an-y
de-nier	de-ni-er
mama	ma-ma
slip-pery	slip-per-y
reval-u-a-tion	re-val-u-a-tion
labi-um	la-bi-um
op-ti-mistic	op-ti-mis-tic
ra-di-ograph	ra-di-o-graph
video-taped	videotaped
ve-nial	ve-ni-al
babysit-ting	babysitting
freaky	freak-y
scalar	sca-lar
so-ci-etal	so-ci-e-tal
dis-parag-ing	dis-par-ag-ing
dither	dith-er
weedy	weed-y
carafe	ca-rafe
com-mu-nica-tive-ness	com-mu-ni-ca-tive-ness
medal	med-al
re-splen-dent	re-splend-ent
forest-ed	forested
ir-re-triev-ably	ir-re-triev-a-bly
co-mestible	co-mes-ti-ble
pa-tri-lin-eal	pat-ri-lin-e-al
sapi-ent	sa-pi-ent
ganger	gang-er
detox-i-fi-ca-tion	de-tox-i-fi-ca-tion
ebul-lient	e-bul-lient
busker	busk-er
sonorous	so-no-rous
lin-ear	lin-e-ar
recharge-able	re-charge-a-ble
restart	re-start
unit	u-nit
stretchy	stretch-y
sub-ur-bia	sub-ur-bi-a
backgam-mon	back-gam-mon
cylin-der	cyl-in-der
haystack	hay-stack
jerkin	jer-kin
chaos	cha-os
ma-nia	ma-ni-a
costar	co-star
tra-chea	tra-che-a
aris-toc-ra-cy	ar-is-toc-ra-cy
over-pay	o-ver-pay
lofty	loft-y
mag-ne-tome-ter	mag-ne-tom-e-ter
liquor-ish	liq-uor-ish
net-work-ing	networking
menar-che	men-ar-che
in-dex-ing	indexing
manes	ma-nes
lemon	lem-on
techno-pho-bic	tech-no-pho-bic
casi-no	ca-si-no
grenadier	gren-a-dier
lega-tion	le-ga-tion
pirou-ette	pir-ou-ette
gen-uine-ness	gen-u-ine-ness
lion	li-on
as-segai	as-se-gai
preschool	pre-school
broadsword	broad-sword
de-lec-table	de-lec-ta-ble
illiq-uid	il-liq-uid
suf-frag-ist	suf-fra-gist
dowry	dow-ry
epi-graph	ep-i-graph
atavism	at-a-vism
tele-text	tel-e-text
manger	man-ger
glit-tery	glit-ter-y
para-mour	par-a-mour
where-abouts	where-a-bouts
qui-etus	qui-e-tus
dis-solute	dis-so-lute
cer-ti-fi-able	cer-ti-fi-a-ble
springer	spring-er
seaborne	sea-borne
baloney	ba-lo-ney
gatepost	gate-post
uni-for-mi-ty	u-ni-form-i-ty
bowsprit	bow-sprit
dis-agree-ment	dis-a-gree-ment
tele-pho-to	tel-e-pho-to
in-scrutable	in-scru-ta-ble
in-trauter-ine	in-tra-u-ter-ine
scrawny	scrawn-y
tran-scen-dent	tran-scend-ent
ptero-dactyl	pter-o-dac-tyl
preda-tor	pred-a-tor
un-re-cov-er-able	un-re-cov-er-a-ble
bud-get	budg-et
pathogen	path-o-gen
hypochon-dri-a-cal	hy-po-chon-dri-a-cal
im-moral-i-ty	im-mo-ral-i-ty
ini-ti-a-tion	in-i-ti-a-tion
leucine	leu-cine
mucky	muck-y
codling	cod-ling
es-planade	es-pla-nade
geo-syn-chro-nous	ge-o-syn-chro-nous
preva-lence	prev-a-lence
con-sid-er-able	con-sid-er-a-ble
naive	na-ive
leer-ing	leering
cra-nial	cra-ni-al
naked-ness	na-ked-ness
ini-tia-tive	in-i-ti-a-tive
lizard	liz-ard
flan-nelette	flan-nel-ette
plucky	pluck-y
up-heaval	up-heav-al
idol-a-try	i-dol-a-try
body-build-ing	bod-y-build-ing
neu-ronal	neu-ron-al
reti-na	ret-i-na
easel	ea-sel
di-atom	di-a-tom
doily	doi-ly
ureter	u-re-ter
de-ter-minable	de-ter-mi-na-ble
hourly	hour-ly
unchecked	un-checked
monog-a-mous-ly	mo-nog-a-mous-ly
camel	cam-el
bi-l-abi-al	bi-la-bi-al
palimpsest	pal-imp-sest
autarchy	au-tar-chy
sumo	su-mo
repro-bate	rep-ro-bate
ep-ithe-lial	ep-i-the-li-al
ever-last-ing	ev-er-last-ing
drom-e-dary	drom-e-dar-y
epis-tle	e-pis-tle
com-forter	com-fort-er
ar-guable	ar-gu-a-ble
un-pre-dictable	un-pre-dict-a-ble
orac-u-lar	o-rac-u-lar
un-sus-tain-able	un-sus-tain-a-ble
cur-tained	curtained
bac-teri-um	bac-te-ri-um
rani	ra-ni
un-easy	un-eas-y
sus-tain-abil-i-ty	sus-tain-a-bil-i-ty
pedol-o-gy	pe-dol-o-gy
ar-bi-trary	ar-bi-trar-y
im-per-son-ator	im-per-son-a-tor
ema-ci-a-tion	e-ma-ci-a-tion
in-de-pen-dent-ly	in-de-pend-ent-ly
look-ing	looking
in-dica-tive	in-dic-a-tive
apex	a-pex
phrase-ol-o-gy	phra-se-ol-o-gy
vi-able	vi-a-ble
geo-phys-i-cal	ge-o-phys-i-cal
resur-gence	re-sur-gence
fin-ery	fin-er-y
plen-teous	plen-te-ous
dredger	dredg-er
hy-per-boloid	hy-per-bo-loid
earthy	earth-y
satiny	sat-in-y
com-pan-ion-able	com-pan-ion-a-ble
mus-cu-loskele-tal	mus-cu-lo-skel-e-tal
co-rian-der	co-ri-an-der
catal-y-sis	ca-tal-y-sis
trendy	trend-y
best-seller	best-sell-er
tele-o-log-i-cal	tel-e-o-log-i-cal
knowl-edge-able	knowl-edge-a-ble
api-an	a-pi-an
un-avail-abil-i-ty	un-a-vail-a-bil-i-ty
spon-sored	sponsored
ker-atin	ker-a-tin
loess	lo-ess
retroac-tive	ret-ro-ac-tive
pe-ri-as-tron	per-i-as-tron
sor-cery	sor-cer-y
any-more	an-y-more
ji-u-jit-su	jiu-jit-su
romper	romp-er
un-af-ford-able	un-af-ford-a-ble
retroac-tive-ly	ret-ro-ac-tive-ly
subto-tal	sub-to-tal
an-ti-sta-t-ic	an-ti-stat-ic
over-spend	o-ver-spend
hy-draulics	hy-drau-lics
mono-cul-ture	mon-o-cul-ture
be-fud-dled	befuddled
opus	o-pus
clash-ing	clashing
re-process	re-proc-ess
steve-dore	ste-ve-dore
tele-vise	tel-e-vise
feb-ru-ary	feb-ru-ar-y
dis-ori-en-ta-tion	dis-o-ri-en-ta-tion
un-prece-dent-ed	un-prec-e-dent-ed
every-thing	eve-ry-thing
puffer	puff-er
equal	e-qual
miser-li-ness	mi-ser-li-ness
vestibule	ves-ti-bule
mi-croscopy	mi-cros-co-py
era	e-ra
es-tu-ary	es-tu-ar-y
io-dide	i-o-dide
petu-lant	pet-u-lant
glyc-erol	glyc-er-ol
musty	mus-ty
rounder	round-er
leg-isla-tive	leg-is-la-tive
de-scen-der	de-scend-er
tren-chant	trench-ant
char-i-o-teer	char-i-ot-eer
pussy-cat	pussycat
es-calade	es-ca-lade
elec-tron	e-lec-tron
repa-tri-a-tion	re-pa-tri-a-tion
macro-eco-nom-ic	mac-ro-ec-o-nom-ic
pa-tri-o-tism	pa-tri-ot-ism
dial	di-al
in-sur-mount-able	in-sur-mount-a-ble
pro-tease	pro-te-ase
eco-log-i-cal	ec-o-log-i-cal
over-come	o-ver-come
saver	sav-er
ide-al-is-tic	i-de-al-is-tic
rec-on-cil-able	rec-on-cil-a-ble
tofu	to-fu
codex	co-dex
spokes-woman	spokes-wom-an
arith-metic	a-rith-me-tic
wicked-ly	wick-ed-ly
fuel	fu-el
gateau	ga-teau
redi-rec-tion	re-di-rec-tion
fishy	fish-y
rhap-sody	rhap-so-dy
over-re-acts	o-ver-re-acts
preter-nat-ur-al	pre-ter-nat-u-ral
re-word-ings	re-word-ings
erad-i-cat-ed	e-rad-i-cat-ed
repar-tee	rep-ar-tee
elim-i-na-tion	e-lim-i-na-tion
marzi-pan	mar-zi-pan
his-t-a-mine	his-ta-mine
linger	lin-ger
poignan-cy	poign-an-cy
orate	o-rate
quest-ing	questing
ele-phan-tine	el-e-phan-tine
mega-ton	meg-a-ton
necro-man-cy	nec-ro-man-cy
as-sertive	as-ser-tive
shoplift-ing	shop-lift-ing
hap-py-golucky	hap-py-go-luck-y
proxy	prox-y
petard	pe-tard
nightlife	night-life
pre-sentable	pre-sent-a-ble
col-le-gial	col-le-gi-al
aphe-lion	a-phe-li-on
classy	class-y
com-peti-tor	com-pet-i-tor
celiba-cy	cel-i-ba-cy
dis-ci-pli-nary	dis-ci-pli-nar-y
brigadier	brig-a-dier
ukulele	u-ku-le-le
bear-able	bear-a-ble
equip-ment	e-quip-ment
again	a-gain
eval-u-a-tor	e-val-u-a-tor
sorghum	sor-ghum
gob-bledy-gook	gob-ble-dy-gook
rheuma-tol-ogy	rheu-ma-tol-o-gy
above	a-bove
arum	ar-um
silo	si-lo
undig-ni-fied	un-dig-ni-fied
ripen	rip-en
moldy	mold-y
in-evitably	in-ev-i-ta-bly
quadruped	quad-ru-ped
repast	re-past
pronom-i-nal	pro-nom-i-nal
ra-bid	rab-id
gassy	gas-sy
earnest-ly	ear-nest-ly
gavotte	ga-votte
mere-tri-cious	mer-e-tri-cious
periscope	per-i-scope
agency	a-gen-cy
re-versible	re-vers-i-ble
stetho-scope	steth-o-scope
to-bac-conist	to-bac-co-nist
cafe-te-ria	caf-e-te-ri-a
en-force-able	en-force-a-ble
in-tra-mur-al	in-tra-mu-ral
Words with errors: 1861
Words with incorrect number of syllables: 1774
Total evluated: 6500
Perfect accuracy: 0.71
Number of syllables accuracy: 0.73
Average Levenshtein Distance(across incorrect words): 1.18
