Attempt	Real
foam-ing	foaming
s-peak	speak
chapel	chap-el
s-trat-e-gy	strat-e-gy
p-re-serve	pre-serve
any-how	an-y-how
pubescen-t	pu-bes-cent
s-nap-per	snap-per
phe-nomeno-log-i-cal	phe-nom-e-no-log-i-cal
idio-syn-cratic	id-i-o-syn-crat-ic
con-tretemp-s	con-tre-temps
her-i-ta-ble	her-it-a-ble
porcine	por-cine
thril-l	thrill
quixot-ic	quix-ot-ic
any-body	an-y-bod-y
ashen	ash-en
avoid	a-void
lager	la-ger
legate	leg-ate
fum-bling	fumbling
fu-ner-ary	fu-ner-ar-y
cheery	cheer-y
oc-cu-pan-t	oc-cu-pant
in-ex-haustible	in-ex-haust-i-ble
mod-icum	mod-i-cum
quit-s	quits
his-togram	his-to-gram
s-tore	store
piglet	pig-let
s-cuf-f	scuff
prod-uc-t	prod-uct
s-tom-p	stomp
epi-demi-o-log-i-cal	ep-i-de-mi-o-log-i-cal
t-elecom-mu-ni-ca-tion	tel-e-com-mu-ni-ca-tion
cere-bel-lum	cer-e-bel-lum
s-core-less	score-less
s-teel-work-s	steel-works
bul-b	bulb
de-for-mi-ty	de-form-i-ty
gospel	gos-pel
binoc-u-lars	bin-oc-u-lars
thau-maturge	thau-ma-turge
homage	hom-age
sus-pend-ed	sus-pen-ded
coy-ote	coy-o-te
walkover	walk-o-ver
ini-tia-tive	in-i-ti-a-tive
aver-sion	a-ver-sion
s-taunch-ly	staunch-ly
even-song	e-ven-song
soli-tude	sol-i-tude
viper	vi-per
ax-il-lary	ax-il-lar-y
ver-dan-t	ver-dant
crier	cri-er
cur-able	cur-a-ble
paramount-cy	par-a-mount-cy
morass	mo-rass
ex-porta-bil-i-ty	ex-por-ta-bi-li-ty
furtive	fur-tive
pro-fes-sion-al-is-m	pro-fes-sion-al-ism
tanker	tank-er
rose-mary	rose-mar-y
h-es-i-ta-tion	hes-i-ta-tion
daun-t	daunt
bribery	brib-er-y
fac-t	fact
preg-nan-t	preg-nant
table-ware	ta-ble-ware
markup	mark-up
e-vac-uee	e-vac-u-ee
un-usu-al-ly	un-u-su-al-ly
pun-ish-able	pun-ish-a-ble
fore-see-able	fore-see-a-ble
fo-liage	fo-li-age
thievish	thiev-ish
trusty	trust-y
e-mer-ald	em-er-ald
alarm-ing	a-larm-ing
steadi-ness	stead-i-ness
broadsword	broad-sword
nightin-gale	night-in-gale
shady	shad-y
prodi-gious	pro-di-gious
naked-ness	na-ked-ness
pesti-lence	pes-ti-lence
perime-ter	pe-rim-e-ter
stereo-typ-i-cal	ster-e-o-typ-i-cal
m-nemon-ic-s	mne-mon-ics
pro-pri-etress	pro-pri-e-tress
s-nip-ing	snip-ing
colour	co-lour
sacro-sanc-t	sac-ro-sanct
t-wofold	two-fold
dogged	dog-ged
tele-pho-to	tel-e-pho-to
har-mo-nious	har-mo-ni-ous
sim-per-ing	simpering
horsey	hors-ey
promi-nence	prom-i-nence
po-et-ic-s	po-et-ics
mean-s	means
s-lalom	sla-lom
parch-men-t	parch-ment
gener-ic	ge-ner-ic
pol-lard-ed	pollarded
veni-son	ven-i-son
tru-cu-len-t	truc-u-lent
co-rian-der	co-ri-an-der
pe-trel	pet-rel
frothy	froth-y
psy-chopathol-o-gy	psy-cho-pa-thol-o-gy
s-tan-dard	stand-ard
awash	a-wash
con-tigu-ous	con-tig-u-ous
willpow-er	will-pow-er
ob-jec-t	ob-ject
apothe-cary	a-poth-e-car-y
moth-bal-l	moth-ball
s-neer	sneer
g-lut-tonous	glut-ton-ous
deco-rous	dec-o-rous
sec-u-lar-is-m	sec-u-lar-ism
boomer	boom-er
delu-sive	de-lu-sive
vine-gar	vin-e-gar
u-nau-dit-ed	un-au-dit-ed
jit-tery	jit-ter-y
over-coat	o-ver-coat
muslin	mus-lin
diver-s	di-vers
alone	a-lone
la-ten-t	la-tent
prospec-tus	pro-spec-tus
but-tery	but-ter-y
briskly	brisk-ly
tou-sled	tousled
worsted	wor-sted
u-n-avoid-ably	un-a-void-a-bly
brassiere	bras-siere
pho-to-volta-ic	pho-to-vol-ta-ic
benef-i-cen-t	be-nef-i-cent
f-reak-ish	freak-ish
s-to-icis-m	sto-i-cism
barefaced	bare-faced
in-duce-men-t	in-duce-ment
in-testi-nal	in-tes-ti-nal
arum	ar-um
ax-iom	ax-i-om
e-mer-gen-t	e-mer-gent
over-sup-ply	o-ver-sup-ply
aqua	aq-ua
usurp-er	u-surp-er
uned-i-fy-ing	un-ed-i-fy-ing
sym-bion-t	sym-bi-ont
copy-ist	cop-y-ist
un-bear-ably	un-bear-a-bly
ap-pre-cia-ble	ap-pre-ci-a-ble
biop-sy	bi-op-sy
de-pen-dence	de-pend-ence
s-lant-ing	slant-ing
ragout	ra-gout
s-luice	sluice
car-dioid	car-di-oid
re-sent-men-t	re-sent-ment
haughty	haugh-ty
brain-stor-m	brain-storm
re-bury	re-bur-y
busy	bus-y
moorhen	moor-hen
harpist	har-pist
dispir-it-ed	dis-pir-it-ed
hec-tor-ing	hectoring
light-s	lights
pathos	pa-thos
g-nat	gnat
mas-culin-i-ty	mas-cu-lin-i-ty
gra-nary	gra-na-ry
over-ex-po-sure	o-ver-ex-po-sure
rein-sur-ance	re-in-sur-ance
propen-si-ty	pro-pen-si-ty
basil	bas-il
odd-s	odds
aso-cial	a-so-cial
colos-sal	co-los-sal
blush-ing	blushing
di-a-bolis-m	di-ab-o-lism
mush-room-ing	mushrooming
es-capist	es-cap-ist
leer-ing	leering
d-u-al-i-ty	du-al-i-ty
cys-t	cyst
par-enter-al	par-en-ter-al
river-side	riv-er-side
ma-tri-lin-eal	mat-ri-lin-e-al
platy-pus	plat-y-pus
dis-heart-en-ing	dis-hear-te-ning
in-ex-ac-t	in-ex-act
fin-ery	fin-er-y
om-nipo-tence	om-nip-o-tence
id-io-cy	id-i-o-cy
katy-did	ka-ty-did
s-pank	spank
com-ple-men-tary	com-ple-men-ta-ry
be-wil-dered	bewildered
pan-the-is-m	pan-the-ism
s-moth-er	smoth-er
wily	wil-y
dis-moun-t	dis-mount
over-reach	o-ver-reach
pharao-h	phar-aoh
un-re-li-able	un-re-li-a-ble
talkie	talk-ie
feu-dal-is-m	feu-dal-ism
over-act-ing	overacting
un-quan-tifi-able	un-quan-ti-fi-a-ble
gazelle	ga-zelle
physic-s	phys-ics
cel-l	cell
im-pro-visato-ry	im-pro-vi-sa-to-ry
d-if-fer-ent-ly	dif-fer-ent-ly
serum	se-rum
sali-vary	sal-i-var-y
s-low-ly	slow-ly
rock-etry	rock-et-ry
colosto-my	co-los-to-my
liquor-ish	liq-uor-ish
in-nu-mer-able	in-nu-mer-a-ble
recita-tion	rec-i-ta-tion
poly-glot	pol-y-glot
prebend	preb-end
reify	re-i-fy
naughty	naugh-ty
share-able	share-a-ble
labi-a	la-bi-a
fold-ing	folding
avert	a-vert
dol-drum-s	dol-drums
s-trait-en	strait-en
squea-mish	squeam-ish
positron	pos-i-tron
body	bod-y
s-corch-ing	scorch-ing
ca-cao	ca-ca-o
coro-nal	cor-o-nal
piti-ful	pit-i-ful
sibyl	sib-yl
prowler	prowl-er
usu-al-ly	u-su-al-ly
coolan-t	cool-ant
transat-lantic	trans-at-lan-tic
eigen-state	ei-gen-state
ped-i-men-t	ped-i-ment
chill-ing	chilling
physique	phy-sique
s-port	sport
holis-m	ho-lism
prece-dence	prec-e-dence
u-nar-tic-u-lat-ed	un-ar-tic-u-lat-ed
in-stal-l	in-stall
ser-van-t	serv-ant
vicarage	vic-ar-age
com-mis-sari-at	com-mis-sar-i-at
cross-road-s	cross-roads
dairy-ing	dair-y-ing
salu-ta-tion	sal-u-ta-tion
hy-pother-mi-a	hy-po-ther-mi-a
propy-lene	pro-pyl-ene
mil-ligram	mil-li-gram
hero-ine	her-o-ine
sug-ary	sug-ar-y
rec-on-cil-able	rec-on-cil-a-ble
backpedal	back-ped-al
basil-i-ca	ba-sil-i-ca
pun-y	pu-ny
pri-mar-i-ly	pri-ma-ri-ly
e-m-anate	em-a-nate
literati	lit-e-ra-ti
t-in-foil	tin-foil
n-im-ble	nim-ble
im-mov-able	im-mov-a-ble
de-tainee	de-tain-ee
s-tatu-to-ry	stat-u-to-ry
tidal	tid-al
s-pa-tial-ly	spa-tial-ly
lodestar	lode-star
clemen-cy	clem-en-cy
based	based
kayak	kay-ak
in-choate	in-cho-ate
solid-ly	sol-id-ly
im-pro-pri-ety	im-pro-pri-e-ty
tyran-ni-cide	ty-ran-ni-cide
soapy	soap-y
con-tour-ing	con-touring
rant-ing	ranting
bubon-ic	bu-bon-ic
in-ter-de-pen-den-t	in-ter-de-pend-ent
liv-able	liv-a-ble
be-fal-l	be-fall
d-war-f	dwarf
comi-ty	com-i-ty
speedome-ter	speed-om-e-ter
glassy	glass-y
s-trange	strange
un-event-ful	un-e-vent-ful
sinew	sin-ew
makeshift	make-shift
nico-tine	nic-o-tine
creamy	cream-y
jour-nalese	jour-nal-ese
mis-t	mist
lib-er-al-is-m	lib-er-al-ism
chival-ry	chiv-al-ry
mega-hertz	meg-a-hertz
car-rion	car-ri-on
qua-train	quat-rain
s-lug-gard	slug-gard
d-weller	dwell-er
s-worn	sworn
habi-ta-tion	hab-i-ta-tion
navvy	nav-vy
eatery	eat-er-y
s-i-nus	si-nus
ravi-o-li	ra-vi-o-li
invit-ing	in-vit-ing
py-rotech-nic	py-ro-tech-nic
rel-a-tivis-m	rel-a-tiv-ism
grenade	gre-nade
trust-ed	trusted
triv-ial	triv-i-al
hab-er-dash-ery	hab-er-dash-er-y
har-mo-nious-ly	har-mo-ni-ous-ly
brasserie	bras-se-rie
rainy	rain-y
ra-dionu-clide	ra-di-o-nu-clide
antwer-p	antwerp
able	a-ble
i-n-ap-pro-pri-ate-ly	in-ap-pro-pri-ate-ly
slav-ery	slav-er-y
e-d-uca-tive	ed-u-ca-tive
recital	re-cit-al
makeweight	make-weight
re-can-t	re-cant
pro-pel-lan-t	pro-pel-lant
herbal-ist	herb-al-ist
distaff	dis-taff
petard	pe-tard
rear-m	re-arm
n-odal	nod-al
screwy	screw-y
con-junc-t	con-junct
tam-bourine	tam-bou-rine
tum-bled	tumbled
power-boat	pow-er-boat
kriegspiel	krieg-spiel
para-mil-i-tary	par-a-mil-i-tar-y
in-dul-gen-t	in-dul-gent
ori-en-tal-is-m	o-ri-en-tal-ism
u-nan-swer-able	un-an-swer-a-ble
kalei-do-scope	ka-lei-do-scope
dis-cred-it-ed	discredited
sundry	sun-dry
rene-go-ti-a-tion	re-ne-go-ti-a-tion
hege-mon-ic	heg-e-mon-ic
pho-to-genic	pho-to-gen-ic
at-tain-men-t	at-tain-ment
cabri-o-let	cab-ri-o-let
ot-toman	ot-to-man
brushy	brush-y
u-n-ac-count-ed	un-ac-count-ed
bovine	bo-vine
s-loop	sloop
coro-nary	cor-o-nar-y
detox	de-tox
premise	prem-ise
febrile	fe-brile
ax-e	axe
s-parkle	spar-kle
serif	ser-if
struc-tural-ly	struc-tur-al-ly
treaty	trea-ty
whomev-er	whom-ev-er
con-juror	con-ju-ror
re-in-state-men-t	re-in-state-ment
d-e-duc-tion	de-duc-tion
re-newed	renewed
fore-fron-t	fore-front
tena-cious	te-na-cious
un-men-tion-able	un-men-tion-a-ble
at-trib-ut-able	at-trib-ut-a-ble
lazi-ness	la-zi-ness
simil-i-tude	si-mil-i-tude
in-ter-sec-t	in-ter-sect
avul-sion	a-vul-sion
in-den-t	in-dent
vari-ate	var-i-ate
sun-burned	sunburned
hypocrisy	hy-poc-ri-sy
meta-mor-phis-m	met-a-mor-phism
aven-s	av-ens
couloir	cou-loir
triplex	tri-plex
prefer-ably	pref-er-a-bly
opal	o-pal
retro	ret-ro
tit-ter-ing	tittering
over-strung	o-ver-strung
mine-strone	min-e-stro-ne
phleg-m	phlegm
de-tectably	de-tect-a-bly
mi-cro-bial	mi-cro-bi-al
whaler	whal-er
hermeneu-tic	her-me-neu-tic
im-pov-er-ish-men-t	im-pov-er-ish-ment
bur-gundy	bur-gun-dy
chevron	chev-ron
blaster	blast-er
co-her-en-t	co-her-ent
legu-mi-nous	le-gu-mi-nous
ar-ti-fi-cial-i-ty	ar-ti-fi-ci-al-i-ty
hemi-sphere	hem-i-sphere
marigold	mar-i-gold
un-re-peat-able	un-re-peat-a-ble
hellish	hell-ish
fi-nis	fin-is
giblet-s	gib-lets
tele-graph-ic	tel-e-graph-ic
im-pinge-men-t	im-pinge-ment
con-traindi-ca-tion	con-tra-in-di-ca-tion
skew-ered	skewered
bat-tery	bat-ter-y
medal-lion	me-dal-lion
ori-en-tal	o-ri-en-tal
stag-ger-s	stag-gers
u-n-af-fil-i-at-ed	un-af-fil-i-at-ed
ro-tary	ro-ta-ry
u-nim-peach-able	un-im-peach-a-ble
cognoscen-ti	co-gno-scen-ti
fir-m	firm
e-bony	eb-on-y
boa	bo-a
in-vi-o-lable	in-vi-o-la-ble
gaudy	gaud-y
timetable	time-ta-ble
s-cam-p	scamp
un-fa-mil-iar-i-ty	un-fa-mil-i-ar-i-ty
en-hance-men-t	en-hance-ment
chronome-ter	chro-nom-e-ter
binoc-u-lar	bin-oc-u-lar
regress	re-gress
s-tut-ter	stut-ter
diehard	die-hard
im-ma-nen-t	im-ma-nent
panacea	pan-a-ce-a
y-oung	young
im-mi-nen-t	im-mi-nent
hunter	hunt-er
be-wil-der-men-t	be-wil-der-ment
spon-sored	sponsored
askew	a-skew
dumb-found-ed	dumbfounded
rol-l	roll
sub-jec-t	sub-ject
preda-to-ry	pred-a-to-ry
teapot	tea-pot
postal	post-al
pro-ject-ed	projected
grapevine	grape-vine
de-trac-t	de-tract
chas-ten-ing	chastening
s-ta-tis-ti-cal-ly	sta-tis-ti-cal-ly
un-beat-able	un-beat-a-ble
chi-canery	chi-can-er-y
gov-ern-men-t	gov-ern-ment
un-equal	un-e-qual
k-i-lo	ki-lo
zoo-plank-ton	zo-o-plank-ton
b-lis-ter	blis-ter
know-able	know-a-ble
o-r-a-tor-i-cal	or-a-tor-i-cal
e-quian-gu-lar	e-qui-an-gu-lar
pecan	pe-can
con-ic-s	con-ics
ar-chaeopteryx	ar-chae-op-ter-yx
un-der-ar-m	un-der-arm
ex-pi-ra-to-ry	ex-pir-a-to-ry
un-hope-d	un-hoped
crick-eter	crick-et-er
e-s-py	es-py
h-m-m	hmm
py-rotech-nic-s	py-ro-tech-nics
gym-nas-tic-s	gym-nas-tics
cres-cen-t	cres-cent
col-le-gial	col-le-gi-al
spir-i-tu-al-i-ty	spir-it-u-al-i-ty
lazy-bones	la-zy-bones
steam-roller	steam-roll-er
plumba-go	plum-ba-go
cousin	cous-in
opin-ion-at-ed	o-pin-ion-at-ed
k-nap-sack	knap-sack
fi-deli-ty	fi-del-i-ty
oblit-er-a-tion	ob-lit-er-a-tion
lofty	loft-y
qui-eten	qui-et-en
mic-turi-tion	mic-tu-ri-tion
yeti	yet-i
chemise	che-mise
mega-phone	meg-a-phone
as-tro-physic-s	as-tro-phys-ics
k-i-na	ki-na
sub-si-dence	sub-sid-ence
over-man-tel	o-ver-man-tel
moody	mood-y
om-nipo-ten-t	om-nip-o-tent
fed-er-al-is-m	fed-er-al-ism
ob-struc-t	ob-struct
perigee	per-i-gee
steady	stead-y
husky	hus-ky
lassie	las-sie
in-hibitor	in-hib-i-tor
en-rich-men-t	en-rich-ment
s-in-cere-ly	sin-cere-ly
ex-pen-di-ture	ex-pend-i-ture
feath-erlight	feath-er-light
beaver	bea-ver
en-comi-um	en-co-mi-um
bacil-lus	ba-cil-lus
s-cam-per	scamp-er
duet	du-et
peachy	peach-y
re-assess	re-as-sess
in-sou-ciance	in-sou-ci-ance
re-sol-ven-t	re-sol-vent
tac-t	tact
den-t	dent
s-tub-bly	stub-bly
s-cal-a-bil-i-ty	scal-a-bil-i-ty
s-tu-dious	stu-di-ous
poignan-cy	poign-an-cy
k-loof	kloof
re-plen-ish-men-t	re-plen-ish-ment
moder-ni-ty	mo-der-ni-ty
im-prov-i-den-t	im-prov-i-dent
re-cov-ery	re-cov-er-y
ap-pari-tion	ap-pa-ri-tion
ex-cite-men-t	ex-cite-ment
cata-ma-ran	cat-a-ma-ran
away	a-way
me-nial	me-ni-al
phono-log-i-cal	pho-no-log-i-cal
valance	val-ance
ren-dezvous	ren-dez-vous
wattage	watt-age
plumage	plum-age
lit-er-al-is-m	lit-er-al-ism
dis-mis-s	dis-miss
fil-l	fill
sun-tanned	suntanned
for-syth-ia	for-syth-i-a
trawler	trawl-er
milliner	mil-li-ner
un-fath-ome-d	un-fath-omed
co-in-ci-den-t	co-in-ci-dent
s-hears	shears
de-fend-ing	defending
draught-s	draughts
costar	co-star
re-strain-ing	restraining
parox-ys-m	par-ox-ysm
pantry	pan-try
corny	corn-y
habit	hab-it
com-press-ibil-i-ty	com-pres-si-bil-i-ty
block-buster	block-bust-er
testis	tes-tis
deis-m	de-ism
de-part-men-t	de-part-ment
draugh-t	draught
spin-naker	spin-na-ker
dis-parag-ing	dis-par-ag-ing
u-ni-tary	u-ni-tar-y
ar-bi-trary	ar-bi-trar-y
or-di-nary	or-di-nar-y
pep-pered	peppered
preach-ing	preaching
untest-ed	un-test-ed
demon-stra-tive	de-mon-stra-tive
sitar	si-tar
cam-era-man	cam-er-a-man
elec-t	e-lect
avail-able	a-vail-a-ble
c-on-cil-ia-tor	con-cil-i-a-tor
itin-er-an-t	i-tin-er-ant
di-atom-ic	di-a-tom-ic
com-ple-men-t	com-ple-ment
dis-sec-t	dis-sect
un-govern-able	un-gov-ern-a-ble
s-mudge	smudge
any-way	an-y-way
erot-i-ca	e-rot-i-ca
aslan-t	a-slant
ouster	oust-er
s-tovepipe	stove-pipe
s-pare	spare
lu-natic	lu-na-tic
ac-cep-t	ac-cept
mar-riage-able	mar-riage-a-ble
motile	mo-tile
baroque	ba-roque
cata-ton-ic	cat-a-ton-ic
elec-toral	e-lec-tor-al
tex-t	text
prairie	prai-rie
so-cio-bi-ol-o-gy	so-ci-o-bi-ol-o-gy
doyen	doy-en
c-it-i-zen-ry	cit-i-zen-ry
s-late	slate
di-alec-t	di-a-lect
puree	pu-ree
net-bal-l	net-ball
s-tar-lit	star-lit
bac-carat	bac-ca-rat
fidu-cia-ry	fi-du-ci-ar-y
pho-net-ic-s	pho-net-ics
voyeuris-tic	voy-eur-is-tic
s-park-ly	spar-kly
s-ingsong	sing-song
moraine	mo-raine
com-paction	com-pac-tion
sinewy	sin-ew-y
mys-ti-cis-m	mys-ti-cism
par-tic-i-pan-t	par-tic-i-pant
spooky	spook-y
elec-tro-mo-tive	e-lec-tro-mo-tive
s-trafe	strafe
mul-ti-lat-er-al-is-m	mul-ti-lat-er-al-ism
wardrobe	ward-robe
beach-comber	beach-comb-er
cyn-i-cis-m	cyn-i-cism
be-liev-able	be-liev-a-ble
liq-uida-tor	liq-ui-da-tor
sub-trac-t	sub-tract
y-ore	yore
va-pid	vap-id
fire-bal-l	fire-ball
re-ac-t	re-act
laugh-ably	laugh-a-bly
medic-i-nal	me-dic-i-nal
mer-ri-men-t	mer-ri-ment
s-nug	snug
colo-nial-is-m	co-lo-ni-al-ism
con-sid-er-ably	con-sid-er-a-bly
chamois	cham-ois
serai	se-ra-i
hooli-gan	hoo-li-gan
elu-ci-date	e-lu-ci-date
wolfish	wolf-ish
penu-ri-ous	pe-nu-ri-ous
quain-t	quaint
paci-fist	pac-i-fist
cir-cum-ven-t	cir-cum-vent
wringer	wring-er
the-atri-cal-s	the-at-ri-cals
hon-our	ho-nour
mag-netism	mag-net-ism
a-ban-don-men-t	a-ban-don-ment
sander	sand-er
s-corch	scorch
brava-do	bra-va-do
show-ery	show-er-y
so-ci-ety	so-ci-e-ty
triathlon	tri-ath-lon
navel	na-vel
patchy	patch-y
heavy-weight	heav-y-weight
flus-tered	flustered
cus-tody	cus-to-dy
u-n-ap-pre-cia-tive	un-ap-pre-ci-a-tive
boron	bo-ron
procla-ma-tion	proc-la-ma-tion
sub-mersible	sub-mers-i-ble
on-ag-er	on-a-ger
pre-fec-t	pre-fect
im-mea-sur-ably	im-meas-ur-a-bly
arabesque	ar-a-besque
jeop-ardy	jeop-ard-y
pro-pri-etary	pro-pri-e-tar-y
the-o-reti-cian	the-o-re-ti-cian
loutish	lout-ish
t-wo	two
s-cathing	scath-ing
reaper	reap-er
penal-ty	pen-al-ty
pen-i-ten-tiary	pen-i-ten-tia-ry
over-due	o-ver-due
lino	li-no
s-trat-a-gem	strat-a-gem
filmic	film-ic
there-upon	there-up-on
in-sis-tence	in-sist-ence
tithing	tith-ing
dis-en-gage-men-t	dis-en-gage-ment
c-itadel	cit-a-del
turn-about	turn-a-bout
drap-ery	dra-per-y
s-ab-bath	sab-bath
k-ilo-hertz	kil-o-hertz
chloro-phyl-l	chlo-ro-phyll
ve-loci-pede	ve-loc-i-pede
gal-vanome-ter	gal-va-nom-e-ter
s-tu-pid-i-ty	stu-pid-i-ty
pread-o-les-cen-t	pre-ad-o-les-cent
plen-teous	plen-te-ous
felo-nious	fe-lo-ni-ous
guardian-ship	guard-i-an-ship
s-now-stor-m	snow-storm
te-dious	te-di-ous
bulky	bulk-y
ten-able	ten-a-ble
im-plan-t	im-plant
l-itur-gi-cal	li-tur-gi-cal
protest	pro-test
chirpy	chirp-y
hereto-fore	here-to-fore
over-lay	o-ver-lay
refu-ta-tion	ref-u-ta-tion
short-s	shorts
pream-pli-fi-er	pre-am-pli-fi-er
ghana	ghana
crys-talline	crys-tal-line
re-li-ably	re-li-a-bly
i-nat-ten-tive	in-at-ten-tive
pome-lo	pom-e-lo
arise	a-rise
trashy	trash-y
nut-shel-l	nut-shell
por-ten-t	por-tent
be-twix-t	be-twixt
vari-ant	var-i-ant
con-nivance	con-niv-ance
man-i-cured	ma-ni-cured
clemen-t	clem-ent
re-stric-t	re-strict
su-per-scrip-t	su-per-script
necrop-o-lis	ne-crop-o-lis
sickbed	sick-bed
su-per-posed	superposed
s-ap-phire	sap-phire
forepaw	fore-paw
scrip-t	script
peanut	pea-nut
umpteenth	ump-teenth
de-cryp-t	de-crypt
thiev-ery	thiev-er-y
lounger	loung-er
in-frared	in-fra-red
steadi-ly	stead-i-ly
mo-men-tary	mo-men-tar-y
legged	leg-ged
pi-caresque	pic-a-resque
dactyl	dac-tyl
s-tock-tak-ing	stock-tak-ing
as-cetic	as-cet-ic
g-narled	gnarled
heater	heat-er
s-tol-id	stol-id
torus	to-rus
ran-corous	ran-cor-ous
hero	he-ro
s-tar-ling	star-ling
her-bi-cide	herb-i-cide
puma	pu-ma
con-demned	condemned
dero-gate	der-o-gate
s-mall-ness	small-ness
unerring	un-err-ing
di-eti-tian	di-e-ti-tian
c-om-men-da-tion	com-men-da-tion
over-staffed	overstaffed
de-r-ate	de-rate
re-ver-ber-an-t	re-ver-ber-ant
painful	pain-ful
remap	re-map
reti-nal	ret-i-nal
jaz-z	jazz
stuff-in-g	stuff-ing
par-alin-guis-tic	par-a-lin-guis-tic
com-pelling	com-pel-ling
genus	ge-nus
t-setse	tset-se
vivi-sec-tion	viv-i-sec-tion
ge-nial	ge-ni-al
bal-cony	bal-co-ny
s-naf-fle	snaf-fle
s-cald	scald
res-o-nan-t	res-o-nant
ap-palling-ly	ap-pall-ing-ly
vam-p	vamp
bi-cep-s	bi-ceps
sec-ondary	sec-ond-ar-y
episode	ep-i-sode
pal-lia-tive	pal-li-a-tive
velo-drome	ve-lo-drome
tur-bocharged	turbocharged
suc-cum-b	suc-cumb
y-achts-man	yachts-man
s-ling-shot	sling-shot
pic-turesque	pic-tur-esque
s-lay-er	slay-er
malaise	ma-laise
s-car-let	scar-let
gig-gling	giggling
knol-l	knoll
crin-kled	crinkled
s-tar-board	star-board
s-pank-ing	spank-ing
hym-n	hymn
par-en-t	par-ent
teacup	tea-cup
gazette	ga-zette
gravy	gra-vy
cyclic	cy-clic
lin-gerie	lin-ge-rie
l-la-ma	lla-ma
elec-tive	e-lec-tive
trigonom-e-try	trig-o-nom-e-try
di-lata-tion	dil-a-ta-tion
join-t	joint
periscope	per-i-scope
suf-fi-cien-t	suf-fi-cient
showjumper-s	show-jum-pers
geyser	gey-ser
s-ca-lene	sca-lene
per-fec-tion-is-m	per-fec-tion-ism
de-tach-men-t	de-tach-ment
macaque	ma-caque
k-nave	knave
s-laugh-ter	slaugh-ter
cryo-stat	cry-o-stat
lemur	le-mur
es-tu-ary	es-tu-ar-y
undy-ing	un-dy-ing
foolscap	fools-cap
fever	fe-ver
celi-bate	cel-i-bate
lifeboat	life-boat
c-etacean	ce-ta-cean
pla-gia-ris-m	pla-gia-rism
dis-re-spec-t	dis-re-spect
ec-to-plas-m	ec-to-plasm
car-dio-vas-cu-lar	car-di-o-vas-cu-lar
ram-p	ramp
copy	cop-y
poky	pok-y
bar-baris-m	bar-ba-rism
sa-van-t	sa-vant
haver-ing	ha-ve-ring
re-vam-p	re-vamp
d-educ-t	de-duct
n-ear-sight-ed	near-sight-ed
trade-marked	trademarked
tri-maran	tri-ma-ran
reval-ue	re-val-ue
case-men-t	case-ment
dishy	dish-y
y-ours	yours
poly-mor-phous	pol-y-mor-phous
y-our-self	your-self
s-par-tan	spar-tan
crispy	crisp-y
de-posi-tary	de-pos-i-tar-y
con-join-t	con-joint
revenan-t	rev-e-nant
tran-scrip-t	tran-script
adop-t	a-dopt
s-coundrel	scoun-drel
g-lyc-erol	glyc-er-ol
bub-blegum	bub-ble-gum
de-tectable	de-tect-a-ble
heraldic	he-ral-dic
in-ter-atom-ic	in-ter-a-tom-ic
en-gage-men-t	en-gage-ment
dandy	dan-dy
streaky	streak-y
un-cre-ative	un-cre-a-tive
s-tu-dio	stu-di-o
mantrap	man-trap
con-scrip-t	con-script
dodgy	dodg-y
va-sec-to-my	vas-ec-to-my
base-bal-l	base-ball
boathouse	boat-house
i-nane	in-ane
di-alec-ti-cal	di-a-lec-ti-cal
u-n-af-fect-ed	un-af-fect-ed
re-new-able	re-new-a-ble
preda-tor	pred-a-tor
cope-d	coped
e-vo-ca-tion	ev-o-ca-tion
footage	foot-age
u-p-lift-ed	uplifted
over-land	o-ver-land
e-jec-t	e-ject
ple-b	pleb
record-ed	re-cor-ded
cedil-la	ce-dil-la
mus-ke-teer	mus-ket-eer
overuse	o-ver-use
high-lander	high-lan-der
over-state-men-t	o-ver-state-ment
treach-ery	treach-er-y
ob-tain-able	ob-tain-a-ble
s-lith-er	slith-er
mit-t	mitt
col-lec-tivis-m	col-lec-tiv-ism
blud-geon	bludg-eon
onus	o-nus
e-vanes-cen-t	ev-a-nes-cent
fre-quent-ed	frequented
mit-i-gat-ing	mitigating
hy-per-boloid	hy-per-bo-loid
in-vari-ant	in-var-i-ant
shrim-p	shrimp
tri-adic	tri-ad-ic
un-re-cov-er-able	un-re-cov-er-a-ble
pesky	pes-ky
over-whelm	o-ver-whelm
hosepipe	hose-pipe
frontal	fron-tal
elite	e-lite
fibu-la	fib-u-la
meaty	meat-y
in-fan-t	in-fant
fatu-ous	fat-u-ous
sim-u-lacrum	sim-u-la-crum
con-form-able	con-form-a-ble
cochlea	coch-le-a
mythol-o-gy	my-thol-o-gy
wari-ness	war-i-ness
de-bauch-ery	de-bauch-er-y
over-al-l	o-ver-all
na-tion-al-is-m	na-tion-al-ism
en-dow-men-t	en-dow-ment
cheva-lier	chev-a-lier
wa-ter-fron-t	wa-ter-front
s-trap-less	strap-less
choco-late	choc-o-late
s-pa-cious	spa-cious
risky	risk-y
crisply	crisp-ly
catchy	catch-y
sub-con-ti-nen-t	sub-con-ti-nent
tele-o-log-i-cal	tel-e-o-log-i-cal
mar-itime	mar-i-time
ex-oskele-ton	ex-o-skel-e-ton
in-hala-tion	in-ha-la-tion
s-to-ic	sto-ic
forest-ed	forested
dis-obey	dis-o-bey
reap-pear	re-ap-pear
epi-der-mis	ep-i-der-mis
ex-trac-t	ex-tract
cloa-ca	clo-a-ca
s-tim-u-lat-ing	stim-u-lat-ing
naked	na-ked
laud-ed	lauded
nu-tri-men-t	nu-tri-ment
satirist	sat-i-rist
blue-bel-l	blue-bell
un-com-fort-able	un-com-fort-a-ble
forty	for-ty
loathing	loath-ing
in-n	inn
in-jury	in-ju-ry
both-ered	bothered
ig-no-ran-t	ig-no-rant
im-politic	im-pol-i-tic
valise	va-lise
stal-l	stall
baguette	ba-guette
gan-g-ly	gan-gly
squally	squal-ly
over-am-bi-tious	o-ver-am-bi-tious
tam-p	tamp
paving	pav-ing
s-tim-u-late	stim-u-late
im-p	imp
hy-dro-stat-ic-s	hy-dro-stat-ics
e-quidis-tan-t	e-qui-dis-tant
pipette	pi-pette
un-quench-able	un-quench-a-ble
com-pen-sato-ry	com-pen-sa-to-ry
in-com-bustible	in-com-bus-ti-ble
monog-a-mous	mo-nog-a-mous
aplen-ty	a-plen-ty
raven-ing	rav-en-ing
iso-stat-ic	i-so-stat-ic
stipen-di-ary	sti-pen-di-ar-y
s-mooth-ly	smooth-ly
out-cal-l	out-call
ex-i-gen-t	ex-i-gent
s-mooth-ness	smooth-ness
s-nort	snort
hos-pitable	hos-pi-ta-ble
in-fir-m	in-firm
ra-tio-nal	ra-tion-al
spi-dery	spi-der-y
pronom-i-nal	pro-nom-i-nal
takeover	take-o-ver
pro-tec-torate	pro-tec-tor-ate
lever-age	lev-er-age
un-ob-jec-tion-able	un-ob-jec-tion-a-ble
limekil-n	lime-kiln
silen-t	si-lent
crafty	craft-y
necrophil-i-a	nec-ro-phil-i-a
aro-mat-ic	ar-o-mat-ic
pay-rol-l	pay-roll
zenith	ze-nith
com-muter	com-mut-er
col-lapsi-ble	col-laps-i-ble
fem-i-nis-m	fem-i-nism
re-cal-ci-tran-t	re-cal-ci-trant
scratchy	scratch-y
nifty	nif-ty
nineti-eth	nine-ti-eth
ar-rester	ar-rest-er
crum-b	crumb
au-dio-vi-su-al	au-di-o-vis-u-al
dis-in-fec-tan-t	dis-in-fect-ant
impi-ety	im-pi-e-ty
tremo-lo	trem-o-lo
de-brief-in-g	debriefing
jour-nal-is-m	jour-nal-ism
scholas-ti-cis-m	scho-las-ti-cism
postlude	post-lude
rein-car-na-tion	re-in-car-na-tion
s-lan-der-ous	slan-der-ous
w-ere-wolf	were-wolf
gad-getry	gadg-et-ry
meta-phys-i-cal	met-a-phys-i-cal
hearsay	hear-say
dumpy	dump-y
rosy	ros-y
troglodyte	trog-lo-dyte
s-cullery	scul-ler-y
pauci-ty	pau-ci-ty
vari-a-tion	var-i-a-tion
para-nor-mal	par-a-nor-mal
e-tu-i	e-tui
pig-ment-ed	pig-men-ted
event-ful	e-vent-ful
serendip-i-tous	ser-en-dip-i-tous
co-conut	co-co-nut
retic-u-lar	re-tic-u-lar
stony	ston-y
zealotry	zeal-ot-ry
paramed-i-cal	par-a-med-i-cal
p-salmody	psal-mo-dy
penknife	pen-knife
monau-ral	mon-au-ral
mealie	meal-ie
bil-iary	bil-i-ar-y
labyrinth	lab-y-rinth
li-brary	li-brar-y
mimicry	mim-ic-ry
im-pe-cu-nious	im-pe-cu-ni-ous
in-ter-vie-wee	in-ter-view-ee
vig-i-lan-t	vig-i-lant
un-re-pen-tan-t	un-re-pent-ant
func-tion-al-is-m	func-tion-al-ism
turquoise	tur-quoise
ex-tend-able	ex-tend-a-ble
turfy	turf-y
over-tone	o-ver-tone
er-gonom-ic	er-go-nom-ic
pro-trac-t	pro-tract
rock-ing	rocking
ini-ti-a-tion	in-i-ti-a-tion
s-nook-er	snook-er
man-telshelf	man-tel-shelf
valid	val-id
marcher	march-er
dauphin	dau-phin
book-stal-l	book-stall
s-mat-ter-ing	smat-ter-ing
s-tran-gle	stran-gle
sur-f	surf
e-d-u-ca-tor	ed-u-ca-tor
s-to-ry-book	sto-ry-book
mod-ernist	mod-ern-ist
dy-namo	dy-na-mo
kinder-garten	kin-der-gar-ten
k-ib-butz	kib-butz
pekan	pek-an
in-ces-t	in-cest
pow-dery	pow-der-y
s-i-nu-soidal	si-nus-oi-dal
eleven	e-lev-en
monochro-mat-ic	mon-o-chro-mat-ic
handy	hand-y
s-cold	scold
tru-an-t	tru-ant
lousy	lous-y
s-neak	sneak
lamb-swool	lambs-wool
e-s-o-ter-i-ca	es-o-ter-i-ca
s-pan-gle	span-gle
dis-tinc-t	dis-tinct
k-nack-er	knack-er
con-ser-va-tive	con-serv-a-tive
grouper	group-er
syl-labub	syl-la-bub
con-sid-er-able	con-sid-er-a-ble
warpath	war-path
roulette	rou-lette
door-bel-l	door-bell
do-lor-ous	dol-or-ous
p-reser-va-tive	pre-serv-a-tive
elu-sive	e-lu-sive
sweaty	sweat-y
in-audi-ble	in-au-di-ble
rein-sert	re-in-sert
reshow	re-show
min-uet	min-u-et
habi-tat	hab-i-tat
perquisite	per-qui-site
cesspit	cess-pit
un-der-stand-able	un-der-stand-a-ble
s-lap	slap
wa-tery	wa-ter-y
chaf-f	chaff
caviar	cav-i-ar
ini-tial	in-i-tial
lethar-gy	leth-ar-gy
ob-jec-tion-able	ob-jec-tion-a-ble
ni-hilis-tic	ni-hil-is-tic
key-boardis-t	key-board-ist
over-hand	o-ver-hand
mayflow-er	may-flow-er
plushy	plush-y
cen-tripetal	cen-trip-e-tal
kinswom-an	kins-wom-an
friendlily	friend-li-ly
im-pressed	impressed
in-clemen-t	in-clem-ent
salin-i-ty	sa-lin-i-ty
islet	is-let
stapes	sta-pes
co-gen-t	co-gent
foot-balling	foot-ball-ing
kil-l	kill
in-deli-ble	in-del-i-ble
k-i-nase	ki-nase
over-work	o-ver-work
buf-f	buff
mer-chantable	mer-chant-a-ble
re-con-nec-t	re-con-nect
para-medic	par-a-med-ic
styling	styl-ing
ex-plorato-ry	ex-plor-a-to-ry
con-ver-san-t	con-ver-sant
tri-umvi-rate	tri-um-vi-rate
pro-tean	pro-te-an
leisure-ly	lei-sure-ly
over-draw	o-ver-draw
tepid	tep-id
fly-away	fly-a-way
w-hole	whole
rapid	rap-id
a-pos-tolic	ap-os-tol-ic
purist	pur-ist
stetho-scope	steth-o-scope
dic-tio-n	dic-tion
squalor	squal-or
mo-nop-oly	mo-nop-o-ly
s-lur-ry	slur-ry
ovoid	o-void
en-joy-ably	en-joy-a-bly
backgam-mon	back-gam-mon
hideous	hid-e-ous
innkeep-er	inn-keep-er
mar-quetry	mar-que-try
nympho-ma-ni-ac	nym-pho-ma-ni-ac
re-tiree	re-tir-ee
glos-sary	glos-sa-ry
ap-proach-able	ap-proach-a-ble
monastery	mon-as-ter-y
syn-ovial	syn-o-vi-al
samovar	sam-o-var
gelatin	gel-a-tin
patho-gen-e-sis	path-o-gen-e-sis
pep-pery	pep-per-y
lava-to-ri-al	lav-a-to-ri-al
ex-che-quer	ex-cheq-uer
mufti	muf-ti
repet-i-tive	re-pet-i-tive
prepo-si-tion-al	prep-o-si-tion-al
s-ta-tus	sta-tus
idly	i-dly
reis-sue	re-is-sue
dev-il-men-t	dev-il-ment
i-n-or-di-nate-ly	in-or-di-nate-ly
en-thalpy	en-thal-py
no-madic	no-mad-ic
opales-cen-t	o-pal-es-cent
ranter	rant-er
sar-i	sa-ri
in-con-ti-nen-t	in-con-ti-nent
en-camp-men-t	en-camp-ment
impi	im-pi
s-niff-in-g	sniffing
s-lip-per	slip-per
welly	wel-ly
im-ple-menter	im-ple-ment-er
sec-tar-i-an-is-m	sec-tar-i-an-ism
n-ear-by	near-by
dowdy	dow-dy
s-pawn	spawn
whoop-s	whoops
c-og-nizance	cog-ni-zance
unin-sur-able	un-in-sur-a-ble
u-n-aware	un-a-ware
un-handy	un-hand-y
groundswell	ground-swell
ra-tio-nal-ly	ra-tion-al-ly
s-lan-der	slan-der
curly	curl-y
prophet-ic	pro-phet-ic
asym-me-try	a-sym-me-try
s-ap-per	sap-per
fid-get	fidg-et
fer-men-t	fer-ment
min-der	mind-er
lentil	len-til
i-n-ad-e-quate	in-ad-e-quate
there-after	there-af-ter
reper-cus-sion	re-per-cus-sion
awak-en	a-wak-en
frat-ri-ci-dal	frat-ri-cid-al
electable	e-lect-a-ble
fer-ven-t	fer-vent
s-tain-less	stain-less
driver-less	driv-er-less
rosette	ro-sette
in-stan-t	in-stant
ver-bosi-ty	ver-bos-i-ty
neu-ro-surgery	neu-ro-sur-ger-y
par-si-mo-nious	par-si-mo-ni-ous
de-sir-abil-i-a	de-si-ra-bi-li-a
anonymi-ty	an-o-nym-i-ty
funky	funk-y
ef-fer-en-t	ef-fer-ent
billing	bil-ling
dullard	dull-ard
s-noop	snoop
in-famy	in-fa-my
de-ter-minable	de-ter-mi-na-ble
igloo	ig-loo
hy-dropho-bic	hy-dro-pho-bic
e-clec-tic	ec-lec-tic
pil-l	pill
em-ploy-able	em-ploy-a-ble
sup-ple-men-tary	sup-ple-men-ta-ry
moun-t	mount
pur-suer	pur-su-er
dis-place-men-t	dis-place-ment
sana-to-ri-um	san-a-to-ri-um
om-nipres-ence	om-ni-pres-ence
illiq-uid	il-liq-uid
choral	cho-ral
anom-aly	a-nom-a-ly
ex-tralin-guis-tic	ex-tra-lin-guis-tic
welling-ton	wel-ling-ton
restora-tion	res-to-ra-tion
take-away	take-a-way
non-con-formist	non-con-form-ist
panties	pant-ies
despot	des-pot
over-growth	o-ver-growth
woodsmoke	wood-smoke
l-itotes	li-to-tes
builder	build-er
dis-traugh-t	dis-traught
hexa-dec-i-mal	hex-a-dec-i-mal
t-wo-some	two-some
alive	a-live
toi-letries	toi-let-ries
bar-barous	bar-ba-rous
wildlife	wild-life
man-age-able	man-age-a-ble
tubu-lar	tu-bu-lar
mildewy	mil-dew-y
click-ing	clicking
epis-co-pal	e-pis-co-pal
lap-idary	lap-i-dar-y
casi-no	ca-si-no
twitchy	twitch-y
pullover	pull-o-ver
idyl-lic	i-dyl-lic
sushi	su-shi
cru-cible	cru-ci-ble
crooked	crook-ed
pre-dictabil-i-ty	pre-dict-a-bil-i-ty
dogs-body	dogs-bod-y
iso-topic	i-so-top-ic
dinky	dink-y
un-re-served-ly	un-re-serv-ed-ly
palat-able	pal-at-a-ble
tiger-ish	ti-ger-ish
in-eluctable	in-e-luc-ta-ble
be-wil-der-ing	bewildering
man-dolin	man-do-lin
in-spec-t	in-spect
taskmas-ter	task-mas-ter
evince	e-vince
in-can-des-cen-t	in-can-des-cent
unloved	un-loved
chan-t	chant
cryo-genic	cry-o-gen-ic
phrenol-o-gy	phre-nol-o-gy
mono-pole	mon-o-pole
head-mistress	head-mis-tress
ver-biage	ver-bi-age
aor-ta	a-or-ta
in-hos-pitable	in-hos-pi-ta-ble
rub-bishy	rub-bish-y
lusty	lust-y
re-al-is-m	re-al-ism
tran-scen-den-t	tran-scend-ent
trans-ceiver	trans-ceiv-er
es-capee	es-cap-ee
garbage	gar-bage
deca-dence	dec-a-dence
lamp-lighter	lamp-light-er
in-valu-able	in-val-u-a-ble
trea-son-able	trea-son-a-ble
s-plash	splash
de-ity	de-i-ty
land-for-m	land-form
rhodi-um	rho-di-um
night-fal-l	night-fall
sprayer	spray-er
ringer	ring-er
boohoo	boo-hoo
ur-ticari-a	ur-ti-car-i-a
taster	tast-er
in-ter-con-nec-t	in-ter-con-nect
de-odor-an-t	de-o-dor-ant
flood-ing	flooding
w-hole-some	whole-some
de-nial	de-ni-al
hayloft	hay-loft
at-tribu-tive	at-trib-u-tive
avail-abil-i-ty	a-vail-a-bil-i-ty
bio-sphere	bi-o-sphere
re-sis-tance	re-sist-ance
fer-n	fern
shogun	sho-gun
iso-bar	i-so-bar
fore-ar-m	fore-arm
re-assess-men-t	re-as-sess-ment
stew-ardess	stew-ard-ess
over-charge	o-ver-charge
testy	tes-ty
tacho-graph	tach-o-graph
flautist	flau-tist
ca-ma-raderie	ca-ma-ra-de-rie
un-nerv-ing	unnerving
lisp-ing	lis-ping
joey	jo-ey
sen-ti-men-tal-is-m	sen-ti-men-tal-ism
ship-builder	ship-build-er
solem-n	sol-emn
reshuf-fle	re-shuf-fle
cele-ri-ac	ce-ler-i-ac
mul-ti-pro-ces-sor	mul-ti-proc-es-sor
i-n-ad-e-quate-ly	in-ad-e-quate-ly
lessee	les-see
grenadier	gren-a-dier
pre-tex-t	pre-text
squeaky	squeak-y
s-cor-pi-on	scor-pi-on
canon-i-cal	ca-non-i-cal
brigade	bri-gade
buf-fer	buff-er
par-tic-u-lar-is-m	par-tic-u-lar-ism
s-trange-ness	strange-ness
over-sight	o-ver-sight
s-tark-ly	stark-ly
per-tur-b	per-turb
s-pleen	spleen
over-heat	o-ver-heat
ibis	i-bis
re-cen-t	re-cent
qua-drat-ic	quad-rat-ic
in-dict-men-t	in-dict-ment
arach-nid	a-rach-nid
melo-dra-mat-ic	mel-o-dra-mat-ic
puerile	pu-er-ile
trans-par-en-t	trans-par-ent
mata-dor	mat-a-dor
numb-skul-l	numb-skull
conker	conk-er
tec-ton-ic-s	tec-ton-ics
drifter	drift-er
over-load-ed	overloaded
bio-met-ric-s	bi-o-met-rics
macaw	ma-caw
bal-alai-ka	bal-a-lai-ka
fet-tered	fettered
pa-p	pap
ide-al-is-m	i-de-al-ism
em-ployed	employed
e-q-ui-ty	eq-ui-ty
apolo-get-ic	a-pol-o-get-ic
driv-able	driv-a-ble
com-mod-e	com-mode
resid-u-al	re-sid-u-al
retroac-tive-ly	ret-ro-ac-tive-ly
e-gal-i-tar-i-an-is-m	e-gal-i-tar-i-an-ism
micro-organ-ism	mi-cro-or-gan-ism
mut-t	mutt
lament-ed	la-ment-ed
odi-um	o-di-um
auburn	au-burn
s-tat-ue	stat-ue
in-ter-roga-tor	in-ter-ro-ga-tor
s-pam	spam
quest-ing	questing
ge-ome-ter	ge-om-e-ter
an-thracite	an-thra-cite
vi-o-len-t	vi-o-lent
e-clec-ti-cis-m	ec-lec-ti-cism
wall-flower	wall-flow-er
macro-scop-ic	mac-ro-scop-ic
gas-work-s	gas-works
mis-sion-ary	mis-sion-ar-y
polyester	pol-y-es-ter
saline	sa-line
uten-sil	u-ten-sil
in-dis-putable	in-dis-put-a-ble
ple-nary	ple-na-ry
con-fir-m	con-firm
sonorous	so-no-rous
merid-i-an	me-rid-i-an
diode	di-ode
clin-i-cian	cli-ni-cian
k-nav-ish	knav-ish
s-lash	slash
s-mear	smear
ru-inous	ru-in-ous
unchris-tian	un-chris-tian
pesti-len-t	pes-ti-lent
nitwit	nit-wit
s-lug-gish	slug-gish
tonal-i-ty	to-nal-i-ty
rain-fal-l	rain-fall
n-im-ble-ness	nim-ble-ness
un-al-ter-able	un-al-ter-a-ble
lessen	less-en
om-ni-science	om-nis-cience
in-spec-torate	in-spec-tor-ate
n-ev-er-the-less	nev-er-the-less
serene-ly	se-rene-ly
w-hole-sale	whole-sale
biosyn-the-sis	bi-o-syn-the-sis
method-olog-i-cal	meth-od-o-log-i-cal
s-pear-head	spear-head
geno-ci-dal	gen-o-cid-al
chrono-log-i-cal-ly	chron-o-log-i-cal-ly
ex-plo-ration	ex-plo-ra-tion
polyp	pol-yp
hooray	hoo-ray
bailout	bail-out
s-mug-gle	smug-gle
an-tide-pres-san-t	an-ti-de-pres-sant
s-tun-t	stunt
sycamore	syc-a-more
whoso-ev-er	who-so-ev-er
melod-ic	me-lod-ic
spec-troscopy	spec-tros-co-py
puer-per-al	pu-er-per-al
s-word	sword
plat-inum	plat-i-num
in-com-men-su-rable	in-com-men-su-ra-ble
tri-bune	trib-une
sinker	sink-er
in-evitabil-i-ty	in-ev-i-ta-bil-i-ty
signet	sig-net
an-thro-po-mor-phis-m	an-thro-po-mor-phism
saucepan	sauce-pan
skua	sku-a
ex-tra-or-di-nary	ex-traor-di-nar-y
per-ineum	per-i-ne-um
s-carce	scarce
gulli-bil-i-ty	gul-li-bil-i-ty
auger	au-ger
s-cone	scone
methanol	meth-a-nol
trilin-gual	tri-lin-gual
paci-fis-m	pac-i-fism
maser	ma-ser
s-mil-ing	smil-ing
myelin	my-e-lin
tro-po-sphere	trop-o-sphere
bul-gy	bulg-y
erot-ic	e-rot-ic
or-ga-ni-za-tion	or-gan-i-za-tion
ax-olotl	ax-o-lotl
blur-b	blurb
as-tro-nau-tic-s	as-tro-nau-tics
en-cycli-cal	en-cyc-li-cal
il-menite	il-men-ite
necro-man-cy	nec-ro-man-cy
un-drink-able	un-drink-a-ble
over-time	o-ver-time
as-tronomer	as-tron-o-mer
awning	awn-ing
colan-der	col-an-der
over-writ-ing	overwriting
un-pro-nounce-able	un-pro-nounce-a-ble
for-giv-able	for-giv-a-ble
gen-t	gent
con-sul-tan-cy	con-sult-an-cy
eosin	e-o-sin
s-traw	straw
cos-set-ed	cosseted
potable	po-ta-ble
apoplexy	ap-o-plex-y
ri-fled	rifled
rec-ti-lin-ear	rec-ti-lin-e-ar
thinker	think-er
pri-apic	pri-ap-ic
skul-l	skull
novice	nov-ice
sawyer	saw-yer
bel-liger-ence	bel-lig-er-ence
radish	rad-ish
mil-i-taris-tic	mil-i-ta-ris-tic
re-al-ness	real-ness
brioche	bri-oche
leapfrog	leap-frog
petrol-o-gy	pe-trol-o-gy
su-perbly	su-perb-ly
un-trans-lat-able	un-trans-lat-a-ble
om-nipresen-t	om-ni-pres-ent
sloven-ly	slov-en-ly
e-cho	ech-o
pes-simistic	pes-si-mis-tic
ra-dia-tive	ra-di-a-tive
su-per-fluity	su-per-flu-i-ty
bur-geon-ing	burgeoning
un-change-able	un-change-a-ble
con-for-mance	con-form-ance
apolo-gia	ap-o-lo-gi-a
en-fee-bled	enfeebled
fri-able	fri-a-ble
end-s	ends
re-open	re-o-pen
over-state	o-ver-state
cat-a-com-b	cat-a-comb
tequi-la	te-qui-la
retest	re-test
pan-das	pan-das
malev-o-len-t	ma-lev-o-lent
grouchy	grouch-y
s-tat-uette	stat-u-ette
he-lio-sphere	he-li-o-sphere
itchy	itch-y
mendele-vi-um	men-de-le-vi-um
g-lut	glut
dry-s-tone	dry-stone
over-ripe	o-ver-ripe
calorime-ter	cal-o-rim-e-ter
he-li-copter	hel-i-cop-ter
medal	med-al
psy-cho-anal-y-sis	psy-cho-a-nal-y-sis
seabird	sea-bird
mis-nomer	mis-no-mer
thread-ed	threaded
whistler	whis-tler
dentin	den-tin
ho-mo-ge-neous	ho-mo-ge-ne-ous
pleas-antry	pleas-ant-ry
op-ti-mistic	op-ti-mis-tic
desert	de-sert
re-cal-l	re-call
menar-che	men-ar-che
drol-l	droll
s-pan-ner	span-ner
ir-re-solv-able	ir-re-solv-a-ble
phooey	phoo-ey
im-per-ish-able	im-per-ish-a-ble
surfer	surf-er
tri-umphant-ly	tri-um-phant-ly
chro-mo-so-ma-l	chro-mo-so-mal
na-iad	nai-ad
galleon	gal-le-on
mil-i-tary	mil-i-tar-y
waxy	wax-y
s-teeple-jack	stee-ple-jack
re-pel-len-t	re-pel-lent
polyun-sat-u-rat-ed	pol-y-un-sat-u-rat-ed
salu-tary	sal-u-tar-y
steamship	steam-ship
ide-o-logue	i-de-o-logue
de-vour-ing	devouring
em-piri-cist	em-pir-i-cist
haystack	hay-stack
in-ex-cus-able	in-ex-cus-a-ble
pen-tathlon	pen-tath-lon
s-porty	sport-y
hireling	hire-ling
in-con-gruity	in-con-gru-i-ty
squadron	squad-ron
lemon-ade	lem-on-ade
tight-s	tights
kneecap	knee-cap
as-segai	as-se-gai
eon	e-on
cre-ative-ly	cre-a-tive-ly
en-trap-men-t	en-trap-ment
mazur-ka	ma-zur-ka
hys-terec-to-my	hys-ter-ec-to-my
s-lat-ted	slat-ted
avun-cu-lar	a-vun-cu-lar
cashew	cash-ew
gumshoe	gum-shoe
endgame	end-game
im-ple-men-t	im-ple-ment
nut-s	nuts
rhetoric	rhet-o-ric
man-ner-is-m	man-ner-ism
avid-ly	av-id-ly
twister	twist-er
fuse-lage	fu-se-lage
s-plat-ter	splat-ter
ep-ithe-li-um	ep-i-the-li-um
ha-track	hat-rack
limo	lim-o
barter	bar-ter
en-tomb-men-t	en-tomb-ment
holdal-l	hold-all
break-able	break-a-ble
fever-ish	fe-ver-ish
im-peach-men-t	im-peach-ment
s-tooge	stooge
s-tock-ist	stock-ist
flip-pan-t	flip-pant
ref-er-ee-ing	re-fe-ree-ing
busi-ly	bus-i-ly
per-mit-ting	permitting
ver-dic-t	ver-dict
gatepost	gate-post
eter-nal	e-ter-nal
re-minder	re-mind-er
in-dus-tri-al-is-m	in-dus-tri-al-ism
reclu-sive	re-clu-sive
tan-ta-moun-t	tan-ta-mount
re-uni-fi-ca-tion	re-u-ni-fi-ca-tion
posse	pos-se
s-lum-ber	slum-ber
d-is-fig-ure-men-t	dis-fig-ure-ment
in-vesti-ture	in-ves-ti-ture
sol-diery	sol-dier-y
teleprint-er	tel-e-print-er
in-su-lan-t	in-su-lant
naval	na-val
tri-umphal	tri-um-phal
donor	do-nor
de-rail-men-t	de-rail-ment
hoary	hoar-y
un-easi-ly	un-eas-i-ly
hul-la-baloo	hul-la-ba-loo
winger	wing-er
ma-hogany	ma-hog-a-ny
ev-ery	eve-ry
breathy	breath-y
erec-tile	e-rec-tile
re-place-able	re-place-a-ble
cin-e-matog-ra-pher	cin-e-ma-tog-ra-pher
cyanide	cy-a-nide
plu-per-fec-t	plu-per-fect
s-phyg-mo-manome-ter	sphyg-mo-ma-nom-e-ter
dis-heart-ened	dis-hear-tened
codex	co-dex
colonic	co-lon-ic
ty-pog-ra-pher-s	ty-po-gra-phers
pun-ish-men-t	pun-ish-ment
squirearchy	squire-ar-chy
chromite	chro-mite
hypochon-dri-a-cal	hy-po-chon-dri-a-cal
sagac-i-ty	sa-gac-i-ty
mono-plane	mon-o-plane
tri-den-t	tri-dent
k-ilo-byte	kil-o-byte
sex-tan-t	sex-tant
op-por-tunis-m	op-por-tun-ism
s-torm-ing	storm-ing
mono-logue	mon-o-logue
damnable	dam-na-ble
ra-dio-g-ra-pher	ra-di-og-ra-pher
net-work-ing	networking
s-paghet-ti	spa-ghet-ti
com-mer-cial-is-m	com-mer-cial-ism
pedi-gree	ped-i-gree
seascape	sea-scape
of-fend-ing	of-fen-ding
bowl-s	bowls
pro-ba-tion-ary	pro-ba-tion-ar-y
event-ing	e-vent-ing
monar-chy	mon-ar-chy
aor-tic	a-or-tic
framer	fram-er
in-quisi-tor	in-quis-i-tor
dim-pled	dimpled
marshy	marsh-y
con-fec-tionery	con-fec-tion-er-y
de-flec-t	de-flect
dark-ened	dar-kened
p-tarmi-gan	ptar-mi-gan
semi-cir-cle	sem-i-cir-cle
chronol-o-gy	chro-nol-o-gy
sanc-tu-ary	sanc-tu-ar-y
b-lis-tered	blistered
bougainvil-lea	bou-gain-vil-le-a
n-ev-er	nev-er
ar-range-men-t	ar-range-ment
arouse	a-rouse
wind-sur-f	wind-surf
mono-lay-er	mon-o-lay-er
bologna	bo-lo-gna
anoma-lous	a-nom-a-lous
handrail	hand-rail
poly-no-mi-al	pol-y-no-mi-al
clover	clo-ver
brochure	bro-chure
retroac-tive	ret-ro-ac-tive
vestibu-lar	ves-tib-u-lar
hail-stor-m	hail-storm
cack-ling	cackling
silage	si-lage
ari-a	a-ri-a
swarm-ing	swarming
s-lip-pery	slip-per-y
s-teeple-chase	stee-ple-chase
styrene	sty-rene
her-itage	her-it-age
s-ta-di-um	sta-di-um
g-luti-nous	glu-ti-nous
ju-rispru-dence	ju-ris-pru-dence
obe-di-ence	o-be-di-ence
dis-ar-m	dis-arm
s-tand-stil-l	stand-still
whiskey	whis-key
mer-cury	mer-cu-ry
car-bonyl	car-bon-yl
u-n-awak-ened	un-a-wak-ened
trumpery	trump-er-y
in-fect-ed	in-fec-ted
para-graph	par-a-graph
swishy	swish-y
over-flow	o-ver-flow
bar-b	barb
anteater	ant-eat-er
o-live	ol-ive
steno-sis	ste-no-sis
think-able	think-a-ble
platelet	plate-let
un-prece-dent-ed	un-prec-e-dent-ed
y-owl	yowl
quadri-lat-er-al	quad-ri-lat-er-al
ful-l	full
presto	pres-to
brinkman-ship	brink-man-ship
place-bo	pla-ce-bo
de-cen-t	de-cent
anx-i-ety	anx-i-e-ty
elec-trol-y-sis	e-lec-trol-y-sis
usurer	u-su-rer
ripen	rip-en
bivouac	biv-ou-ac
erode	e-rode
provoca-tive-ly	pro-voc-a-tive-ly
golfer	golf-er
s-toke	stoke
reac-qui-si-tion	re-ac-qui-si-tion
coast-ing	coasting
b-lench	blench
t-in-gle	tin-gle
un-ortho-doxy	un-or-tho-dox-y
jus-ti-fi-ably	jus-ti-fi-a-bly
un-think-able	un-think-a-ble
para-keet	par-a-keet
un-com-mu-nica-tive	un-com-mu-ni-ca-tive
mys-tery	mys-ter-y
hardy	har-dy
racial-ly	ra-cial-ly
kudu	ku-du
hookah	hook-ah
re-cruiter	re-cruit-er
pre-sum-ably	pre-sum-a-bly
s-teer	steer
dis-join-t	dis-joint
over-in-flat-ed	o-ver-in-flat-ed
ethno-graph-ic	eth-no-graph-ic
mer-ce-nary	mer-ce-nar-y
spir-i-tu-al-ist	spir-it-u-al-ist
de-con-struc-tive	deconstructive
di-elec-tric	di-e-lec-tric
k-it	kit
en-hancer	en-hanc-er
flinty	flint-y
re-spectabil-i-ty	re-spect-a-bil-i-ty
baoba-b	ba-o-bab
va-can-t	va-cant
bases	ba-ses
tusker	tusk-er
hawthorn	haw-thorn
flutist	flut-ist
re-freshed	refreshed
spir-i-tu-al-is-m	spir-it-u-al-ism
syl-labary	syl-la-bar-y
s-traight-away	straight-a-way
heady	head-y
ref-er-en-t	ref-er-ent
mistype	mis-type
in-abil-i-ty	in-a-bil-i-ty
spir-i-tu-al	spir-it-u-al
head-scar-f	head-scarf
iris	i-ris
shoplift	shop-lift
cretinous	cre-tin-ous
dis-avow	dis-a-vow
in-fini-tive	in-fin-i-tive
con-form-ity	con-form-i-ty
par-lia-men-tary	par-lia-men-ta-ry
el-e-men-tary	el-e-men-ta-ry
catas-tro-phe	ca-tas-tro-phe
claret	clar-et
lectern	lec-tern
lin-ear-ly	lin-e-ar-ly
d-enizen	den-i-zen
for-man-t	for-mant
iron-stone	i-ron-stone
gallery	gal-ler-y
u-n-ac-com-pa-nied	un-ac-com-pa-nied
ob-stet-ric-s	ob-stet-rics
ex-is-ten-tial-is-m	ex-is-ten-tial-ism
furtive-ly	fur-tive-ly
ne-go-tiable	ne-go-ti-a-ble
u-p-land	up-land
as-sailan-t	as-sail-ant
mist-ime	mis-time
s-low-poke	slow-poke
round-about	round-a-bout
ex-pan-sion-is-m	ex-pan-sion-ism
diplo-ma	di-plo-ma
be-fud-dled	befuddled
layper-son	lay-per-son
gory	gor-y
moral-is-tic	mor-al-is-tic
gen-eros-i-ty	gen-er-os-i-ty
s-toa	sto-a
tonight	to-night
physi-cian	phy-si-cian
stingray	sting-ray
promp-t	prompt
pen-chan-t	pen-chant
ar-gen-t	ar-gent
s-aber	sa-ber
tele-phone	tel-e-phone
de-ter-gen-t	de-ter-gent
gamut	gam-ut
e-ques-tri-an-is-m	e-ques-tri-an-ism
in-con-sis-ten-t	in-con-sist-ent
cre-ation-is-m	cre-a-tion-ism
over-run	o-ver-run
playable	play-a-ble
dis-junc-t	dis-junct
philol-o-gy	phi-lol-o-gy
di-choto-my	di-chot-o-my
so-lic-it-ing	soliciting
mal-ad-just-men-t	mal-ad-just-ment
u-n-avoid-able	un-a-void-a-ble
imag-in-ings	im-ag-in-ings
glasshouse	glass-house
roofer	roof-er
u-nion	un-ion
man-i-festo	man-i-fes-to
over-drive	o-ver-drive
phi-lan-thropy	phi-lan-thro-py
pom-padour	pom-pa-dour
tele-pho-ny	te-leph-o-ny
en-force-men-t	en-force-ment
in-ter-locu-tor	in-ter-loc-u-tor
an-titrust	an-ti-trust
good-night	goodnight
celandine	cel-an-dine
u-nan-tic-i-pat-ed	un-an-tic-i-pat-ed
showy	show-y
humbly	hum-bly
reroute	re-route
p-light	plight
s-plin-t	splint
bi-sec-t	bi-sect
dizzi-ness	diz-zi-ness
s-ling	sling
s-tand-ing	stand-ing
porter-age	por-ter-age
l-itur-gy	lit-ur-gy
urine	u-rine
s-tatis-ti-cian	stat-is-ti-cian
ex-em-plary	ex-em-pla-ry
aquar-i-um	a-quar-i-um
de-ter-mi-nan-t	de-ter-mi-nant
gateau	ga-teau
de-liv-ery	de-liv-er-y
ar-chiv-ist	ar-chi-vist
mut-ter-ing	muttering
as-cen-der	as-cend-er
pam-phle-teer	pam-phlet-eer
holis-ti-cal-ly	ho-lis-ti-cal-ly
s-teep	steep
puz-zle-men-t	puz-zle-ment
collinear	col-lin-e-ar
wrinkly	wrin-kly
pru-den-t	pru-dent
re-pub-li-can-is-m	re-pub-li-can-ism
dis-tur-b	dis-turb
damna-tion	dam-na-tion
stretchy	stretch-y
hang-over	hang-o-ver
en-thralling	en-thral-ling
ine-bri-ate	in-e-bri-ate
s-ta-tion	sta-tion
dis-tin-guish-able	dis-tin-guish-a-ble
shekel	shek-el
stymie	sty-mie
goody	good-y
fruition	fru-i-tion
s-taunch	staunch
reper-to-ry	rep-er-to-ry
co-ef-fi-cien-t	co-ef-fi-cient
cop-pery	cop-per-y
astride	a-stride
overnight	o-ver-night
di-ver-gen-t	di-ver-gent
puffer	puff-er
but-tered	buttered
eigh-teenth	eight-eenth
pro-pri-etor-ship	pro-pri-e-tor-ship
hobo	ho-bo
phos-pho-r	phos-phor
s-lug	slug
wan-t	want
s-mall-hold-er	small-hold-er
crevice	crev-ice
elec-tron-ic-s	e-lec-tron-ics
demo-crat-ic	dem-o-crat-ic
over-pass	o-ver-pass
s-mug-ness	smug-ness
ar-madil-lo	ar-ma-dil-lo
mores	mo-res
op-u-len-t	op-u-lent
im-per-me-able	im-per-me-a-ble
drama-tist	dram-a-tist
rev-e-la-to-ry	re-vel-a-to-ry
mis-align-men-t	mis-a-lign-ment
t-int-ed	tinted
spen-t	spent
s-lan-t	slant
in-duc-t	in-duct
pirou-ette	pir-ou-ette
rogu-ish	ro-guish
lyrist	lyr-ist
bot-tled	bottled
swar-m	swarm
crozi-er	cro-zier
e-u-pho-ri-a	eu-pho-ri-a
del-l	dell
con-fir-ma-to-ry	con-firm-a-to-ry
aphro-disi-ac	aph-ro-dis-i-ac
u-n-ap-peal-ing	un-ap-peal-ing
mono-cul-ture	mon-o-cul-ture
plumy	plum-y
un-promis-ing	un-prom-is-ing
aun-t	aunt
delux-e	de-luxe
glaciat-ed	gla-ci-at-ed
colo-nial	co-lo-ni-al
any-thing	an-y-thing
radon	ra-don
phrasal	phras-al
dis-gust-ed	disgusted
evil-do-er	e-vil-do-er
epiphe-nomenon	ep-i-phe-nom-e-non
blus-ter-ing	blustering
in-trauter-ine	in-tra-u-ter-ine
busker	busk-er
cre-ative	cre-a-tive
canon-ic	ca-non-ic
tragedy	trag-e-dy
verdi-gris	ver-di-gris
the-is-m	the-ism
un-abat-ed	un-a-bat-ed
dil-l	dill
c-it-ron	cit-ron
con-tes-tant	con-test-ant
rigid	rig-id
u-niden-ti-fied	un-i-den-ti-fied
in-ge-nu-ity	in-ge-nu-i-ty
pe-riphrastic	per-i-phras-tic
ni-troge-nous	ni-trog-e-nous
hindquar-ter-s	hind-quar-ters
s-tudy	stud-y
bur-sary	bur-sa-ry
buz-z	buzz
s-tock-y	stock-y
gloomy	gloom-y
quar-t	quart
chantry	chan-try
chi-nois-erie	chi-noi-se-rie
athe-ist	a-the-ist
per-me-able	per-me-a-ble
turnover	turn-o-ver
supreme-ly	su-preme-ly
dis-tan-t	dis-tant
aper-ture	ap-er-ture
cas-sowary	cas-so-war-y
weav-ing	weaving
en-doge-nous	en-dog-e-nous
repar-tee	rep-ar-tee
ex-cel-sior	ex-cel-si-or
thrifty	thrift-y
so-bri-ety	so-bri-e-ty
iron-work-s	i-ron-works
mod-ernism	mod-ern-ism
saga	sa-ga
oc-tagon	oc-ta-gon
metaphor	met-a-phor
shiv-er-ing	shivering
sonor-i-ty	so-nor-i-ty
flossy	floss-y
dis-so-nan-t	dis-so-nant
kerosene	ker-o-sene
epis-co-pate	e-pis-co-pate
s-teril-i-ty	ste-ril-i-ty
post-mod-ernist	post-mod-ern-ist
herbal-is-m	her-bal-ism
du-op-oly	du-op-o-ly
briefer	brief-er
ir-re-press-ible	ir-re-press-i-ble
flashy	flash-y
dis-in-fec-t	dis-in-fect
puni-tive	pu-ni-tive
mighty	might-y
charge-able	charge-a-ble
stripy	strip-y
nul-l	null
per-pe-tu-ity	per-pe-tu-i-ty
cen-trifu-gal	cen-trif-u-gal
the-atri-cal	the-at-ri-cal
im-pris-on-men-t	im-pris-on-ment
trum-peter	trum-pet-er
newsagen-t	news-a-gent
pass-ably	pass-a-bly
erad-i-cate	e-rad-i-cate
s-tates-man-ship	states-man-ship
s-e-lectee	se-lect-ee
punch-line	punchline
lot-tery	lot-ter-y
em-bod-i-men-t	em-bod-i-ment
over-con-fi-den-t	o-ver-con-fi-dent
hul-l	hull
un-sup-port-able	un-sup-port-a-ble
chaffinch	chaf-finch
as-para-gus	as-par-a-gus
si-lencer	si-lenc-er
genre	gen-re
s-toope-d	stooped
i-n-ad-e-qua-cy	in-ad-e-qua-cy
en-croach-men-t	en-croach-ment
greasy	greas-y
axle	ax-le
s-ince	since
frivol	friv-ol
s-plin-ter	splin-ter
dis-obe-di-ence	dis-o-be-di-ence
cerise	ce-rise
s-trained	strained
glo-be-trot-ting	globe-trot-ting
lusti-ly	lust-i-ly
libero	li-be-ro
epis-tle	e-pis-tle
pyrite	py-rite
deeply	deep-ly
leather	leath-er
shrub-bery	shrub-ber-y
iron-work	i-ron-work
seago-ing	sea-go-ing
phys-io-ther-a-pist	phys-i-o-ther-a-pist
ac-coun-t	ac-count
eerie	ee-rie
sibi-lan-t	sib-i-lant
pro-tease	pro-te-ase
rent-ed	rented
per-mafrost	per-ma-frost
imag-in-able	im-ag-i-na-ble
l-o-gof-f	log-off
re-seller	re-sell-er
erup-tive	e-rup-tive
rein-car-nate	re-in-car-nate
hostel-ry	hos-tel-ry
cam-panol-o-gy	cam-pa-nol-o-gy
poly-car-bon-ate	pol-y-car-bon-ate
mam-malian	mam-ma-li-an
lyric	lyr-ic
avow	a-vow
ac-t	act
en-treaty	en-treat-y
sur-moun-t	sur-mount
suet	su-et
vizier	vi-zier
s-losh	slosh
any-more	an-y-more
sophistry	soph-ist-ry
poros-i-ty	po-ros-i-ty
jean-s	jeans
fore-stal-l	fore-stall
mono-ma-ni-a	mon-o-ma-ni-a
ex-pect-ed	expected
b-lessed-ness	bless-ed-ness
kalei-do-scop-ic	ka-lei-do-scop-ic
mar-chioness	mar-chion-ess
crock-ery	crock-er-y
trans-porta-tion	trans-por-ta-tion
re-mis-s	re-miss
par-tici-ple	par-ti-ci-ple
s-tu-den-t	stu-dent
mini-bar	min-i-bar
geosyn-chronous	ge-o-syn-chro-nous
k-nack	knack
ba-ro-nial	ba-ro-ni-al
gravedig-ger	grave-dig-ger
pi-anola	pi-a-no-la
cat-tery	cat-te-ry
p-reser-va-tion	pres-er-va-tion
sym-po-sium	sym-po-si-um
lifebelt	life-belt
jazzy	jazz-y
iri-des-cen-t	ir-i-des-cent
ex-trater-res-tri-al	ex-tra-ter-res-tri-al
in-con-testable	in-con-test-a-ble
mag-ne-sium	mag-ne-si-um
macron	ma-cron
mu-tan-t	mu-tant
hy-draulic-s	hy-drau-lics
satire	sat-ire
loca-tive	loc-a-tive
un-wary	un-war-y
beanstalk	bean-stalk
rheumat-ic	rheu-mat-ic
u-ni-ver-sal-is-m	u-ni-ver-sal-ism
veg-etable	veg-e-ta-ble
un-proven	un-prov-en
leg-endary	leg-end-ar-y
chan-cellery	chan-cel-ler-y
ap-pendage	ap-pend-age
re-sis-tan-t	re-sist-ant
res-cuer	res-cu-er
catarrh	ca-tarrh
dis-mal-l-y	dis-mal-ly
s-mug-gler	smug-gler
elec-tron-i-cal-ly	e-lec-tron-i-cal-ly
paci-fi-er	pac-i-fi-er
i-nar-tic-u-late	in-ar-tic-u-late
cool-ing	cooling
tractable	trac-ta-ble
s-teer-ing	steer-ing
u-topi-a	u-to-pi-a
in-deco-rous	in-dec-o-rous
os-teopa-thy	os-te-op-a-thy
as-ceti-cis-m	as-cet-i-cism
u-nan-swered	un-an-swered
ther-mo-elec-tric	ther-mo-e-lec-tric
mo-tocross	mo-to-cross
moray	mo-ray
lig-a-men-t	lig-a-ment
ivy	i-vy
s-pas-m	spasm
item	i-tem
s-ta-sis	sta-sis
ar-ran-t	ar-rant
over-tax	o-ver-tax
sil-very	sil-ver-y
residue	res-i-due
dread-lock-s	dread-locks
fontanel	fon-ta-nel
muf-f	muff
les-bian	les-bi-an
in-jec-t	in-ject
scholas-tic	scho-las-tic
re-lax-ation	re-lax-a-tion
us-abil-i-ty	us-a-bil-i-ty
s-nake-skin	snake-skin
v-enue	ven-ue
dolomite	do-lo-mite
di-achron-ic	di-a-chron-ic
haven	ha-ven
brawler	brawl-er
sole-cis-m	sol-e-cism
d-in-gle	din-gle
knel-l	knell
whether	wheth-er
pulpy	pulp-y
salty	salt-y
over-grown	o-ver-grown
in-ex-orable	in-ex-o-ra-ble
Words with errors: 2224
Words with incorrect number of syllables: 2025
Total evluated: 6500
Perfect accuracy: 0.66
Number of syllables accuracy: 0.69
Average Levenshtein Distance(across incorrect words): 1.22
