Attempt	Real
friv-o-li-ty	fri-vol-i-ty
virtue	vir-tue
yel-lowed	yellowed
coro-nary	cor-o-nar-y
kilo-hertz	kil-o-hertz
sober-ly	so-ber-ly
gasi-fy	gas-i-fy
tachy-on	tach-y-on
elude	e-lude
per-pe-tu-ity	per-pe-tu-i-ty
ar-bi-trari-ness	ar-bi-trar-i-ness
so-cioe-co-nom-ic	so-ci-o-ec-o-nom-ic
dandy	dan-dy
un-work-able	un-work-a-ble
dis-cernible	dis-cern-i-ble
mal-adroit	mal-a-droit
scruti-ny	scru-ti-ny
stilet-to	sti-let-to
eu-phemisti-cal-ly	eu-phe-mis-ti-cal-ly
test-ing	testing
in-ter-ci-ty	in-ter-cit-y
dum-found-ing	dumf-ound-ing
ashore	a-shore
struc-tural-ism	struc-tur-al-ism
un-steady	un-stead-y
un-ob-ser-vant	un-ob-serv-ant
valid-ly	val-id-ly
repro-bate	rep-ro-bate
uni-fi-ca-tion	u-ni-fi-ca-tion
com-modore	com-mo-dore
lassie	las-sie
pout-ing	pouting
grenade	gre-nade
an-ti-sta-t-ic	an-ti-stat-ic
flan-nelette	flan-nel-ette
elim-i-na-tion	e-lim-i-na-tion
mil-i-tary	mil-i-tar-y
un-emo-tion-al	un-e-mo-tion-al
hero	he-ro
deben-ture	de-ben-ture
pageantry	pag-eant-ry
vic-ar-i-ous	vi-car-i-ous
in-du-bitable	in-du-bi-ta-ble
fil-i-buster	fil-i-bus-ter
tri-umphal-ism	tri-um-phal-ism
midriff	mid-riff
hawthorn	haw-thorn
eques-tri-an	e-ques-tri-an
rock-et-ing	rocketing
hosepipe	hose-pipe
in-ter-po-lat-able	in-ter-po-la-ta-ble
starlight	star-light
chid-ing	chiding
necrophil-ia	nec-ro-phil-i-a
copi-er	cop-i-er
en-chant-i-ng	en-chant-ing
py-rotech-nics	py-ro-tech-nics
raisin	rai-sin
copy-right	cop-y-right
camshaft	cam-shaft
un-ques-tion-able	un-ques-tion-a-ble
karakul	kar-a-kul
facile	fac-ile
un-beat-able	un-beat-a-ble
inca	in-ca
ma-tri-archy	ma-tri-ar-chy
bevy	bev-y
deathbed	death-bed
beryl-li-um	be-ryl-li-um
ob-scu-ran-tist	ob-scu-rant-ist
ethno-graph-ic	eth-no-graph-ic
ir-re-ducible	ir-re-duc-i-ble
ethol-o-gy	e-thol-o-gy
tena-cious	te-na-cious
tem-po-rary	tem-po-rar-y
cre-ation-ist	cre-a-tion-ist
cas-sowary	cas-so-war-y
turn-about	turn-a-bout
sloven-ly	slov-en-ly
buzzer	buzz-er
in-quiry	in-quir-y
keynote	key-note
holis-ti-cal-ly	ho-lis-ti-cal-ly
multi-na-tion-al	mul-ti-na-tion-al
demon-stra-bly	de-mon-stra-bly
ria	ri-a
cataract	cat-a-ract
di-ure-sis	di-u-re-sis
sor-cery	sor-cer-y
prostaglandin	pros-ta-glan-din
colonist	col-o-nist
racy	rac-y
dropout	drop-out
uni-lat-er-al-ist	u-ni-lat-er-al-ist
mimet-ic	mi-met-ic
neona-tal	ne-o-na-tal
every-one	eve-ry-one
reper-cus-sion	re-per-cus-sion
spir-i-tu-al	spir-it-u-al
lan-der	land-er
elon-gate	e-lon-gate
impi	im-pi
footrest	foot-rest
tremen-dous-ly	tre-men-dous-ly
phy-loge-ny	phy-log-e-ny
chunky	chunk-y
ir-rec-on-cil-able	ir-rec-on-cil-a-ble
so-lace	sol-ace
sinecure	si-ne-cure
mea-sure	meas-ure
topol-o-gy	to-pol-o-gy
tenet	ten-et
over-pay-ment	o-ver-pay-ment
caldera	cal-de-ra
in-ter-nu-clear	in-ter-nu-cle-ar
dioce-san	di-oc-e-san
fanci-er	fan-ci-er
smudgy	smudg-y
prowess	prow-ess
dio-cese	di-o-cese
wom-ankind	wom-an-kind
rescale	re-scale
habit	hab-it
aban-don-ment	a-ban-don-ment
un-hy-gien-ic	un-hy-gi-en-ic
in-tractable	in-trac-ta-ble
veni-son	ven-i-son
iso-lat-ed	i-so-lat-ed
ro-tary	ro-ta-ry
cou-turi-er	cou-tu-ri-er
re-freshed	refreshed
rein-car-nate	re-in-car-nate
par-adise	par-a-dise
de-fines	def-ines
unim-ped-ed	un-im-ped-ed
aloud	a-loud
worsted	wor-sted
mo-tocross	mo-to-cross
hindquar-ters	hind-quar-ters
seamy	seam-y
dis-ori-en-ta-tion	dis-o-ri-en-ta-tion
dimin-u-en-do	di-min-u-en-do
in-former	in-form-er
vet-eri-nary	vet-er-i-nar-y
evan-ge-list	e-van-ge-list
vir-ginal	vir-gin-al
salu-tary	sal-u-tar-y
apogee	ap-o-gee
rosy	ros-y
papa	pa-pa
emit	e-mit
elec-toral	e-lec-tor-al
arise	a-rise
knuck-le-duster	knuck-le-dust-er
mega-lo-ma-ni-ac	meg-a-lo-ma-ni-ac
win-ery	win-er-y
notepad	note-pad
forgery	for-ger-y
prodi-gious	pro-di-gious
breast-feed-ing	breastfeeding
diox-ide	di-ox-ide
dairy	dair-y
un-quench-able	un-quench-a-ble
in-ex-press-ible	in-ex-press-i-ble
deco	dec-o
baleen	ba-leen
refugee	ref-u-gee
cin-e-matog-ra-ph-er	cin-e-ma-tog-ra-pher
cocky	cock-y
taffe-ta	taf-fe-ta
re-as-sur-ing	reassuring
hearti-ly	heart-i-ly
dimer	di-mer
botanist	bot-a-nist
eras-er	e-ras-er
scullery	scul-ler-y
over-sup-ply	o-ver-sup-ply
dis-agree	dis-a-gree
overqual-i-fied	o-ver-qual-i-fied
lighter	light-er
around	a-round
sinewy	sin-ew-y
sub-si-dence	sub-sid-ence
equidis-tant	e-qui-dis-tant
thrifty	thrift-y
idea	i-de-a
meta-physics	met-a-phys-ics
re-assem-bly	re-as-sem-bly
iso-mer	i-so-mer
over-pro-duc-tion	o-ver-pro-duc-tion
im-moral-i-ty	im-mo-ral-i-ty
sever-i-ty	se-ver-i-ty
buck-min-ster-fullerene	buck-min-ster-ful-ler-ene
dodgy	dodg-y
poly-eth-yl-ene	pol-y-eth-yl-ene
pygmy	pyg-my
lichen	li-chen
vis-i-ta-tion	vis-it-a-tion
solid-ly	sol-id-ly
un-prece-dent-ed	un-prec-e-dent-ed
litur-gi-cal	li-tur-gi-cal
spon-sored	sponsored
for-get-table	for-get-ta-ble
pro-ba-tion-ary	pro-ba-tion-ar-y
ap-pre-cia-bly	ap-pre-ci-a-bly
as-pi-ra-tional	as-pi-ra-tion-al
poky	pok-y
glac-i-er	gla-cier
reprise	re-prise
mil-i-taris-tic	mil-i-ta-ris-tic
aca-d-e-m-ic	ac-a-dem-ic
ex-is-tence	ex-ist-ence
triple	tri-ple
kalei-do-scop-ic	ka-lei-do-scop-ic
her-mitage	her-mit-age
geo-chem-istry	ge-o-chem-is-try
dal-liance	dal-li-ance
cred-it-wor-thy	cred-it-worth-y
over-long	o-ver-long
widen	wid-en
pro-mul-gate	prom-ul-gate
ebul-lient	e-bul-lient
mela-tonin	mel-a-to-nin
ta-pes-try	tap-es-try
waspish	wasp-ish
in-trauter-ine	in-tra-u-ter-ine
posthu-mous	post-hu-mous
legume	leg-ume
unique-ness	u-nique-ness
gen-i-talia	gen-i-ta-li-a
petu-lant	pet-u-lant
tele-scope	tel-e-scope
felo-nious	fe-lo-ni-ous
metempsy-chosis	me-tem-psy-cho-sis
irony	i-ro-ny
palatal	pal-a-tal
livid	liv-id
sali-vary	sal-i-var-y
nan-otech-nol-o-gy	nan-o-tech-nol-o-gy
evict	e-vict
un-fa-mil-iar-i-ty	un-fa-mil-i-ar-i-ty
de-cider	de-cid-er
crunchy	crunch-y
necro-man-tic	nec-ro-man-tic
arrange-ment	ar-range-ment
steam-roller	steam-roll-er
bish-opric	bish-op-ric
darter	dart-er
cow-ardice	cow-ard-ice
lin-ear-ly	lin-e-ar-ly
sabra	sa-bra
hy-per-bole	hy-per-bo-le
top-i-ary	to-pi-ar-y
frown-ing	frowning
rheumat-ic	rheu-mat-ic
emo-tive	e-mo-tive
print-able	print-a-ble
blotchy	blotch-y
pro-ject-ed	projected
libero	li-be-ro
flat-tery	flat-ter-y
deny	de-ny
lul-la-by	lull-a-by
ni-hilis-tic	ni-hil-is-tic
sta-t-ics	stat-ics
pathfind-er	path-find-er
emery	em-er-y
vanil-la	va-nil-la
stoma	sto-ma
cadet	ca-det
el-ven	elv-en
rounder	round-er
eu-phemism	eu-phe-mism
testis	tes-tis
mantling	man-tling
iso-topic	i-so-top-ic
largo	lar-go
slob-ber-ing	slobbering
in-ad-ver-tent-ly	in-ad-vert-ent-ly
mileage	mile-age
geri-atric	ger-i-at-ric
chemist	chem-ist
free-lancer	free-lanc-er
de-mount-able	de-mount-a-ble
dero-gate	der-o-gate
sapi-ent	sa-pi-ent
avoid	a-void
weari-ness	wea-ri-ness
on-tol-ogy	on-tol-o-gy
mytho-log-i-cal	myth-o-log-i-cal
con-trol-lable	con-trol-la-ble
over-es-ti-ma-tion	o-ver-es-ti-ma-tion
uni-ver-sal-i-ty	u-ni-ver-sal-i-ty
blaster	blast-er
con-sulate	con-su-late
dither	dith-er
tom-fool-ery	tom-fool-er-y
jerkin	jer-kin
bi-og-ra-ph-er	bi-og-ra-pher
le-nient	le-ni-ent
liqueur	li-queur
anoint	a-noint
swinger	swing-er
se-nior-i-ty	sen-ior-i-ty
cog-nizant	cog-ni-zant
nether-most	neth-er-most
repo-si-tion	re-po-si-tion
pres-bytery	pres-by-ter-y
dishar-mo-ny	dis-har-mo-ny
con-sumerism	con-sum-er-ism
over-ca-pac-i-ty	o-ver-ca-pac-i-ty
pharaoh	phar-aoh
mis-spellings	mis-spel-lings
screen-writer	screen-writ-er
neo-phyte	ne-o-phyte
apothe-cary	a-poth-e-car-y
pesti-len-tial	pes-ti-len-tial
li-brary	li-brar-y
joyrid-ing	joy-rid-ing
sub-lu-nary	sub-lu-nar-y
cen-tipede	cen-ti-pede
pro-bity	pro-bi-ty
plebiscite	pleb-i-scite
busi-ness-woman	busi-ness-wom-an
growler	growl-er
neme-sis	nem-e-sis
paraf-fin	par-af-fin
sponger	spong-er
julep	ju-lep
resin	res-in
voodoo	voo-doo
heresy	her-e-sy
bur-bling	burbling
prospec-tive	pro-spec-tive
over-spill	o-ver-spill
beaker	beak-er
brand-ed	bran-ded
tan-ger-ine	tan-ge-rine
con-tentious	con-ten-tious
epis-co-pate	e-pis-co-pate
elvish	elv-ish
mon-o-clon-al	mon-o-clo-nal
many	man-y
sav-agery	sav-age-ry
pos-i-tivist	pos-i-tiv-ist
budgeri-gar	budg-er-i-gar
un-frozen	un-fro-zen
equiv-a-lence	e-quiv-a-lence
de-ductible	de-duct-i-ble
unimag-i-na-tive	un-im-ag-i-na-tive
nougat	nou-gat
papule	pap-ule
saucepan	sauce-pan
elec-tro-car-dio-gram	e-lec-tro-car-di-o-gram
maisonette	mai-son-ette
chalet	cha-let
ra-dia-tive	ra-di-a-tive
pa-pri-ka	pap-ri-ka
is-suer	is-su-er
uni-ty	u-ni-ty
va-porous	va-por-ous
gu-ber-na-to-r-i-al	gu-ber-na-to-ri-al
uniden-ti-fi-able	un-i-den-ti-fi-a-ble
salient	sa-li-ent
turntable	turn-ta-ble
bedrag-gled	be-drag-gled
able	a-ble
over-lord	o-ver-lord
open-er	o-pen-er
tantrum	tan-trum
weepy	weep-y
or-tho-doxy	or-tho-dox-y
as-pidis-tra	as-pi-dis-tra
grouper	group-er
chromite	chro-mite
cuneiform	cu-ne-i-form
glis-ten-ing	gli-ste-ning
shandy	shan-dy
bony	bon-y
frag-men-tary	frag-men-tar-y
lethal-i-ty	le-thal-i-ty
heavy	heav-y
garage	ga-rage
scenery	scen-er-y
basal	ba-sal
thruster	thrust-er
sta-tionery	sta-tion-er-y
over-re-act	o-ver-re-act
beefeater	beef-eat-er
pago-da	pa-go-da
archer	arch-er
clumpy	clump-y
omen	o-men
civic	civ-ic
ravine	ra-vine
equine	e-quine
warpath	war-path
lancet	lan-cet
can-nery	can-ner-y
bad-minton	bad-min-ton
ra-dius	ra-di-us
bologna	bo-lo-gna
bom-bardier	bom-bar-dier
idyll	i-dyll
carat	car-at
swasti-ka	swas-ti-ka
het-ero-sex-u-al	het-er-o-sex-u-al
en-er-getic	en-er-get-ic
in-salu-bri-ous	in-sa-lu-bri-ous
cra-nial	cra-ni-al
rene-go-ti-ate	re-ne-go-ti-ate
patho-gen-e-sis	path-o-gen-e-sis
beanie	bean-ie
rein-ter-pret	re-in-ter-pret
thau-maturge	thau-ma-turge
chromi-um	chro-mi-um
seascape	sea-scape
impi-ety	im-pi-e-ty
un-con-t-a-m-i-nat-ed	un-con-tam-i-nat-ed
con-ge-nial	con-gen-ial
con-certi-na	con-cer-ti-na
mar-quetry	mar-que-try
re-porter	re-port-er
pyrite	py-rite
je-junum	je-ju-num
cathar-sis	ca-thar-sis
moorhen	moor-hen
over-writ-ing	overwriting
syn-ovial	syn-o-vi-al
anx-i-ety	anx-i-e-ty
emer-ald	em-er-ald
mi-cro-elec-tron-ics	mi-cro-e-lec-tron-ics
ex-pan-sion-ary	ex-pan-sion-ar-y
emo-tion-al	e-mo-tion-al
cheva-lier	chev-a-lier
de-bat-able	de-bat-a-ble
bul-letin	bul-le-tin
archangel	arch-an-gel
urchin	ur-chin
de-ity	de-i-ty
unim-por-tance	un-im-por-tance
in-ex-plic-a-ble	in-ex-pli-ca-ble
cryo-gen-ics	cry-o-gen-ics
ex-pend-able	ex-pend-a-ble
pe-riph-ery	pe-riph-er-y
de-liv-ery	de-liv-er-y
droopy	droop-y
ex-pand-able	ex-pand-a-ble
un-usu-al-ly	un-u-su-al-ly
legate	leg-ate
makeweight	make-weight
solemn	sol-emn
rhetor-i-cal-ly	rhe-tor-i-cal-ly
penin-su-lar	pen-in-su-lar
video-taped	videotaped
cloudy	cloud-y
promis-cu-ity	prom-is-cu-i-ty
telecom-mut-ing	te-le-com-mu-ting
goer	go-er
psalter	psal-ter
rafter	raft-er
con-trivance	con-triv-ance
erad-i-ca-tion	e-rad-i-ca-tion
ether	e-ther
auto	au-to
sundry	sun-dry
ruin	ru-in
undi-min-ished	un-di-min-ished
trousers	trou-sers
lawyer	law-yer
re-quiem	req-ui-em
declam-a-to-ry	de-clam-a-to-ry
trouper	troup-er
lot-tery	lot-ter-y
lumpen	lum-pen
reap-ply	re-ap-ply
frica-tive	fric-a-tive
wolfhound	wolf-hound
lino	li-no
pesti-lent	pes-ti-lent
an-niver-sary	an-ni-ver-sa-ry
asy-lum	a-sy-lum
raspy	rasp-y
de-featist	de-feat-ist
un-sea-son-able	un-sea-son-a-ble
mistype	mis-type
cack-ling	cackling
de-po-si-tion	dep-o-si-tion
scalar	sca-lar
onion	on-ion
di-rec-torate	di-rec-to-rate
sus-penders	sus-pend-ers
teenaged	teen-aged
mono-lay-er	mon-o-lay-er
hearthrug	hearth-rug
cata-ton-ic	cat-a-ton-ic
bio-m-e-try	bi-om-e-try
elec-tro-mag-net	e-lec-tro-mag-net
over-write	o-ver-write
un-ap-proach-able	un-ap-proach-a-ble
in-dige-nous	in-dig-e-nous
wash-er-woman	wash-er-wom-an
pyri-dine	pyr-i-dine
naked	na-ked
de-mo-graph-ics	dem-o-graph-ics
di-alect	di-a-lect
flinch-ing	flin-ching
bar-tender	bar-tend-er
may-oral-ty	may-or-al-ty
be-liev-abil-i-ty	be-liev-a-bil-i-ty
reli-quary	rel-i-quar-y
shep-herdess	shep-herd-ess
marathon	mar-a-thon
posthu-mous-ly	post-hu-mous-ly
pro-tea	pro-te-a
plat-inum	plat-i-num
nonex-is-tence	non-ex-ist-ence
condi-ment	con-di-ment
elec-trophore-sis	e-lec-tro-pho-re-sis
em-bo-som	em-bos-om
ve-nial	ve-ni-al
peas-antry	peas-ant-ry
steve-dore	ste-ve-dore
propo-si-tion-al	prop-o-si-tion-al
kitchen-ware	kitch-en-ware
uni-lat-er-al	u-ni-lat-er-al
sonorous	so-no-rous
celiba-cy	cel-i-ba-cy
toady	toad-y
laun-dered	laundered
foxy	fox-y
hexa-m-e-ter	hex-am-e-ter
de-bauch-ery	de-bauch-er-y
re-hearsal	re-hears-al
holis-tic	ho-lis-tic
trel-lised	trellised
cog-nizance	cog-ni-zance
per-fectibil-i-ty	per-fect-i-bil-i-ty
tele-o-log-i-cal	tel-e-o-log-i-cal
riot	ri-ot
salty	salt-y
salmon	salm-on
id-iot	id-i-ot
pulpy	pulp-y
rivulet	riv-u-let
de-tainee	de-tain-ee
be-fud-dling	befuddling
uni-ver-sal-ism	u-ni-ver-sal-ism
scoff-ing	scoffing
over-growth	o-ver-growth
mori-bund	mor-i-bund
floaty	float-y
prepo-si-tion	prep-o-si-tion
sales-woman	sales-wom-an
elec-tro	e-lec-tro
drudgery	drudg-er-y
ush-erette	ush-er-ette
apos-to-late	a-pos-to-late
ex-oti-cism	ex-ot-i-cism
kilo-ton	kil-o-ton
lyri-cism	lyr-i-cism
ex-cel-sior	ex-cel-si-or
elixir	e-lix-ir
di-a-betes	di-a-be-tes
pan-theon	pan-the-on
puree	pu-ree
para-pet	par-a-pet
evac-u-a-tion	e-vac-u-a-tion
dunghill	dung-hill
mushy	mush-y
gan-g-ly	gan-gly
pur-po-sive	pur-pos-ive
porta-bil-i-ty	port-a-bil-i-ty
apiece	a-piece
await	a-wait
starchy	starch-y
dizzi-ness	diz-zi-ness
hereti-cal	he-ret-i-cal
dis-hon-esty	dis-hon-es-ty
de-spi-ca-ble	des-pi-ca-ble
bias	bi-as
di-ana	di-an-a
eighty	eight-y
in-nu-mer-able	in-nu-mer-a-ble
re-pairable	re-pair-a-ble
rur-al	ru-ral
in-fantry-man	in-fan-try-man
species	spe-cies
co-eval	co-e-val
gener-i-cal-ly	ge-ner-i-cal-ly
in-ap-plic-a-ble	in-ap-pli-ca-ble
mi-croscopy	mi-cros-co-py
catgut	cat-gut
breakup	break-up
surgery	sur-ger-y
bang-ing	banging
lefty	left-y
unto	un-to
melan-choly	mel-an-chol-y
ashen	ash-en
re-ceiv-able	re-ceiv-a-ble
paci-fi-er	pac-i-fi-er
mayflower	may-flow-er
topaz	to-paz
opin-ion	o-pin-ion
os-tracism	os-tra-cism
methanol	meth-a-nol
bio-met-rics	bi-o-met-rics
sacra-ment	sac-ra-ment
pedan-tic	pe-dan-tic
awry	a-wry
vista	vis-ta
ego-tism	e-go-tism
del-i-catessen	del-i-ca-tes-sen
re-pen-tance	re-pent-ance
claus-tro-pho-bia	claus-tro-pho-bi-a
in-dex-ing	indexing
con-sum-able	con-sum-a-ble
basil-i-ca	ba-sil-i-ca
mnemon-ic	mne-mon-ic
tonal-i-ty	to-nal-i-ty
non-event	non-e-vent
ra-di-ograph	ra-di-o-graph
di-alec-tic	di-a-lec-tic
in-signia	in-sig-ni-a
over-look	o-ver-look
cine	cin-e
gun-nery	gun-ner-y
liti-gious	li-ti-gious
carousel	car-ou-sel
over-sleep	o-ver-sleep
ex-pect-ed	expected
baronet	bar-on-et
con-sid-er-able	con-sid-er-a-ble
un-set-tling	unsettling
de-riso-ry	de-ri-so-ry
ban-tamweight	ban-tam-weight
hor-mon-al	hor-mo-nal
legu-mi-nous	le-gu-mi-nous
saline	sa-line
obe-di-ent	o-be-di-ent
het-ero-dox	het-er-o-dox
ab-solute-ly	ab-so-lute-ly
ir-repara-ble	ir-rep-a-ra-ble
iso-ton-ic	i-so-ton-ic
rigid-i-fy	ri-gid-i-fy
lethar-gy	leth-ar-gy
stonework	stone-work
para-noia	par-a-noi-a
over-hand	o-ver-hand
au-thoress	au-thor-ess
cir-cling	circling
tithing	tith-ing
con-ser-va-to-ry	con-serv-a-to-ry
car-avel	car-a-vel
cut-lery	cut-ler-y
shaven	shav-en
anorex-ic	an-o-rex-ic
husky	hus-ky
milk-shake	milkshake
in-ter-change-ably	in-ter-change-a-bly
in-evitabil-i-ty	in-ev-i-ta-bil-i-ty
unan-i-mous	u-nan-i-mous
rubric	ru-bric
ivy	i-vy
de-f-i-n-i-tion-al	def-i-ni-tion-al
catchy	catch-y
tute-lage	tu-te-lage
ar-guable	ar-gu-a-ble
ser-vant	serv-ant
ven-omous	ven-om-ous
va-grancy	va-gran-cy
piv-otal	piv-ot-al
iso-lat-ing	i-so-lat-ing
fool-hardy	fool-har-dy
apoc-a-lyp-tic	a-poc-a-lyp-tic
pot-tery	pot-ter-y
dumpy	dump-y
chore-o-g-ra-ph-er	cho-re-og-ra-pher
cochlea	coch-le-a
ganger	gang-er
habi-ta-tion	hab-i-ta-tion
doyen	doy-en
math-e-mati-cian	math-e-ma-ti-cian
te-dious	te-di-ous
dogged-ly	dog-ged-ly
atone-ment	a-tone-ment
widescreen	wide-screen
quan-tifi-ca-tion	quan-ti-fi-ca-tion
steeple-chase	stee-ple-chase
ephemera	e-phem-er-a
an-ti-quary	an-ti-quar-y
voyeuris-tic	voy-eur-is-tic
dereg-u-late	de-reg-u-late
epis-to-lary	e-pis-to-lar-y
fran-coph-o-ne	fran-co-phone
voyeurism	vo-yeur-ism
propin-quity	pro-pin-qui-ty
dan-de-lion	dan-de-li-on
motet	mo-tet
tem-porar-i-ly	tem-po-rar-i-ly
minute-ly	mi-nute-ly
apos-ta-sy	a-pos-ta-sy
servi-tude	ser-vi-tude
any-place	an-y-place
navy	na-vy
drowsi-ness	drow-si-ness
kiosk	ki-osk
colos-sal	co-los-sal
brawny	brawn-y
foothold	foot-hold
spiny	spin-y
over-crowd	o-ver-crowd
shady	shad-y
over-shad-ow	o-ver-shad-ow
car-cino-gen-e-sis	car-cin-o-gen-e-sis
abuse	a-buse
apron	a-pron
grouchy	grouch-y
as-tro-physics	as-tro-phys-ics
dogs-body	dogs-bod-y
tri-maran	tri-ma-ran
pe-cu-niary	pe-cu-ni-ar-y
sim-u-lacrum	sim-u-la-crum
jan-u-ary	jan-u-ar-y
dusty	dust-y
plur-al	plu-ral
rhodo-den-dron	rho-do-den-dron
any-body	an-y-bod-y
pri-mar-i-ly	pri-ma-ri-ly
re-tal-ia-to-ry	re-tal-i-a-to-ry
axle	ax-le
boxy	box-y
baobab	ba-o-bab
pan-icky	pan-ick-y
stinger	sting-er
elec-table	e-lect-a-ble
un-nat-ur-al	un-nat-u-ral
carotid	ca-rot-id
mod-icum	mod-i-cum
pota-to	po-ta-to
tramway	tram-way
amount	a-mount
uni-corn	u-ni-corn
un-usu-al	un-u-su-al
spencer	spen-cer
linkup	link-up
hy-per-boloid	hy-per-bo-loid
grapevine	grape-vine
eroge-nous	e-rog-e-nous
eques-tri-an-ism	e-ques-tri-an-ism
un-adapt-ed	un-a-dapt-ed
crispy	crisp-y
halo-gen	hal-o-gen
syrup	syr-up
in-ter-dis-ci-pli-nary	in-ter-dis-ci-pli-nar-y
mea-sure-ment	meas-ure-ment
re-trieval	re-triev-al
ju-nior	jun-ior
bawl-ing	baw-ling
ge-neti-cist	ge-net-i-cist
in-vi-o-lable	in-vi-o-la-ble
man-i-festo	man-i-fes-to
tarsal	tar-sal
ra-dio-ther-a-py	ra-di-o-ther-a-py
iso-la-tion-ism	i-so-la-tion-ism
eigen-state	ei-gen-state
bilin-gual-ism	bi-lin-gual-ism
per-cu-ta-neous	per-cu-ta-ne-ous
bumper	bump-er
piebald	pie-bald
au-gury	au-gu-ry
ge-nial	ge-ni-al
diskette	disk-ette
hookah	hook-ah
look-ing	looking
cheesy	chees-y
unas-sum-ing	un-as-sum-ing
chapel	chap-el
bonus	bo-nus
apo-lit-i-cal	a-po-lit-i-cal
coun-ter-in-tu-itive	coun-ter-in-tu-i-tive
atom-ic	a-tom-ic
fruity	fruit-y
ini-ti-a-tion	in-i-ti-a-tion
sol-diery	sol-dier-y
tractable	trac-ta-ble
writer	writ-er
busty	bust-y
har-mo-nious-ly	har-mo-ni-ous-ly
ledger	ledg-er
ar-chaism	ar-cha-ism
non-con-for-mi-ty	non-con-form-i-ty
over-bear-ing	o-ver-bear-ing
bola	bo-la
di-gestible	di-gest-i-ble
cannabis	can-na-bis
melo-dra-ma	mel-o-dra-ma
gooey	goo-ey
en-force-able	en-force-a-ble
physics	phys-ics
sub-jec-tivism	sub-jec-tiv-ism
beach-comber	beach-comb-er
cen-trifu-gal	cen-trif-u-gal
unloved	un-loved
sorghum	sor-ghum
volatil-i-ty	vol-a-til-i-ty
smelt-ing	smelting
stereo-typ-i-cal	ster-e-o-typ-i-cal
moral-ly	mor-al-ly
catheter	cath-e-ter
stopover	stop-o-ver
para-sol	par-a-sol
un-der-achieve-ment	un-der-a-chieve-ment
tox-i-c-i-ty	tox-ic-i-ty
slouch-ing	slouching
imag-i-na-tive	im-ag-i-na-tive
con-fus-able	con-fus-a-ble
baron	bar-on
heron	her-on
pam-phle-teer	pam-phlet-eer
over-hear	o-ver-hear
para-dox	par-a-dox
spir-i-tu-al-ist	spir-it-u-al-ist
lachry-mal	lach-ry-mal
about	a-bout
un-speak-able	un-speak-a-ble
unchecked	un-checked
in-sur-gency	in-sur-gen-cy
sacro-sanct	sac-ro-sanct
stiffly	stiff-ly
gal-vanome-ter	gal-va-nom-e-ter
foot-baller	foot-ball-er
rooi-bos	roo-i-bos
marzi-pan	mar-zi-pan
renum-ber	re-num-ber
sumo	su-mo
el-dest	eld-est
hearty	heart-y
sanc-ti-mo-nious	sanc-ti-mo-ni-ous
mer-cury	mer-cu-ry
prodi-gal	prod-i-gal
viva	vi-va
galaxy	gal-ax-y
count-able	count-a-ble
cyclic	cy-clic
breathy	breath-y
tapir	ta-pir
backpedal	back-ped-al
leisure	lei-sure
tele-path-ic	tel-e-path-ic
bur-gundy	bur-gun-dy
etui	e-tui
mishap	mis-hap
labyrinthine	lab-y-rin-thine
elapse	e-lapse
un-de-sir-able	un-de-sir-a-ble
protest-ing	protesting
duel	du-el
poly-car-bon-ate	pol-y-car-bon-ate
suit-able	suit-a-ble
copi-lot	co-pi-lot
green-ery	green-er-y
clever	clev-er
enig-mat-ic	en-ig-mat-ic
be-whiskered	be-whisk-ered
un-en-vi-able	un-en-vi-a-ble
twitchy	twitch-y
gloomy	gloom-y
op-er-cu-lum	o-per-cu-lum
sonata	so-na-ta
iden-ti-fi-able	i-den-ti-fi-a-ble
un-sup-port-able	un-sup-port-a-ble
nephew	neph-ew
away	a-way
rapid-ly	rap-id-ly
fermi-on	fer-mi-on
mono-phon-ic	mon-o-phon-ic
fiendish	fiend-ish
elec-tri-cal-ly	e-lec-tri-cal-ly
draftee	draft-ee
seg-ment-ed	seg-men-ted
squea-mish	squeam-ish
throaty	throat-y
penu-ri-ous	pe-nu-ri-ous
mazur-ka	ma-zur-ka
speedy	speed-y
vinyl	vi-nyl
over-heat	o-ver-heat
switchgear	switch-gear
ec-sta-t-ic	ec-stat-ic
courtier	cour-ti-er
per-ish-able	per-ish-a-ble
doughty	dough-ty
un-premed-i-tat-ed	un-pre-med-i-tat-ed
hawser	haw-ser
domi-cil-iary	dom-i-cil-i-ar-y
teatime	tea-time
man-ager-ess	man-ag-er-ess
arith-metic	a-rith-me-tic
un-event-ful	un-e-vent-ful
repack	re-pack
aton-ic	a-ton-ic
menagerie	me-nag-er-ie
sawmill	saw-mill
gua-camole	gua-ca-mo-le
prepa-ra-tion	prep-a-ra-tion
hero-ism	her-o-ism
emer-gency	e-mer-gen-cy
marten	mar-ten
scathing	scath-ing
un-du-lat-ing	un-du-la-ting
in-tegri-ty	in-teg-ri-ty
axis	ax-is
as-pirin	as-pi-rin
boast-ing	boas-ting
swishy	swish-y
overem-pha-sis	o-ver-em-pha-sis
palati-nate	pa-lat-i-nate
re-cov-ery	re-cov-er-y
warhorse	war-horse
tenor	ten-or
in-alien-able	in-al-ien-a-ble
in-tra-venous-ly	in-tra-ve-nous-ly
amus-ing	a-mus-ing
ra-tio-nal-ist	ra-tion-al-ist
funky	funk-y
mas-culin-i-ty	mas-cu-lin-i-ty
prosody	pros-o-dy
hero-ical-ly	he-ro-i-cal-ly
judo	ju-do
blowfly	blow-fly
com-bi-na-to-r-i-al	com-bi-na-to-ri-al
equip-ment	e-quip-ment
dif-fer-ing	differing
mildew	mil-dew
crescen-do	cre-scen-do
to-kenism	to-ken-ism
swarm-ing	swarming
crevasse	cre-vasse
snig-ger-ing	sniggering
arachno-pho-bia	a-rach-no-pho-bi-a
post-mistress	post-mis-tress
sala-man-der	sal-a-man-der
taxi	tax-i
ne-go-tia-tor	ne-go-ti-a-tor
roadmap	road-map
undis-turbed	un-dis-turbed
un-healthy	un-health-y
mar-keter	mar-ket-er
sinew	sin-ew
cir-cuitous	cir-cu-i-tous
rewrite	re-write
fusty	fus-ty
rodeo	ro-de-o
ben-e-fi-cia-ry	ben-e-fi-ci-ar-y
hostler	hos-tler
presto	pres-to
eroti-cism	e-rot-i-cism
blus-ter-ing	blustering
chiefly	chief-ly
duo	du-o
atri-um	a-tri-um
body-guard	bod-y-guard
missal	mis-sal
dyer	dy-er
chi-canery	chi-can-er-y
palu-dal	pa-lu-dal
ca-su-al-ty	cas-u-al-ty
cere-bel-lum	cer-e-bel-lum
koala	ko-a-la
hazy	ha-zy
busi-nesslike	busi-ness-like
en-dometri-um	en-do-me-tri-um
jam-boree	jam-bo-ree
chasti-ty	chas-ti-ty
coda	co-da
inkwell	ink-well
con-fronta-tion-al	con-fron-ta-tion-al
pinafore	pin-a-fore
char-woman	char-wom-an
soya	soy-a
pizzi-ca-to	piz-zi-ca-to
forcible	for-ci-ble
thievish	thiev-ish
user	us-er
de-mog-ra-ph-er	de-mog-ra-pher
re-new-able	re-new-a-ble
sewage	sew-age
dis-parate	dis-pa-rate
unin-sur-able	un-in-sur-a-ble
only	on-ly
banger	bang-er
kwacha	kwa-cha
origa-mi	o-ri-ga-mi
up-heaval	up-heav-al
painstak-ing-ly	pains-tak-ing-ly
chanter	chant-er
ax-e-man	axe-man
dopey	dope-y
dullard	dull-ard
mi-crochip	mi-cro-chip
les-bian-ism	les-bi-an-ism
grassy	grass-y
moi-ety	moi-e-ty
skua	sku-a
mili-tia	mi-li-tia
tena-cious-ly	te-na-cious-ly
lover	lov-er
lever-age	lev-er-age
calum-ny	cal-um-ny
nowa-days	now-a-days
capy-bara	cap-y-ba-ra
syco-phan-tic	syc-o-phan-tic
vel-veteen	vel-vet-een
islet	is-let
cabri-o-let	cab-ri-o-let
athe-is-tic	a-the-is-tic
mal-odor-ous	mal-o-dor-ous
downy	down-y
poli-ty	pol-i-ty
achieve	a-chieve
dis-qui-etude	dis-qui-e-tude
iden-ti-fy	i-den-ti-fy
swindler	swin-dler
salience	sa-li-ence
im-ma-te-r-i-al	im-ma-te-ri-al
in-signif-i-cant	in-sig-nif-i-cant
car-dio-vas-cu-lar	car-di-o-vas-cu-lar
owlish	owl-ish
hypochon-dri-a-cal	hy-po-chon-dri-a-cal
gherkin	gher-kin
bleary	blear-y
eu-pho-nious	eu-pho-ni-ous
gud-geon	gudg-eon
undig-ni-fied	un-dig-ni-fied
puer-per-al	pu-er-per-al
in-fini-tude	in-fin-i-tude
no-ti-fi-able	no-ti-fi-a-ble
un-equiv-o-cal	un-e-quiv-o-cal
boule-vard	boul-e-vard
lessor	les-sor
augite	au-gite
mar-chioness	mar-chion-ess
orig-i-na-tion	o-rig-i-na-tion
gala	ga-la
wadi	wa-di
ir-res-olute	ir-res-o-lute
ine-bri-ate	in-e-bri-ate
stew-ardess	stew-ard-ess
episode	ep-i-sode
changeling	change-ling
col-lec-tivist	col-lec-tiv-ist
alive	a-live
un-mis-tak-ably	un-mis-tak-a-bly
monar-chist	mon-ar-chist
re-spectable	re-spect-a-ble
bathos	ba-thos
seda-tive	sed-a-tive
ex-clu-sion-ary	ex-clu-sion-ar-y
creamy	cream-y
re-for-esta-tion	re-for-est-a-tion
in-vert-ed	inverted
emo-tion-al-ly	e-mo-tion-al-ly
crenel-la-tions	cren-el-la-tions
phle-boto-my	phle-bot-o-my
nitwit	nit-wit
maser	ma-ser
ves-ti-gial	ves-tig-i-al
teeter	tee-ter
hered-i-ty	he-red-i-ty
im-pre-sario	im-pre-sa-ri-o
de-lin-eate	de-lin-e-ate
oviduct	o-vi-duct
gun-metal	gun-met-al
schooner	schoon-er
wind-surfer	wind-surf-er
elu-ci-da-tion	e-lu-ci-da-tion
gospel	gos-pel
dy-namism	dy-na-mism
retic-u-lar	re-tic-u-lar
mi-cro-surgery	mi-cro-sur-ger-y
mnemon-ics	mne-mon-ics
calami-ty	ca-lam-i-ty
decade	dec-ade
brassy	brass-y
vagabond	vag-a-bond
river-side	riv-er-side
retro-fit	ret-ro-fit
essence	es-sence
philoso-pher	phi-los-o-pher
defe-cate	def-e-cate
bas-ketry	bas-ket-ry
puma	pu-ma
smoth-ered	smothered
maul-ing	mauling
fundrais-er	fund-rais-er
gale-na	ga-le-na
gra-nary	gra-na-ry
sec-re-tari-at	sec-re-tar-i-at
in-sou-ciant	in-sou-ci-ant
clank-ing	clan-king
reaper	reap-er
mea-sur-able	meas-ur-a-ble
faucet	fau-cet
tourism	tour-ism
mili-tia-man	mi-li-tia-man
link-able	link-a-ble
im-pres-sion-able	im-pres-sion-a-ble
devo-tee	dev-o-tee
tiny	ti-ny
lech-ery	lech-er-y
forego	fore-go
pro-gressed	progressed
sinis-tral	sin-is-tral
chorale	cho-rale
avenger	a-veng-er
scream-ing	screaming
profli-ga-cy	prof-li-ga-cy
gener-ic	ge-ner-ic
roundup	round-up
mas-cara	mas-car-a
holdup	hold-up
rani	ra-ni
sax-ony	sax-o-ny
quadru-ple	quad-ru-ple
patho-log-i-cal-ly	path-o-log-i-cal-ly
scrolling	scroll-ing
dactylic	dac-tyl-ic
snifter	snif-ter
in-sa-tiable	in-sa-tia-ble
con-sis-ten-cy	con-sist-en-cy
coy-ote	coy-o-te
con-temptible	con-tempt-i-ble
phil-an-thropic	phil-an-throp-ic
cranky	crank-y
en-chanter	en-chant-er
forester	for-est-er
coralline	cor-al-line
pre-s-e-lect	pre-se-lect
con-fronta-tion	con-fron-ta-tion
rever-ie	rev-er-ie
emas-cu-late	e-mas-cu-late
ivory	i-vo-ry
the-atri-cals	the-at-ri-cals
pur-suant	pur-su-ant
mid-dleweight	mid-dle-weight
bire-frin-gent	bi-re-frin-gent
sneer-ing	sneering
pipette	pi-pette
bedrock	bed-rock
gulli-bil-i-ty	gul-li-bil-i-ty
ru-ina-tion	ru-in-a-tion
opi-um	o-pi-um
con-stab-u-lary	con-stab-u-lar-y
ridicu-lous	ri-dic-u-lous
teapot	tea-pot
hy-dro-elec-tric	hy-dro-e-lec-tric
sisal	si-sal
turn-around	turn-a-round
erode	e-rode
ex-tra-mur-al	ex-tra-mu-ral
vari-abil-i-ty	var-i-a-bil-i-ty
demon-strate	dem-on-strate
wrinkly	wrin-kly
im-muno-sup-pres-sive	im-mu-no-sup-pres-sive
vestal	ves-tal
avalanche	av-a-lanche
valu-able	val-u-a-ble
iron-works	i-ron-works
moody	mood-y
blud-geon	bludg-eon
tib-ia	tib-i-a
lifestyle	life-style
uni-ver-sal	u-ni-ver-sal
ghana	ghana
umpteenth	ump-teenth
restora-tive	re-stor-a-tive
athe-ism	a-the-ism
epi-gram-mat-ic	ep-i-gram-mat-ic
even	e-ven
avow	a-vow
church-war-den	church-ward-en
bases	ba-ses
re-searcher	re-search-er
in-con-testable	in-con-test-a-ble
tra-verse	trav-erse
dairy-man	dair-y-man
hy-dros-phere	hy-dro-sphere
prefer-able	pref-er-a-ble
rein-ven-tion	re-in-ven-tion
seedbed	seed-bed
laugh-ably	laugh-a-bly
cloven	clo-ven
ten-antry	ten-ant-ry
ego-ma-ni-ac	e-go-ma-ni-ac
mis-an-thropy	mis-an-thro-py
in-de-struc-tible	in-de-struct-i-ble
flighty	flight-y
stony	ston-y
som-brero	som-bre-ro
echo	ech-o
rein-car-nat-ed	reincarnated
rege-late	re-ge-late
pho-to-copy	pho-to-cop-y
gable	ga-ble
crino-line	crin-o-line
celebri-ty	ce-leb-ri-ty
eman-ci-pa-tion	e-man-ci-pa-tion
leg-isla-tive	leg-is-la-tive
touristy	tour-ist-y
dy-s-tro-phy	dys-tro-phy
de-fen-dant	de-fend-ant
trainee	train-ee
in-signif-i-cance	in-sig-nif-i-cance
cre-ator	cre-a-tor
com-mis-sioned	commissioned
turnover	turn-o-ver
steeply	steep-ly
valen-tine	val-en-tine
cam-panile	cam-pa-ni-le
synap-tic	syn-ap-tic
op-er-a-tional-ly	op-er-a-tion-al-ly
so-cio-bi-ol-o-gy	so-ci-o-bi-ol-o-gy
floozy	floo-zy
cara-pace	car-a-pace
trea-son-able	trea-son-a-ble
con-flict-ual	con-flic-tu-al
valise	va-lise
promis-ing	prom-is-ing
unar-tic-u-lat-ed	un-ar-tic-u-lat-ed
teenag-er	teen-ag-er
usu-al-ly	u-su-al-ly
unas-so-ci-at-ed	un-as-so-ci-at-ed
de-press-ing	de-pres-sing
cen-trifuge	cen-tri-fuge
rein-vest	re-in-vest
provo-ca-tion	prov-o-ca-tion
pho-to-s-phere	pho-to-sphere
manome-ter	ma-nom-e-ter
pi-anola	pi-a-no-la
gamy	gam-y
loutish	lout-ish
aware-ness	a-ware-ness
rhea	rhe-a
query	que-ry
strug-gling	struggling
binoc-u-lar	bin-oc-u-lar
sali-vate	sal-i-vate
hoary	hoar-y
ju-niper	ju-ni-per
con-cor-dant	con-cord-ant
denizen	den-i-zen
calami-tous	ca-lam-i-tous
chill-ing	chilling
bene-fac-tress	ben-e-fac-tress
tingly	tin-gly
semi-colon	sem-i-co-lon
byprod-uct	by-prod-uct
brav-ery	brav-er-y
ep-silon	ep-si-lon
sideshow	side-show
cladding	clad-ding
pa-pyrus	pa-py-rus
sycamore	syc-a-more
no-tice-able	no-tice-a-ble
min-uet	min-u-et
oxy-moron	ox-y-mo-ron
asym-me-try	a-sym-me-try
veto	ve-to
at-tack-ing	attacking
ex-plorato-ry	ex-plor-a-to-ry
geno-type	gen-o-type
squadron	squad-ron
di-atom-ic	di-a-tom-ic
pro-boscis	pro-bos-cis
piton	pi-ton
reprisal	re-pris-al
pineal	pin-e-al
along-side	a-long-side
rogu-ish	ro-guish
vol-cano	vol-ca-no
frankly	frank-ly
con-veyanc-ing	con-vey-anc-ing
nifty	nif-ty
gantry	gan-try
poplar	pop-lar
rent-ed	rented
brunette	bru-nette
ar-rival	ar-ri-val
delu-sive	de-lu-sive
iconog-ra-phy	i-co-nog-ra-phy
manes	ma-nes
galleon	gal-le-on
auburn	au-burn
tele-scop-ic	tel-e-scop-ic
gateau	ga-teau
awake	a-wake
geo-phys-i-cal	ge-o-phys-i-cal
geo-sta-tion-ary	ge-o-sta-tion-ar-y
ge-nial-i-ty	ge-ni-al-i-ty
de-ni-able	de-ni-a-ble
zero	ze-ro
who-dunit	who-dun-it
newsprint	news-print
slant-ed	slanted
re-minder	re-mind-er
tur-bocharged	turbocharged
em-bossed	embossed
va-pid	vap-id
unasked	un-asked
ashamed	a-shamed
equal-i-ty	e-qual-i-ty
pho-to-chem-istry	pho-to-chem-is-try
ir-re-mov-able	ir-re-mov-a-ble
in-abil-i-ty	in-a-bil-i-ty
un-fet-tered	unfettered
nyala	nya-la
un-prof-itable	un-prof-it-a-ble
hide-away	hide-a-way
pre-dictably	pre-dict-a-bly
apol-o-gize	a-pol-o-gize
cabaret	cab-a-ret
penul-ti-mate	pe-nul-ti-mate
in-choate	in-cho-ate
resur-gent	re-sur-gent
in-con-gruity	in-con-gru-i-ty
arc-ing	arcing
idem	i-dem
un-rea-son-ably	un-rea-son-a-bly
un-san-i-tary	un-san-i-tar-y
dauber	daub-er
dentin	den-tin
sub-ur-ban-i-sa-tion	su-bur-ba-ni-sa-tion
epi-graph	ep-i-graph
poly-he-dron	pol-y-he-dron
pas-toral	pas-to-ral
par-enter-al	par-en-ter-al
un-re-pen-tant	un-re-pent-ant
pollen	pol-len
metonymy	me-ton-y-my
tonal	ton-al
voca-tive	voc-a-tive
lol-lipop	lol-li-pop
tulip	tu-lip
id-iomat-ic	id-i-o-mat-ic
pauci-ty	pau-ci-ty
con-ceiv-able	con-ceiv-a-ble
vendet-ta	ven-det-ta
over-draw	o-ver-draw
wormy	worm-y
ple-nary	ple-na-ry
diplo-ma	di-plo-ma
iso-sta-t-ic	i-so-stat-ic
su-per-abun-dant	su-per-a-bun-dant
creaky	creak-y
trade-marked	trademarked
telex	tel-ex
taxi-dermy	tax-i-der-my
dri-ven	driv-en
damna-tion	dam-na-tion
espy	es-py
in-valid	in-va-lid
op-eretta	op-er-et-ta
crazy	cra-zy
reread	re-read
layper-son	lay-per-son
necrop-o-lis	ne-crop-o-lis
ema-ci-at-ed	e-ma-ci-at-ed
uni-lat-er-al-ly	u-ni-lat-er-al-ly
col-le-gial	col-le-gi-al
ru-ined	ruined
midair	mid-air
su-per-posed	superposed
basil	bas-il
re-cessed	recessed
jazzy	jazz-y
imag-in-ings	im-ag-in-ings
ptarmi-gan	ptar-mi-gan
sub-terfuge	sub-ter-fuge
ocean-ic	o-ce-an-ic
aplomb	a-plomb
im-ple-menter	im-ple-ment-er
con-sor-tium	con-sor-ti-um
asymp-to-matic	a-symp-to-mat-ic
phonon	pho-non
arthro-pod	ar-thro-pod
pro-le-tari-at	pro-le-tar-i-at
stymie	sty-mie
every-where	eve-ry-where
ig-nominy	ig-no-min-y
sec-toral	sec-tor-al
ge-neal-o-gy	ge-ne-al-o-gy
coro-ner	cor-o-ner
pros-e-cu-to-r-i-al	pros-e-cu-to-ri-al
sur-viv-abil-i-ty	sur-viv-a-bil-i-ty
ra-dionu-clide	ra-di-o-nu-clide
in-fect-ed	in-fec-ted
castel-lat-ed	cas-tel-lat-ed
ide-o-log-i-cal-ly	i-de-o-log-i-cal-ly
physic	phys-ic
busy	bus-y
em-ployed	employed
lurid	lu-rid
monas-tic	mo-nas-tic
med-ica-tion	med-i-ca-tion
over-turn	o-ver-turn
tun-able	tun-a-ble
re-s-e-lect	re-se-lect
idol-a-try	i-dol-a-try
telekine-sis	tel-e-ki-ne-sis
colan-der	col-an-der
con-denser	con-dens-er
washout	wash-out
pesti-lence	pes-ti-lence
scaly	scal-y
worka-day	work-a-day
anony-mous-ly	a-non-y-mous-ly
con-tention	con-ten-tion
hero-ine	her-o-ine
mama	ma-ma
book-binder	book-bind-er
di-a-bolism	di-ab-o-lism
coitus	co-i-tus
reti-na	ret-i-na
dis-cor-dance	dis-cord-ance
artistry	art-ist-ry
tourni-quet	tour-ni-quet
fron-tispiece	fron-tis-piece
bil-iary	bil-i-ar-y
ap-pendage	ap-pend-age
overkill	o-ver-kill
hotspot	hot-spot
cretin	cre-tin
cough-ing	coughing
porcine	por-cine
pitiable	pit-i-a-ble
chem-istry	chem-is-try
cool-ing	cooling
hye-na	hy-e-na
sleepi-ness	sleep-i-ness
the-atri-cal	the-at-ri-cal
ir-refutable	ir-ref-u-ta-ble
lessen	less-en
in-ter-roga-tor	in-ter-ro-ga-tor
archival	ar-chi-val
ovary	o-va-ry
exother-mic	ex-o-ther-mic
meta-mor-phism	met-a-mor-phism
un-be-liev-able	un-be-liev-a-ble
un-der-stand-able	un-der-stand-a-ble
plen-teous	plen-te-ous
carmine	car-mine
minibus	min-i-bus
in-cisor	in-ci-sor
duo-logue	du-o-logue
sedi-tion	se-di-tion
over-do	o-ver-do
eeri-ly	ee-ri-ly
man-darin	man-da-rin
eclec-tic	ec-lec-tic
desider-a-tum	de-sid-er-a-tum
piti-less	pit-i-less
equal-ly	e-qual-ly
scanty	scant-y
un-aligned	un-a-ligned
tripoli	trip-o-li
bio-rhythm	bi-o-rhythm
gassy	gas-sy
for-warder	for-ward-er
us-abil-i-ty	us-a-bil-i-ty
geno-ci-dal	gen-o-cid-al
cur-tained	curtained
tricky	trick-y
in-suf-fer-able	in-suf-fer-a-ble
lep-rechaun	lep-re-chaun
chaot-ic	cha-ot-ic
cater-pil-lar	cat-er-pil-lar
sul-tana	sul-tan-a
ra-dioac-tiv-i-ty	ra-di-o-ac-tiv-i-ty
cus-tom-ary	cus-tom-ar-y
restora-tion	res-to-ra-tion
ele-phan-tine	el-e-phan-tine
relict	rel-ict
wag-gery	wag-ger-y
lack-adaisi-cal	lack-a-dai-si-cal
wafer	wa-fer
archdea-con	arch-dea-con
de-lim-it-ed	delimited
chimera	chi-me-ra
mandible	man-di-ble
wash-able	wash-a-ble
unan-i-mous-ly	u-nan-i-mous-ly
in-sou-ciance	in-sou-ci-ance
glassy	glass-y
run-away	run-a-way
fa-ther-ing	fathering
equable	eq-ua-ble
valiant-ly	val-iant-ly
benev-o-lence	be-nev-o-lence
predilec-tion	pre-di-lec-tion
boatswain	boat-swain
sub-servience	sub-ser-vi-ence
en-tourage	en-tou-rage
san-i-tary	san-i-tar-y
elec-tri-fy	e-lec-tri-fy
hit-table	hit-ta-ble
cor-ti-cos-teroid	cor-ti-co-ster-oid
syco-phancy	syc-o-phan-cy
skintight	skin-tight
rack-e-teer-ing	rack-et-eer-ing
undi-gest-ed	un-di-gest-ed
retic-u-lat-ed	re-tic-u-lat-ed
re-fin-ery	re-fin-er-y
pen-sion-able	pen-sion-a-ble
con-tender	con-tend-er
causal	caus-al
in-flat-able	in-flat-a-ble
jour-nalese	jour-nal-ese
com-pelling-ly	com-pel-ling-ly
sporran	spor-ran
necrop-sy	nec-rop-sy
gen-er-a-tional	gen-er-a-tion-al
hideous-ly	hid-e-ous-ly
wreck-ing	wrecking
over-dose	o-ver-dose
partheno-gen-e-sis	par-the-no-gen-e-sis
legal-ly	le-gal-ly
col-lapsi-ble	col-laps-i-ble
ra-dio	ra-di-o
omis-sion	o-mis-sion
an-titrust	an-ti-trust
dy-namo	dy-na-mo
raillery	rail-ler-y
un-pre-dictable	un-pre-dict-a-ble
prophet	proph-et
furtive-ly	fur-tive-ly
tapi-o-ca	tap-i-o-ca
linoleum	li-no-le-um
prog-es-terone	pro-ges-ter-one
high-lighter	high-ligh-ter
ath-leti-cism	ath-let-i-cism
barter	bar-ter
over-all	o-ver-all
some-body	some-bod-y
man-nequin	man-ne-quin
quest-ing	questing
vol-canic	vol-can-ic
vil-lainy	vil-lain-y
evil	e-vil
trea-so-nous	trea-son-ous
biodegrad-able	bi-o-de-grad-a-ble
zaire	za-ire
surfer	surf-er
mar-ke-teer	mar-ket-eer
cetacean	ce-ta-cean
capri-ole	cap-ri-ole
un-al-ter-able	un-al-ter-a-ble
amuse	a-muse
ora-tion	o-ra-tion
windy	wind-y
bazaar	ba-zaar
epi-der-mis	ep-i-der-mis
wolfish	wolf-ish
un-prov-able	un-prov-a-ble
twofaced	two-faced
drainage	drain-age
leisured	lei-sured
stenog-ra-ph-er	ste-nog-ra-pher
table-land	ta-ble-land
un-bear-able	un-bear-a-ble
mac-a-roni	mac-a-ro-ni
trace-abil-i-ty	trace-a-bil-i-ty
harem	har-em
hon-orif-ic	hon-or-if-ic
di-ary	di-a-ry
rein-te-gra-tion	re-in-te-gra-tion
achieve-ment	a-chieve-ment
sewing	sew-ing
tremu-lous	trem-u-lous
cousin	cous-in
dis-con-ti-nu-ity	dis-con-ti-nu-i-ty
pe-riphrastic	per-i-phras-tic
mis-cel-lany	mis-cel-la-ny
dim-pled	dimpled
claimant	claim-ant
weary-ing	wea-ry-ing
un-drink-able	un-drink-a-ble
prebend	preb-end
masochist	mas-och-ist
over-lay	o-ver-lay
askew	a-skew
con-cil-iar	con-cil-i-ar
span-gled	spangled
anger	an-ger
caliph	ca-liph
de-pen-den-cy	de-pend-en-cy
talon	tal-on
nega-tion	ne-ga-tion
geo-cen-tric	ge-o-cen-tric
pover-ty	pov-er-ty
read-mis-sion	re-ad-mis-sion
testy	tes-ty
morsel	mor-sel
tribu-la-tion	trib-u-la-tion
medal-lion	me-dal-lion
bloomer	bloom-er
un-break-able	un-break-a-ble
un-cre-ative	un-cre-a-tive
dele-te-ri-ous	del-e-te-ri-ous
reap-pear-ance	re-ap-pear-ance
dif-fuser	dif-fus-er
mankind	man-kind
mat-te	matte
wiper	wip-er
debu-tant	deb-u-tant
physi-cian	phy-si-cian
valid	val-id
edgy	edg-y
bac-carat	bac-ca-rat
over-in-flat-ed	o-ver-in-flat-ed
sto-ical	sto-i-cal
den-tistry	den-tis-try
suit-ably	suit-a-bly
seashore	sea-shore
as-cen-dan-cy	as-cend-an-cy
ji-u-jit-su	jiu-jit-su
hyp-nother-a-py	hyp-no-ther-a-py
pupil	pu-pil
hul-la-baloo	hul-la-ba-loo
radix	ra-dix
reser-voir	res-er-voir
drinker	drink-er
ca-cao	ca-ca-o
di-aphanous	di-aph-a-nous
ago	a-go
redo-lent	red-o-lent
sym-po-sium	sym-po-si-um
en-forcer	en-forc-er
stager	stag-er
sto-ry-telling	sto-ry-tell-ing
ovate	o-vate
mon-e-tarism	mon-e-ta-rism
silt-ing	silting
or-ga-ni-za-tion	or-gan-i-za-tion
rigid-i-ty	ri-gid-i-ty
dredger	dredg-er
hooli-gan	hoo-li-gan
duo-de-num	du-o-de-num
re-assem-ble	re-as-sem-ble
earshot	ear-shot
ide-al-ist	i-de-al-ist
bluish	blu-ish
dic-tio-nary	dic-tion-ar-y
ban-ter-ing	bantering
pantry	pan-try
shim-mer-ing	shimmering
stratig-ra-phy	stra-tig-ra-phy
sedan	se-dan
urea	u-re-a
plan-e-tary	plan-e-tar-y
tick-et-ed	ticketed
monastery	mon-as-ter-y
wether	weth-er
macro	mac-ro
gaiter	gait-er
panache	pa-nache
bio-chemist	bi-o-chem-ist
herbal-ist	herb-al-ist
unabridged	un-a-bridged
bunkum	bun-kum
genii	ge-ni-i
unre-deemed	un-re-deemed
dis-agree-able	dis-a-gree-a-ble
in-ter-de-pen-dent	in-ter-de-pend-ent
nasty	nas-ty
egre-gious	e-gre-gious
haulage	haul-age
lodger	lodg-er
iso-la-tion-ist	i-so-la-tion-ist
zoo-plank-ton	zo-o-plank-ton
epit-o-me	e-pit-o-me
quadru-pole	quad-ru-pole
sub-species	sub-spe-cies
silky	silk-y
degra-da-tion	deg-ra-da-tion
unchris-t-ian	un-chris-tian
reval-ue	re-val-ue
het-ero-sex-u-al-i-ty	het-er-o-sex-u-al-i-ty
mover	mov-er
iden-ti-fi-er	i-den-ti-fi-er
steadi-ness	stead-i-ness
des-tiny	des-ti-ny
oblige	o-blige
crin-kled	crinkled
copy-writer	cop-y-writ-er
guinea	guin-ea
poly-cyclic	pol-y-cy-clic
corkscrew	cork-screw
chancy	chanc-y
epi-ge-net-ic	ep-i-ge-net-ic
retic-u-lum	re-tic-u-lum
un-aware	un-a-ware
un-miss-able	un-miss-a-ble
cor-re-spon-dence	cor-re-spond-ence
vi-su-al	vis-u-al
punc-til-ious	punc-til-i-ous
sacral	sa-cral
cheer-leader	cheer-lead-er
aright	a-right
in-com-bustible	in-com-bus-ti-ble
scholas-ti-cism	scho-las-ti-cism
re-align	re-a-lign
char-i-o-teer	char-i-ot-eer
stron-groom	strong-room
in-quisi-tor	in-quis-i-tor
poi-so-nous	poi-son-ous
en-v-i-ron	en-vi-ron
fusil-lade	fu-sil-lade
vex-ing	vexing
mo-men-tary	mo-men-tar-y
tiler	til-er
lacteal	lac-te-al
barom-e-ter	ba-rom-e-ter
li-bidi-nous	li-bid-i-nous
rea-son-able	rea-son-a-ble
peren-ni-al-ly	per-en-ni-al-ly
dosage	dos-age
es-capism	es-cap-ism
stormy	storm-y
res-cuer	res-cu-er
fil-ial	fil-i-al
genoa	gen-o-a
pushy	push-y
frailty	frail-ty
agency	a-gen-cy
over-pro-duced	overproduced
ban-dage	band-age
fleecy	fleec-y
gad-getry	gadg-et-ry
satire	sat-ire
nir-vana	nir-va-na
kalei-do-scope	ka-lei-do-scope
nineti-eth	nine-ti-eth
willpow-er	will-pow-er
privy	priv-y
gavial	ga-vi-al
re-cidi-vist	re-cid-i-vist
mossy	mos-sy
ema-ci-a-tion	e-ma-ci-a-tion
rob-bery	rob-ber-y
stripling	strip-ling
unedit-ed	un-ed-it-ed
climber	climb-er
rein-sur-ance	re-in-sur-ance
yeasty	yeast-y
un-am-bigu-ous	un-am-big-u-ous
cursed	curs-ed
teach-able	teach-a-ble
whizkids	whizkids
brigade	bri-gade
uvu-lar	u-vu-lar
poly-mor-phism	pol-y-mor-phism
velum	ve-lum
backgam-mon	back-gam-mon
pi-anis-si-mo	pi-a-nis-si-mo
snowflake	snow-flake
cor-re-spon-dent	cor-re-spond-ent
reroutes	re-routes
recog-ni-tion	rec-og-ni-tion
scapu-la	scap-u-la
thirsty	thirst-y
brevi-ty	brev-i-ty
horo-scope	hor-o-scope
gofer	go-fer
elon-gat-ed	e-lon-gat-ed
thrilling	thrill-ing
hy-dro-sta-t-ic	hy-dro-stat-ic
seedy	seed-y
un-sellable	un-sell-a-ble
co-proces-sor	co-proc-es-sor
sym-bio-sis	sym-bi-o-sis
semi-con-duct-ing	sem-i-con-duct-ing
pro-tec-torate	pro-tec-tor-ate
evade	e-vade
ori-en-tal	o-ri-en-tal
encage	en-cage
di-a-conal	di-ac-o-nal
un-nerv-ing	unnerving
prefer-ably	pref-er-a-bly
precinct	pre-cinct
liquor-ish	liq-uor-ish
over-am-bi-tious	o-ver-am-bi-tious
mendele-vi-um	men-de-le-vi-um
share-able	share-a-ble
potash	pot-ash
wimpy	wimp-y
un-par-don-able	un-par-don-a-ble
apace	a-pace
op-ti-mistic	op-ti-mis-tic
body	bod-y
elec-tro-cu-tion	e-lec-tro-cu-tion
ap-pa-ra-tus	ap-pa-rat-us
sado-masochis-tic	sa-do-mas-o-chis-tic
tele-text	tel-e-text
re-tain-ing	retaining
unimag-in-able	un-im-ag-i-na-ble
bassist	bass-ist
aris-toc-ra-cy	ar-is-toc-ra-cy
eco-log-i-cal-ly	ec-o-log-i-cal-ly
obei-sance	o-bei-sance
balder-dash	bal-der-dash
canon-ic	ca-non-ic
dowry	dow-ry
spooky	spook-y
over-step	o-ver-step
milliner	mil-li-ner
geopo-lit-i-cal	ge-o-po-lit-i-cal
heartache	heart-ache
epi-cure	ep-i-cure
mus-ke-teer	mus-ket-eer
su-per-in-ten-dence	su-per-in-tend-ence
un-ac-cept-ably	un-ac-cept-a-bly
re-gret-table	re-gret-ta-ble
eerie	ee-rie
tem-pera-ment	tem-per-a-ment
replic-a-ble	rep-li-ca-ble
di-gester	di-gest-er
sui-ci-dal	su-i-cid-al
posy	po-sy
briefly	brief-ly
killing	kill-ing
squeegee	squee-gee
dip-so-ma-nia	dip-so-ma-ni-a
ion	i-on
founder	found-er
dis-abling	disabling
uterus	u-ter-us
emer-sion	e-mer-sion
macron	ma-cron
pold-er	pol-der
lilac	li-lac
mer-chantable	mer-chant-a-ble
cagoule	ca-goule
frip-pery	frip-per-y
delir-i-um	de-lir-i-um
unim-peach-able	un-im-peach-a-ble
sug-gestible	sug-gest-i-ble
man-age-r-i-al	man-a-ge-ri-al
premise	prem-ise
parox-ysm	par-ox-ysm
dri-ver	driv-er
melody	mel-o-dy
hys-te-ria	hys-te-ri-a
un-demon-stra-tive	un-de-mon-stra-tive
mea-sure-less	meas-ure-less
func-tionary	func-tion-ar-y
con-flict-ed	conflicted
diva	di-va
di-etet-ic	di-e-tet-ic
teller	tell-er
de-cayed	decayed
decile	dec-ile
Words with errors: 1863
Words with incorrect number of syllables: 1759
Total evluated: 6500
Perfect accuracy: 0.71
Number of syllables accuracy: 0.73
Average Levenshtein Distance(across incorrect words): 1.19
