Attempt	Real
an-swer-able	an-swer-a-ble
demo	dem-o
lazuli	laz-u-li
curvi-lin-ear	cur-vi-lin-e-ar
sil-vered	silvered
how-itzer	how-itz-er
aright	a-right
ar-guable	ar-gu-a-ble
thirsty	thirst-y
geyser	gey-ser
bio-di-ver-si-ty	bi-o-di-ver-si-ty
in-vesti-ture	in-ves-ti-ture
so-lic-it-ing	soliciting
ca-su-al-ty	cas-u-al-ty
rapi-er	ra-pi-er
tho-racic	tho-rac-ic
tele-ol-o-gy	tel-e-ol-o-gy
crazi-ness	cra-zi-ness
get-away	get-a-way
shaky	shak-y
neo-phyte	ne-o-phyte
uni-corn	u-ni-corn
minaret	min-a-ret
mi-cro-com-put-er	mi-cro-com-pu-ter
no-tably	no-ta-bly
mega-lith	meg-a-lith
im-per-me-able	im-per-me-a-ble
er-gonom-ics	er-go-nom-ics
marcher	march-er
patchy	patch-y
retic-u-lum	re-tic-u-lum
chirpy	chirp-y
in-ves-tiga-tive	in-ves-ti-ga-tive
in-quisi-to-r-i-al	in-quis-i-to-ri-al
meta-lan-guage	met-a-lan-guage
over-hand	o-ver-hand
porter-age	por-ter-age
pro-cre-ation	pro-cre-a-tion
spelling	spell-ing
mover	mov-er
necro-mancer	nec-ro-man-cer
atone	a-tone
bovine	bo-vine
no-body	no-bod-y
bowsprit	bow-sprit
dy-s-tro-phy	dys-tro-phy
crooked	crook-ed
pumice	pum-ice
metaphor-i-cal-ly	met-a-phor-i-cal-ly
sub-stan-dard	sub-stand-ard
gazelle	ga-zelle
diode	di-ode
debtor	debt-or
peri-patet-ic	per-i-pa-tet-ic
renowned	re-nowned
deuteron	deu-ter-on
synap-tic	syn-ap-tic
com-peti-tor	com-pet-i-tor
as-tro-physics	as-tro-phys-ics
haystack	hay-stack
com-fort-ably	com-fort-a-bly
spir-i-tu-al-ist	spir-it-u-al-ist
elas-tic	e-las-tic
elec-tro-sta-t-ic	e-lec-tro-stat-ic
poly-merase	pol-y-mer-ase
rack-e-teer-ing	rack-et-eer-ing
mal-leable	mal-le-a-ble
id-iomat-ic	id-i-o-mat-ic
heavy-weight	heav-y-weight
prepo-si-tion-al	prep-o-si-tion-al
neu-ronal	neu-ron-al
gherkin	gher-kin
ini-ti-a-tion	in-i-ti-a-tion
golfer	golf-er
physi-cian	phy-si-cian
ethnog-ra-phy	eth-nog-ra-phy
di-rec-torate	di-rec-to-rate
colos-sus	co-los-sus
scan-dalous	scan-dal-ous
de-spi-ca-ble	des-pi-ca-ble
utopi-an	u-to-pi-an
cashier	cash-ier
elec-tric-i-ty	e-lec-tric-i-ty
supra-na-tion-al	su-pra-na-tion-al
in-ter-preter	in-ter-pret-er
fugi-tive	fu-gi-tive
octet	oc-tet
mi-cro-bial	mi-cro-bi-al
in-quisi-tor	in-quis-i-tor
seis-mome-ter	seis-mom-e-ter
spon-sored	sponsored
de-riso-ry	de-ri-so-ry
lounger	loung-er
rhap-sody	rhap-so-dy
es-capade	es-ca-pade
un-prece-dent-ed	un-prec-e-dent-ed
nodal	nod-al
mono-lith	mon-o-lith
un-der-achieve-ment	un-der-a-chieve-ment
despot	des-pot
anvil	an-vil
de-fen-dant	de-fend-ant
elec-tron	e-lec-tron
li-able	li-a-ble
fri-able	fri-a-ble
lever	lev-er
shiv-ery	shiv-er-y
mur-al	mu-ral
telling-ly	tell-ing-ly
or-di-nary	or-di-nar-y
lig-and	li-gand
squea-mish	squeam-ish
piercer	pierc-er
geom-e-try	ge-om-e-try
un-ser-vice-able	un-ser-vice-a-ble
bud-get	budg-et
palat-able	pal-at-a-ble
erec-tion	e-rec-tion
lighter	light-er
in-frared	in-fra-red
para-pet	par-a-pet
medal-lion	me-dal-lion
un-re-cov-er-able	un-re-cov-er-a-ble
singsong	sing-song
aba-cus	ab-a-cus
pup-peteer	pup-pet-eer
en-tropy	en-tro-py
con-stab-u-lary	con-stab-u-lar-y
erode	e-rode
warpaint	war-paint
forepaw	fore-paw
ap-pa-ra-tus	ap-pa-rat-us
rekin-dle	re-kin-dle
skua	sku-a
un-steady	un-stead-y
damsel	dam-sel
de-ductible	de-duct-i-ble
or-bital	or-bit-al
birdie	bird-ie
viaduct	vi-a-duct
over-charge	o-ver-charge
patel-la	pa-tel-la
can-dlelit	can-dle-lit
cav-ernous	cav-ern-ous
iso-met-ric	i-so-met-ric
elec-tri-fy	e-lec-tri-fy
ga-lop	gal-op
tele-vised	televised
sawmill	saw-mill
ap-plic-a-bil-i-ty	ap-pli-ca-bil-i-ty
claus-tro-pho-bia	claus-tro-pho-bi-a
arachno-pho-bia	a-rach-no-pho-bi-a
elec-toral	e-lec-tor-al
orig-i-nate	o-rig-i-nate
sub-atom-ic	sub-a-tom-ic
necro-man-cy	nec-ro-man-cy
reprint	re-print
deliri-ous	de-lir-i-ous
wran-gling	wrangling
pep-pered	peppered
re-doubtable	re-doubt-a-ble
kilo-hertz	kil-o-hertz
umpteen	ump-teen
moun-taineer-ing	moun-tain-eer-ing
poky	pok-y
downy	down-y
pyra-mid	pyr-a-mid
sepul-chral	se-pul-chral
med-i-c-i-nal	me-dic-i-nal
reval-ue	re-val-ue
hori-zon	ho-ri-zon
episod-ic	ep-i-sod-ic
over-act-ing	overacting
hookah	hook-ah
anoint	a-noint
telecom-mu-ni-ca-tion	tel-e-com-mu-ni-ca-tion
promi-nent	prom-i-nent
aris-to-crat	a-ris-to-crat
body-guard	bod-y-guard
re-assem-ble	re-as-sem-ble
stealthy	stealth-y
health-ily	health-i-ly
un-en-vi-able	un-en-vi-a-ble
pro-lactin	pro-lac-tin
aor-ta	a-or-ta
snifter	snif-ter
avenge	a-venge
hearthrug	hearth-rug
lithos-phere	lith-o-sphere
gale-na	ga-le-na
prob-a-bilis-tic	prob-a-bi-lis-tic
hairy	hair-y
ex-clu-sion-ary	ex-clu-sion-ar-y
iras-ci-ble	i-ras-ci-ble
un-af-ford-able	un-af-ford-a-ble
sacral	sa-cral
car-cino-gen-e-sis	car-cin-o-gen-e-sis
salu-tary	sal-u-tar-y
limp-ing	limping
restart	re-start
over-drive	o-ver-drive
preva-lence	prev-a-lence
ate-lier	at-el-ier
bathrobe	bath-robe
japan	ja-pan
unique	u-nique
isother-mal	i-so-ther-mal
geo-phys-i-cal	ge-o-phys-i-cal
slouch-ing	slouching
catchy	catch-y
any-way	an-y-way
longish	long-ish
hazy	ha-zy
erot-ic	e-rot-ic
di-a-bolism	di-ab-o-lism
daisy	dai-sy
in-con-sid-er-able	in-con-sid-er-a-ble
astir	a-stir
shad-owy	shad-ow-y
table-ware	ta-ble-ware
bac-te-rio-phage	bac-te-ri-o-phage
with-ered	withered
de-spon-dent	de-spond-ent
reper-toire	rep-er-toire
sub-ur-bia	sub-ur-bi-a
em-bryo	em-bry-o
lamb-swool	lambs-wool
vestibule	ves-ti-bule
grandios-i-ty	gran-di-os-i-ty
mau-soleum	mau-so-le-um
para-chutist	par-a-chut-ist
farad	far-ad
ax-il-lary	ax-il-lar-y
horny	horn-y
de-mog-ra-ph-er	de-mog-ra-pher
aro-mather-a-py	a-ro-ma-ther-a-py
de-f-i-n-i-tion-al	def-i-ni-tion-al
haulage	haul-age
scraper	scrap-er
ep-ithe-lial	ep-i-the-li-al
frizzy	friz-zy
harshen	harsh-en
hauli-er	haul-ier
elite	e-lite
mono-mi-al	mo-no-mi-al
auburn	au-burn
dither	dith-er
parochial	pa-ro-chi-al
lofty	loft-y
mul-ti-pro-cess-ing	mul-ti-proc-ess-ing
fermi-on	fer-mi-on
or-ga-nize	or-gan-ize
re-fusal	re-fus-al
physic	phys-ic
soloist	so-lo-ist
un-easi-ness	un-eas-i-ness
vil-lainy	vil-lain-y
phil-an-thropist	phi-lan-thro-pist
cere-bel-lum	cer-e-bel-lum
ra-dio-met-ric	ra-di-o-met-ric
ecol-o-gist	e-col-o-gist
dis-tri-b-u-tion	dis-tri-bu-tion
yippee	yip-pee
soupy	soup-y
tem-pera-ment	tem-per-a-ment
quadruped	quad-ru-ped
translu-cen-cy	trans-lu-cen-cy
laun-dered	laundered
ir-repara-ble	ir-rep-a-ra-ble
usury	u-su-ry
megas-tar	meg-a-star
wiry	wir-y
ar-chaeopteryx	ar-chae-op-ter-yx
many	man-y
legroom	leg-room
resur-gence	re-sur-gence
ionos-phere	i-on-o-sphere
friv-o-li-ty	fri-vol-i-ty
cre-osote	cre-o-sote
baron-age	bar-on-age
crosstalk	cross-talk
stopover	stop-o-ver
racial-ly	ra-cial-ly
coro-ner	cor-o-ner
iso-la-tion	i-so-la-tion
unto	un-to
evoke	e-voke
liv-ery	liv-er-y
preda-to-ry	pred-a-to-ry
re-cy-clable	re-cy-cla-ble
feb-ru-ary	feb-ru-ar-y
tingly	tin-gly
cata-ton-ic	cat-a-ton-ic
nestling	nest-ling
mis-cel-lanea	mis-cel-la-ne-a
granny	gran-ny
bur-sary	bur-sa-ry
mar-tinet	mar-ti-net
pedes-tri-an	pe-des-tri-an
in-de-ci-pher-able	in-de-ci-pher-a-ble
en-counter	en-coun-ter
tyran-ny	tyr-an-ny
premis-es	prem-is-es
equinoc-tial	e-qui-noc-tial
melo-dra-ma	mel-o-dra-ma
sacro-sanct	sac-ro-sanct
navy	na-vy
bun-gled	bungled
brainy	brain-y
hy-draulic	hy-drau-lic
ugly	ug-ly
epis-temic	ep-i-ste-mic
methanol	meth-a-nol
par-si-mo-nious	par-si-mo-ni-ous
opal	o-pal
trea-so-nous	trea-son-ous
owlet	owl-et
pearly	pearl-y
shifty	shift-y
reser-voir	res-er-voir
over-done	o-ver-done
elec-tro-mag-net	e-lec-tro-mag-net
prospect	pros-pect
metro	met-ro
newsy	news-y
techno-pho-bia	tech-no-pho-bia
styl-is-tic	sty-lis-tic
mod-esty	mod-es-ty
singer	sing-er
de-sir-able	de-sir-a-ble
mer-cu-r-ial	mer-cu-ri-al
over-anx-ious	o-ver-anx-ious
groom-ing	grooming
piv-ot-ed	pivoted
visa	vi-sa
pres-tidig-i-ta-tion	pres-ti-dig-i-ta-tion
felon	fel-on
taster	tast-er
mul-ti-me-dia	mul-ti-me-di-a
em-bolism	em-bo-lism
volup-tuous	vo-lup-tu-ous
cagoule	ca-goule
raver	rav-er
elec-tor	e-lec-tor
sym-po-sium	sym-po-si-um
oblo-quy	ob-lo-quy
japon-i-ca	ja-pon-i-ca
in-con-ve-nient	in-con-ven-ient
gener-i-cal-ly	ge-ner-i-cal-ly
in-de-pen-dent	in-de-pend-ent
em-bell-ish-ment	em-bel-lish-ment
phy-loge-ny	phy-log-e-ny
geisha	gei-sha
sub-unit	sub-u-nit
no-tary	no-ta-ry
rusty	rust-y
im-politic	im-pol-i-tic
an-titrust	an-ti-trust
re-cidi-vism	re-cid-i-vism
scampi	scam-pi
beat-i-tude	be-at-i-tude
im-per-son-ator	im-per-son-a-tor
duel	du-el
epi-taxy	ep-i-tax-y
para-dox-i-cal	par-a-dox-i-cal
wafer	wa-fer
grotesque	gro-tesque
cola	co-la
auger	au-ger
medi-um	me-di-um
su-prema-cy	su-prem-a-cy
em-bassy	em-bas-sy
plumber	plumb-er
syco-phan-tic	syc-o-phan-tic
un-solv-able	un-solv-a-ble
par-alin-guis-tic	par-a-lin-guis-tic
un-der-rat-ed	underrated
aphid	a-phid
weightlift-ing	weight-lift-ing
oblig-ing	o-blig-ing
pi-ran-ha	pi-ra-nha
pho-to-copy	pho-to-cop-y
oral	o-ral
teardrop	tear-drop
bereft	be-reft
mon-e-tary	mon-e-tar-y
re-order	re-or-der
holo-caust	hol-o-caust
polyandry	pol-y-an-dry
fron-tispiece	fron-tis-piece
neona-tal	ne-o-na-tal
union	un-ion
stapes	sta-pes
swindler	swin-dler
antacid	ant-ac-id
politic	pol-i-tic
per-pe-tu-ity	per-pe-tu-i-ty
moorhen	moor-hen
binoc-u-lar	bin-oc-u-lar
helpline	help-line
uni-lat-er-al-ism	u-ni-lat-er-al-ism
stinger	sting-er
slaver	slav-er
batik	ba-tik
juicy	juic-y
cryp-tol-ogy	cryp-tol-o-gy
over-work	o-ver-work
phy-lac-tery	phy-lac-ter-y
aubergine	au-ber-gine
pre-lim-i-nary	pre-lim-i-nar-y
hy-dro-elec-tric	hy-dro-e-lec-tric
mas-tery	mas-ter-y
medi-oc-rity	me-di-oc-ri-ty
papil-la	pa-pil-la
en-hancer	en-hanc-er
dis-cour-tesy	dis-cour-te-sy
pri-apic	pri-ap-ic
pathogen	path-o-gen
seedy	seed-y
avid-i-ty	a-vid-i-ty
cred-itable	cred-it-a-ble
tiler	til-er
lava	la-va
geno-ci-dal	gen-o-cid-al
ar-madil-lo	ar-ma-dil-lo
postlude	post-lude
flossy	floss-y
brio	bri-o
pre-lude	prel-ude
over-all	o-ver-all
in-deli-bly	in-del-i-bly
rosette	ro-sette
in-de-ter-minable	in-de-ter-mi-na-ble
queasy	quea-sy
trumpery	trump-er-y
tick-et-ed	ticketed
teller	tell-er
nonex-is-tence	non-ex-ist-ence
idly	i-dly
as-cen-der	as-cend-er
smarten	smart-en
pol-lard-ed	pollarded
ethe-re-al	e-the-re-al
eddy	ed-dy
odi-ous	o-di-ous
ante	an-te
portable	port-a-ble
seclu-sion	se-clu-sion
cy-tol-ogy	cy-tol-o-gy
tepid	tep-id
de-nier	de-ni-er
biofeed-back	bi-o-feed-back
de-viance	de-vi-ance
un-de-ni-able	un-de-ni-a-ble
quizzi-cal	quiz-zi-cal
over-crowd-ing	o-ver-crow-ding
for-tu-itous-ly	for-tu-i-tous-ly
mileage	mile-age
so-ciopo-lit-i-cal	so-ci-o-po-lit-i-cal
con-tentious	con-ten-tious
mas-sacre	mas-sa-cre
repet-i-tive	re-pet-i-tive
un-print-able	un-print-a-ble
rheumat-ic	rheu-mat-ic
bio-met-rics	bi-o-met-rics
cur-tilage	cur-ti-lage
con-duct-ed	conducted
im-pass-able	im-pass-a-ble
apos-to-late	a-pos-to-late
aback	a-back
yeti	yet-i
vi-t-a-min	vi-ta-min
por-traitist	por-trait-ist
knowl-edge-able	knowl-edge-a-ble
epi-der-mis	ep-i-der-mis
vivi-sec-tion	viv-i-sec-tion
con-fir-ma-to-ry	con-firm-a-to-ry
blus-ter-ing	blustering
cagey	cag-ey
diplo-ma	di-plo-ma
pan-das	pan-das
brack-et-ed	bracketed
over-throw	o-ver-throw
enor-mous-ly	e-nor-mous-ly
gen-tri-fied	gentrified
grasshop-per	grass-hop-per
re-spon-der	re-spond-er
loaded	load-ed
de-bauch-ery	de-bauch-er-y
trage-di-an	tra-ge-di-an
cys-teine	cys-te-ine
liquor-ish	liq-uor-ish
pion	pi-on
steeple-chase	stee-ple-chase
em-bit-tered	embittered
purist	pur-ist
cheesy	chees-y
sprawl-ing	sprawling
seg-ment-ed	seg-men-ted
mod-ernism	mod-ern-ism
poly-crys-talline	pol-y-crys-tal-line
coinage	coin-age
over-draft	o-ver-draft
sec-re-tari-at	sec-re-tar-i-at
stilet-to	sti-let-to
py-rotech-nic	py-ro-tech-nic
chival-rous	chiv-al-rous
fever-ish	fe-ver-ish
pres-ti-gious	pres-tig-ious
ide-ol-o-gy	i-de-ol-o-gy
rounder	round-er
ca-ma-raderie	ca-ma-ra-de-rie
over-time	o-ver-time
dis-cred-it-ed	discredited
habi-ta-tion	hab-i-ta-tion
blaster	blast-er
over-flow	o-ver-flow
poet	po-et
forestry	for-est-ry
glis-ten-ing	gli-ste-ning
mutiny	mu-ti-ny
oral-ly	o-ral-ly
weedy	weed-y
salaam	sa-laam
item	i-tem
maul-ing	mauling
car-avel	car-a-vel
in-signif-i-cant	in-sig-nif-i-cant
un-emo-tion-al	un-e-mo-tion-al
notwith-stand-ing	not-with-stand-ing
moody	mood-y
calo-rie	cal-o-rie
sawyer	saw-yer
pari-ah	pa-ri-ah
con-toured	contoured
ig-nominy	ig-no-min-y
epi-demi-ol-o-gy	ep-i-de-mi-ol-o-gy
corky	cork-y
crum-by	crumb-y
swelling	swell-ing
gigo-lo	gig-o-lo
mine-strone	min-e-stro-ne
raider	raid-er
mili-tia-man	mi-li-tia-man
bes-tial-i-ty	bes-ti-al-i-ty
elec-tri-cian	e-lec-tri-cian
faulty	fault-y
naval	na-val
ar-cana	ar-ca-na
de-pri-va-tion	dep-ri-va-tion
para-ble	par-a-ble
ma-hogany	ma-hog-a-ny
blankly	blank-ly
over-worked	overworked
hi-ero-glyph	hi-er-o-glyph
in-hab-i-tant	in-hab-it-ant
archivist	ar-chi-vist
fatu-ous	fat-u-ous
re-newed	renewed
car-boxyl	car-box-yl
arouse	a-rouse
psalmist	psalm-ist
hyp-nother-a-py	hyp-no-ther-a-py
positron	pos-i-tron
spiky	spik-y
hoary	hoar-y
aphe-lion	a-phe-li-on
monar-chist	mon-ar-chist
matins	mat-ins
minu-ti-ae	mi-nu-ti-ae
poly-syl-lab-ic	pol-y-syl-lab-ic
hy-pox-ia	hy-pox-i-a
spindly	spin-dly
mam-malian	mam-ma-li-an
au-gury	au-gu-ry
reshuf-fle	re-shuf-fle
fara-day	far-a-day
inca	in-ca
gelig-nite	gel-ig-nite
cor-ti-cos-teroid	cor-ti-co-ster-oid
usu-al	u-su-al
pussy	pus-sy
elide	e-lide
over-come	o-ver-come
sec-ondary	sec-ond-ar-y
bunkum	bun-kum
em-piri-cism	em-pir-i-cism
mistype	mis-type
brawny	brawn-y
med-ica-tion	med-i-ca-tion
bib-lio-phile	bib-li-o-phile
petrol-o-gy	pe-trol-o-gy
hotspot	hot-spot
cater-pil-lar	cat-er-pil-lar
cin-e-matog-ra-ph-er	cin-e-ma-tog-ra-pher
so-cio-bi-ol-o-gy	so-ci-o-bi-ol-o-gy
leav-ened	leavened
playable	play-a-ble
pre-dictably	pre-dict-a-bly
totem	to-tem
harem	har-em
usurp-er	u-surp-er
in-sup-port-able	in-sup-port-a-ble
premise	prem-ise
tar-ty	tart-y
evoca-tive	e-voc-a-tive
dis-avow-al	dis-a-vow-al
dizzy	diz-zy
steeply	steep-ly
rur-al	ru-ral
elfin	elf-in
toluene	tol-u-ene
ty-pog-ra-phers	ty-po-gra-phers
cat-alyt-ic	cat-a-lyt-ic
over-ly-ing	o-ver-ly-ing
timid-ly	tim-id-ly
pos-i-tivism	pos-i-tiv-ism
plexus	plex-us
over-pay	o-ver-pay
bang-ing	banging
colo-nial	co-lo-ni-al
un-elect-ed	un-e-lect-ed
re-assess	re-as-sess
bullfinch	bull-finch
geron-tol-ogy	ger-on-tol-o-gy
as-pi-rant	as-pir-ant
copi-lot	co-pi-lot
ec-topic	ec-top-ic
froward	fro-ward
specif-i-cal-ly	spe-cif-i-cal-ly
rege-late	re-ge-late
blun-der-ing	blundering
in-ter-op-er-abil-i-ty	in-ter-op-er-a-bil-i-ty
blocky	block-y
hor-mon-al	hor-mo-nal
eques-tri-an	e-ques-tri-an
harpists	har-pists
cater-er	ca-ter-er
lichen	li-chen
glos-sary	glos-sa-ry
chaffinch	chaf-finch
rasper	rasp-er
plumage	plum-age
serai	se-ra-i
seago-ing	sea-go-ing
painful-ly	pain-ful-ly
joey	jo-ey
de-f-i-n-i-tion	def-i-ni-tion
dentin	den-tin
gecko	geck-o
chintzy	chintz-y
click-ing	clicking
ptarmi-gan	ptar-mi-gan
en-chanter	en-chant-er
corvette	cor-vette
heresy	her-e-sy
su-per-abun-dant	su-per-a-bun-dant
triple	tri-ple
om-nipres-ence	om-ni-pres-ence
bacil-lus	ba-cil-lus
of-fend-ing	of-fen-ding
garter	gar-ter
plover	plov-er
polypropy-lene	pol-y-pro-pyl-ene
notepa-per	note-pa-per
bloody	blood-y
aplomb	a-plomb
speci-fici-ty	spec-i-fic-i-ty
vestry	ves-try
en-chant-ed	enchanted
laden	lad-en
eclip-tic	e-clip-tic
pleat-ed	pleated
hy-dro-sta-t-ic	hy-dro-stat-ic
ovum	o-vum
babysit	ba-by-sit
his-toric	his-tor-ic
rock-et-ing	rocketing
plen-teous	plen-te-ous
galaxy	gal-ax-y
dele-tion	de-le-tion
apos-ta-sy	a-pos-ta-sy
re-unite	re-u-nite
labi-um	la-bi-um
enu-mer-ate	e-nu-mer-ate
copy-ist	cop-y-ist
gelatin	gel-a-tin
periglacial	per-i-gla-cial
un-der-study	un-der-stud-y
cre-ator	cre-a-tor
con-cor-dant	con-cord-ant
an-tifreeze	an-ti-freeze
dis-pos-able	dis-pos-a-ble
avowed	a-vowed
cervix	cer-vix
melo-di-ous	me-lo-di-ous
pronom-i-nal	pro-nom-i-nal
evo-ca-tion	ev-o-ca-tion
necro-man-tic	nec-ro-man-tic
du-op-oly	du-op-o-ly
sev-ered	severed
un-in-for-ma-tive	un-in-form-a-tive
uvu-la	u-vu-la
sergeant	ser-geant
mimet-ic	mi-met-ic
ma-chin-ery	ma-chin-er-y
mag-is-te-r-i-al	mag-is-te-ri-al
asi-nine	as-i-nine
viceroy	vice-roy
con-t-a-m-i-nate	con-tam-i-nate
colonel	colo-nel
lech-ery	lech-er-y
castel-lat-ed	cas-tel-lat-ed
viewfind-er	view-find-er
bather	bath-er
par-al-lelepiped	par-al-lel-e-pi-ped
residue	res-i-due
id-io-path-ic	id-i-o-path-ic
talkie	talk-ie
booty	boo-ty
wail-ing	wailing
woofer	woof-er
ele-phant	el-e-phant
detri-men-tal	det-ri-men-tal
re-cessed	recessed
ho-mo-pho-bia	ho-mo-pho-bi-a
mea-sure-ment	meas-ure-ment
briefer	brief-er
medusa	me-du-sa
un-bridge-able	un-bridge-a-ble
hy-per-bole	hy-per-bo-le
un-rep-re-sen-ta-tive	un-rep-re-sent-a-tive
uni-lat-er-al-ist	u-ni-lat-er-al-ist
un-for-giv-able	un-for-giv-a-ble
styling	styl-ing
warthog	wart-hog
dip-so-ma-nia	dip-so-ma-ni-a
clash-ing	clashing
farmer	farm-er
florid	flor-id
un-suit-able	un-suit-a-ble
mor-tu-ary	mor-tu-ar-y
re-word-ings	re-word-ings
con-ge-nial	con-gen-ial
frankly	frank-ly
halo	ha-lo
humbly	hum-bly
fetishist	fet-ish-ist
rafter	raft-er
mealie	meal-ie
fifty	fif-ty
cordillera	cor-dil-le-ra
transcon-ti-nen-tal	trans-con-ti-nen-tal
walkover	walk-o-ver
para-mil-i-tary	par-a-mil-i-tar-y
in-sa-tiable	in-sa-tia-ble
nomen-cla-ture	no-men-cla-ture
lik-able	lik-a-ble
eosin	e-o-sin
solo	so-lo
buf-foon-ery	buf-foon-er-y
reap-point	re-ap-point
re-volver	re-volv-er
cedar	ce-dar
he-lios-phere	he-li-o-sphere
monogamy	mo-nog-a-my
imag-ine	im-ag-ine
sphyg-mo-manome-ter	sphyg-mo-ma-nom-e-ter
ar-senide	ar-se-nide
de-tectable	de-tect-a-ble
un-awares	un-a-wares
break-able	break-a-ble
sub-sidy	sub-si-dy
overkill	o-ver-kill
elec-tron-i-cal-ly	e-lec-tron-i-cal-ly
lega-tor	le-ga-tor
fruition	fru-i-tion
cus-tom-ary	cus-tom-ar-y
lazi-ness	la-zi-ness
espres-so	es-pres-so
ir-re-solv-able	ir-re-solv-a-ble
haiku	hai-ku
in-ter-po-lat-able	in-ter-po-la-ta-ble
felo-nious	fe-lo-ni-ous
fora-men	fo-ra-men
pantry	pan-try
cladding	clad-ding
dozen	doz-en
de-monolo-gy	de-mon-ol-o-gy
pitiable	pit-i-a-ble
moral	mor-al
duet	du-et
aver-sive	a-ver-sive
tulip	tu-lip
un-ready	un-read-y
stat-u-ary	stat-u-ar-y
yeasty	yeast-y
bat-ter-ing	battering
macro	mac-ro
in-ad-ver-tent-ly	in-ad-vert-ent-ly
di-ver-sion-ary	di-ver-sion-ar-y
pogrom	po-grom
ven-omous	ven-om-ous
mono-syl-lab-ic	mon-o-syl-lab-ic
re-ceiv-able	re-ceiv-a-ble
frothy	froth-y
quasar	qua-sar
celeb	ce-leb
ima-go	i-ma-go
chid-ing	chiding
om-nipo-tence	om-nip-o-tence
chi-nois-erie	chi-noi-se-rie
fid-gety	fidg-et-y
repack-age	re-pack-age
posthu-mous-ly	post-hu-mous-ly
ex-cus-able	ex-cus-a-ble
repos-i-to-ry	re-pos-i-to-ry
ra-di-ogram	ra-di-o-gram
ahead	a-head
over-rule	o-ver-rule
furtive	fur-tive
humerus	hu-mer-us
any-one	an-y-one
elas-tic-i-ty	e-las-tic-i-ty
tum-bled	tumbled
em-body	em-bod-y
in-tractable	in-trac-ta-ble
per-sis-tent-ly	per-sist-ent-ly
bedrag-gled	be-drag-gled
con-ducive	con-du-cive
diathermy	di-a-ther-my
plan-e-tary	plan-e-tar-y
jerkin	jer-kin
uni-tary	u-ni-tar-y
re-splen-dent	re-splend-ent
parish	par-ish
api-ary	a-pi-ar-y
dif-fuser	dif-fus-er
steeple	stee-ple
unedit-ed	un-ed-it-ed
carpal	car-pal
un-con-trol-lably	un-con-trol-la-bly
rec-on-cil-able	rec-on-cil-a-ble
epic	ep-ic
aris-to-crat-ic	a-ris-to-crat-ic
un-der-body	un-der-bod-y
over-whelm-ing	o-ver-whelm-ing
lyrist	lyr-ist
para-graph	par-a-graph
sala-mi	sa-la-mi
ex-huma-tion	ex-hu-ma-tion
mor-phia	mor-phi-a
proac-tive	pro-ac-tive
pa-tri-lin-eal	pat-ri-lin-e-al
un-con-t-a-m-i-nat-ed	un-con-tam-i-nat-ed
clien-tele	cli-en-tele
vagabond	vag-a-bond
over-whelm	o-ver-whelm
archer	arch-er
het-ero-dox	het-er-o-dox
de-mo-graph-ics	dem-o-graph-ics
cloa-ca	clo-a-ca
respire	re-spire
in-sis-tent	in-sist-ent
pro-pri-eto-r-i-al	pro-pri-e-to-ri-al
pur-veyance	pur-vey-ance
frontal	fron-tal
nifty	nif-ty
hourly	hour-ly
wrestler	wres-tler
flut-ter-ing	fluttering
wiz-ardry	wiz-ard-ry
pachy-derm	pach-y-derm
bear-able	bear-a-ble
pid-gin	pidg-in
re-spon-dent	re-spond-ent
hys-terec-to-my	hys-ter-ec-to-my
pedestal	ped-es-tal
spo-radic	spo-rad-ic
plebiscite	pleb-i-scite
scanty	scant-y
mist-ime	mis-time
bio-morph	bi-o-morph
crozi-er	cro-zier
de-tectably	de-tect-a-bly
in-con-sis-ten-cy	in-con-sist-en-cy
canon-i-cal	ca-non-i-cal
re-vo-ca-ble	rev-o-ca-ble
spiny	spin-y
un-so-licit-ed	un-so-lic-it-ed
baby	ba-by
imag-i-nary	im-ag-i-nar-y
poly-car-bon-ate	pol-y-car-bon-ate
in-ter-atom-ic	in-ter-a-tom-ic
un-nerv-ing	unnerving
rhodi-um	rho-di-um
grenade	gre-nade
vic-ar-i-ous	vi-car-i-ous
aso-cial	a-so-cial
pro-tean	pro-te-an
vex-ing	vexing
cyan	cy-an
gur-gling	gurgling
sisal	si-sal
holy	ho-ly
mildewy	mil-dew-y
cheva-lier	chev-a-lier
sa-fari	sa-fa-ri
epi-taph	ep-i-taph
spir-i-tu-al-ism	spir-it-u-al-ism
ridicu-lous-ness	ri-dic-u-lous-ness
ex-tra-galac-tic	ex-tra-ga-lac-tic
sodi-um	so-di-um
tom-fool-ery	tom-fool-er-y
over-grown	o-ver-grown
pu-gna-cious	pug-na-cious
ide-al-i-ty	i-de-al-i-ty
codex	co-dex
artistry	art-ist-ry
tremu-lous	trem-u-lous
rhodo-den-dron	rho-do-den-dron
spokesman	spokes-man
be-trothal	be-troth-al
stoa	sto-a
in-ter-nu-clear	in-ter-nu-cle-ar
bil-iary	bil-i-ar-y
sportive	spor-tive
lunchtime	lunch-time
un-adorned	un-a-dorned
heater	heat-er
trio	tri-o
sanc-ti-mo-nious	sanc-ti-mo-ni-ous
atom-ic	a-tom-ic
brioche	bri-oche
tyran-ni-cide	ty-ran-ni-cide
wreck-ing	wrecking
re-spectably	re-spect-a-bly
fruit-ing	fruiting
liqueur	li-queur
howdy	how-dy
dimwit	dim-wit
show-ery	show-er-y
evade	e-vade
par-al-lelism	par-al-lel-ism
payable	pay-a-ble
mort-gagor	mort-ga-gor
above	a-bove
labyrinthine	lab-y-rin-thine
boathouse	boat-house
ho-n-our	ho-nour
pep-pery	pep-per-y
ge-nial	ge-ni-al
aviary	a-vi-ar-y
saber	sa-ber
con-trast-ing	contrasting
equa-tor	e-qua-tor
monies	mon-ies
chateau	cha-teau
climber	climb-er
ar-guably	ar-gu-a-bly
over-load	o-ver-load
flutist	flut-ist
bub-blegum	bub-ble-gum
video-con-fer-enc-ing	vid-e-o-con-fer-enc-ing
un-shak-able	un-shak-a-ble
propul-sive	pro-pul-sive
unan-nounced	un-an-nounced
mildew	mil-dew
deca-dence	dec-a-dence
di-etet-ic	di-e-tet-ic
gatepost	gate-post
in-hala-tion	in-ha-la-tion
ex-tra-mur-al	ex-tra-mu-ral
shaver	shav-er
im-prison	im-pris-on
re-li-able	re-li-a-ble
util-i-ty	u-til-i-ty
qua-drat-ic	quad-rat-ic
grenadier	gren-a-dier
mousy	mous-y
in-eluctable	in-e-luc-ta-ble
toma-to	to-ma-to
iambic	i-am-bic
con-fi-den-tial-i-ty	con-fi-den-ti-al-i-ty
ileum	il-e-um
mono-pole	mon-o-pole
di-uret-ic	di-u-ret-ic
satiny	sat-in-y
deroga-to-ry	de-rog-a-to-ry
quater-nion	qua-ter-ni-on
snowflake	snow-flake
con-ser-v-a-tive	con-serv-a-tive
en-docrine	en-do-crine
canopy	can-o-py
lol-lipop	lol-li-pop
frag-men-tary	frag-men-tar-y
sum-mery	sum-mer-y
stonework	stone-work
om-ni-science	om-nis-cience
col-lec-tivi-sa-tion	col-lec-ti-vi-sa-tion
ot-toman	ot-to-man
ni-hilis-tic	ni-hil-is-tic
mas-cara	mas-car-a
kestrel	kes-trel
philo-soph-i-cal-ly	phil-o-soph-i-cal-ly
mata-dor	mat-a-dor
meri-no	me-ri-no
tillage	till-age
velo-drome	ve-lo-drome
freck-led	freckled
scruffy	scruff-y
oph-thalmic	oph-thal-mic
raspy	rasp-y
ap-pari-tion	ap-pa-ri-tion
onyx	on-yx
on-tol-ogy	on-tol-o-gy
elec-troneg-a-tive	e-lec-tro-neg-a-tive
un-invit-ing	un-in-vit-ing
painstak-ing-ly	pains-tak-ing-ly
nu-clear	nu-cle-ar
tele-sales	tel-e-sales
mega-lith-ic	meg-a-lith-ic
bur-gundy	bur-gun-dy
piti-ful	pit-i-ful
blood-thirsty	blood-thirst-y
tra-verse	trav-erse
fusible	fu-si-ble
di-atom-ic	di-a-tom-ic
liny	lin-y
opin-ion-at-ed	o-pin-ion-at-ed
corny	corn-y
rub-bery	rub-ber-y
coau-thor	co-au-thor
swingy	swing-y
tun-able	tun-a-ble
ruin	ru-in
re-pro-ducibly	re-pro-duc-i-bly
dormer	dor-mer
im-pri-matur	im-pri-ma-tur
chiefly	chief-ly
trea-sur-er	treas-ur-er
ri-fled	rifled
take-away	take-a-way
isosce-les	i-sos-ce-les
mora-to-ri-um	mor-a-to-ri-um
over-hear	o-ver-hear
crony	cro-ny
leath-ery	leath-er-y
in-escapable	in-es-cap-a-ble
omi-nous-ly	om-i-nous-ly
debone	de-bone
foren-sic	fo-ren-sic
laugh-ably	laugh-a-bly
lo-quaci-ty	lo-quac-i-ty
mut-ter-ing	muttering
avi-ate	a-vi-ate
ran-corous	ran-cor-ous
om-nibus	om-ni-bus
im-muno-log-i-cal	im-mu-no-log-i-cal
dodo	do-do
tanker	tank-er
sui-ci-dal	su-i-cid-al
con-demned	condemned
goatskin	goat-skin
un-ques-tion-able	un-ques-tion-a-ble
silent	si-lent
greedy	greed-y
moped	mo-ped
kismet	kis-met
ap-plica-tive	ap-pli-ca-tive
quirky	quirk-y
vari-ance	var-i-ance
in-ex-orable	in-ex-o-ra-ble
nonethe-less	none-the-less
ob-se-quious	ob-se-qui-ous
dis-qui-etude	dis-qui-e-tude
tsuna-mi	tsu-na-mi
sus-pend-ed	sus-pen-ded
book-binder	book-bind-er
enor-mous	e-nor-mous
au-dio	au-di-o
un-de-cid-able	un-de-cid-a-ble
plat-i-tudi-nous	plat-i-tu-di-nous
monas-tic	mo-nas-tic
im-petu-ous	im-pet-u-ous
bal-alai-ka	bal-a-lai-ka
glam-orous	glam-or-ous
rein-tro-duc-tion	re-in-tro-duc-tion
ru-inous	ru-in-ous
en-joy-able	en-joy-a-ble
or-nithol-o-gy	or-ni-thol-o-gy
specu-lum	spec-u-lum
stetho-scope	steth-o-scope
singly	sin-gly
zealot	zeal-ot
diox-in	di-ox-in
roast-ed	roasted
co-pro-lite	cop-ro-lite
syl-labary	syl-la-bar-y
city	cit-y
con-stituent	con-stit-u-ent
anteater	ant-eat-er
quadru-pole	quad-ru-pole
moi-ety	moi-e-ty
apothe-cary	a-poth-e-car-y
up-silon	up-si-lon
vis-i-ta-tion	vis-it-a-tion
ra-bid	rab-id
inan-i-mate	in-an-i-mate
puis-sant	pu-is-sant
scintig-ra-phy	scin-tig-ra-phy
whiten	whit-en
over-ac-tive	o-ver-ac-tive
zenith	ze-nith
elec-table	e-lect-a-ble
apo-lit-i-cal	a-po-lit-i-cal
undo	un-do
pro-pri-ety	pro-pri-e-ty
every-thing	eve-ry-thing
lemon-ade	lem-on-ade
litany	lit-a-ny
de-tach-able	de-tach-a-ble
gaslight	gas-light
para-sol	par-a-sol
trel-lised	trellised
dereg-u-late	de-reg-u-late
speedome-ter	speed-om-e-ter
silken	silk-en
ethol-o-gy	e-thol-o-gy
tawny	taw-ny
kine-mat-ics	kin-e-mat-ics
su-per-in-ten-dence	su-per-in-tend-ence
hero-in	her-o-in
dis-cor-dance	dis-cord-ance
wadding	wad-ding
co-eval	co-e-val
pro-tect-ed	protected
odor-ous	o-dor-ous
transat-lantic	trans-at-lan-tic
ex-pen-di-ture	ex-pend-i-ture
gib-ber-ing	gibbering
coro-nal	cor-o-nal
any-place	an-y-place
dinghy	din-ghy
su-prema-cist	su-prem-a-cist
trans-portable	trans-port-a-ble
barefaced	bare-faced
orig-i-na-tor	o-rig-i-na-tor
gen-uine-ness	gen-u-ine-ness
some-body	some-bod-y
pullover	pull-o-ver
de-sir-abil-ia	de-si-ra-bi-li-a
tightrope	tight-rope
loafer	loaf-er
stat-uesque	stat-u-esque
dis-penser	dis-pens-er
con-ceiv-able	con-ceiv-a-ble
archdea-con	arch-dea-con
hypocrisy	hy-poc-ri-sy
read-abil-i-ty	read-a-bil-i-ty
evening	eve-ning
achieve	a-chieve
bio-chem-istry	bi-o-chem-is-try
weighty	weight-y
repar-tee	rep-ar-tee
con-flict-ed	conflicted
bar-bar-ian	bar-bar-i-an
arid	ar-id
over-lay	o-ver-lay
loca-tive	loc-a-tive
tiling	til-ing
fizzy	fizz-y
sorghum	sor-ghum
dwin-dling	dwindling
poem	po-em
lachry-mal	lach-ry-mal
undis-tort-ed	un-dis-tort-ed
viril-i-ty	vi-ril-i-ty
cra-nial	cra-ni-al
le-nient	le-ni-ent
gravi-ton	grav-i-ton
awhile	a-while
rein-ter-pre-ta-tion	re-in-ter-pre-ta-tion
ra-tio-nale	ra-tion-ale
hye-na	hy-e-na
sus-tain-able	sus-tain-a-ble
sideshow	side-show
marathon	mar-a-thon
barter	bar-ter
any-how	an-y-how
de-brief-ing	debriefing
rewind	re-wind
over-sen-si-tive	o-ver-sen-si-tive
broadsword	broad-sword
parox-ysm	par-ox-ysm
toupee	tou-pee
an-te-dilu-vian	an-te-di-lu-vi-an
droopy	droop-y
perquisite	per-qui-site
het-ero-gene-ity	het-er-o-ge-ne-i-ty
un-know-able	un-know-a-ble
laager	laa-ger
dis-heart-ened	dis-hear-tened
genoa	gen-o-a
ego-tism	e-go-tism
nice-ty	ni-ce-ty
in-sipid	in-sip-id
evan-ge-lism	e-van-ge-lism
as-ceti-cism	as-cet-i-cism
rein-ter-pret	re-in-ter-pret
denizen	den-i-zen
pleas-antry	pleas-ant-ry
car-cino-gen	car-cin-o-gen
lazy	la-zy
mantrap	man-trap
cut-lery	cut-ler-y
con-temptible	con-tempt-i-ble
foghorn	fog-horn
be-witch-ing	bewitching
hia-tus	hi-a-tus
idle	i-dle
cleaver	cleav-er
ruler	rul-er
in-vari-ably	in-var-i-a-bly
speller	spell-er
arise	a-rise
pipeline	pipe-line
me-te-o-rol-o-gy	me-te-or-ol-o-gy
mazur-ka	ma-zur-ka
starter	start-er
iso-mer	i-so-mer
in-di-gestible	in-di-gest-i-ble
timer	tim-er
more-over	more-o-ver
charge-able	charge-a-ble
heady	head-y
over-write	o-ver-write
eeri-ly	ee-ri-ly
un-abashed-ly	un-a-bash-ed-ly
know-able	know-a-ble
eleven	e-lev-en
colum-nar	co-lum-nar
fig-u-ra-tive	fig-ur-a-tive
oakum	oa-kum
unas-so-ci-at-ed	un-as-so-ci-at-ed
solemn	sol-emn
op-er-a-tional-ly	op-er-a-tion-al-ly
non-con-for-mi-ty	non-con-form-i-ty
bradawl	brad-awl
vic-ar-i-ous-ly	vi-car-i-ous-ly
re-liance	re-li-ance
nau-sea	nau-se-a
asym-met-ri-cal	a-sym-met-ri-cal
prepar-a-tive	pre-par-a-tive
culi-nary	cu-li-nar-y
do-lerite	dol-er-ite
soapy	soap-y
over-e-mo-tion-al	o-ver-e-mo-tion-al
archery	ar-cher-y
casi-no	ca-si-no
elec-tro	e-lec-tro
detox-i-fi-ca-tion	de-tox-i-fi-ca-tion
method-olog-i-cal	meth-od-o-log-i-cal
es-capist	es-cap-ist
mono-rail	mon-o-rail
minute-ly	mi-nute-ly
easy-go-ing	eas-y-go-ing
gawky	gawk-y
con-ser-va-to-ry	con-serv-a-to-ry
de-mo-c-ra-t-ic	dem-o-crat-ic
bistable	bi-sta-ble
unim-pres-sive	un-im-pres-sive
shoelace	shoe-lace
strudel	stru-del
rheuma-tism	rheu-ma-tism
im-paction	im-pac-tion
bi-l-abi-al	bi-la-bi-al
ni-troge-nous	ni-trog-e-nous
dis-turbing-ly	dis-turb-ing-ly
duchess	duch-ess
in-tu-itive-ly	in-tu-i-tive-ly
spi-dery	spi-der-y
pro-boscis	pro-bos-cis
drainage	drain-age
causative	caus-a-tive
sooty	soot-y
squeegee	squee-gee
astig-ma-tism	a-stig-ma-tism
snoop-ing	snooping
asep-tic	a-sep-tic
hereto-fore	here-to-fore
un-pro-nounce-able	un-pro-nounce-a-ble
polic-ing	policing
feal-ty	fe-al-ty
panacea	pan-a-ce-a
un-con-scionable	un-con-scion-a-ble
antler	ant-ler
supreme-ly	su-preme-ly
black-ened	blackened
semi-fi-nal	sem-i-fi-nal
grouper	group-er
balmy	balm-y
es-capism	es-cap-ism
whim-per-ing	whimpering
lan-guorous	lan-guor-ous
starlight	star-light
panties	pant-ies
mnemon-ic	mne-mon-ic
dual	du-al
mul-ti-plica-tive	mul-ti-pli-ca-tive
uni-sex	u-ni-sex
squalid	squal-id
holdup	hold-up
steeple-jack	stee-ple-jack
un-for-get-table	un-for-get-ta-ble
merid-i-an	me-rid-i-an
astray	a-stray
rewrap	re-wrap
ir-re-triev-ably	ir-re-triev-a-bly
broody	brood-y
dyer	dy-er
very	ver-y
un-nec-es-sary	un-nec-es-sar-y
fu-ner-ary	fu-ner-ar-y
clover	clo-ver
macro-eco-nom-ic	mac-ro-ec-o-nom-ic
bene-fac-tress	ben-e-fac-tress
whizkids	whizkids
whole-saler	whole-sal-er
askance	a-skance
pre-dict-ed	predicted
ro-tary	ro-ta-ry
obe-di-ent-ly	o-be-di-ent-ly
fuzzy	fuzz-y
iso-tope	i-so-tope
lovelorn	love-lorn
epis-to-lary	e-pis-to-lar-y
strug-gling	struggling
semi-colon	sem-i-co-lon
mul-ti-proces-sor	mul-ti-proc-es-sor
balus-ter	bal-us-ter
sauna	sau-na
heather	heath-er
de-posi-tary	de-pos-i-tar-y
ready	read-y
metic-u-lous	me-tic-u-lous
silli-ness	sil-li-ness
ex-e-cutable	ex-e-cut-a-ble
ex-pan-sion-ary	ex-pan-sion-ar-y
stroller	stroll-er
watch-able	watch-a-ble
lido	li-do
lin-ear	lin-e-ar
floozy	floo-zy
urea	u-re-a
soda	so-da
de-ni-able	de-ni-a-ble
pa-pyrus	pa-py-rus
ca-cao	ca-ca-o
rib-aldry	rib-ald-ry
unas-sist-ed	un-as-sist-ed
emo-tion-al	e-mo-tion-al
ben-der	bend-er
dahlia	dahl-ia
rewire	re-wire
racial	ra-cial
un-com-fort-able	un-com-fort-a-ble
nymp-holep-sy	nym-pho-lep-sy
gro-cery	gro-cer-y
paragon	par-a-gon
over-due	o-ver-due
pogo	po-go
ob-scu-ran-tist	ob-scu-rant-ist
zoo-plank-ton	zo-o-plank-ton
malaise	ma-laise
em-bell-ish	em-bel-lish
el-ven	elv-en
rein-sert	re-in-sert
racist	rac-ist
han-dover	hand-o-ver
over-ly	o-ver-ly
durable	du-ra-ble
pre-or-dained	preordained
re-spectable	re-spect-a-ble
bari-tone	bar-i-tone
eq-ui-table	eq-ui-ta-ble
porno-graph-ic	por-no-graph-ic
con-vivial	con-viv-i-al
ringer	ring-er
struc-tural-ly	struc-tur-al-ly
psy-chother-a-pist	psy-cho-ther-a-pist
eter-ni-ty	e-ter-ni-ty
weapon	weap-on
chapel	chap-el
cordage	cord-age
wretched	wretch-ed
prodi-gy	prod-i-gy
over-feed	o-ver-feed
smithy	smith-y
nightlife	night-life
dance-able	dance-a-ble
borstal	bor-stal
se-ca-teurs	sec-a-teurs
armistice	ar-mi-stice
tran-scen-dence	tran-scend-ence
voyeur	vo-yeur
malev-o-lent	ma-lev-o-lent
or-a-to-rio	or-a-to-ri-o
builder	build-er
lauda-to-ry	laud-a-to-ry
apron	a-pron
dila-tor	di-la-tor
con-veyanc-ing	con-vey-anc-ing
vi-able	vi-a-ble
omis-sion	o-mis-sion
im-munol-o-gy	im-mu-nol-o-gy
imag-in-able	im-ag-i-na-ble
nobly	no-bly
ede-ma	e-de-ma
sago	sa-go
risot-to	ri-sot-to
mono-logue	mon-o-logue
my-opic	my-op-ic
posthu-mous	post-hu-mous
econo-met-rics	e-con-o-met-rics
pouter	pout-er
com-forter	com-fort-er
odor-if-er-ous	o-dor-if-er-ous
respite	res-pite
fur-rowed	furrowed
manslaugh-ter	man-slaugh-ter
over-sup-ply	o-ver-sup-ply
in-dec-lin-able	in-de-clin-a-ble
white-washed	whitewashed
peanut	pea-nut
punch-able	punch-a-ble
coleslaw	cole-slaw
mag-ne-tos-phere	mag-ne-to-sphere
mauler	maul-er
ema-ci-at-ed	e-ma-ci-at-ed
moraine	mo-raine
paunchy	paunch-y
gluti-nous	glu-ti-nous
ped-a-gogy	ped-a-go-gy
eroge-nous	e-rog-e-nous
loader	load-er
reify	re-i-fy
het-erol-o-gous	het-er-ol-o-gous
rigid-i-ty	ri-gid-i-ty
smoother	smooth-er
whaler	whal-er
pathol-o-gy	pa-thol-o-gy
ex-tend-ing	extending
resid-ual	re-sid-u-al
lino	li-no
raga-muf-fin	rag-a-muf-fin
edit-ed	edited
over-writ-ing	overwriting
mucky	muck-y
gra-tu-itous	gra-tu-i-tous
beg-gary	beg-gar-y
chasti-ty	chas-ti-ty
sky-scraper	sky-scrap-er
over-re-acts	o-ver-re-acts
stu-dious-ly	stu-di-ous-ly
asyn-chro-nous	a-syn-chro-nous
nosy	nos-y
cuprous	cu-prous
retic-ule	ret-i-cule
id-i-olect	id-i-o-lect
geo-syn-chro-nous	ge-o-syn-chro-nous
ex-pec-tant-ly	ex-pect-ant-ly
polemi-cist	po-lem-i-cist
mono-gram	mon-o-gram
hangar	hang-ar
rigid-i-fy	ri-gid-i-fy
lega-tion	le-ga-tion
para-mour	par-a-mour
de-sirous	de-sir-ous
left-over	left-o-ver
damnable	dam-na-ble
hearti-ly	heart-i-ly
sun-tanned	suntanned
saucepan	sauce-pan
ridicule	rid-i-cule
topo-graph-i-cal	top-o-graph-i-cal
over-act	o-ver-act
dic-tio-nary	dic-tion-ar-y
arrange-ment	ar-range-ment
turn-around	turn-a-round
decor	de-cor
peri-na-tal	per-i-na-tal
among	a-mong
sce-nario	sce-nar-i-o
cylin-dri-cal	cy-lin-dri-cal
chancery	chan-cer-y
duo-de-num	du-o-de-num
voyeuris-tic	voy-eur-is-tic
gaiter	gait-er
share-able	share-a-ble
pho-to-genic	pho-to-gen-ic
salmon	salm-on
orgy	or-gy
no-tice-able	no-tice-a-ble
flat-tery	flat-ter-y
biki-ni	bi-ki-ni
sun-burned	sunburned
dauphin	dau-phin
im-ma-te-r-i-al	im-ma-te-ri-al
repo-si-tion	re-po-si-tion
oviduct	o-vi-duct
ex-oti-cism	ex-ot-i-cism
un-ap-pre-cia-tive	un-ap-pre-ci-a-tive
sali-vate	sal-i-vate
work-able	work-a-ble
con-vert-ible	con-vert-i-ble
pornog-ra-phy	por-nog-ra-phy
egress	e-gress
in-escapably	in-es-cap-a-bly
stinker	stink-er
skele-tal	skel-e-tal
lovesick	love-sick
cousin	cous-in
melo-dra-mat-ic	mel-o-dra-mat-ic
gan-g-ly	gan-gly
cu-rios-i-ty	cu-ri-os-i-ty
out-lawed	outlawed
dis-obe-di-ence	dis-o-be-di-ence
vine-gar	vin-e-gar
bel-liger-ent	bel-lig-er-ent
sole-cism	sol-e-cism
fla-gel-la-tion	flag-el-la-tion
messy	mess-y
eroti-cism	e-rot-i-cism
foundling	found-ling
psaltery	psal-ter-y
uni-verse	u-ni-verse
union-i-sa-tion	un-ion-i-sa-tion
mirac-u-lous	mi-rac-u-lous
ri-boflavin	ri-bo-fla-vin
un-der-e-d-u-cat-ed	un-der-ed-u-cat-ed
fleshy	flesh-y
drink-able	drink-a-ble
trencher	trench-er
ici-cle	i-ci-cle
ha-cien-da	ha-ci-en-da
lulu	lu-lu
wacky	wack-y
palmy	palm-y
saver	sav-er
colour	co-lour
pathol-o-gist	pa-thol-o-gist
dioce-san	di-oc-e-san
sandy	sand-y
over-re-act	o-ver-re-act
tremo-lo	trem-o-lo
lega-to	le-ga-to
quadri-lat-er-al	quad-ri-lat-er-al
deco	dec-o
stu-dious	stu-di-ous
over-ween-ing	o-ver-ween-ing
egal-i-tar-i-an	e-gal-i-tar-i-an
over-win-ter	o-ver-win-ter
vari-able	var-i-a-ble
hideous	hid-e-ous
lo-goff	log-off
bal-moral	bal-mor-al
ap-plic-a-ble	ap-pli-ca-ble
tapas	ta-pas
lyric	lyr-ic
ni-hilism	ni-hil-ism
sibyl	sib-yl
over-weight	o-ver-weight
rota	ro-ta
bonobo	bo-no-bo
aper-i-tif	a-pe-ri-tif
sneaky	sneak-y
delir-i-um	de-lir-i-um
ar-rival	ar-ri-val
orig-i-nal-i-ty	o-rig-i-nal-i-ty
timid-i-ty	ti-mid-i-ty
dispir-it-ing	dis-pir-it-ing
flamin-go	fla-min-go
lin-gerie	lin-ge-rie
event-ing	e-vent-ing
poly-styrene	pol-y-sty-rene
macaque	ma-caque
artis-tic	ar-tis-tic
mar-quetry	mar-que-try
mediocre	me-di-o-cre
rooi-bos	roo-i-bos
ovoid	o-void
un-bear-ably	un-bear-a-bly
tripoli	trip-o-li
fi-nale	fi-na-le
equine	e-quine
un-drink-able	un-drink-a-ble
re-place-able	re-place-a-ble
tiger-ish	ti-ger-ish
li-brary	li-brar-y
iden-ti-cal	i-den-ti-cal
gestalt	ge-stalt
mendele-vi-um	men-de-le-vi-um
bromine	bro-mine
leapfrog	leap-frog
big-otry	big-ot-ry
nega-tion	ne-ga-tion
su-perbly	su-perb-ly
un-at-tain-able	un-at-tain-a-ble
elec-trode	e-lec-trode
samu-rai	sam-u-rai
urol-o-gist	u-rol-o-gist
unadul-ter-at-ed	un-a-dul-ter-at-ed
re-mov-able	re-mov-a-ble
tele-pho-ny	te-leph-o-ny
dis-putable	dis-put-a-ble
per-man-ganate	per-man-ga-nate
monothe-ism	mon-o-the-ism
con-tretemps	con-tre-temps
in-ad-ver-tent	in-ad-vert-ent
liv-able	liv-a-ble
qui-eten	qui-et-en
un-al-ter-able	un-al-ter-a-ble
pen-sion-able	pen-sion-a-ble
pan-creas	pan-cre-as
neonate	ne-o-nate
top-i-ary	to-pi-ar-y
sen-hor	se-nhor
elab-o-rate-ly	e-lab-o-rate-ly
sto-ry-telling	sto-ry-tell-ing
shifter	shift-er
gullible	gul-li-ble
ternary	ter-na-ry
parochial-ism	pa-ro-chi-al-ism
dwelling	dwell-ing
soya	soy-a
coast-ing	coasting
ir-recov-er-able	ir-re-cov-er-a-ble
speechi-fy-ing	speechifying
crafty	craft-y
taunt-ing	taunting
over-spend	o-ver-spend
stinky	stink-y
usurp	u-surp
emit-ter	e-mit-ter
gourmet	gour-met
ma-chete	ma-chet-e
elec-tric	e-lec-tric
forte	for-te
midi	mid-i
in-vol-un-tary	in-vol-un-tar-y
om-nipresent	om-ni-pres-ent
teeter	tee-ter
mica	mi-ca
mis-align-ment	mis-a-lign-ment
molten	mol-ten
her-mitage	her-mit-age
nonessen-tial	non-es-sen-tial
porous	po-rous
evac-u-ate	e-vac-u-ate
re-new-able	re-new-a-ble
incog-ni-to	in-cog-ni-to
taxi	tax-i
spacey	spac-ey
over-seer	o-ver-se-er
steadi-ly	stead-i-ly
glassy	glass-y
afraid	a-fraid
sub-ter-ranean	sub-ter-ra-ne-an
every-one	eve-ry-one
arabesque	ar-a-besque
sporty	sport-y
va-sec-to-my	vas-ec-to-my
iden-ti-fi-er	i-den-ti-fi-er
diplo-mat-ic	dip-lo-mat-ic
neuter	neu-ter
el-e-men-tary	el-e-men-ta-ry
transna-tion-al	trans-na-tion-al
ceilidh	cei-lidh
treach-ery	treach-er-y
brassy	brass-y
un-quench-able	un-quench-a-ble
pam-phle-teer	pam-phlet-eer
un-break-able	un-break-a-ble
every-day	eve-ry-day
pen-tame-ter	pen-tam-e-ter
apolo-gia	ap-o-lo-gi-a
zona-tion	zo-na-tion
tetrox-ide	te-trox-ide
pu-ri-tanism	pu-ri-tan-ism
salver	sal-ver
cafe-te-ria	caf-e-te-ri-a
data	da-ta
forgery	for-ger-y
lot-tery	lot-ter-y
loopy	loop-y
mayfly	may-fly
es-capee	es-cap-ee
undiplo-mat-ic	un-dip-lo-mat-ic
lack-adaisi-cal	lack-a-dai-si-cal
cig-ar	ci-gar
defam-a-to-ry	de-fam-a-to-ry
potash	pot-ash
drifter	drift-er
gusty	gust-y
bilin-gual	bi-lin-gual
ap-palling-ly	ap-pall-ing-ly
mi-croc-ode	mi-cro-code
berserk	ber-serk
as-cetic	as-cet-ic
ragged	rag-ged
lit-toral	lit-to-ral
able	a-ble
clemen-cy	clem-en-cy
finicky	fin-ick-y
cowslip	cow-slip
pro-pa-gan-da	prop-a-gan-da
flinch-ing	flin-ching
papa	pa-pa
co-mestible	co-mes-ti-ble
neon	ne-on
any-ways	an-y-ways
book-able	book-a-ble
hayloft	hay-loft
cos-set-ed	cosseted
sapling	sap-ling
leghorn	leg-horn
slinky	slink-y
roller	roll-er
pe-trel	pet-rel
slushy	slush-y
bauble	bau-ble
rein-vent	re-in-vent
asleep	a-sleep
ir-re-proach-able	ir-re-proach-a-ble
over-stress	o-ver-stress
tidy	ti-dy
fly-away	fly-a-way
beachy	beach-y
spencer	spen-cer
apoc-a-lyp-tic	a-poc-a-lyp-tic
mono-lay-er	mon-o-lay-er
arranger	ar-rang-er
hypochon-dri-ac	hy-po-chon-dri-ac
nir-vana	nir-va-na
sys-temic	sys-tem-ic
coura-geous	cou-ra-geous
py-rotech-nics	py-ro-tech-nics
eigen-state	ei-gen-state
eval-u-a-tive	e-val-u-a-tive
java	ja-va
porta-bil-i-ty	port-a-bil-i-ty
cognoscen-ti	co-gno-scen-ti
un-con-quer-able	un-con-quer-a-ble
artiste	ar-tiste
satir-ic	sa-tir-ic
the-atri-cal-i-ty	the-at-ri-cal-i-ty
gua-camole	gua-ca-mo-le
abroad	a-broad
dimer	di-mer
pasty	past-y
treat-able	treat-a-ble
sunken	sunk-en
pi-laster	pi-las-ter
fran-coph-o-ne	fran-co-phone
emer-ald	em-er-ald
ex-oskele-ton	ex-o-skel-e-ton
the-atri-cals	the-at-ri-cals
com-mis-sari-at	com-mis-sar-i-at
in-vig-o-rate	in-vig-or-ate
trade-marked	trademarked
melanin	mel-a-nin
apos-tle	a-pos-tle
windswept	wind-swept
dri-ve-way	drive-way
ex-pend-able	ex-pend-a-ble
bomber	bomb-er
piti-less	pit-i-less
ban-knote	bank-note
ago	a-go
com-press-ibil-i-ty	com-pres-si-bil-i-ty
elec-tro-dy-nam-ics	e-lec-tro-dy-nam-ics
func-tionary	func-tion-ar-y
spinach	spin-ach
tyrant	ty-rant
taxi-cab	tax-i-cab
atone-ment	a-tone-ment
kitchen-ware	kitch-en-ware
sala-man-der	sal-a-man-der
hideous-ly	hid-e-ous-ly
tele-vi-sion	tel-e-vi-sion
dra-con-ian	dra-co-ni-an
re-assert	re-as-sert
loosen	loos-en
pas-toral	pas-to-ral
kilo-byte	kil-o-byte
slalom	sla-lom
duchy	duch-y
tele-vise	tel-e-vise
dis-mem-bered	dismembered
fa-ther-ing	fathering
radish	rad-ish
hefty	heft-y
apro-pos	ap-ro-pos
de-liv-ery	de-liv-er-y
elec-troen-cephalo-gram	e-lec-tro-en-ceph-a-lo-gram
sweater	sweat-er
over-head	o-ver-head
proph-esy	proph-e-sy
epis-tle	e-pis-tle
idol-a-try	i-dol-a-try
kinky	kink-y
dactylic	dac-tyl-ic
cycli-cal	cy-cli-cal
cir-cling	circling
im-muno-sup-pres-sive	im-mu-no-sup-pres-sive
tarot	ta-rot
elu-ci-da-tion	e-lu-ci-da-tion
er-bium	er-bi-um
phys-io-ther-a-py	phys-i-o-ther-a-py
beryl-li-um	be-ryl-li-um
hab-er-dash-ery	hab-er-dash-er-y
aquar-i-um	a-quar-i-um
tetchy	tetch-y
az-imuth	az-i-muth
naive	na-ive
sav-agery	sav-age-ry
in-tu-itive	in-tu-i-tive
cetacean	ce-ta-cean
retsi-na	ret-si-na
hear-ken	heark-en
au-toma-tion	au-to-ma-tion
hearty	heart-y
valise	va-lise
email	e-mail
smoth-ered	smothered
down-loaded	downloaded
aphro-disi-ac	aph-ro-dis-i-ac
febrile	fe-brile
dic-ta-to-r-i-al	dic-ta-to-ri-al
napoleon	na-po-le-on
amazed	a-mazed
screwy	screw-y
thau-maturge	thau-ma-turge
Words with errors: 1844
Words with incorrect number of syllables: 1732
Total evluated: 6500
Perfect accuracy: 0.72
Number of syllables accuracy: 0.73
Average Levenshtein Distance(across incorrect words): 1.19
