Attempt	Real
beryl	ber-yl
sonar	so-nar
palatal	pal-a-tal
un-de-sir-able	un-de-sir-a-ble
cli-toral	clit-o-ral
avid-i-ty	a-vid-i-ty
rusty	rust-y
psy-chi-atric	psy-chi-at-ric
recheck	re-check
painful-ly	pain-ful-ly
gov-er-nance	gov-ern-ance
sprayer	spray-er
de-liv-er-able	de-liv-er-a-ble
us-able	us-a-ble
nougat	nou-gat
gusty	gust-y
over-whelm	o-ver-whelm
prelate	prel-ate
wigeon	wig-eon
garbage	gar-bage
miser	mi-ser
reim-pose	re-im-pose
dere-lic-tion	der-e-lic-tion
tele-graph-ic	tel-e-graph-ic
aura	au-ra
ria	ri-a
barter	bar-ter
chemist	chem-ist
pere-grine	per-e-grine
marten	mar-ten
en-er-getic	en-er-get-ic
shorty	short-y
cater	ca-ter
bac-teri-um	bac-te-ri-um
nurs-ery	nurs-er-y
duet	du-et
reser-va-tion	res-er-va-tion
seedbed	seed-bed
con-duct-ed	conducted
car-dio-vas-cu-lar	car-di-o-vas-cu-lar
rein-vest-ment	re-in-vest-ment
geo-sta-tion-ary	ge-o-sta-tion-ar-y
cupo-la	cu-po-la
iso-ton-ic	i-so-ton-ic
dis-com-fort-ing	discomforting
uni-ver-sal-ist	u-ni-ver-sal-ist
lech-ery	lech-er-y
scam-per	scamp-er
translu-cen-cy	trans-lu-cen-cy
iso-la-tion-ist	i-so-la-tion-ist
boyfriend	boy-friend
squalor	squal-or
ogle	o-gle
sahib	sa-hib
hy-gien-ic	hy-gi-en-ic
in-ge-nious	in-gen-ious
idea	i-de-a
celiba-cy	cel-i-ba-cy
warthog	wart-hog
fuse-lage	fu-se-lage
proph-esy	proph-e-sy
in-ex-press-ible	in-ex-press-i-ble
metaphor	met-a-phor
rat-tlesnake	rat-tle-snake
pli-able	pli-a-ble
brioche	bri-oche
rep-til-ian	rep-til-i-an
su-per-fluity	su-per-flu-i-ty
starter	start-er
banger	bang-er
ine-bri-a-tion	in-e-bri-a-tion
vari-cose	var-i-cose
in-abil-i-ty	in-a-bil-i-ty
mythol-o-gy	my-thol-o-gy
un-suit-able	un-suit-a-ble
dormer	dor-mer
bradawl	brad-awl
arthro-pod	ar-thro-pod
con-tention	con-ten-tion
plenum	ple-num
un-men-tion-able	un-men-tion-a-ble
dy-namism	dy-na-mism
neonate	ne-o-nate
moc-casin	moc-ca-sin
tusker	tusk-er
in-con-testable	in-con-test-a-ble
down-loaded	downloaded
elec-trophore-sis	e-lec-tro-pho-re-sis
chid-ing	chiding
ir-re-solv-able	ir-re-solv-a-ble
rapid-ly	rap-id-ly
monog-a-mous	mo-nog-a-mous
raisin	rai-sin
col-lec-tivi-sa-tion	col-lec-ti-vi-sa-tion
mono-plane	mon-o-plane
het-ero-ge-neous	het-er-o-ge-ne-ous
re-bury	re-bur-y
grantee	gran-tee
em-broi-dery	em-broi-der-y
inessen-tial	in-es-sen-tial
spencer	spen-cer
halo-gen	hal-o-gen
pep-pered	peppered
dero-ga-tion	der-o-ga-tion
bian-nu-al	bi-an-nu-al
dis-may-ing	dismaying
espres-so	es-pres-so
co-conut	co-co-nut
avarice	av-a-rice
calami-tous	ca-lam-i-tous
geo-met-ric	ge-o-met-ric
union-ist	un-ion-ist
sibi-lant	sib-i-lant
co-eval	co-e-val
litotes	li-to-tes
over-feed	o-ver-feed
alarm	a-larm
dis-turbing-ly	dis-turb-ing-ly
in-ter-minable	in-ter-mi-na-ble
teenag-er	teen-ag-er
pro-peller	pro-pel-ler
bene-fac-tress	ben-e-fac-tress
witch-ery	witch-er-y
hearty	heart-y
apart-ment	a-part-ment
newslet-ter	news-let-ter
puny	pu-ny
pre-sen-ter	pre-sent-er
di-aphrag-mat-ic	di-a-phrag-mat-ic
naked	na-ked
unglam-orous	un-glam-or-ous
bistro	bis-tro
over-fill	o-ver-fill
meta-mor-phism	met-a-mor-phism
uri-nary	u-ri-nar-y
de-tectable	de-tect-a-ble
mag-ne-sium	mag-ne-si-um
wafer	wa-fer
atavis-tic	at-a-vis-tic
con-stituent	con-stit-u-ent
de-mog-ra-ph-er	de-mog-ra-pher
gale-na	ga-le-na
in-tra-venous-ly	in-tra-ve-nous-ly
cream-ery	cream-er-y
de-signed-ly	de-sign-ed-ly
cabaret	cab-a-ret
tachy-on	tach-y-on
baby	ba-by
uni-ty	u-ni-ty
hemi-sphere	hem-i-sphere
method	meth-od
click-ing	clicking
sta-t-ic	stat-ic
in-com-bustible	in-com-bus-ti-ble
catchy	catch-y
idio-syn-crat-ic	id-i-o-syn-crat-ic
epis-to-lary	e-pis-to-lar-y
eques-tri-an	e-ques-tri-an
apol-o-gist	a-pol-o-gist
lan-guorous	lan-guor-ous
laven-der	lav-en-der
filet	fi-let
san-i-tary	san-i-tar-y
erad-i-ca-tion	e-rad-i-ca-tion
civil-ian	ci-vil-ian
im-preg-nable	im-preg-na-ble
unabridged	un-a-bridged
elec-tion	e-lec-tion
ini-tia-tive	in-i-ti-a-tive
legal-ly	le-gal-ly
pe-cu-liar-i-ty	pe-cu-li-ar-i-ty
sala-cious	sa-la-cious
neo-prene	ne-o-prene
coma	co-ma
sax-ony	sax-o-ny
irid-i-um	i-rid-i-um
singer	sing-er
graphol-o-gy	graph-ol-o-gy
darter	dart-er
icy	i-cy
scrumhalf	scrum-half
ex-per-i-menter	ex-per-i-ment-er
foible	foi-ble
mil-ligram	mil-li-gram
per-i-he-lion	per-i-he-li-on
megas-tar	meg-a-star
beaver	bea-ver
lessen	less-en
co-proces-sor	co-proc-es-sor
res-onator	res-o-na-tor
defam-a-to-ry	de-fam-a-to-ry
roughage	rough-age
at-tribu-tive	at-trib-u-tive
cordage	cord-age
pe-ri-as-tron	per-i-as-tron
de-ser-ti-fi-ca-tion	de-sert-i-fi-ca-tion
per-jury	per-ju-ry
type-writer	type-writ-er
non-event	non-e-vent
hys-te-ria	hys-te-ri-a
anorex-ic	an-o-rex-ic
unas-so-ci-at-ed	un-as-so-ci-at-ed
an-thro-pogenic	an-thro-po-gen-ic
re-gret-tably	re-gret-ta-bly
reap-praisal	re-ap-prais-al
bury	bur-y
con-sulate	con-su-late
prece-dence	prec-e-dence
colo-nial	co-lo-ni-al
un-know-able	un-know-a-ble
mono-gram	mon-o-gram
sur-viv-able	sur-viv-a-ble
im-mov-able	im-mov-a-ble
machi-na-tion	mach-i-na-tion
in-ter-mol-e-c-u-lar	in-ter-mo-lec-u-lar
axle	ax-le
damni-fy	dam-ni-fy
cabri-o-let	cab-ri-o-let
elab-o-ra-tion	e-lab-o-ra-tion
pedantry	ped-ant-ry
free-lancer	free-lanc-er
there-upon	there-up-on
plaza	pla-za
ra-tio-nal-ist	ra-tion-al-ist
in-ap-plic-a-ble	in-ap-pli-ca-ble
bacil-lus	ba-cil-lus
ero-sion	e-ro-sion
mi-croc-ode	mi-cro-code
hubris-tic	hu-bris-tic
or-bital	or-bit-al
hater	hat-er
mantrap	man-trap
deuteron	deu-ter-on
tailplane	tail-plane
ebul-lient	e-bul-lient
face-tious	fa-ce-tious
wolfhound	wolf-hound
tra-cheoto-my	tra-che-ot-o-my
doubtless-ly	doubt-less-ly
eval-u-a-tive	e-val-u-a-tive
elo-cu-tion	el-o-cu-tion
per-mit-ting	permitting
tur-bocharg-er	tur-bo-charg-er
copi-er	cop-i-er
gory	gor-y
gigo-lo	gig-o-lo
over-done	o-ver-done
sor-cery	sor-cer-y
sitar	si-tar
cham-pi-onship	cham-pi-on-ship
spanker	spank-er
de-f-i-n-i-tion	def-i-ni-tion
tear-away	tear-a-way
carotene	car-o-tene
pho-to-chem-istry	pho-to-chem-is-try
mogul	mo-gul
pewter	pew-ter
ole-an-der	o-le-an-der
puer-per-al	pu-er-per-al
kinder-garten	kin-der-gar-ten
trea-sur-er	treas-ur-er
un-mis-tak-ably	un-mis-tak-a-bly
fibu-la	fib-u-la
bitmap	bit-map
dunghill	dung-hill
gim-micky	gim-mick-y
gra-tu-itous	gra-tu-i-tous
in-vestor	in-ves-tor
or-ga-ni-za-tion	or-gan-i-za-tion
dimin-u-en-do	di-min-u-en-do
ir-ra-tional-i-ty	ir-ra-tion-al-i-ty
omi-nous-ly	om-i-nous-ly
sur-viv-abil-i-ty	sur-viv-a-bil-i-ty
beanie	bean-ie
ex-huma-tion	ex-hu-ma-tion
regime	re-gime
hon-esty	hon-es-ty
as-tro-physi-cist	as-tro-phys-i-cist
wind-surfer	wind-surf-er
parabo-la	pa-rab-o-la
gas-troin-testi-nal	gas-tro-in-tes-ti-nal
lament	la-ment
philol-o-gy	phi-lol-o-gy
real	re-al
lifestyle	life-style
ex-tra-mur-al	ex-tra-mu-ral
milord	mi-lord
monomer	mon-o-mer
carat	car-at
chamomile	cham-o-mile
rosy	ros-y
platy-pus	plat-y-pus
re-liance	re-li-ance
river-ine	riv-er-ine
ar-cana	ar-ca-na
un-cre-ative	un-cre-a-tive
ni-hilis-tic	ni-hil-is-tic
mighty	might-y
sero-tonin	ser-o-to-nin
steril-i-ty	ste-ril-i-ty
mu-cosa	mu-co-sa
cannabis	can-na-bis
provo-ca-tion	prov-o-ca-tion
spec-tropho-tome-ter	spec-tro-pho-tom-e-ter
hi-jack-ing	hi-jac-king
eti-quette	et-i-quette
cat-a-clysmic	cat-a-clys-mic
in-sis-tent	in-sist-ent
de-liv-ery	de-liv-er-y
con-comi-tant	con-com-i-tant
anti	an-ti
unglazed	un-glazed
siren	si-ren
de-fend-ing	defending
snorkel	snor-kel
pa-tri-lin-eal	pat-ri-lin-e-al
un-no-tice-able	un-no-tice-a-ble
meta-mor-phose	met-a-mor-phose
caviar	cav-i-ar
in-erad-i-ca-ble	in-e-rad-i-ca-ble
stripling	strip-ling
en-fee-bled	enfeebled
per-sis-tent-ly	per-sist-ent-ly
dactyl	dac-tyl
mono-lith	mon-o-lith
limpet	lim-pet
my-opia	my-o-pi-a
penal-ty	pen-al-ty
heraldic	he-ral-dic
labia	la-bi-a
pseu-do-ny-mous	pseu-don-y-mous
leath-ery	leath-er-y
bumper	bump-er
killing	kill-ing
car-cino-gen	car-cin-o-gen
inat-ten-tive	in-at-ten-tive
pun-ish-able	pun-ish-a-ble
achieve	a-chieve
in-elas-tic	in-e-las-tic
glia	gli-a
de-con-struc-tive	deconstructive
lin-eage	lin-e-age
iden-ti-ty	i-den-ti-ty
antonym	an-to-nym
every-one	eve-ry-one
climber	climb-er
iron-mon-ger	i-ron-mon-ger
dis-obey	dis-o-bey
ema-ci-at-ed	e-ma-ci-at-ed
un-treat-able	un-treat-a-ble
syn-onym	syn-o-nym
patchy	patch-y
avoid-ance	a-void-ance
iso-met-ric	i-so-met-ric
in-scrutable	in-scru-ta-ble
prof-itably	prof-it-a-bly
brunette	bru-nette
fever-ish-ly	fe-ver-ish-ly
corn-flower	corn-flow-er
amount	a-mount
lop-sided	lop-sid-ed
rein-tro-duc-tion	re-in-tro-duc-tion
gravedig-ger	grave-dig-ger
re-pen-tance	re-pent-ance
macrophage	mac-ro-phage
vol-cano	vol-ca-no
hu-morist	hu-mor-ist
craven	cra-ven
en-teri-tis	en-ter-i-tis
pelvic	pel-vic
timid-ly	tim-id-ly
tint-ed	tinted
ir-re-press-ible	ir-re-press-i-ble
cor-dial	cor-di-al
cu-rios-i-ty	cu-ri-os-i-ty
lo-goff	log-off
ethno-graph-ic	eth-no-graph-ic
mil-lenar-i-an	mil-le-nar-i-an
valen-tine	val-en-tine
de-brief-ing	debriefing
trousers	trou-sers
pho-to-s-phere	pho-to-sphere
un-sea-son-ably	un-sea-son-a-bly
macro-eco-nom-ic	mac-ro-ec-o-nom-ic
youngish	young-ish
schoolmistress	school-mis-tress
padding	pad-ding
in-fantry	in-fan-try
lectern	lec-tern
think-able	think-a-ble
spinal	spi-nal
unadul-ter-at-ed	un-a-dul-ter-at-ed
spooky	spook-y
hip-popota-mus	hip-po-pot-a-mus
comi-ty	com-i-ty
de-viance	de-vi-ance
eu-phemisti-cal-ly	eu-phe-mis-ti-cal-ly
wreck-ing	wrecking
salient	sa-li-ent
loopy	loop-y
iron	i-ron
turnout	turn-out
over-lord	o-ver-lord
aware	a-ware
de-r-ate	de-rate
babysit-ting	babysitting
morale	mo-rale
awak-en	a-wak-en
piety	pi-e-ty
in-hibito-ry	in-hib-i-to-ry
dispir-it-ing	dis-pir-it-ing
apos-tro-phe	a-pos-tro-phe
toasty	toast-y
melody	mel-o-dy
colonel	colo-nel
timescale	time-scale
mal-odor-ous	mal-o-dor-ous
macaw	ma-caw
leg-isla-tive	leg-is-la-tive
smithereens	smith-er-eens
oblig-a-tion	ob-li-ga-tion
ri-ot-ing	ri-o-ting
facet	fac-et
in-ho-mo-ge-neous	in-ho-mo-ge-ne-ous
rege-late	re-ge-late
grandiose	gran-di-ose
un-bridge-able	un-bridge-a-ble
bullfinch	bull-finch
colum-nar	co-lum-nar
botany	bot-a-ny
he-do-nist	he-don-ist
dweller	dwell-er
floater	float-er
playfel-low	play-fel-low
bowsprit	bow-sprit
bene-fac-tor	ben-e-fac-tor
costar	co-star
tablet	tab-let
per-me-abil-i-ty	per-me-a-bil-i-ty
emer-ald	em-er-ald
mel-liflu-ous	mel-lif-lu-ous
wiring	wir-ing
man-i-festo	man-i-fes-to
cen-trifuge	cen-tri-fuge
onto	on-to
re-galia	re-ga-li-a
blush-ing	blushing
freaky	freak-y
deco	dec-o
un-stop-pable	un-stop-pa-ble
glassy	glass-y
decor	de-cor
cola	co-la
brava-do	bra-va-do
rodeo	ro-de-o
di-uret-ic	di-u-ret-ic
wari-ness	war-i-ness
pro-ject-ed	projected
equa-nim-i-ty	e-qua-nim-i-ty
maser	ma-ser
arachno-pho-bia	a-rach-no-pho-bi-a
pro-ce-du-ral-ly	pro-ce-dur-al-ly
quotable	quot-a-ble
handrail	hand-rail
hero-ine	her-o-ine
imag-i-na-tion	im-ag-i-na-tion
oviduct	o-vi-duct
pan-creas	pan-cre-as
garage	ga-rage
medic	med-ic
cradling	cra-dling
telepa-thy	te-lep-a-thy
nascent	nas-cent
joyrid-ing	joy-rid-ing
col-lec-tivism	col-lec-tiv-ism
wicked-ly	wick-ed-ly
duress	du-ress
cam-panile	cam-pa-ni-le
jester	jest-er
ashore	a-shore
hal-lelu-jah	hal-le-lu-jah
revenant	rev-e-nant
across	a-cross
stam-mer-ing	stammering
replic-a-ble	rep-li-ca-ble
co-ex-is-tent	co-ex-ist-ent
sneaky	sneak-y
motet	mo-tet
con-tigu-ous	con-tig-u-ous
im-pri-matur	im-pri-ma-tur
tubu-lar	tu-bu-lar
me-te-o-rol-o-gy	me-te-or-ol-o-gy
mar-i-onette	mar-i-on-ette
dra-con-ian	dra-co-ni-an
homi-cide	hom-i-cide
sharp-en-er	shar-pen-er
over-loaded	overloaded
con-sid-er-ably	con-sid-er-a-bly
moral-i-ty	mo-ral-i-ty
stinger	sting-er
avens	av-ens
delin-quent	de-lin-quent
read-abil-i-ty	read-a-bil-i-ty
privy	priv-y
epi-ge-net-ic	ep-i-ge-net-ic
nephew	neph-ew
as-besto-sis	as-bes-to-sis
corky	cork-y
surly	sur-ly
elic-it	e-lic-it
fur-rowed	furrowed
fig-u-ra-tive-ly	fig-ur-a-tive-ly
eva-sion	e-va-sion
print-able	print-a-ble
tiger-ish	ti-ger-ish
gamut	gam-ut
para-sol	par-a-sol
deu-teri-um	deu-te-ri-um
quan-tifi-ca-tion	quan-ti-fi-ca-tion
bot-tled	bottled
gur-gling	gurgling
ragout	ra-gout
toluene	tol-u-ene
reawak-en	re-a-wak-en
spiny	spin-y
leucine	leu-cine
over-spill	o-ver-spill
deco-rous	dec-o-rous
surfer	surf-er
in-ex-cus-able	in-ex-cus-a-ble
ir-res-olute	ir-res-o-lute
ketchup	ketch-up
hy-per-boloid	hy-per-bo-loid
emet-ic	e-met-ic
postage	post-age
ba-ro-nial	ba-ro-ni-al
statu-to-ry	stat-u-to-ry
blud-geon	bludg-eon
gen-uine	gen-u-ine
gallery	gal-ler-y
hooky	hook-y
restora-tive	re-stor-a-tive
quiet-ness	qui-et-ness
vene-re-al	ve-ne-re-al
leafy	leaf-y
solemn	sol-emn
ethnog-ra-phy	eth-nog-ra-phy
de-lin-eate	de-lin-e-ate
tanker	tank-er
shaver	shav-er
ma-tri-lin-eal	mat-ri-lin-e-al
in-ex-orable	in-ex-o-ra-ble
nar-ra-tol-ogy	nar-ra-tol-o-gy
timer	tim-er
lyri-cism	lyr-i-cism
colos-sus	co-los-sus
cetacean	ce-ta-cean
untest-ed	un-test-ed
breast-feed-ing	breastfeeding
in-salu-bri-ous	in-sa-lu-bri-ous
mono-phon-ic	mon-o-phon-ic
squally	squal-ly
sober	so-ber
drama-tist	dram-a-tist
qui-eten	qui-et-en
busi-ness-woman	busi-ness-wom-an
prof-itable	prof-it-a-ble
chee-rio	cheer-i-o
re-strain-ing	restraining
deli	del-i
spiky	spik-y
spicy	spic-y
debu-tante	deb-u-tante
rheuma-tol-ogy	rheu-ma-tol-o-gy
over-crowd-ed	o-ver-crow-ded
serene-ly	se-rene-ly
lar-ynx-es	la-rynx-es
im-port-ed	imported
unloved	un-loved
bank-able	bank-a-ble
restive	res-tive
repli-cate	rep-li-cate
un-be-liev-able	un-be-liev-a-ble
do-lerite	dol-er-ite
pirou-ette	pir-ou-ette
un-quan-tifi-able	un-quan-ti-fi-a-ble
join-ery	join-er-y
sun-tanned	suntanned
bio-di-ver-si-ty	bi-o-di-ver-si-ty
ra-tio-nale	ra-tion-ale
beget	be-get
car-borun-dum	car-bo-run-dum
por-traitist	por-trait-ist
un-awares	un-a-wares
golfer	golf-er
par-lia-men-tary	par-lia-men-ta-ry
cryp-tol-ogy	cryp-tol-o-gy
pro-gressed	progressed
seabed	sea-bed
monarch	mon-arch
busi-ly	bus-i-ly
telegram	tel-e-gram
econo-met-rics	e-con-o-met-rics
in-ex-tin-guish-able	in-ex-tin-guish-a-ble
halfway	half-way
iambic	i-am-bic
apoc-a-lypse	a-poc-a-lypse
geron-toc-ra-cy	ger-on-toc-ra-cy
he-li-cal	hel-i-cal
mazy	ma-zy
post-mod-ernist	post-mod-ern-ist
mono-chrome	mon-o-chrome
cos-set-ed	cosseted
methanol	meth-a-nol
ide-al-ly	i-de-al-ly
corset	cor-set
ex-cep-tion-able	ex-cep-tion-a-ble
spo-radic	spo-rad-ic
mo-les-ter	mo-lest-er
user	us-er
tirade	ti-rade
ravine	ra-vine
valid	val-id
edgy	edg-y
over-take	o-ver-take
piper	pip-er
in-equal-i-ty	in-e-qual-i-ty
con-fi-den-tial-i-ty	con-fi-den-ti-al-i-ty
un-con-tain-able	un-con-tain-a-ble
geopo-lit-i-cal	ge-o-po-lit-i-cal
telekine-sis	tel-e-ki-ne-sis
in-fini-tude	in-fin-i-tude
necro-mancer	nec-ro-man-cer
im-mutable	im-mu-ta-ble
rangy	rang-y
aster	as-ter
spillage	spill-age
em-bell-ish-ment	em-bel-lish-ment
bereft	be-reft
as-cen-der	as-cend-er
sapi-ent	sa-pi-ent
febrile	fe-brile
chi-ropody	chi-rop-o-dy
dili-gent-ly	dil-i-gent-ly
au-tonomous	au-ton-o-mous
papil-la	pa-pil-la
fetishist	fet-ish-ist
rata-touille	ra-ta-touille
ap-praisal	ap-prais-al
dri-vable	driv-a-ble
ra-tio-nal-ly	ra-tion-al-ly
aquar-i-um	a-quar-i-um
adopt	a-dopt
as-pirin	as-pi-rin
pedant	ped-ant
wadding	wad-ding
toga	to-ga
dis-playable	displayable
over-ween-ing	o-ver-ween-ing
un-in-hab-it-able	un-in-hab-it-a-ble
papule	pap-ule
melan-cho-lia	mel-an-cho-li-a
com-mu-nica-tive	com-mu-ni-ca-tive
meio-sis	mei-o-sis
over-ca-pac-i-ty	o-ver-ca-pac-i-ty
un-easi-ly	un-eas-i-ly
mega-lith-ic	meg-a-lith-ic
un-lucky	un-luck-y
bunker	bun-ker
temptress	tempt-ress
chrysalis	chrys-a-lis
con-cussed	concussed
ma-nia	ma-ni-a
apart-ness	a-part-ness
couloir	cou-loir
minute	mi-nute
copy	cop-y
un-speak-able	un-speak-a-ble
char-woman	char-wom-an
in-fini-tive	in-fin-i-tive
mut-ter-ing	muttering
crossover	cross-o-ver
in-fir-mary	in-fir-ma-ry
bas-ketry	bas-ket-ry
jus-ti-fi-able	jus-ti-fi-a-ble
turnip	tur-nip
rhap-sody	rhap-so-dy
scal-able	scal-a-ble
squalid	squal-id
colonic	co-lon-ic
flab-ber-gast-ed	flabbergasted
hy-pox-ia	hy-pox-i-a
car-diopul-monary	car-di-o-pul-mo-nar-y
ter-tiary	ter-ti-ar-y
stingray	sting-ray
ep-ithe-li-um	ep-i-the-li-um
porcine	por-cine
ju-nior	jun-ior
chem-istry	chem-is-try
gi-antism	gi-ant-ism
ca-nary	ca-nar-y
bowlder	bowl-der
beret	be-ret
read-mit	re-ad-mit
atroc-i-ty	a-troc-i-ty
handy	hand-y
preser-va-tion	pres-er-va-tion
ge-nom-ic	ge-no-mic
swasti-ka	swas-ti-ka
suf-frag-ist	suf-fra-gist
elec-tro-sta-t-ics	e-lec-tro-stat-ics
moral-ist	mor-al-ist
un-ruly	un-ru-ly
cursed	curs-ed
pumice	pum-ice
post-mod-ernism	post-mod-ern-ism
herbal	herb-al
in-con-tro-vert-ible	in-con-tro-vert-i-ble
fi-nale	fi-na-le
in-fla-tion-ary	in-fla-tion-ar-y
welder	weld-er
strate-gic	stra-te-gic
un-aware	un-a-ware
un-en-vi-able	un-en-vi-a-ble
bear-able	bear-a-ble
sewage	sew-age
per-former	per-form-er
vestibule	ves-ti-bule
fly-away	fly-a-way
min-der	mind-er
de-cay-ing	decaying
id-iot	id-i-ot
om-nibus	om-ni-bus
com-mis-sari-at	com-mis-sar-i-at
rea-son-ably	rea-son-a-bly
canon-ry	can-on-ry
sto-icism	sto-i-cism
avail-abil-i-ty	a-vail-a-bil-i-ty
denizen	den-i-zen
earnest-ly	ear-nest-ly
pago-da	pa-go-da
sportive	spor-tive
ap-pa-ra-tus	ap-pa-rat-us
iso-sta-t-ic	i-so-stat-ic
trans-fer-able	trans-fer-a-ble
speechi-fy-ing	speechifying
nonethe-less	none-the-less
helper	help-er
satirist	sat-i-rist
ratepay-er	rate-pay-er
saunter	saun-ter
aslant	a-slant
sado-masochis-tic	sa-do-mas-o-chis-tic
valet	val-et
un-count-able	un-count-a-ble
wel-com-ing	wel-co-ming
shopfront	shop-front
diploid	dip-loid
be-fud-dled	befuddled
tuxe-do	tux-e-do
as-cen-dan-cy	as-cend-an-cy
sub-ur-bia	sub-ur-bi-a
ap-palling-ly	ap-pall-ing-ly
un-sur-pass-able	un-sur-pass-a-ble
im-per-son-ator	im-per-son-a-tor
lizard	liz-ard
lo-quaci-ty	lo-quac-i-ty
re-for-esta-tion	re-for-est-a-tion
sofa	so-fa
footwear	foot-wear
nat-ur-al	nat-u-ral
com-pan-ion-able	com-pan-ion-a-ble
vi-su-al-ly	vis-u-al-ly
bathrobe	bath-robe
para-mount-cy	par-a-mount-cy
fishy	fish-y
com-ple-men-tary	com-ple-men-ta-ry
cour-tesy	cour-te-sy
mama	ma-ma
elec-tive	e-lec-tive
mora-to-ri-um	mor-a-to-ri-um
milk-shake	milkshake
un-de-mo-c-ra-t-ic	un-dem-o-crat-ic
melo-dra-ma	mel-o-dra-ma
tele-o-log-i-cal	tel-e-o-log-i-cal
celi-bate	cel-i-bate
scruti-ny	scru-ti-ny
lacteal	lac-te-al
stron-groom	strong-room
retic-u-lat-ed	re-tic-u-lat-ed
ditch-ing	ditching
elec-tric-i-ty	e-lec-tric-i-ty
mili-tia-man	mi-li-tia-man
drap-ery	dra-per-y
wrestler	wres-tler
in-con-sid-er-able	in-con-sid-er-a-ble
dizzy	diz-zy
twilit	twi-lit
mastodon	mas-to-don
com-bustible	com-bus-ti-ble
bour-geoisie	bour-geoi-sie
cut-lery	cut-ler-y
dairy-man	dair-y-man
or-nithol-o-gy	or-ni-thol-o-gy
mari-nade	mar-i-nade
tu-mul-tuous	tu-mul-tu-ous
lassie	las-sie
palimpsest	pal-imp-sest
un-equal	un-e-qual
vol-canic	vol-can-ic
wom-ankind	wom-an-kind
damnable	dam-na-ble
in-tu-itive-ly	in-tu-i-tive-ly
triv-ial	triv-i-al
his-t-a-mine	his-ta-mine
where-abouts	where-a-bouts
overeat	o-ver-eat
bak-ery	bak-er-y
haulage	haul-age
plateau	pla-teau
con-stab-u-lary	con-stab-u-lar-y
unim-pressed	un-im-pressed
reval-u-a-tion	re-val-u-a-tion
cloven	clo-ven
fontanel	fon-ta-nel
bish-opric	bish-op-ric
ra-dionu-clide	ra-di-o-nu-clide
millinery	mil-li-ner-y
even-tu-al-i-ty	e-ven-tu-al-i-ty
con-nect-ing	con-nec-ting
chancery	chan-cer-y
tasty	tast-y
homonym	hom-o-nym
prompter	prompt-er
toothy	tooth-y
den-drochronol-o-gy	den-dro-chro-nol-o-gy
prover-bial	pro-ver-bi-al
uni-lat-er-al	u-ni-lat-er-al
cus-tomer	cus-tom-er
un-mea-sur-able	un-meas-ur-a-ble
lu-mi-nary	lu-mi-nar-y
es-teemed	e-steemed
macaque	ma-caque
mid-dleweight	mid-dle-weight
olive	ol-ive
brack-et-ed	bracketed
loony	loon-y
july	ju-ly
ex-pi-ra-to-ry	ex-pir-a-to-ry
tsuna-mi	tsu-na-mi
eland	e-land
forego	fore-go
baronet	bar-on-et
dyer	dy-er
moral	mor-al
again	a-gain
debonair	deb-o-nair
prof-itabil-i-ty	prof-it-a-bil-i-ty
pro-pri-ety	pro-pri-e-ty
pen-tame-ter	pen-tam-e-ter
apothe-cary	a-poth-e-car-y
hi-ero-glyph	hi-er-o-glyph
ahead	a-head
crevice	crev-ice
re-mark-able	re-mark-a-ble
over-val-ue	o-ver-val-ue
clank-ing	clan-king
kilo-hertz	kil-o-hertz
fron-tispiece	fron-tis-piece
glac-i-er	gla-cier
un-re-cov-er-able	un-re-cov-er-a-ble
de-monolo-gy	de-mon-ol-o-gy
tweedy	tweed-y
para-mount	par-a-mount
para-pet	par-a-pet
phrasal	phras-al
itin-er-ary	i-tin-er-ar-y
litany	lit-a-ny
sacral	sa-cral
buf-foon-ery	buf-foon-er-y
peremp-to-ry	per-emp-to-ry
ori-en-tal	o-ri-en-tal
partheno-gen-e-sis	par-the-no-gen-e-sis
coali-tion	co-a-li-tion
liti-gious	li-ti-gious
over-dose	o-ver-dose
sus-tain-abil-i-ty	sus-tain-a-bil-i-ty
positron	pos-i-tron
mar-riage-able	mar-riage-a-ble
dearie	dear-ie
cam-panol-o-gy	cam-pa-nol-o-gy
cameo	cam-e-o
coda	co-da
stom-achache	stom-ach-ache
un-remit-ting	un-re-mit-ting
mea-sure	meas-ure
multi-na-tion-al	mul-ti-na-tion-al
un-ser-vice-able	un-ser-vice-a-ble
con-vict-ed	convicted
hy-dro-elec-tric	hy-dro-e-lec-tric
haven	ha-ven
dreamy	dream-y
ethics	eth-ics
drafty	draft-y
pant-i-ng	pant-ing
scrapie	scrap-ie
com-pact-ed	compacted
power-boat	pow-er-boat
fri-able	fri-a-ble
dis-tillery	dis-till-er-y
mutiny	mu-ti-ny
racial	ra-cial
prowess	prow-ess
panz-er	pan-zer
casi-no	ca-si-no
su-per-cil-ious	su-per-cil-i-ous
cater-er	ca-ter-er
lefty	left-y
lento	len-to
com-mend-ably	com-mend-a-bly
soda	so-da
rook-ery	rook-er-y
holler	hol-ler
midair	mid-air
car-avel	car-a-vel
both-ered	bothered
si-lencer	si-lenc-er
phonol-o-gy	pho-nol-o-gy
rheumat-ics	rheu-mat-ics
dyad	dy-ad
odor-ous	o-dor-ous
there-abouts	there-a-bouts
kilo	ki-lo
plumy	plum-y
ionos-phere	i-on-o-sphere
crier	cri-er
unan-i-mous-ly	u-nan-i-mous-ly
tremo-lo	trem-o-lo
rhodo-den-dron	rho-do-den-dron
beta	be-ta
steeple-chase	stee-ple-chase
epi-gram-mat-ic	ep-i-gram-mat-ic
vizier	vi-zier
scary	scar-y
wealthy	wealth-y
au-gury	au-gu-ry
busi-nesslike	busi-ness-like
comet	com-et
xeno-phobe	xen-o-phobe
stealthy	stealth-y
evade	e-vade
un-usu-al	un-u-su-al
car-dioid	car-di-oid
imag-in-able	im-ag-i-na-ble
durable	du-ra-ble
chaot-ic	cha-ot-ic
meta-lan-guage	met-a-lan-guage
dumpling	dump-ling
thrilling	thrill-ing
seedling	seed-ling
lisp-ing	lis-ping
hubris	hu-bris
en-vi-able	en-vi-a-ble
edit	ed-it
elab-o-rate-ly	e-lab-o-rate-ly
codex	co-dex
em-bassy	em-bas-sy
unimag-in-able	un-im-ag-i-na-ble
sporty	sport-y
at-tain-able	at-tain-a-ble
iota	i-o-ta
avi-ate	a-vi-ate
im-paction	im-pac-tion
resid-uary	re-sid-u-ar-y
ranker	rank-er
re-port-ed	reported
scan-dalous	scan-dal-ous
eroge-nous	e-rog-e-nous
baroness	bar-on-ess
cine	cin-e
abaft	a-baft
equip-ment	e-quip-ment
poly-math	pol-y-math
ga-lop	gal-op
psalmody	psal-mo-dy
un-re-pairable	un-re-pair-a-ble
es-capade	es-ca-pade
goer	go-er
karaoke	kar-a-o-ke
sketchy	sketch-y
con-troller	con-trol-ler
fuel	fu-el
reroutes	re-routes
equa-tor	e-qua-tor
hostage	hos-tage
de-viant	de-vi-ant
sticky	stick-y
dither	dith-er
jeer-ing	jeering
even	e-ven
place-bo	pla-ce-bo
styl-is-tic	sty-lis-tic
dis-cor-dance	dis-cord-ance
up-lift-ed	uplifted
idyll	i-dyll
toughie	tough-ie
episod-ic	ep-i-sod-ic
pedestal	ped-es-tal
aubergine	au-ber-gine
menswear	mens-wear
elec-tro	e-lec-tro
im-politic	im-pol-i-tic
arouse	a-rouse
an-throp-ic	an-thro-pic
pala-tial	pa-la-tial
eatery	eat-er-y
sneer-ing	sneering
sand-piper	sand-pi-per
dis-tiller	dis-till-er
limpid	lim-pid
ined-i-ble	in-ed-i-ble
unimag-in-ably	un-im-ag-i-na-bly
mul-ti-me-ter	mul-tim-e-ter
astray	a-stray
nymp-holep-sy	nym-pho-lep-sy
jerkin	jer-kin
over-much	o-ver-much
readapt	re-a-dapt
raillery	rail-ler-y
omit	o-mit
ex-is-tent	ex-ist-ent
salu-bri-ous	sa-lu-bri-ous
blos-som-ing	blossoming
testos-terone	tes-tos-ter-one
ob-scu-ran-tism	ob-scu-rant-ism
aqualung	aq-ua-lung
ha-cien-da	ha-ci-en-da
saucy	sau-cy
pussy	pus-sy
sub-sis-tence	sub-sist-ence
how-itzer	how-itz-er
vol-un-tary	vol-un-tar-y
pogo	po-go
en-riched	enriched
com-menter	com-ment-er
ca-su-istry	cas-u-ist-ry
med-i-c-i-nal	me-dic-i-nal
mis-sion-ary	mis-sion-ar-y
even-tu-al	e-ven-tu-al
mis-nomer	mis-no-mer
re-pen-tant	re-pent-ant
finicky	fin-ick-y
ge-o-mag-net-i-cal-ly	ge-o-mag-ne-ti-cal-ly
re-searcher	re-search-er
ex-tralin-guis-tic	ex-tra-lin-guis-tic
coura-geous	cou-ra-geous
necro-sis	ne-cro-sis
un-sellable	un-sell-a-ble
ine-bri-ate	in-e-bri-ate
ca-su-al-ty	cas-u-al-ty
mon-e-tarism	mon-e-ta-rism
palace	pal-ace
over-pow-er	o-ver-pow-er
topog-ra-phy	to-pog-ra-phy
paci-fy	pac-i-fy
leak-ing	leaking
easy-go-ing	eas-y-go-ing
centi-grade	cen-ti-grade
fruit-ing	fruiting
em-bit-tered	embittered
con-ser-v-a-tive	con-serv-a-tive
goatskin	goat-skin
toka-mak	to-ka-mak
slushy	slush-y
basin	ba-sin
pan-golin	pan-go-lin
liquor	liq-uor
telex	tel-ex
lunchtime	lunch-time
equate	e-quate
un-der-writer	un-der-writ-er
undi-rect-ed	un-di-rect-ed
over-load	o-ver-load
in-con-solable	in-con-sol-a-ble
pout-ing	pouting
iso-lat-ing	i-so-lat-ing
dowdy	dow-dy
ante	an-te
in-nu-mer-able	in-nu-mer-a-ble
project	proj-ect
iso-la-tion	i-so-la-tion
cuneiform	cu-ne-i-form
arum	ar-um
mati-nee	mat-i-nee
doyenne	doy-enne
crony	cro-ny
un-for-giv-able	un-for-giv-a-ble
ex-tra-galac-tic	ex-tra-ga-lac-tic
orig-i-na-tion	o-rig-i-na-tion
emo-tive	e-mo-tive
vestal	ves-tal
event-ing	e-vent-ing
rapid	rap-id
maudlin	maud-lin
equer-ry	eq-uer-ry
sea-son-able	sea-son-a-ble
qua-dru-pli-cate	quad-ru-pli-cate
in-ter-lock-ing	in-ter-loc-king
re-deemable	re-deem-a-ble
ki-mono	ki-mo-no
forty	for-ty
physique	phy-sique
layper-son	lay-per-son
hori-zon	ho-ri-zon
laud-able	laud-a-ble
sky-scraper	sky-scrap-er
crus-tacean	crus-ta-cean
operand	op-er-and
pho-bia	pho-bi-a
who-dunit	who-dun-it
di-a-betes	di-a-be-tes
baron-age	bar-on-age
oblique	o-blique
egre-gious	e-gre-gious
in-creduli-ty	in-cre-du-li-ty
lithos-phere	lith-o-sphere
pompous	pomp-ous
stu-dious	stu-di-ous
en-crust-ed	encrusted
beeswax	bees-wax
cheery	cheer-y
whistler	whis-tler
ex-plorato-ry	ex-plor-a-to-ry
heron-ry	her-on-ry
cau-li-flower	cau-li-flow-er
clever	clev-er
li-censee	li-cen-see
pe-trel	pet-rel
semi-con-duct-ing	sem-i-con-duct-ing
know-able	know-a-ble
mar-garine	mar-ga-rine
epis-te-mo-log-i-cal	e-pis-te-mo-log-i-cal
sealant	seal-ant
com-mu-nion	com-mun-ion
cuirass	cui-rass
in-dige-nous	in-dig-e-nous
crock-ery	crock-er-y
util-i-tar-i-an	u-til-i-tar-i-an
sacra-ment	sac-ra-ment
dri-v-el	driv-el
mater	ma-ter
asun-der	a-sun-der
con-stituen-cy	con-stit-u-en-cy
shogun	sho-gun
smirk-ing	smirking
archangel	arch-an-gel
song-writer	song-writ-er
dozen	doz-en
su-prema-cy	su-prem-a-cy
un-man-age-able	un-man-age-a-ble
baby-ish	ba-by-ish
liv-ery	liv-er-y
glut-tony	glut-ton-y
ma-tri-archy	ma-tri-ar-chy
syn-chronic-i-ty	syn-chro-nic-i-ty
devo-tee	dev-o-tee
murky	murk-y
dis-cotheque	dis-co-theque
hereti-cal	he-ret-i-cal
punky	punk-y
lulu	lu-lu
panties	pant-ies
propane	pro-pane
gro-cery	gro-cer-y
lusty	lust-y
ne-go-tiable	ne-go-ti-a-ble
phoneme	pho-neme
matins	mat-ins
ex-oge-nous	ex-og-e-nous
body	bod-y
brevi-ty	brev-i-ty
wa-terbed	wa-ter-bed
erad-i-cate	e-rad-i-cate
au-thoress	au-thor-ess
crenel-la-tions	cren-el-la-tions
con-vect-ed	convected
camshaft	cam-shaft
semi-con-scious	sem-i-con-scious
bound-ary	bound-a-ry
spec-troscopy	spec-tros-co-py
un-der-rat-ed	underrated
peace-able	peace-a-ble
bathos	ba-thos
undis-turbed	un-dis-turbed
deci-bel	dec-i-bel
melo-dra-mat-ic	mel-o-dra-mat-ic
burly	bur-ly
beryl-li-um	be-ryl-li-um
coca	co-ca
liveli-hood	live-li-hood
inim-itable	in-im-i-ta-ble
camper	camp-er
coro-net	cor-o-net
skater	skat-er
mag-ne-tome-ter	mag-ne-tom-e-ter
dis-ori-en-tat-ed	disorientated
hardy	har-dy
in-choate	in-cho-ate
chro-matog-ra-phy	chro-ma-tog-ra-phy
sus-pend-ed	sus-pen-ded
in-es-timable	in-es-ti-ma-ble
un-pre-dictably	un-pre-dict-a-bly
en-joy-ably	en-joy-a-bly
sul-tana	sul-tan-a
dredger	dredg-er
en-abled	e-na-bled
goa-tee	goat-ee
await	a-wait
ranch-ing	ranching
respite	res-pite
timid	tim-id
servi-ette	ser-vi-ette
with-ered	withered
equal	e-qual
em-bossed	embossed
panache	pa-nache
mis-aligned	mis-a-ligned
pur-suance	pur-su-ance
habi-ta-tion	hab-i-ta-tion
viva	vi-va
par-si-mo-nious	par-si-mo-ni-ous
duik-er	dui-ker
re-tiree	re-tir-ee
clam-orous	clam-or-ous
dic-tio-nary	dic-tion-ar-y
ron-dav-el	ron-da-vel
cam-era	cam-er-a
faucet	fau-cet
un-ob-ser-vant	un-ob-serv-ant
loess	lo-ess
domi-cile	dom-i-cile
apoplec-tic	ap-o-plec-tic
sav-agery	sav-age-ry
un-re-served-ly	un-re-serv-ed-ly
pom-padour	pom-pa-dour
hide-away	hide-a-way
cladding	clad-ding
cos-mopoli-tan	cos-mo-pol-i-tan
hosan-na	ho-san-na
racial-ism	ra-cial-ism
grunter	grunt-er
retic-u-lum	re-tic-u-lum
hero	he-ro
steplad-der	step-lad-der
gud-geon	gudg-eon
stratig-ra-phy	stra-tig-ra-phy
brazen	bra-zen
mi-cro-surgery	mi-cro-sur-ger-y
thievish	thiev-ish
tox-i-c-i-ty	tox-ic-i-ty
aro-matic-i-ty	ar-o-ma-tic-i-ty
reclu-sive	re-clu-sive
im-mea-sur-ably	im-meas-ur-a-bly
di-nosaur	di-no-saur
donor	do-nor
pizze-ria	piz-ze-ri-a
in-spi-ra-tional	in-spi-ra-tion-al
bonobo	bo-no-bo
napoleon	na-po-le-on
treach-ery	treach-er-y
un-for-get-table	un-for-get-ta-ble
kamikaze	ka-mi-ka-ze
atri-um	a-tri-um
foot-baller	foot-ball-er
rein-ter-pret	re-in-ter-pret
video-taped	videotaped
aorist	a-o-rist
elim-i-nate	e-lim-i-nate
scur-rilous	scur-ril-ous
stormer	storm-er
lauda-to-ry	laud-a-to-ry
pro-tect-ed	protected
yeti	yet-i
ileum	il-e-um
hor-mon-al	hor-mo-nal
ed-i-to-r-i-al	ed-i-to-ri-al
avun-cu-lar	a-vun-cu-lar
beachy	beach-y
para-phrase	par-a-phrase
hang-over	hang-o-ver
celebri-ty	ce-leb-ri-ty
pre-dictable	pre-dict-a-ble
epi-demi-o-log-i-cal	ep-i-de-mi-o-log-i-cal
apery	ap-er-y
epi-logue	ep-i-logue
castoff	cast-off
con-cil-iar	con-cil-i-ar
slaver	slav-er
un-processed	un-proc-essed
busk-ing	busking
tiger	ti-ger
wartime	war-time
theos-o-phy	the-os-o-phy
moray	mo-ray
distaff	dis-taff
erec-tile	e-rec-tile
melan-cholic	mel-an-chol-ic
un-adorned	un-a-dorned
sedi-tious	se-di-tious
damask	dam-ask
meri-no	me-ri-no
any-how	an-y-how
se-nior	sen-ior
psalter	psal-ter
over-see	o-ver-see
rapi-er	ra-pi-er
choline	cho-line
uni-di-rec-tion-al	u-ni-di-rec-tion-al
un-tidy	un-ti-dy
can-nery	can-ner-y
rel-a-tivism	rel-a-tiv-ism
kitchen-ware	kitch-en-ware
kinswoman	kins-wom-an
so-cio-cul-tur-al	so-ci-o-cul-tur-al
per-ineum	per-i-ne-um
tute-lage	tu-te-lage
flighty	flight-y
the-atri-cal-ly	the-at-ri-cal-ly
un-mis-tak-able	un-mis-tak-a-ble
earnest-ness	ear-nest-ness
gateau	ga-teau
eigen-val-ue	ei-gen-val-ue
glitzy	glitz-y
remix	re-mix
in-sis-tence	in-sist-ence
un-trans-lat-able	un-trans-lat-a-ble
co-pro-lite	cop-ro-lite
ax-iom	ax-i-om
bar-barism	bar-ba-rism
preterite	pret-er-ite
un-us-able	un-us-a-ble
delir-i-um	de-lir-i-um
per-fidy	per-fi-dy
vagabond	vag-a-bond
for-giv-able	for-giv-a-ble
polon-aise	pol-o-naise
rein-vig-o-rate	re-in-vig-or-ate
crazi-ly	cra-zi-ly
moral-ism	mor-al-ism
cityscape	cit-y-scape
ox-alate	ox-a-late
raver	rav-er
de-cathlon	de-cath-lon
satchel	satch-el
net-work-ing	networking
gener-i-cal-ly	ge-ner-i-cal-ly
retroac-tive-ly	ret-ro-ac-tive-ly
pyra-mi-dal	py-ram-i-dal
plat-inum	plat-i-num
char-i-o-teer	char-i-ot-eer
dis-mem-bered	dismembered
leapfrog	leap-frog
no-tice-ably	no-tice-a-bly
firkin	fir-kin
me-dieval	me-di-e-val
de-pri-va-tion	dep-ri-va-tion
over-pay-ment	o-ver-pay-ment
galleon	gal-le-on
poly-tech-nic	pol-y-tech-nic
crys-talline	crys-tal-line
any-body	an-y-bod-y
dy-nasty	dy-nas-ty
wormy	worm-y
shaven	shav-en
pur-suant	pur-su-ant
groundswell	ground-swell
risot-to	ri-sot-to
chromi-um	chro-mi-um
grouchy	grouch-y
de-sir-able	de-sir-a-ble
over-pass	o-ver-pass
spoilage	spoil-age
wordy	word-y
psy-chother-a-pist	psy-cho-ther-a-pist
un-de-cid-able	un-de-cid-a-ble
be-wil-dered	bewildered
lot-tery	lot-ter-y
con-queror	con-quer-or
kriegspiel	krieg-spiel
aun-tie	aunt-ie
laden	lad-en
oblige	o-blige
sailor	sail-or
obelisk	ob-e-lisk
over-pow-er-ing	o-ver-pow-er-ing
coax-i-al	co-ax-i-al
propul-sive	pro-pul-sive
kestrel	kes-trel
fi-deli-ty	fi-del-i-ty
premis-es	prem-is-es
car-bona-ceous	car-bo-na-ceous
flick-er-ing	flickering
emen-da-tion	e-men-da-tion
dis-able	dis-a-ble
pros-e-cu-to-r-i-al	pros-e-cu-to-ri-al
in-sou-ciance	in-sou-ci-ance
su-per-nu-mer-ary	su-per-nu-mer-ar-y
snig-ger-ing	sniggering
para-mil-i-tary	par-a-mil-i-tar-y
grapevine	grape-vine
ra-di-ograph-ic	ra-di-o-graph-ic
avowed	a-vowed
im-pres-sion-able	im-pres-sion-a-ble
un-touch-able	un-touch-a-ble
dri-ve-way	drive-way
julep	ju-lep
apos-tolic	ap-os-tol-ic
cau-tion-ary	cau-tion-ar-y
emu	e-mu
dauphin	dau-phin
aphid	a-phid
verdi-gris	ver-di-gris
covenant	cov-e-nant
zealotry	zeal-ot-ry
ura-ni-um	u-ra-ni-um
count-able	count-a-ble
steamship	steam-ship
mul-ti-plica-tive	mul-ti-pli-ca-tive
artistry	art-ist-ry
sub-jec-tivism	sub-jec-tiv-ism
poly-gon	pol-y-gon
ir-ra-tional	ir-ra-tion-al
turnover	turn-o-ver
any-more	an-y-more
poly-syl-la-ble	pol-y-syl-la-ble
shady	shad-y
any-where	an-y-where
coloured	co-loured
ho-muncu-lus	ho-mun-cu-lus
unlove-ly	un-love-ly
over-draft	o-ver-draft
over-anx-ious	o-ver-anx-ious
enor-mous-ly	e-nor-mous-ly
ex-ul-tant	ex-ult-ant
verisimil-i-tude	ver-i-si-mil-i-tude
nun-nery	nun-ner-y
coro-ner	cor-o-ner
pastis	pas-tis
re-stroom	rest-room
pri-mor-dial	pri-mor-di-al
bar-racu-da	bar-ra-cu-da
crisply	crisp-ly
ici-cle	i-ci-cle
pizzi-ca-to	piz-zi-ca-to
mini	min-i
theodo-lite	the-od-o-lite
menar-che	men-ar-che
duo	du-o
ex-pand-able	ex-pand-a-ble
bindery	bind-er-y
su-prema-cist	su-prem-a-cist
scrib-bling	scribbling
clover	clo-ver
meta-mor-phic	met-a-mor-phic
sun-flower	sun-flow-er
droplet	drop-let
thorny	thorn-y
frigid	frig-id
ten-antry	ten-ant-ry
incog-ni-to	in-cog-ni-to
hy-dropho-bic	hy-dro-pho-bic
trac-ery	trac-er-y
tele-vi-sion	tel-e-vi-sion
fairy	fair-y
wrinkly	wrin-kly
stinky	stink-y
porce-lain	por-ce-lain
cologne	co-logne
teeter	tee-ter
oblig-ing-ly	o-blig-ing-ly
basil	bas-il
undis-put-ed	un-dis-put-ed
genii	ge-ni-i
gaucherie	gau-che-rie
un-com-fort-able	un-com-fort-a-ble
causal	caus-al
mo-lesta-tion	mo-les-ta-tion
front-ed	fronted
in-au-gur-al	in-au-gu-ral
lit-toral	lit-to-ral
sta-tis-ti-cian	stat-is-ti-cian
ne-ma-tode	nem-a-tode
squea-mish	squeam-ish
un-clas-si-fi-able	un-clas-si-fi-a-ble
may-oral-ty	may-or-al-ty
par-ent-ing	parenting
swinger	swing-er
may-oral	may-or-al
necrop-sy	nec-rop-sy
curie	cu-rie
pathol-o-gist	pa-thol-o-gist
polyurethane	pol-y-u-re-thane
antrum	an-trum
voyeuris-tic	voy-eur-is-tic
catalep-sy	cat-a-lep-sy
ptero-dactyl	pter-o-dac-tyl
chewy	chew-y
urchin	ur-chin
halo	ha-lo
penum-bra	pe-num-bra
op-por-tunism	op-por-tun-ism
heater	heat-er
fetishis-tic	fet-ish-is-tic
jeal-ousy	jeal-ous-y
over-com-pen-sate	o-ver-com-pen-sate
un-abashed	un-a-bashed
tractable	trac-ta-ble
body-guard	bod-y-guard
mega-lo-ma-nia	meg-a-lo-ma-ni-a
as-phyx-ia	as-phyx-i-a
re-splen-dent	re-splend-ent
beery	beer-y
pity	pit-y
yardage	yard-age
ex-pec-tant-ly	ex-pect-ant-ly
theoc-ra-cy	the-oc-ra-cy
record-ed	re-cor-ded
ide-o-log-i-cal	i-de-o-log-i-cal
smelly	smell-y
arrange	ar-range
comber	comb-er
in-nocu-ous	in-noc-u-ous
voca-tive	voc-a-tive
be-trothal	be-troth-al
flutist	flut-ist
are-na	a-re-na
provider	pro-vid-er
erot-ic	e-rot-ic
iron-ic	i-ron-ic
doyen	doy-en
gen-eros-i-ty	gen-er-os-i-ty
metatarsal	met-a-tar-sal
can-dlelit	can-dle-lit
at-trib-ut-able	at-trib-ut-a-ble
dauber	daub-er
plebiscite	pleb-i-scite
ban-ter-ing	bantering
gaze-bo	ga-ze-bo
com-man-der	com-mand-er
un-frozen	un-fro-zen
elec-trolyte	e-lec-tro-lyte
hair-spray	hairspray
backgam-mon	back-gam-mon
res-onate	res-o-nate
rea-son-able-ness	rea-son-a-ble-ness
un-buried	un-bur-ied
car-rion	car-ri-on
eman-ci-pat-ed	e-man-ci-pat-ed
beefeater	beef-eat-er
de-caf-feinate	de-caf-fein-ate
im-prison	im-pris-on
japan	ja-pan
open-ly	o-pen-ly
so-bri-ety	so-bri-e-ty
over-pop-u-la-tion	o-ver-pop-u-la-tion
flinty	flint-y
lega-tor	le-ga-tor
dodger	dodg-er
binoc-u-lars	bin-oc-u-lars
elate	e-late
sub-mersible	sub-mers-i-ble
aqua-naut	aq-ua-naut
rhetoric	rhet-o-ric
kosher	ko-sher
tapir	ta-pir
vengeance	venge-ance
piercer	pierc-er
mus-cu-loskele-tal	mus-cu-lo-skel-e-tal
grandeur	gran-deur
mi-crowave	mi-cro-wave
elect	e-lect
bracelet	brace-let
ebony	eb-on-y
as-para-gus	as-par-a-gus
for-get-table	for-get-ta-ble
dul-cimer	dul-ci-mer
dis-ori-en-ta-tion	dis-o-ri-en-ta-tion
antacid	ant-ac-id
re-mark-ably	re-mark-a-bly
warpath	war-path
emerge	e-merge
over-ride	o-ver-ride
usurp-er	u-surp-er
sooty	soot-y
wingspan	wing-span
overem-pha-sis	o-ver-em-pha-sis
dis-gust-ed	disgusted
ide-al-is-tic	i-de-al-is-tic
re-cruiter	re-cruit-er
timetable	time-ta-ble
im-per-me-able	im-per-me-a-ble
steeple-jack	stee-ple-jack
decile	dec-ile
body-build-ing	bod-y-build-ing
prostaglandin	pros-ta-glan-din
orig-i-nate	o-rig-i-nate
ini-ti-a-tion	in-i-ti-a-tion
vil-lager	vil-lag-er
uter-ine	u-ter-ine
thread-ed	threaded
over-rate	o-ver-rate
prefer-able	pref-er-a-ble
liq-uida-tor	liq-ui-da-tor
opaque	o-paque
bio-med-ical	bi-o-med-i-cal
pouter	pout-er
poly-glot	pol-y-glot
pes-simist	pes-si-mist
con-tentious	con-ten-tious
greensward	green-sward
onus	o-nus
footrest	foot-rest
budgie	budg-ie
over-sleep	o-ver-sleep
potable	po-ta-ble
diathermy	di-a-ther-my
pur-suer	pur-su-er
hypochon-dri-a-cal	hy-po-chon-dri-a-cal
barefaced	bare-faced
di-alec-ti-cal	di-a-lec-ti-cal
promis-ing	prom-is-ing
rial	ri-al
sepia	se-pi-a
pre-sen-ta-tion	pres-en-ta-tion
gospel	gos-pel
sies-ta	si-es-ta
en-chanter	en-chant-er
grenade	gre-nade
poly-cyclic	pol-y-cy-clic
dan-de-lion	dan-de-li-on
en-v-i-ron	en-vi-ron
di-vorcee	di-vor-cee
debu-tant	deb-u-tant
lengthy	length-y
sug-ary	sug-ar-y
eu-pho-nious	eu-pho-ni-ous
reap-pear-ance	re-ap-pear-ance
woman	wom-an
aton-al	a-ton-al
cesspool	cess-pool
un-palat-able	un-pal-at-a-ble
feb-ru-ary	feb-ru-ar-y
smelt-ing	smelting
pointy	point-y
warhorse	war-horse
tenac-i-ty	te-nac-i-ty
uni-ver-sal	u-ni-ver-sal
pu-ri-tanism	pu-ri-tan-ism
over-pay	o-ver-pay
groovy	groov-y
method-olog-i-cal	meth-od-o-log-i-cal
over-cast	o-ver-cast
opin-ion-at-ed	o-pin-ion-at-ed
ven-omous	ven-om-ous
ego-ma-ni-ac	e-go-ma-ni-ac
ovum	o-vum
feath-erlight	feath-er-light
var-ie-gat-ed	var-i-e-gat-ed
mon-o-clon-al	mon-o-clo-nal
ves-ti-gial	ves-tig-i-al
canon-ic	ca-non-ic
tingly	tin-gly
view-able	view-a-ble
posse	pos-se
lighter	light-er
briefer	brief-er
un-con-scionable	un-con-scion-a-ble
syco-phan-tic	syc-o-phan-tic
velum	ve-lum
emo-tion-al-ly	e-mo-tion-al-ly
out-lawed	outlawed
ex-ten-der	ex-tend-er
arc-ing	arcing
proac-tive	pro-ac-tive
hia-tus	hi-a-tus
patho-log-i-cal	path-o-log-i-cal
os-tracism	os-tra-cism
manda-to-ry	man-da-to-ry
monies	mon-ies
bio-chemist	bi-o-chem-ist
han-dover	hand-o-ver
so-cio-bi-ol-o-gy	so-ci-o-bi-ol-o-gy
in-tractable	in-trac-ta-ble
tri-umphal	tri-um-phal
pro-le-tari-at	pro-le-tar-i-at
ve-nial	ve-ni-al
elu-sive	e-lu-sive
en-tourage	en-tou-rage
touris-tic	tour-is-tic
froward	fro-ward
tableau	tab-leau
cen-tipede	cen-ti-pede
ion	i-on
epi-taph	ep-i-taph
icon-o-clasm	i-con-o-clasm
un-solv-able	un-solv-a-ble
styling	styl-ing
equinox	e-qui-nox
isotrop-ic	i-so-trop-ic
kilo-byte	kil-o-byte
kiwi	ki-wi
roundel	roun-del
ni-troge-nous	ni-trog-e-nous
gamy	gam-y
mea-sure-ment	meas-ure-ment
unau-dit-ed	un-au-dit-ed
dy-s-tro-phy	dys-tro-phy
rosary	ro-sa-ry
glossy	gloss-y
semi-de-tached	sem-i-de-tached
azure	az-ure
doubter	doubt-er
mas-tery	mas-ter-y
courage	cour-age
furtive	fur-tive
gib-ber-ing	gibbering
laser	la-ser
soli-taire	sol-i-taire
di-aphragm	di-a-phragm
hy-acinth	hy-a-cinth
ever	ev-er
largo	lar-go
is-suance	is-su-ance
poly-mer	pol-y-mer
ex-pect-ed	expected
fil-i-buster	fil-i-bus-ter
coax-ing	coaxing
bur-ial	bur-i-al
aviary	a-vi-ar-y
uni-corn	u-ni-corn
prove-nance	prov-e-nance
bur-gundy	bur-gun-dy
melo-di-ous	me-lo-di-ous
crooked	crook-ed
catheter	cath-e-ter
fragili-ty	fra-gil-i-ty
sesame	ses-a-me
vial	vi-al
celandine	cel-an-dine
lodestar	lode-star
parental	pa-ren-tal
apron	a-pron
bedrid-den	bed-rid-den
stymie	sty-mie
un-equiv-o-cal-ly	un-e-quiv-o-cal-ly
apoc-a-lyp-tic	a-poc-a-lyp-tic
vine-gar	vin-e-gar
inani-ty	in-an-i-ty
mytho-log-i-cal	myth-o-log-i-cal
quater-nion	qua-ter-ni-on
over-dra-mat-ic	o-ver-dra-mat-ic
con-for-mance	con-form-ance
tri-maran	tri-ma-ran
ret-inue	ret-i-nue
laager	laa-ger
ep-ithe-lial	ep-i-the-li-al
tav-er-na	ta-ver-na
ex-ocrine	ex-o-crine
temer-i-ty	te-mer-i-ty
elite	e-lite
emer-gence	e-mer-gence
para-noia	par-a-noi-a
en-cycli-cal	en-cyc-li-cal
mar-ketable	mar-ket-a-ble
virus	vi-rus
rheumat-ic	rheu-mat-ic
eval-u-ate	e-val-u-ate
brandy	bran-dy
briefly	brief-ly
un-watch-able	un-watch-a-ble
aza-lea	a-zal-ea
puerile	pu-er-ile
lazuli	laz-u-li
on-tol-ogy	on-tol-o-gy
prepa-ra-tion	prep-a-ra-tion
coinage	coin-age
rocky	rock-y
polyun-sat-u-rat-ed	pol-y-un-sat-u-rat-ed
demon-stra-bly	de-mon-stra-bly
vari-ate	var-i-ate
over-drive	o-ver-drive
fundrais-ing	fund-rais-ing
dis-qui-etude	dis-qui-e-tude
stargaz-er	star-gaz-er
sta-tion-ary	sta-tion-ar-y
in-haler	in-hal-er
sisal	si-sal
salary	sal-a-ry
guilty	guilt-y
twofaced	two-faced
physic	phys-ic
cobalt	co-balt
teenage	teen-age
loco	lo-co
hookah	hook-ah
overkill	o-ver-kill
bubon-ic	bu-bon-ic
choral	cho-ral
for-syth-ia	for-syth-i-a
over-whelm-ing	o-ver-whelm-ing
labi-um	la-bi-um
unchris-t-ian	un-chris-tian
promi-nent	prom-i-nent
re-word-ings	re-word-ings
soli-tude	sol-i-tude
awry	a-wry
uni-fy	u-ni-fy
bur-nished	burnished
cathar-tic	ca-thar-tic
lender	lend-er
pornog-ra-ph-er	por-nog-ra-pher
con-demned	condemned
gaiter	gait-er
im-moral-i-ty	im-mo-ral-i-ty
pester	pes-ter
icon-o-clas-tic	i-con-o-clas-tic
any	an-y
mega-hertz	meg-a-hertz
green-ery	green-er-y
rein-ter-pre-ta-tion	re-in-ter-pre-ta-tion
lousy	lous-y
giblets	gib-lets
lith-o-g-ra-phy	li-thog-ra-phy
dual	du-al
lounger	loung-er
meta-physics	met-a-phys-ics
mar-tinet	mar-ti-net
amaz-ing	a-maz-ing
docile	doc-ile
fluffy	fluff-y
fault-ing	faulting
odi-um	o-di-um
dis-ori-ent	dis-o-ri-ent
carouse	ca-rouse
cer-ti-fi-able	cer-ti-fi-a-ble
tri-adic	tri-ad-ic
scapu-la	scap-u-la
as-cetic	as-cet-ic
pageant	pag-eant
peanut	pea-nut
ar-bi-trari-ness	ar-bi-trar-i-ness
ha-track	hat-rack
por-phyrit-ic	por-phy-rit-ic
er-ro-neous-ly	er-ro-ne-ous-ly
lanky	lank-y
sil-vered	silvered
in-trauter-ine	in-tra-u-ter-ine
taboo	ta-boo
break-able	break-a-ble
mili-tia	mi-li-tia
evac-uee	e-vac-u-ee
racon-teur	rac-on-teur
joey	jo-ey
mar-gin-a-lia	mar-gi-na-li-a
swelling	swell-ing
trainee	train-ee
treaty	trea-ty
Words with errors: 1867
Words with incorrect number of syllables: 1768
Total evluated: 6500
Perfect accuracy: 0.71
Number of syllables accuracy: 0.73
Average Levenshtein Distance(across incorrect words): 1.20
