Attempt	Real
crawler	crawl-er
pol-luter	pol-lut-er
su-per-fi-cial-i-ty	su-per-fi-ci-al-i-ty
fussy	fuss-y
salu-bri-ous	sa-lu-bri-ous
un-count-able	un-count-a-ble
trans-mo-gri-fy	trans-mog-ri-fy
reap-ply	re-ap-ply
proxy	prox-y
easy	eas-y
bel-liger-ent	bel-lig-er-ent
sander	sand-er
hy-draulics	hy-drau-lics
patis-serie	pa-tis-se-rie
an-tipa-thy	an-tip-a-thy
or-biter	or-bit-er
he-lios-phere	he-li-o-sphere
hand-picked	handpicked
reser-voir	res-er-voir
needy	need-y
evo-ca-tion	ev-o-ca-tion
promise	prom-ise
pan-das	pan-das
round-about	round-a-bout
taxi	tax-i
deep-en-ing	deepening
redi-rect	re-di-rect
specu-lum	spec-u-lum
facet	fac-et
gos-sipy	gos-sip-y
re-cessed	recessed
stu-dentship	stu-dent-ship
de-ify	de-i-fy
di-nosaur	di-no-saur
char-i-o-teer	char-i-ot-eer
mil-lenar-i-an	mil-le-nar-i-an
repack-age	re-pack-age
demon-stra-ble	de-mon-stra-ble
breath-able	breath-a-ble
for-tu-itous-ly	for-tu-i-tous-ly
gaze-bo	ga-ze-bo
omega	o-me-ga
block-buster	block-bust-er
phys-iog-no-my	phys-i-og-no-my
claret	clar-et
dis-tin-guish-able	dis-tin-guish-a-ble
un-ortho-dox	un-or-tho-dox
heady	head-y
mar-ketable	mar-ket-a-ble
cider	ci-der
assig-na-tion	as-sig-na-tion
de-crepit	de-crep-it
chival-ry	chiv-al-ry
statute	stat-ute
paci-fist	pac-i-fist
sus-tain-abil-i-ty	sus-tain-a-bil-i-ty
cur-tained	curtained
boxy	box-y
dis-tillery	dis-till-er-y
cho-les-terol	cho-les-ter-ol
iron-work	i-ron-work
unas-suaged	un-as-suaged
im-agery	im-age-ry
lifebelt	life-belt
mono-graph	mon-o-graph
get-away	get-a-way
dis-cernible	dis-cern-i-ble
mid-dleweight	mid-dle-weight
retry	re-try
over-run	o-ver-run
po-ten-tiome-ter	po-ten-ti-om-e-ter
psy-chopathol-o-gy	psy-cho-pa-thol-o-gy
fluffy	fluff-y
procla-ma-tion	proc-la-ma-tion
pelvis	pel-vis
de-liv-er-able	de-liv-er-a-ble
twitchy	twitch-y
au-tomat	au-to-mat
topo-graph-i-cal	top-o-graph-i-cal
derelict	der-e-lict
triv-ia	triv-i-a
aper-i-tif	a-pe-ri-tif
rec-i-p-ro-cal	re-cip-ro-cal
in-de-pen-dence	in-de-pend-ence
in-con-solable	in-con-sol-a-ble
pedi-gree	ped-i-gree
labur-num	la-bur-num
parental	pa-ren-tal
in-ad-vis-able	in-ad-vis-a-ble
in-valu-able	in-val-u-a-ble
halo-gen	hal-o-gen
apoplexy	ap-o-plex-y
paunchy	paunch-y
re-volver	re-volv-er
cu-rat-ed	curated
pi-anola	pi-a-no-la
chamois	cham-ois
prepar-a-tive	pre-par-a-tive
giro	gi-ro
ju-bilee	ju-bi-lee
any-one	an-y-one
sub-ur-bia	sub-ur-bi-a
re-dis-tri-b-u-tion	re-dis-tri-bu-tion
ri-boflavin	ri-bo-fla-vin
navy	na-vy
bleat-ing	bleating
kudu	ku-du
geno-type	gen-o-type
sinewy	sin-ew-y
cabri-o-let	cab-ri-o-let
mov-able	mov-a-ble
dig-ni-tary	dig-ni-tar-y
em-broi-dery	em-broi-der-y
seabird	sea-bird
best-selling	best-sell-ing
detox-i-fy	de-tox-i-fy
gaslight	gas-light
ini-ti-a-tion	in-i-ti-a-tion
quixot-ic	quix-ot-ic
con-tem-po-rary	con-tem-po-rar-y
readi-ness	read-i-ness
as-siduity	as-si-du-i-ty
cologne	co-logne
nau-sea	nau-se-a
ap-palling-ly	ap-pall-ing-ly
paraf-fin	par-af-fin
in-her-i-tance	in-her-it-ance
flick-er-ing	flickering
hy-drother-mal	hy-dro-ther-mal
con-cate-nate	con-cat-e-nate
elec-tro-sta-t-ic	e-lec-tro-stat-ic
athe-ism	a-the-ism
con-denser	con-dens-er
geno-ci-dal	gen-o-cid-al
minke	min-ke
rapid-ly	rap-id-ly
un-con-tain-able	un-con-tain-a-ble
zona-tion	zo-na-tion
lo-quaci-ty	lo-quac-i-ty
scat-tered	scattered
gravy	gra-vy
omen	o-men
monar-chist	mon-ar-chist
book-able	book-a-ble
rewritable	re-writ-a-ble
emet-ic	e-met-ic
racial	ra-cial
quiet-ness	qui-et-ness
an-tithe-sis	an-tith-e-sis
un-avail-abil-i-ty	un-a-vail-a-bil-i-ty
decre-ment	dec-re-ment
jester	jest-er
sta-tion-ary	sta-tion-ar-y
herbal-ism	her-bal-ism
steve-dore	ste-ve-dore
cara-pace	car-a-pace
dis-ci-pli-nary	dis-ci-pli-nar-y
in-ge-nious	in-gen-ious
re-ceiver-ship	re-ceiv-er-ship
dairy-ing	dair-y-ing
seedling	seed-ling
frica-tive	fric-a-tive
squirearchy	squire-ar-chy
bulky	bulk-y
re-former	re-form-er
any-where	an-y-where
de-fend-ing	defending
junker	jun-ker
ap-pendage	ap-pend-age
apery	ap-er-y
un-trans-lat-able	un-trans-lat-a-ble
grouper	group-er
spunky	spunk-y
con-fronta-tion-al	con-fron-ta-tion-al
su-per-hero	su-per-he-ro
rein-vest-ment	re-in-vest-ment
hye-na	hy-e-na
deathbed	death-bed
stom-achache	stom-ach-ache
aware-ness	a-ware-ness
un-in-for-ma-tive	un-in-form-a-tive
over-throw	o-ver-throw
labi-al	la-bi-al
col-umn	co-lumn
mis-er-able	mis-er-a-ble
scathing	scath-ing
bagatelle	bag-a-telle
min-der	mind-er
rheo-stat	rhe-o-stat
tremo-lo	trem-o-lo
pre-sentable	pre-sent-a-ble
elec-tro-mo-tive	e-lec-tro-mo-tive
ante	an-te
in-tu-itive	in-tu-i-tive
logo	lo-go
dark-ened	dar-kened
punc-til-ious	punc-til-i-ous
uni-lat-er-al	u-ni-lat-er-al
over-board	o-ver-board
hu-mankind	hu-man-kind
onyx	on-yx
tri-maran	tri-ma-ran
brio	bri-o
clever	clev-er
valet	val-et
chas-ten-ing	chastening
rev-enue	rev-e-nue
hatch-ery	hatch-er-y
sus-penders	sus-pend-ers
courtier	cour-ti-er
usurp-er	u-surp-er
gen-i-talia	gen-i-ta-li-a
palm-istry	palm-is-try
wag-gery	wag-ger-y
avul-sion	a-vul-sion
an-niver-sary	an-ni-ver-sa-ry
gob-bledy-gook	gob-ble-dy-gook
beeswax	bees-wax
wash-basin	wash-ba-sin
grandeur	gran-deur
purview	pur-view
semi-con-duct-ing	sem-i-con-duct-ing
diskette	disk-ette
pan-icky	pan-ick-y
mo-lesta-tion	mo-les-ta-tion
mam-malian	mam-ma-li-an
ingress	in-gress
colon	co-lon
para-met-ric	par-a-met-ric
shopfront	shop-front
dauber	daub-er
dri-ve	drive
con-duct-ed	conducted
diox-in	di-ox-in
karate	ka-ra-te
choral	cho-ral
pseudo-pod	pseu-do-pod
as-cetic	as-cet-ic
emis-sary	em-is-sar-y
soapy	soap-y
ca-cao	ca-ca-o
di-vider	di-vid-er
shoplift	shop-lift
over-draft	o-ver-draft
var-ie-gat-ed	var-i-e-gat-ed
turkey	tur-key
teleprint-er	tel-e-print-er
cam-era	cam-er-a
de-liv-ery	de-liv-er-y
re-liance	re-li-ance
del-i-catessen	del-i-ca-tes-sen
hypochon-dri-ac	hy-po-chon-dri-ac
con-tretemps	con-tre-temps
deroga-to-ry	de-rog-a-to-ry
stenog-ra-ph-er	ste-nog-ra-pher
un-avail-ing	un-a-vail-ing
un-bridge-able	un-bridge-a-ble
miser-ly	mi-ser-ly
taxi-dermy	tax-i-der-my
teacher	teach-er
agent	a-gent
trel-lised	trellised
mankind	man-kind
ori-ent	o-ri-ent
retsi-na	ret-si-na
monarch	mon-arch
treaty	trea-ty
de-gauss-ing	degaussing
demon-stra-tive	de-mon-stra-tive
ig-no-min-ious	ig-no-min-i-ous
brew-ery	brew-er-y
tilde	til-de
su-per-in-ten-dence	su-per-in-tend-ence
linen	lin-en
crick-eter	crick-et-er
in-ter-po-lat-able	in-ter-po-la-ta-ble
for-get-table	for-get-ta-ble
mi-crodot	mi-cro-dot
pi-caresque	pic-a-resque
bowlder	bowl-der
yokel	yo-kel
cen-trifuge	cen-tri-fuge
pari-ah	pa-ri-ah
den-drochronol-o-gy	den-dro-chro-nol-o-gy
zealotry	zeal-ot-ry
liar	li-ar
pavil-ion	pa-vil-ion
in-scrutable	in-scru-ta-ble
se-nior-i-ty	sen-ior-i-ty
sub-sis-tence	sub-sist-ence
covenant	cov-e-nant
tri-bune	trib-une
weapon	weap-on
pe-riphra-sis	pe-riph-ra-sis
vic-to-ria	vic-to-ri-a
premis-es	prem-is-es
bilin-gual	bi-lin-gual
defam-a-to-ry	de-fam-a-to-ry
centi-grade	cen-ti-grade
in-flat-able	in-flat-a-ble
vis-i-ta-tion	vis-it-a-tion
paragon	par-a-gon
raver	rav-er
epic	ep-ic
kilo-volt	kil-o-volt
tourni-quet	tour-ni-quet
freaky	freak-y
feldspar	feld-spar
in-ter-change-ably	in-ter-change-a-bly
layper-son	lay-per-son
in-signif-i-cance	in-sig-nif-i-cance
dumper	dump-er
pager	pag-er
cheeky	cheek-y
con-trast-ing	contrasting
paraglid-ing	par-a-glid-ing
muslin	mus-lin
ob-streper-ous	ob-strep-er-ous
unedit-ed	un-ed-it-ed
es-pousal	es-pous-al
glos-sary	glos-sa-ry
med-dling	meddling
para-mount-cy	par-a-mount-cy
de-odor-ant	de-o-dor-ant
scholas-ti-cism	scho-las-ti-cism
ver-i-fi-able	ver-i-fi-a-ble
wary	war-y
semi-fi-nal	sem-i-fi-nal
aplen-ty	a-plen-ty
pam-phle-teer	pam-phlet-eer
deserts	de-serts
con-sular	con-su-lar
con-trivance	con-triv-ance
clayey	clay-ey
dis-cov-ery	dis-cov-er-y
grenadier	gren-a-dier
rene-go-ti-ate	re-ne-go-ti-ate
riot	ri-ot
basilisk	bas-i-lisk
cog-nizance	cog-ni-zance
cowherd	cow-herd
elec-tive	e-lec-tive
in-hibitor	in-hib-i-tor
re-freshed	refreshed
handrail	hand-rail
de-sir-able	de-sir-a-ble
her-bi-cide	herb-i-cide
pharaoh	phar-aoh
baldy	bald-y
evac-uee	e-vac-u-ee
despot-ic	des-pot-ic
hotbed	hot-bed
ap-pre-cia-bly	ap-pre-ci-a-bly
phooey	phoo-ey
in-ge-nu-ity	in-ge-nu-i-ty
evanes-cent	ev-a-nes-cent
oculist	oc-u-list
taboo	ta-boo
union-ist	un-ion-ist
piebald	pie-bald
pre-sum-ably	pre-sum-a-bly
sinis-tral	sin-is-tral
kamikaze	ka-mi-ka-ze
away	a-way
vari-a-tion	var-i-a-tion
apron	a-pron
in-jury	in-ju-ry
firmware	firm-ware
mem-o-ra-bil-ia	mem-o-ra-bil-i-a
craven	cra-ven
burly	bur-ly
clien-tele	cli-en-tele
rar-efac-tion	rar-e-fac-tion
hexa-ne	hex-ane
teardrop	tear-drop
swindler	swin-dler
tacky	tack-y
elvish	elv-ish
polemic	po-lem-ic
stunt-ed	stunted
hoary	hoar-y
ta-pes-try	tap-es-try
uni-form	u-ni-form
cagey	cag-ey
count-able	count-a-ble
con-cussed	concussed
duchess	duch-ess
mono-mi-al	mo-no-mi-al
or-nithol-o-gy	or-ni-thol-o-gy
manes	ma-nes
platelet	plate-let
un-de-sir-able	un-de-sir-a-ble
im-memo-r-i-al	im-me-mo-ri-al
chore-o-g-ra-ph-er	cho-re-og-ra-pher
cau-tion-ary	cau-tion-ar-y
theoc-ra-cy	the-oc-ra-cy
poly-glot	pol-y-glot
specif-i-cal-ly	spe-cif-i-cal-ly
trumpery	trump-er-y
par-tial-i-ty	par-ti-al-i-ty
erased	e-rased
su-prema-cy	su-prem-a-cy
cham-pi-onship	cham-pi-on-ship
orate	o-rate
spindly	spin-dly
serendip-i-ty	ser-en-dip-i-ty
re-hearsal	re-hears-al
tapir	ta-pir
aquiline	aq-ui-line
playable	play-a-ble
translu-cent	trans-lu-cent
nurs-ery-man	nurs-er-y-man
op-er-a-tional	op-er-a-tion-al
hangar	hang-ar
re-align-ment	re-a-lign-ment
transat-lantic	trans-at-lan-tic
guilty	guilt-y
lion	li-on
perime-ter	pe-rim-e-ter
rein-sur-ance	re-in-sur-ance
tasty	tast-y
brasserie	bras-se-rie
bazaar	ba-zaar
bac-te-r-i-al	bac-te-ri-al
steeple-jack	stee-ple-jack
open-er	o-pen-er
mistyp-ings	mis-ty-pings
barom-e-ter	ba-rom-e-ter
taber-na-cle	tab-er-nac-le
un-prov-able	un-prov-a-ble
hawser	haw-ser
colan-der	col-an-der
les-bian	les-bi-an
so-bri-ety	so-bri-e-ty
in-ter-ci-ty	in-ter-cit-y
key-boardist	key-board-ist
triple	tri-ple
in-stan-ta-neous	in-stan-ta-ne-ous
un-abat-ed	un-a-bat-ed
poky	pok-y
stocky	stock-y
un-break-able	un-break-a-ble
tren-chant	trench-ant
whole-wheat	wholewheat
trapeze	tra-peze
apoc-a-lyp-tic	a-poc-a-lyp-tic
tachy-car-dia	tach-y-car-di-a
ethnog-ra-phy	eth-nog-ra-phy
ra-dius	ra-di-us
sauer-kraut	sau-er-kraut
epochal	ep-och-al
his-toric	his-tor-ic
beat-i-tude	be-at-i-tude
anony-mous-ly	a-non-y-mous-ly
cowslip	cow-slip
sergeant	ser-geant
apiece	a-piece
mag-ne-tos-phere	mag-ne-to-sphere
hal-ibut	hal-i-but
me-te-o-rol-o-gist	me-te-or-ol-o-gist
per-mafrost	per-ma-frost
blessed-ness	bless-ed-ness
de-pen-dent	de-pend-ent
overop-ti-mistic	o-ver-op-ti-mis-tic
bony	bon-y
golfer	golf-er
conur-ba-tion	con-ur-ba-tion
sunken	sunk-en
read-able	read-a-ble
limpet	lim-pet
car-roty	car-rot-y
gestalt	ge-stalt
pho-to-elec-tric	pho-to-e-lec-tric
apho-rism	aph-o-rism
melan-choly	mel-an-chol-y
sus-pend-ed	sus-pen-ded
con-sis-tent	con-sist-ent
depre-da-tion	dep-re-da-tion
chantry	chan-try
prebend	preb-end
shaky	shak-y
mas-sacre	mas-sa-cre
re-peater	re-peat-er
thruster	thrust-er
turquoise	tur-quoise
melod-ic	me-lod-ic
darter	dart-er
lov-able	lov-a-ble
laugh-able	laugh-a-ble
avarice	av-a-rice
com-plainant	com-plain-ant
flinch-ing	flin-ching
recipe	rec-i-pe
anom-aly	a-nom-a-ly
colon-nade	col-on-nade
retic-u-lum	re-tic-u-lum
bio-morph	bi-o-morph
sparkler	spar-kler
wrin-kled	wrinkled
sur-viv-abil-i-ty	sur-viv-a-bil-i-ty
ques-tion-able	ques-tion-a-ble
elec-tro-mag-net-ic	e-lec-tro-mag-net-ic
over-growth	o-ver-growth
growl-ing	growling
roofer	roof-er
botany	bot-a-ny
lig-and	li-gand
ma-tri-lin-eal	mat-ri-lin-e-al
aquifer	aq-ui-fer
reprise	re-prise
epilep-sy	ep-i-lep-sy
haystack	hay-stack
cir-cum-lo-cu-to-ry	cir-cum-loc-u-to-ry
im-moral	im-mor-al
emo-tion-al	e-mo-tion-al
cur-able	cur-a-ble
sui-ci-dal	su-i-cid-al
wom-ankind	wom-an-kind
co-conut	co-co-nut
ecol-o-gist	e-col-o-gist
apothe-cary	a-poth-e-car-y
sup-ple-men-tary	sup-ple-men-ta-ry
unit	u-nit
sub-sidiary	sub-sid-i-ar-y
igua-na	i-gua-na
chrysalis	chrys-a-lis
purga-tive	pur-ga-tive
epi-gram-mat-ic	ep-i-gram-mat-ic
over-see	o-ver-see
reim-ple-ment-ed	reimplemented
charis-ma	cha-ris-ma
con-sumerism	con-sum-er-ism
test-ing	testing
rein-car-nat-ed	reincarnated
re-bury	re-bur-y
minu-ti-ae	mi-nu-ti-ae
demigod	dem-i-god
chivvy	chiv-vy
every-where	eve-ry-where
glit-tery	glit-ter-y
nonethe-less	none-the-less
hori-zon	ho-ri-zon
mover	mov-er
handy	hand-y
iron-i-cal-ly	i-ron-i-cal-ly
change-able	change-a-ble
elic-it	e-lic-it
perquisite	per-qui-site
platy-pus	plat-y-pus
phle-boto-my	phle-bot-o-my
even-tu-al	e-ven-tu-al
in-con-sid-er-able	in-con-sid-er-a-ble
treat-able	treat-a-ble
con-queror	con-quer-or
brioche	bri-oche
verdi-gris	ver-di-gris
sun-flower	sun-flow-er
un-lucky	un-luck-y
mist-ime	mis-time
chara-banc	char-a-banc
up-heaval	up-heav-al
flow-ery	flow-er-y
the-atri-cal	the-at-ri-cal
vary	var-y
dogged-ly	dog-ged-ly
ap-pre-cia-ble	ap-pre-ci-a-ble
pullover	pull-o-ver
body-build-ing	bod-y-build-ing
over-play	o-ver-play
over-writ-ing	overwriting
signet	sig-net
over-pay	o-ver-pay
opin-ion	o-pin-ion
hazy	ha-zy
im-paction	im-pac-tion
blither-ing	blith-er-ing
han-dover	hand-o-ver
mono-chro-mat-ic	mon-o-chro-mat-ic
di-a-conal	di-ac-o-nal
uni-di-rec-tion-al	u-ni-di-rec-tion-al
fiat	fi-at
toma-to	to-ma-to
cataract	cat-a-ract
adapt	a-dapt
or-di-nary	or-di-nar-y
dra-con-ian	dra-co-ni-an
sol-diery	sol-dier-y
smoth-ered	smothered
moray	mo-ray
spher-oid	sphe-roid
bedrock	bed-rock
nougat	nou-gat
para-med-ical	par-a-med-i-cal
ex-pect-ed	expected
caviar	cav-i-ar
es-capist	es-cap-ist
dis-avow-al	dis-a-vow-al
in-ter-dis-ci-pli-nary	in-ter-dis-ci-pli-nar-y
uni-fy	u-ni-fy
car-cino-gen-e-sis	car-cin-o-gen-e-sis
par-alin-guis-tic	par-a-lin-guis-tic
arise	a-rise
car-bonyl	car-bon-yl
un-bo-som	un-bos-om
polon-aise	pol-o-naise
scorcher	scorch-er
elec-tri-cian	e-lec-tri-cian
glitzy	glitz-y
rudi-men-ta-ry	ru-di-men-ta-ry
lieu-tenant	lieu-ten-ant
in-vari-able	in-var-i-a-ble
en-joy-able	en-joy-a-ble
wafer	wa-fer
shandy	shan-dy
bawdy	bawd-y
wiry	wir-y
armistice	ar-mi-stice
spinal	spi-nal
melo-dra-mat-ic	mel-o-dra-mat-ic
retest	re-test
ema-ci-a-tion	e-ma-ci-a-tion
bio-m-e-try	bi-om-e-try
payable	pay-a-ble
garter	gar-ter
aper-ture	ap-er-ture
bo-hemi-an	bo-he-mi-an
coau-thor	co-au-thor
ori-en-tal	o-ri-en-tal
di-lata-tion	dil-a-ta-tion
gluti-nous	glu-ti-nous
in-fantry	in-fan-try
innkeep-er	inn-keep-er
camel	cam-el
elec-tro	e-lec-tro
evac-u-ate	e-vac-u-ate
un-ser-vice-able	un-ser-vice-a-ble
un-even-ly	un-e-ven-ly
pan-tomime	pan-to-mime
weasel	wea-sel
quartzite	quartz-ite
prefer-ably	pref-er-a-bly
foundry	found-ry
tara-masala-ta	ta-ra-ma-sa-la-ta
over-sup-ply	o-ver-sup-ply
naive	na-ive
tuna	tu-na
es-capade	es-ca-pade
se-quencer	se-quenc-er
aza-lea	a-zal-ea
un-rea-son-able	un-rea-son-a-ble
glac-i-er	gla-cier
leafy	leaf-y
bio-ta	bi-o-ta
mar-malade	mar-ma-lade
nether-most	neth-er-most
ego-ism	e-go-ism
unau-then-ti-cat-ed	un-au-then-ti-cat-ed
cheer-ing	cheering
boathouse	boat-house
re-vival-ism	re-viv-al-ism
nec-es-sary	nec-es-sar-y
carotid	ca-rot-id
as-besto-sis	as-bes-to-sis
milky	milk-y
ben-der	bend-er
sub-jec-tivism	sub-jec-tiv-ism
un-ob-serv-able	un-ob-serv-a-ble
over-take	o-ver-take
megabyte	meg-a-byte
eu-phemisti-cal-ly	eu-phe-mis-ti-cal-ly
quencher	quench-er
cat-alyt-ic	cat-a-lyt-ic
de-spon-den-cy	de-spond-en-cy
im-porter	im-port-er
fac-to-r-i-al	fac-to-ri-al
genome	ge-nome
echoic	e-cho-ic
damsel	dam-sel
chi-nois-erie	chi-noi-se-rie
far-away	far-a-way
util-i-tar-i-an	u-til-i-tar-i-an
diminu-tive	di-min-u-tive
ra-dio-ther-a-py	ra-di-o-ther-a-py
im-ma-te-r-i-al	im-ma-te-ri-al
sober	so-ber
les-bian-ism	les-bi-an-ism
taxi-der-mist	tax-i-der-mist
iso-met-ric	i-so-met-ric
rip-pling	rippling
biped	bi-ped
im-pri-matur	im-pri-ma-tur
viewfind-er	view-find-er
prof-itable	prof-it-a-ble
vana-di-um	va-na-di-um
tuxe-do	tux-e-do
unim-proved	un-im-proved
plumage	plum-age
un-ap-proach-able	un-ap-proach-a-ble
mar-i-onette	mar-i-on-ette
con-ceiv-ably	con-ceiv-a-bly
tele-pho-ny	te-leph-o-ny
madam	mad-am
clam-p-down	clamp-down
rhetoric	rhet-o-ric
man-i-festo	man-i-fes-to
colonic	co-lon-ic
or-tho-doxy	or-tho-dox-y
con-demned	condemned
op-ti-mistic	op-ti-mis-tic
di-choto-mous	di-chot-o-mous
tiling	til-ing
ashen	ash-en
atoll	at-oll
un-stop-pable	un-stop-pa-ble
pe-rusal	pe-rus-al
trea-sur-er	treas-ur-er
polyp	pol-yp
psy-chi-atric	psy-chi-at-ric
em-body	em-bod-y
lava-to-r-i-al	lav-a-to-ri-al
ec-topic	ec-top-ic
equable	eq-ua-ble
viva	vi-va
char-cu-terie	char-cu-te-rie
lachry-mal	lach-ry-mal
hayloft	hay-loft
poly-gon	pol-y-gon
com-plain-ing	complaining
pres-tidig-i-ta-tion	pres-ti-dig-i-ta-tion
xeno-phobe	xen-o-phobe
propul-sive	pro-pul-sive
nasty	nas-ty
unite	u-nite
pro-le-tari-at	pro-le-tar-i-at
bap-tismal	bap-tis-mal
shaman-ic	sha-man-ic
sa-fari	sa-fa-ri
io-dide	i-o-dide
collinear	col-lin-e-ar
dis-ori-en-ta-tion	dis-o-ri-en-ta-tion
comet	com-et
fiendish	fiend-ish
leghorn	leg-horn
cordage	cord-age
pro-tect-ed	protected
kaiser	kai-ser
twister	twist-er
uni-ver-sal-ist	u-ni-ver-sal-ist
for-tu-itous	for-tu-i-tous
ethos	e-thos
kitch-enette	kitch-en-ette
sur-viv-able	sur-viv-a-ble
min-istry	min-is-try
samu-rai	sam-u-rai
earplug	ear-plug
semi-con-scious	sem-i-con-scious
un-ap-pre-cia-tive	un-ap-pre-ci-a-tive
rooftop	roof-top
cor-re-spon-dent	cor-re-spond-ent
sacra-ment	sac-ra-ment
silken	silk-en
voodoo	voo-doo
reper-to-ry	rep-er-to-ry
wispy	wisp-y
sporty	sport-y
mushy	mush-y
de-spi-ca-ble	des-pi-ca-ble
canopy	can-o-py
his-t-a-mine	his-ta-mine
es-teemed	e-steemed
con-tender	con-tend-er
spillage	spill-age
tureen	tu-reen
kneecap	knee-cap
un-tidy	un-ti-dy
poli-ty	pol-i-ty
staphy-lo-coc-cus	staph-y-lo-coc-cus
debone	de-bone
ca-reerist	ca-reer-ist
con-traindi-ca-tion	con-tra-in-di-ca-tion
demise	de-mise
nobly	no-bly
thrilling	thrill-ing
gasi-fy	gas-i-fy
in-fante	in-fan-te
mini-cab	min-i-cab
video-tape	vid-e-o-tape
evis-cer-ate	e-vis-cer-ate
de-canter	de-cant-er
voyeurism	vo-yeur-ism
frizzy	friz-zy
util-i-tar-i-an-ism	u-til-i-tar-i-an-ism
awake	a-wake
bur-bling	burbling
re-for-esta-tion	re-for-est-a-tion
killjoy	kill-joy
util-i-ty	u-til-i-ty
trio	tri-o
velo-drome	ve-lo-drome
solem-ni-ty	so-lem-ni-ty
ten-able	ten-a-ble
sausage	sau-sage
crypt-analy-sis	crypt-a-nal-y-sis
pre-his-toric	pre-his-tor-ic
shaman	sha-man
ta-per-ing	ta-pe-ring
teenage	teen-age
busi-nesslike	busi-ness-like
radix	ra-dix
decile	dec-ile
equal	e-qual
plenum	ple-num
funky	funk-y
goody	good-y
revenant	rev-e-nant
liftoff	lift-off
face-tious	fa-ce-tious
tawny	taw-ny
triathlon	tri-ath-lon
rounder	round-er
mishap	mis-hap
usury	u-su-ry
lethar-gic	le-thar-gic
beaker	beak-er
op-eretta	op-er-et-ta
elo-cu-tion	el-o-cu-tion
in-ca-pable	in-ca-pa-ble
evac-u-a-tion	e-vac-u-a-tion
raisin	rai-sin
reshow	re-show
lap-idary	lap-i-dar-y
ridicu-lous-ly	ri-dic-u-lous-ly
re-tal-ia-to-ry	re-tal-i-a-to-ry
un-treat-able	un-treat-a-ble
hexa-gram	hex-a-gram
ref-er-ee-ing	re-fe-ree-ing
avail-abil-i-ty	a-vail-a-bil-i-ty
in-ter-lock-ing	in-ter-loc-king
perdi-tion	per-di-tion
freely	free-ly
clement	clem-ent
crofter	croft-er
emo-tive	e-mo-tive
crumbly	crum-bly
equiv-a-lent	e-quiv-a-lent
maudlin	maud-lin
melo-dra-ma	mel-o-dra-ma
un-en-durable	un-en-dur-a-ble
avid	av-id
ever-more	ev-er-more
unim-por-tance	un-im-por-tance
im-per-turbable	im-per-turb-a-ble
bene-dic-tion	ben-e-dic-tion
tiler	til-er
equidis-tant	e-qui-dis-tant
ap-proval	ap-prov-al
hit-table	hit-ta-ble
straight-away	straight-a-way
apolo-getic	a-pol-o-get-ic
es-cha-tol-ogy	es-cha-tol-o-gy
phys-io-ther-a-pist	phys-i-o-ther-a-pist
overindul-gence	o-ver-in-dul-gence
soli-taire	sol-i-taire
layabout	lay-a-bout
patchy	patch-y
un-car-ed	un-cared
zebu	ze-bu
con-tigu-ous	con-tig-u-ous
bib-lio-phile	bib-li-o-phile
wastrel	wast-rel
zither	zith-er
se-ca-teurs	sec-a-teurs
lithos-phere	lith-o-sphere
meow	me-ow
coma	co-ma
whiskey	whis-key
simil-i-tude	si-mil-i-tude
siren	si-ren
pira-cy	pi-ra-cy
ex-ult-ing	exulting
stinker	stink-er
techno-pho-bic	tech-no-pho-bic
de-scen-dant	de-scend-ant
sawyer	saw-yer
lyri-cist	lyr-i-cist
hexa-dec-i-mal	hex-a-dec-i-mal
un-at-tain-able	un-at-tain-a-ble
in-de-struc-tible	in-de-struct-i-ble
copi-lot	co-pi-lot
body-work	bod-y-work
fran-coph-o-ne	fran-co-phone
de-scend-ing	descending
pol-lard-ed	pollarded
no-tice-ably	no-tice-a-bly
open-hand-ed	o-pen-hand-ed
per-ineum	per-i-ne-um
ex-pec-tant-ly	ex-pect-ant-ly
litur-gy	lit-ur-gy
plat-inum	plat-i-num
broody	brood-y
daffy	daf-fy
drink-able	drink-a-ble
gaiter	gait-er
cos-set-ed	cosseted
ool-o-gy	o-ol-o-gy
cut-lery	cut-ler-y
pelvic	pel-vic
mil-i-tarist	mil-i-ta-rist
beanstalks	bean-stalks
mirac-u-lous-ly	mi-rac-u-lous-ly
de-nial	de-ni-al
founder	found-er
teacup	tea-cup
coro-na-tion	cor-o-na-tion
hege-mo-ny	he-gem-o-ny
lounger	loung-er
bo-som	bos-om
grimy	grim-y
crusty	crust-y
elan	e-lan
syn-ony-mous	syn-on-y-mous
pe-ri-od-ic-i-ty	pe-ri-o-dic-i-ty
col-le-gial	col-le-gi-al
scampi	scam-pi
detri-ment	det-ri-ment
thyris-tor	thy-ris-tor
joust-ing	jousting
wind-surfer	wind-surf-er
rib-aldry	rib-ald-ry
tele-work-ing	teleworking
dis-heart-en-ing	dis-hear-te-ning
legate	leg-ate
un-sellable	un-sell-a-ble
mater	ma-ter
batik	ba-tik
scoff-ing	scoffing
lozenge	loz-enge
aun-tie	aunt-ie
carafe	ca-rafe
undi-min-ished	un-di-min-ished
an-nu-ity	an-nu-i-ty
but-tressed	buttressed
serol-o-gy	se-rol-o-gy
oral	o-ral
glam-orous	glam-or-ous
turntable	turn-ta-ble
iso-mer	i-so-mer
taffe-ta	taf-fe-ta
un-clas-si-fi-able	un-clas-si-fi-a-ble
turmer-ic	tur-mer-ic
backer	back-er
gaga	ga-ga
sav-agery	sav-age-ry
spec-tropho-tome-ter	spec-tro-pho-tom-e-ter
agree-ment	a-gree-ment
hyp-nother-a-py	hyp-no-ther-a-py
te-dious	te-di-ous
dairy	dair-y
gen-uine-ly	gen-u-ine-ly
elec-troen-cephalo-gram	e-lec-tro-en-ceph-a-lo-gram
booty	boo-ty
sisal	si-sal
uniden-ti-fied	un-i-den-ti-fied
here-abouts	here-a-bouts
tardy	tar-dy
scrumhalf	scrum-half
steady-ing	steadying
delict	de-lict
essence	es-sence
bur-geon-ing	burgeoning
sibyl	sib-yl
re-assem-ble	re-as-sem-ble
galling	gall-ing
per-man-ganate	per-man-ga-nate
ne-go-tia-tor	ne-go-ti-a-tor
scapu-la	scap-u-la
enun-ci-ate	e-nun-ci-ate
strate-gist	strat-e-gist
prepo-si-tion-al	prep-o-si-tion-al
bullfinch	bull-finch
in-stan-ta-neous-ly	in-stan-ta-ne-ous-ly
homi-ly	hom-i-ly
scrupu-lous-ly	scru-pu-lous-ly
ir-re-versible	ir-re-vers-i-ble
posy	po-sy
con-struc-tivist	con-struc-tiv-ist
shifter	shift-er
rheuma-tism	rheu-ma-tism
tiny	ti-ny
en-chant-ed	enchanted
epi-dem-ic	ep-i-dem-ic
clumpy	clump-y
pas-toral	pas-to-ral
per-sis-tent-ly	per-sist-ent-ly
unashamed-ly	un-a-sham-ed-ly
stan-dard	stand-ard
ur-ticaria	ur-ti-car-i-a
medul-la	me-dul-la
carat	car-at
bacil-lus	ba-cil-lus
fora-men	fo-ra-men
he-li-cal	hel-i-cal
helper	help-er
rhetor-i-cal	rhe-tor-i-cal
moth-er-stobe	mo-ther-stobe
wardrobe	ward-robe
di-etet-ic	di-e-tet-ic
polyurethane	pol-y-u-re-thane
pro-pa-gan-da	prop-a-gan-da
over-pass	o-ver-pass
cyclic	cy-clic
dreamy	dream-y
over-crowd	o-ver-crowd
repli-ca-tion	rep-li-ca-tion
crevice	crev-ice
pronom-i-nal	pro-nom-i-nal
in-valid	in-va-lid
plunger	plung-er
baby-ish	ba-by-ish
waxy	wax-y
im-per-son-ator	im-per-son-a-tor
deco	dec-o
eco-log-i-cal	ec-o-log-i-cal
mist-imed	mis-timed
kook-abur-ra	kook-a-bur-ra
humbly	hum-bly
con-sul-tant	con-sult-ant
isother-mal	i-so-ther-mal
barter	bar-ter
cre-ative-ly	cre-a-tive-ly
smithereens	smith-er-eens
feath-erlight	feath-er-light
port-fo-lio	port-fo-li-o
padre	pa-dre
in-ter-locu-tor	in-ter-loc-u-tor
thau-maturge	thau-ma-turge
ot-toman	ot-to-man
timid	tim-id
nau-tilus	nau-ti-lus
in-vari-ably	in-var-i-a-bly
recharge	re-charge
som-brero	som-bre-ro
un-emo-tion-al	un-e-mo-tion-al
ranger	rang-er
mnemon-ic	mne-mon-ic
mayflower	may-flow-er
babysit	ba-by-sit
astig-ma-tism	a-stig-ma-tism
fetishis-tic	fet-ish-is-tic
mil-lenar-i-an-ism	mil-le-nar-i-an-ism
over-cook	o-ver-cook
sum-mery	sum-mer-y
ir-ra-tional-i-ty	ir-ra-tion-al-i-ty
reg-istry	reg-is-try
illiq-uid	il-liq-uid
elas-tic	e-las-tic
ledger	ledg-er
idio-syn-crat-ic	id-i-o-syn-crat-ic
emit	e-mit
charge-able	charge-a-ble
cun-nilin-gus	cun-ni-lin-gus
ar-rival	ar-ri-val
utopi-an	u-to-pi-an
ben-e-fi-cia-ry	ben-e-fi-ci-ar-y
chrono-graph	chron-o-graph
ap-proach-able	ap-proach-a-ble
racism	rac-ism
oblig-a-tion	ob-li-ga-tion
man-ager-ess	man-ag-er-ess
il-lim-itable	il-lim-it-a-ble
pi-ran-ha	pi-ra-nha
repli-ca-tor	rep-li-ca-tor
mis-nomer	mis-no-mer
heresy	her-e-sy
pre-fab-ri-cat-ed	prefabricated
com-mis-sari-at	com-mis-sar-i-at
ex-em-plary	ex-em-pla-ry
su-per-fluity	su-per-flu-i-ty
oven	ov-en
igloo	ig-loo
rock-ery	rock-er-y
chemise	che-mise
work-able	work-a-ble
equa-tor	e-qua-tor
in-creduli-ty	in-cre-du-li-ty
mono-gram	mon-o-gram
su-perla-tive	su-per-la-tive
valise	va-lise
beta	be-ta
en-er-getic	en-er-get-ic
ex-cep-tion-able	ex-cep-tion-a-ble
groupie	group-ie
leisurewear	lei-sure-wear
obe-di-ence	o-be-di-ence
poseur	po-seur
dosage	dos-age
side-re-al	si-de-re-al
omit	o-mit
there-abouts	there-a-bouts
sala-cious	sa-la-cious
stager	stag-er
mer-chantable	mer-chant-a-ble
nu-clear	nu-cle-ar
semi	sem-i
bean-ery	bean-er-y
pre-ventable	pre-vent-a-ble
na-iad	nai-ad
cal-care-ous	cal-car-e-ous
camisole	cam-i-sole
palati-nate	pa-lat-i-nate
tri-umphal-ism	tri-um-phal-ism
damask	dam-ask
link-able	link-a-ble
recheck	re-check
tangy	tang-y
lectern	lec-tern
resched-ule	re-sched-ule
foible	foi-ble
chi-canery	chi-can-er-y
sprayer	spray-er
hang-over	hang-o-ver
aris-to-crat-ic	a-ris-to-crat-ic
archer	arch-er
an-tivi-ral	an-ti-vi-ral
nosy	nos-y
emir	e-mir
per-cu-ta-neous	per-cu-ta-ne-ous
ethe-re-al	e-the-re-al
roadmap	road-map
deliri-ous	de-lir-i-ous
avun-cu-lar	a-vun-cu-lar
idler	i-dler
rub-bishy	rub-bish-y
domi-no	dom-i-no
gos-samer	gos-sa-mer
pes-simist	pes-si-mist
semi-con-duc-tor	sem-i-con-duc-tor
mighty	might-y
phy-loge-ny	phy-log-e-ny
bes-tiary	bes-ti-ar-y
labi-um	la-bi-um
ovate	o-vate
enor-mous-ly	e-nor-mous-ly
colos-sal	co-los-sal
poplar	pop-lar
chalky	chalk-y
re-lax-ation	re-lax-a-tion
un-drink-able	un-drink-a-ble
courage	cour-age
in-de-ter-minable	in-de-ter-mi-na-ble
painkiller	pain-kil-ler
edit	ed-it
pester	pes-ter
cur-ricu-lum	cur-ric-u-lum
cack-ling	cackling
reaper	reap-er
es-tu-ary	es-tu-ar-y
mi-croc-ode	mi-cro-code
im-muno-sup-pres-sive	im-mu-no-sup-pres-sive
lessen	less-en
un-achiev-able	un-a-chiev-a-ble
crater	cra-ter
rarely	rare-ly
medal	med-al
oily	oil-y
fold-ing	folding
ova-tion	o-va-tion
icon-ic	i-con-ic
abuse	a-buse
over-full	o-ver-full
dis-putable	dis-put-a-ble
anvil	an-vil
neg-ligee	neg-li-gee
per-fidy	per-fi-dy
amus-ing	a-mus-ing
schooner	schoon-er
polem-i-cal	po-lem-i-cal
se-lectee	se-lect-ee
wiring	wir-ing
springer	spring-er
elec-tri-cal	e-lec-tri-cal
rock-et-ing	rocketing
pael-la	pa-el-la
chimera	chi-me-ra
athe-ist	a-the-ist
modal-i-ty	mo-dal-i-ty
dri-ver	driv-er
equa-nim-i-ty	e-qua-nim-i-ty
doc-u-men-tary	doc-u-men-ta-ry
ogle	o-gle
bizarre	bi-zarre
dis-ap-proval	dis-ap-prov-al
het-ero-gene-ity	het-er-o-ge-ne-i-ty
emis-sion	e-mis-sion
cheater	cheat-er
necro-sis	ne-cro-sis
eigen-state	ei-gen-state
mega-volt	meg-a-volt
symp-to-matic	symp-to-mat-ic
polemi-cist	po-lem-i-cist
ca-su-al-ty	cas-u-al-ty
brawler	brawl-er
ge-ot-her-mal	ge-o-ther-mal
en-treaty	en-treat-y
un-com-fort-able	un-com-fort-a-ble
in-deco-rous	in-dec-o-rous
fly-away	fly-a-way
tren-chant-ly	trench-ant-ly
civic	civ-ic
myelin	my-e-lin
toady	toad-y
in-equity	in-eq-ui-ty
renter	rent-er
baobab	ba-o-bab
lusti-ly	lust-i-ly
med-ical	med-i-cal
hero-in	her-o-in
aorist	a-o-rist
tele-graph	tel-e-graph
tarsal	tar-sal
area	ar-e-a
bar-barous	bar-ba-rous
elec-tor	e-lec-tor
gramo-phone	gram-o-phone
un-e-lec-table	un-e-lect-a-ble
mata-dor	mat-a-dor
uned-i-fy-ing	un-ed-i-fy-ing
negate	ne-gate
uni-lat-er-al-ism	u-ni-lat-er-al-ism
asym-me-try	a-sym-me-try
vi-t-a-min	vi-ta-min
bi-car-bon-ate	bi-car-bo-nate
un-re-solv-able	un-re-solv-a-ble
sched-uler	sched-ul-er
apos-tolic	ap-os-tol-ic
bur-gundy	bur-gun-dy
loathing	loath-ing
over-act-ing	overacting
fes-ter-ing	festering
poly-crys-talline	pol-y-crys-tal-line
over-ture	o-ver-ture
stron-groom	strong-room
sided	sid-ed
un-palat-able	un-pal-at-a-ble
prophet-ess	proph-et-ess
evo-lute	ev-o-lute
as-tro-physics	as-tro-phys-ics
ri-ot-ing	ri-o-ting
nympho-ma-ni-ac	nym-pho-ma-ni-ac
deci-bel	dec-i-bel
non-con-for-mi-ty	non-con-form-i-ty
delu-sive	de-lu-sive
drainage	drain-age
pro-tec-torate	pro-tec-tor-ate
trencher	trench-er
respire	re-spire
keynote	key-note
rel-a-tivis-tic	rel-a-tiv-is-tic
vel-vety	vel-vet-y
ring-leader	ring-lead-er
geo-physics	ge-o-phys-ics
above	a-bove
bleary	blear-y
dilem-ma	di-lem-ma
patel-la	pa-tel-la
vac-uole	vac-u-ole
dizzi-ness	diz-zi-ness
cedar	ce-dar
chemist	chem-ist
drift-ing	drif-ting
reprint	re-print
qua-drat-ic	quad-rat-ic
ax-e-man	axe-man
touristy	tour-ist-y
idio-syn-crasy	id-i-o-syn-cra-sy
rearm	re-arm
papa	pa-pa
he-do-nism	he-don-ism
ternary	ter-na-ry
trans-former	trans-form-er
over-heat-ed	overheated
di-gester	di-gest-er
evolve	e-volve
hy-per-boloid	hy-per-bo-loid
jam-boree	jam-bo-ree
re-doubtable	re-doubt-a-ble
as-pirin	as-pi-rin
rub-bery	rub-ber-y
ni-hilist	ni-hil-ist
re-gret-table	re-gret-ta-ble
raven-ing	rav-en-ing
evil-do-er	e-vil-do-er
resin	res-in
al-ready	al-read-y
readapt	re-a-dapt
snaky	snak-y
raider	raid-er
malev-o-lent	ma-lev-o-lent
head-mistress	head-mis-tress
in-com-press-ible	in-com-press-i-ble
in-signia	in-sig-ni-a
vino	vi-no
biop-sy	bi-op-sy
res-olute	res-o-lute
teleg-ra-phy	te-leg-ra-phy
dis-con-ti-nu-ity	dis-con-ti-nu-i-ty
leg-isla-tive	leg-is-la-tive
bark-ing	barking
can-tilever	can-ti-le-ver
prepara-to-ry	pre-par-a-to-ry
un-awak-ened	un-a-wak-ened
eat-able	eat-a-ble
ra-di-ograph	ra-di-o-graph
gamut	gam-ut
in-vari-ant	in-var-i-ant
peanut	pea-nut
lech-ery	lech-er-y
scam-per	scamp-er
forcibly	for-ci-bly
syn-chronic-i-ty	syn-chro-nic-i-ty
wether	weth-er
ide-al	i-de-al
as-para-gus	as-par-a-gus
canal	ca-nal
bac-teri-um	bac-te-ri-um
mi-crosec-ond	mi-cro-sec-ond
grid-iron	grid-i-ron
wily	wil-y
whoso-ev-er	who-so-ev-er
opi-um	o-pi-um
con-san-guineous	con-san-guin-e-ous
wa-terbed	wa-ter-bed
ra-tio-nal-ly	ra-tion-al-ly
harshen	harsh-en
ho-n-our	ho-nour
poly-chro-mat-ic	pol-y-chro-mat-ic
dahlia	dahl-ia
aton-al	a-ton-al
plaza	pla-za
re-versed	reversed
in-fir-mary	in-fir-ma-ry
cheesy	chees-y
aphro-disi-ac	aph-ro-dis-i-ac
het-ero-dox	het-er-o-dox
cryo-genic	cry-o-gen-ic
con-nivance	con-niv-ance
cherub	cher-ub
cervix	cer-vix
manda-to-ry	man-da-to-ry
masochist	mas-och-ist
zaire	za-ire
midriff	mid-riff
uniden-ti-fi-able	un-i-den-ti-fi-a-ble
event-ful	e-vent-ful
unis-sued	un-is-sued
er-bium	er-bi-um
rosette	ro-sette
bene-fac-tor	ben-e-fac-tor
hooli-gan-ism	hoo-li-gan-ism
over-rate	o-ver-rate
una-nim-i-ty	u-na-nim-i-ty
atone-ment	a-tone-ment
gyro	gy-ro
mil-i-tary	mil-i-tar-y
mul-ti-level	mul-ti-lev-el
schoolmistress	school-mis-tress
agency	a-gen-cy
imag-i-na-tion	im-ag-i-na-tion
dyer	dy-er
leisure	lei-sure
papule	pap-ule
catal-y-sis	ca-tal-y-sis
mati-nee	mat-i-nee
coolant	cool-ant
hul-la-baloo	hul-la-ba-loo
emo-tion	e-mo-tion
polo	po-lo
elu-ci-date	e-lu-ci-date
brutish	brut-ish
spanker	spank-er
in-tractable	in-trac-ta-ble
ego-tis-ti-cal	e-go-tis-ti-cal
dul-cimer	dul-ci-mer
rheuma-tol-ogy	rheu-ma-tol-o-gy
petro-chem-i-cal	pet-ro-chem-i-cal
di-elec-tric	di-e-lec-tric
si-nu-soid	si-nus-oid
meta-phys-i-cal	met-a-phys-i-cal
over-heat	o-ver-heat
re-tain-ing	retaining
preva-lent	prev-a-lent
sus-tain-able	sus-tain-a-ble
ranker	rank-er
over-done	o-ver-done
trav-el-ogue	trav-e-logue
sorghum	sor-ghum
ass-es	as-ses
ex-citable	ex-cit-a-ble
lethal-i-ty	le-thal-i-ty
topol-o-gy	to-pol-o-gy
cor-nu-copia	cor-nu-co-pi-a
sub-atom-ic	sub-a-tom-ic
ego-cen-tric	e-go-cen-tric
hered-i-ty	he-red-i-ty
fal-ter-ing	fal-te-ring
greensward	green-sward
fermi-on	fer-mi-on
look-ing	looking
neu-ro-science	neu-ro-sci-ence
avid-i-ty	a-vid-i-ty
pectin	pec-tin
evoke	e-voke
chorea	cho-re-a
fifty	fif-ty
tra-chea	tra-che-a
vil-lager	vil-lag-er
sub-cu-ta-neous	sub-cu-ta-ne-ous
cu-ra-to-r-i-al	cu-ra-to-ri-al
in-evitable	in-ev-i-ta-ble
poros-i-ty	po-ros-i-ty
ir-ra-tional-ly	ir-ra-tion-al-ly
over-long	o-ver-long
para-nor-mal	par-a-nor-mal
ela-tion	e-la-tion
per-centile	per-cen-tile
along	a-long
un-mis-tak-able	un-mis-tak-a-ble
rec-i-p-ro-cate	re-cip-ro-cate
dis-ori-ent	dis-o-ri-ent
hia-tus	hi-a-tus
seal-ing	sealing
florist	flo-rist
brassiere	bras-siere
farad	far-ad
unlov-ing	un-lov-ing
decagon	dec-a-gon
provoca-tive-ly	pro-voc-a-tive-ly
melanin	mel-a-nin
pant-i-ng	pant-ing
mea-sure-less	meas-ure-less
con-sor-tium	con-sor-ti-um
yippee	yip-pee
spir-i-tu-al-ly	spir-it-u-al-ly
dili-gence	dil-i-gence
rock-ing	rocking
car-bona-ceous	car-bo-na-ceous
psy-choso-cial	psy-cho-so-cial
pass-ably	pass-a-bly
he-li-copter	hel-i-cop-ter
dumb-found-ed	dumbfounded
ion	i-on
poltroon	pol-troon
metal-lic	me-tal-lic
teapot	tea-pot
sys-temic	sys-tem-ic
fault-ing	faulting
den-tistry	den-tis-try
grunter	grunt-er
tremor	trem-or
groovy	groov-y
un-pre-dictably	un-pre-dict-a-bly
turtle-neck	tur-tle-neck
sepul-chral	se-pul-chral
makeshift	make-shift
poly-atom-ic	pol-y-a-tom-ic
rene-go-ti-a-tion	re-ne-go-ti-a-tion
de-sir-abil-i-ty	de-sir-a-bil-i-ty
un-avoid-ably	un-a-void-a-bly
rec-om-mend-ed	recommended
widescreen	wide-screen
vi-able	vi-a-ble
archivist	ar-chi-vist
sleepi-ness	sleep-i-ness
tepid	tep-id
talkie	talk-ie
naked	na-ked
pread-o-les-cent	pre-ad-o-les-cent
condi-ment	con-di-ment
foghorn	fog-horn
un-aligned	un-a-ligned
chim-panzee	chim-pan-zee
pho-to-genic	pho-to-gen-ic
codex	co-dex
calo-rie	cal-o-rie
elec-tric-i-ty	e-lec-tric-i-ty
respite	res-pite
boater	boat-er
sero-tonin	ser-o-to-nin
re-li-ably	re-li-a-bly
stopover	stop-o-ver
ro-mancer	ro-manc-er
bloody	blood-y
stealth-ily	stealth-i-ly
de-pend-abil-i-ty	de-pend-a-bil-i-ty
py-rotech-nic	py-ro-tech-nic
ban-dage	band-age
fundrais-er	fund-rais-er
thinker	think-er
asi-nine	as-i-nine
eatery	eat-er-y
neur-al	neu-ral
ex-ten-der	ex-tend-er
poly-the-ism	pol-y-the-ism
tox-i-c-i-ty	tox-ic-i-ty
gooey	goo-ey
lava-to-ry	lav-a-to-ry
breast-feed	breastfeed
fla-gel-late	flag-el-late
ephemer-al	e-phem-er-al
mufti	muf-ti
event	e-vent
mis-shapen	mis-shap-en
aviary	a-vi-ar-y
pupil	pu-pil
cycli-cal	cy-cli-cal
monox-ide	mon-ox-ide
whistler	whis-tler
astrad-dle	a-strad-dle
halite	hal-ite
haz-ardous	haz-ard-ous
may-oral	may-or-al
gua-camole	gua-ca-mo-le
warmer	warm-er
re-deemer	re-deem-er
operand	op-er-and
read-just-ment	re-ad-just-ment
res-onate	res-o-nate
em-bo-som	em-bos-om
school-teacher	school-teach-er
furtive-ly	fur-tive-ly
physic	phys-ic
bil-iary	bil-i-ar-y
om-ni-science	om-nis-cience
im-pon-der-able	im-pon-der-a-ble
over-write	o-ver-write
se-nior	sen-ior
gra-tu-itous-ly	gra-tu-i-tous-ly
neme-sis	nem-e-sis
lantern	lan-tern
bub-blegum	bub-ble-gum
cred-it-wor-thy	cred-it-worth-y
retroac-tive-ly	ret-ro-ac-tive-ly
humerus	hu-mer-us
moral-ly	mor-al-ly
quadru-pole	quad-ru-pole
crisper	crisp-er
soli-tary	sol-i-tar-y
ex-ploita-tion	ex-ploi-ta-tion
an-thro-pogenic	an-thro-po-gen-ic
palimpsest	pal-imp-sest
ep-silon	ep-si-lon
retic-u-la-tion	re-tic-u-la-tion
colour	co-lour
azure	az-ure
skir-mish-ing	skirmishing
au-thoress	au-thor-ess
reci-procity	rec-i-proc-i-ty
sacro-sanct	sac-ro-sanct
ouster	oust-er
kinder-garten	kin-der-gar-ten
thug-gery	thug-ger-y
spacey	spac-ey
buffer	buff-er
axle	ax-le
arthro-pod	ar-thro-pod
eva-sive	e-va-sive
com-press-ibil-i-ty	com-pres-si-bil-i-ty
ir-re-versibly	ir-re-vers-i-bly
dis-gust-ed	disgusted
mag-ne-tome-ter	mag-ne-tom-e-ter
sinew	sin-ew
de-pri-va-tion	dep-ri-va-tion
de-for-mi-ty	de-form-i-ty
gam-bling	gam-bling
mono-cul-ture	mon-o-cul-ture
limo	lim-o
domi-cile	dom-i-cile
per-ish-able	per-ish-a-ble
si-nu-soidal	si-nus-oi-dal
celandine	cel-an-dine
sycamore	syc-a-more
binoc-u-lars	bin-oc-u-lars
aor-tic	a-or-tic
frontal	fron-tal
piti-ful-ly	pit-i-ful-ly
es-capism	es-cap-ism
obey	o-bey
plumy	plum-y
over-pro-duc-tion	o-ver-pro-duc-tion
bubon-ic	bu-bon-ic
tropopause	trop-o-pause
sim-u-lacrum	sim-u-la-crum
monas-tic	mo-nas-tic
re-pairable	re-pair-a-ble
vestibule	ves-ti-bule
causal-ly	caus-al-ly
rea-son-ably	rea-son-a-bly
wear-able	wear-a-ble
wastage	wast-age
grotesque	gro-tesque
transcon-ti-nen-tal	trans-con-ti-nen-tal
cys-teine	cys-te-ine
weightlift-ing	weight-lift-ing
con-tention	con-ten-tion
por-phyrit-ic	por-phy-rit-ic
adult	a-dult
gateau	ga-teau
katy-did	ka-ty-did
where-abouts	where-a-bouts
bola	bo-la
tu-atara	tu-a-ta-ra
knowl-edge-able	knowl-edge-a-ble
lithi-um	lith-i-um
so-cioe-co-nom-ic	so-ci-o-ec-o-nom-ic
siphon	si-phon
reify	re-i-fy
health-ily	health-i-ly
dactylic	dac-tyl-ic
sauna	sau-na
ther-mo-elec-tric	ther-mo-e-lec-tric
there-after	there-af-ter
posthu-mous	post-hu-mous
lega-cy	leg-a-cy
whiten	whit-en
dis-parate	dis-pa-rate
lam-plit	lamp-lit
clema-tis	clem-a-tis
uvu-la	u-vu-la
floater	float-er
record-ing	re-cord-ing
blush-ing	blushing
basil	bas-il
exe-unt	ex-e-unt
project	proj-ect
skew-ered	skewered
bronchial	bron-chi-al
read-mis-sion	re-ad-mis-sion
undis-closed	un-dis-closed
li-bidi-nous	li-bid-i-nous
wash-er-woman	wash-er-wom-an
oakum	oa-kum
reac-qui-si-tion	re-ac-qui-si-tion
ma-chin-ery	ma-chin-er-y
ep-ithe-lial	ep-i-the-li-al
ap-plic-a-ble	ap-pli-ca-ble
pago-da	pa-go-da
very	ver-y
howler	howl-er
repa-tri-ate	re-pa-tri-ate
speechi-fy-ing	speechifying
cre-ator	cre-a-tor
cleaver	cleav-er
ele-phant	el-e-phant
who-dunit	who-dun-it
peas-antry	peas-ant-ry
habi-ta-tion	hab-i-ta-tion
servi-tude	ser-vi-tude
navel	na-vel
paral-y-sis	pa-ral-y-sis
xeno-pho-bic	xen-o-pho-bic
pen-tathlon	pen-tath-lon
op-por-tunism	op-por-tun-ism
as-sured-ly	as-sur-ed-ly
laser	la-ser
archival	ar-chi-val
de-ni-able	de-ni-a-ble
dal-liance	dal-li-ance
mildewy	mil-dew-y
hon-orif-ic	hon-or-if-ic
ar-bi-trari-ness	ar-bi-trar-i-ness
re-gret-tably	re-gret-ta-bly
ex-trater-res-tri-al	ex-tra-ter-res-tri-al
ridicu-lous-ness	ri-dic-u-lous-ness
galaxy	gal-ax-y
flus-tered	flustered
mega-lith	meg-a-lith
deben-ture	de-ben-ture
sadis-tic	sa-dis-tic
atro-cious	a-tro-cious
hereto-fore	here-to-fore
foundling	found-ling
feb-ru-ary	feb-ru-ar-y
bal-moral	bal-mor-al
rheumat-ic	rheu-mat-ic
in-hala-tion	in-ha-la-tion
flanker	flank-er
redac-tion	re-dac-tion
eleventh	e-lev-enth
epis-to-lary	e-pis-to-lar-y
py-rotech-nics	py-ro-tech-nics
reac-cept	re-ac-cept
de-spon-dent	de-spond-ent
spir-i-tu-al-ism	spir-it-u-al-ism
panz-er	pan-zer
bio-met-ric	bi-o-met-ric
ele-phan-tine	el-e-phan-tine
ex-hibitor	ex-hib-i-tor
orig-i-nal	o-rig-i-nal
apos-tate	a-pos-tate
paean	pae-an
syco-phancy	syc-o-phan-cy
my-opia	my-o-pi-a
hearthrug	hearth-rug
swishy	swish-y
alone	a-lone
sou-venir	sou-ve-nir
ban-knote	bank-note
glycine	gly-cine
er-gonom-ic	er-go-nom-ic
pachy-derm	pach-y-derm
tutu	tu-tu
yel-lowed	yellowed
colony	col-o-ny
dele-tion	de-le-tion
scal-able	scal-a-ble
un-ut-ter-able	un-ut-ter-a-ble
in-sou-ciant	in-sou-ci-ant
visa	vi-sa
rar-efied	rar-e-fied
hearsay	hear-say
de-tainee	de-tain-ee
pig-gery	pig-ger-y
cu-bism	cub-ism
mit-i-gat-ing	mitigating
lin-ear-ly	lin-e-ar-ly
unre-deemed	un-re-deemed
re-tini-tis	ret-i-ni-tis
durable	du-ra-ble
pulpy	pulp-y
forte	for-te
cool-ing	cooling
para-medic	par-a-med-ic
un-elect-ed	un-e-lect-ed
lan-guorous	lan-guor-ous
va-sec-to-my	vas-ec-to-my
pho-to-copy	pho-to-cop-y
em-bed-d-a-ble	em-bed-da-ble
viceroy	vice-roy
hostel-ry	hos-tel-ry
di-alec-tic	di-a-lec-tic
copy-ist	cop-y-ist
lemon-ade	lem-on-ade
ex-i-gency	ex-i-gen-cy
egal-i-tar-i-an	e-gal-i-tar-i-an
mul-ti-proces-sor	mul-ti-proc-es-sor
pre-cau-tion-ary	pre-cau-tion-ar-y
calorime-ter	cal-o-rim-e-ter
busi-ly	bus-i-ly
vari-able	var-i-a-ble
ty-pog-ra-phers	ty-po-gra-phers
psalmist	psalm-ist
dis-mem-bered	dismembered
kedgeree	ked-ger-ee
chili	chil-i
cast-away	cast-a-way
viaduct	vi-a-duct
geo-chem-istry	ge-o-chem-is-try
haughty	haugh-ty
await	a-wait
para-noid	par-a-noid
ejec-tion	e-jec-tion
re-pen-tant	re-pent-ant
blowfly	blow-fly
re-peat-able	re-peat-a-ble
warpath	war-path
uni-ver-sal-ly	u-ni-ver-sal-ly
re-sis-tant	re-sist-ant
tarot	ta-rot
power-boat	pow-er-boat
expo	ex-po
la-ryn-geal	la-ryn-ge-al
duster	dust-er
asy-lum	a-sy-lum
cloa-ca	clo-a-ca
elon-gate	e-lon-gate
coxswain	cox-swain
tint-ed	tinted
as-tro-physi-cist	as-tro-phys-i-cist
ra-dio	ra-di-o
sounder	sound-er
perky	perk-y
con-ge-nial	con-gen-ial
seag-ull	sea-gull
in-ho-mo-ge-neous	in-ho-mo-ge-ne-ous
friv-o-li-ty	fri-vol-i-ty
cater-er	ca-ter-er
surly	sur-ly
rev-erend	rev-er-end
petrol-o-gy	pe-trol-o-gy
ar-senic	ar-se-nic
soloist	so-lo-ist
scrolling	scroll-ing
mo-lasses	mo-las-ses
ego	e-go
geyser	gey-ser
pan-theon	pan-the-on
do-lerite	dol-er-ite
mere-tri-cious	mer-e-tri-cious
con-sulate	con-su-late
un-us-able	un-us-a-ble
naive-ly	na-ive-ly
equiv-o-ca-tion	e-quiv-o-ca-tion
aquat-ic	a-quat-ic
iden-ti-fi-ca-tion	i-den-ti-fi-ca-tion
unim-peach-able	un-im-peach-a-ble
cho-ris-ter	chor-is-ter
aver-sive	a-ver-sive
lusty	lust-y
meta-bol-ic	met-a-bol-ic
op-por-tunist	op-por-tun-ist
holo-caust	hol-o-caust
rein-car-na-tion	re-in-car-na-tion
in-ter-op-er-abil-i-ty	in-ter-op-er-a-bil-i-ty
mol-e-c-u-lar	mo-lec-u-lar
hor-mon-al	hor-mo-nal
rear-ma-ment	re-ar-ma-ment
jour-nalese	jour-nal-ese
un-de-cid-able	un-de-cid-a-ble
vol-un-tary	vol-un-tar-y
di-a-betes	di-a-be-tes
zeta	ze-ta
april	a-pril
spinet	spin-et
equi-lib-ri-um	e-qui-lib-ri-um
enu-mer-a-tor	e-nu-mer-a-tor
homage	hom-age
philol-o-gy	phi-lol-o-gy
biofeed-back	bi-o-feed-back
hedgerow	hedge-row
moi-ety	moi-e-ty
diet	di-et
murky	murk-y
provider	pro-vid-er
pathfind-er	path-find-er
fo-liage	fo-li-age
macro-scop-ic	mac-ro-scop-ic
un-al-ter-able	un-al-ter-a-ble
con-tes-tant	con-test-ant
body	bod-y
ici-cle	i-ci-cle
electro-mechan-i-cal	e-lec-tro-me-chan-i-cal
crafty	craft-y
Words with errors: 1842
Words with incorrect number of syllables: 1732
Total evluated: 6500
Perfect accuracy: 0.72
Number of syllables accuracy: 0.73
Average Levenshtein Distance(across incorrect words): 1.19
