Attempt	Real
mil-i-tarist	mil-i-ta-rist
doorstep	door-step
prepo-si-tion	prep-o-si-tion
nomen-cla-ture	no-men-cla-ture
tabloid	tab-loid
unin-sur-able	un-in-sur-a-ble
re-process	re-proc-ess
scarci-ty	scar-ci-ty
bal-loon-ist	balloonist
inan-i-mate	in-an-i-mate
de-f-i-n-i-tion-al	def-i-ni-tion-al
awake	a-wake
hearti-ly	heart-i-ly
semi-fi-nal-ist	sem-i-fi-nal-ist
riot	ri-ot
melan-cho-lia	mel-an-cho-li-a
auto	au-to
lusti-ly	lust-i-ly
ob-scu-ran-tism	ob-scu-rant-ism
epis-co-pal	e-pis-co-pal
rip-pling	rippling
eddy	ed-dy
podi-um	po-di-um
elec-tro-mag-net	e-lec-tro-mag-net
enor-mous	e-nor-mous
no-tice-able	no-tice-a-ble
silo	si-lo
over-lie	o-ver-lie
racon-teur	rac-on-teur
con-ducive	con-du-cive
crazy	cra-zy
nu-clear	nu-cle-ar
residue	res-i-due
basal	ba-sal
aorist	a-o-rist
founder	found-er
tomboy	tom-boy
marcher	march-er
poly-the-is-tic	pol-y-the-is-tic
cav-ernous	cav-ern-ous
plat-inum	plat-i-num
over-sexed	o-ver-sexed
triplex	tri-plex
cam-era	cam-er-a
dis-abled	dis-a-bled
idler	i-dler
poly-tech-nic	pol-y-tech-nic
here-inafter	here-in-af-ter
sleazy	slea-zy
cere-bel-lum	cer-e-bel-lum
elec-tri-cal	e-lec-tri-cal
tri-umvi-rate	tri-um-vi-rate
breather	breath-er
droopy	droop-y
pedan-tic	pe-dan-tic
corvette	cor-vette
anoint	a-noint
sax-ony	sax-o-ny
molyb-de-num	mo-lyb-de-num
un-invit-ing	un-in-vit-ing
pirou-ette	pir-ou-ette
unlov-ing	un-lov-ing
aban-doned	a-ban-doned
su-per-cil-ious	su-per-cil-i-ous
op-ti-misti-cal-ly	op-ti-mis-ti-cal-ly
ma-hogany	ma-hog-a-ny
lassie	las-sie
in-dige-nous	in-dig-e-nous
friv-o-li-ty	fri-vol-i-ty
na-iad	nai-ad
icy	i-cy
tri-umphal-ism	tri-um-phal-ism
su-prema-cist	su-prem-a-cist
every-one	eve-ry-one
sor-cery	sor-cer-y
isotrop-ic	i-so-trop-ic
kosher	ko-sher
oblige	o-blige
dis-avow-al	dis-a-vow-al
tonal-i-ty	to-nal-i-ty
ver-i-fi-able	ver-i-fi-a-ble
trencher	trench-er
cen-tripetal	cen-trip-e-tal
inkling	ink-ling
gad-get	gadg-et
loafer	loaf-er
en-chant-i-ng	en-chant-ing
eti-quette	et-i-quette
cos-set-ed	cosseted
deism	de-ism
chancery	chan-cer-y
kinder-garten	kin-der-gar-ten
en-hancer	en-hanc-er
lancer	lanc-er
no-tice-ably	no-tice-a-bly
pun-ish-able	pun-ish-a-ble
baili-wick	bail-i-wick
prostaglandin	pros-ta-glan-din
un-know-able	un-know-a-ble
menis-cus	me-nis-cus
un-af-ford-able	un-af-ford-a-ble
colo-nial-ist	co-lo-ni-al-ist
elic-it	e-lic-it
lira	li-ra
ex-ult-ing	exulting
im-pro-vi-sa-tion-al	im-prov-i-sa-tion-al
tick-et-ed	ticketed
ji-u-jit-su	jiu-jit-su
drainage	drain-age
tyran-ny	tyr-an-ny
get-away	get-a-way
fruity	fruit-y
dis-penser	dis-pens-er
pekan	pek-an
vir-ginal	vir-gin-al
frilli-er	fril-li-er
edict	e-dict
pur-suant	pur-su-ant
agent	a-gent
apish	ap-ish
in-former	in-form-er
kilo-watt	kil-o-watt
po-lice-woman	po-lice-wom-an
de-posi-tary	de-pos-i-tar-y
leak-ing	leaking
capy-bara	cap-y-ba-ra
sided	sid-ed
bel-liger-ent	bel-lig-er-ent
retic-u-lum	re-tic-u-lum
gen-eros-i-ty	gen-er-os-i-ty
babysit-ting	babysitting
meta-mor-phosed	metamorphosed
mim-ic-k-er	mim-ick-er
noisy	nois-y
calami-ty	ca-lam-i-ty
ho-minid	hom-i-nid
leg-isla-tive	leg-is-la-tive
un-com-fort-able	un-com-fort-a-ble
pri-apic	pri-ap-ic
foothill	foot-hill
avowed	a-vowed
bassist	bass-ist
ple-beian	ple-be-ian
cleaver	cleav-er
ran-corous	ran-cor-ous
aban-don-ment	a-ban-don-ment
throw-away	throw-a-way
oboe	o-boe
fig-u-ra-tive	fig-ur-a-tive
pronom-i-nal	pro-nom-i-nal
tsuna-mi	tsu-na-mi
wear-able	wear-a-ble
in-haler	in-hal-er
eval-u-a-tor	e-val-u-a-tor
aver-sion	a-ver-sion
cow-ardice	cow-ard-ice
monies	mon-ies
med-dling	meddling
re-ceiv-able	re-ceiv-a-ble
enor-mi-ty	e-nor-mi-ty
over-dra-mat-ic	o-ver-dra-mat-ic
slant-i-ng	slant-ing
blankly	blank-ly
uri-nary	u-ri-nar-y
dis-ori-ent	dis-o-ri-ent
mid--	mid-
sarong	sa-rong
in-sou-ciance	in-sou-ci-ance
as-sailant	as-sail-ant
dis-parag-ing	dis-par-ag-ing
dy-namo	dy-na-mo
sonor-i-ty	so-nor-i-ty
ocean-ic	o-ce-an-ic
im-pass-able	im-pass-a-ble
reawak-en	re-a-wak-en
anti-gen	an-ti-gen
ozone	o-zone
ra-bid	rab-id
con-strict-ed	constricted
su-per-fi-cial-i-ty	su-per-fi-ci-al-i-ty
ur-ticaria	ur-ti-car-i-a
screwy	screw-y
jerky	jerk-y
reap-point	re-ap-point
equa-tion	e-qua-tion
tachy-on	tach-y-on
con-tem-po-rary	con-tem-po-rar-y
miser-ly	mi-ser-ly
be-wil-dered	bewildered
in-es-timable	in-es-ti-ma-ble
can-dlelit	can-dle-lit
un-ortho-doxy	un-or-tho-dox-y
bol-stered	bolstered
orgy	or-gy
un-ten-able	un-ten-a-ble
rhetoric	rhet-o-ric
rent-ed	rented
evan-ge-list	e-van-ge-list
scan-dalous	scan-dal-ous
docile	doc-ile
omi-nous-ly	om-i-nous-ly
bristling	bris-tling
awry	a-wry
an-tecedent	an-te-ced-ent
lazuli	laz-u-li
tele-scop-ic	tel-e-scop-ic
ora-tion	o-ra-tion
ovate	o-vate
cig-ar	ci-gar
cater-er	ca-ter-er
fever	fe-ver
morsel	mor-sel
ex-pan-sion-ary	ex-pan-sion-ar-y
pre-fab-ri-cat-ed	prefabricated
pup-peteer	pup-pet-eer
emo-tive	e-mo-tive
episod-ic	ep-i-sod-ic
temptress	tempt-ress
in-signif-i-cance	in-sig-nif-i-cance
paschal	pas-chal
rewrite	re-write
cheater	cheat-er
backchat	back-chat
surly	sur-ly
undiplo-mat-ic	un-dip-lo-mat-ic
par-si-mo-nious	par-si-mo-ni-ous
phle-boto-my	phle-bot-o-my
re-alpoli-tik	re-al-po-li-tik
apro-pos	ap-ro-pos
poly-eth-yl-ene	pol-y-eth-yl-ene
trireme	tri-reme
pa-ra-me-ter	pa-ram-e-ter
navel	na-vel
laud-ed	lauded
panache	pa-nache
as-cen-der	as-cend-er
pes-simism	pes-si-mism
man-dolin	man-do-lin
busi-nesslike	busi-ness-like
springy	spring-y
tapi-o-ca	tap-i-o-ca
volup-tuous	vo-lup-tu-ous
nymp-holep-sy	nym-pho-lep-sy
un-pre-dictabil-i-ty	un-pre-dict-a-bil-i-ty
ra-dionu-clide	ra-di-o-nu-clide
record-ing	re-cord-ing
tu-to-r-i-al	tu-to-ri-al
leisured	lei-sured
umpteenth	ump-teenth
chili	chil-i
dis-ap-proval	dis-ap-prov-al
un-apolo-getic	un-a-pol-o-get-ic
ge-neal-o-gy	ge-ne-al-o-gy
scriptwriter	script-writ-er
ob-lig-ate	ob-li-gate
rur-al	ru-ral
le-nient	le-ni-ent
hotspot	hot-spot
bitmap	bit-map
un-aware	un-a-ware
in-deli-ble	in-del-i-ble
in-salu-bri-ous	in-sa-lu-bri-ous
liquor-ish	liq-uor-ish
desul-to-ry	des-ul-to-ry
chan-cellery	chan-cel-ler-y
skele-tal	skel-e-tal
ar-madil-lo	ar-ma-dil-lo
fer-al	fe-ral
pseudo-pod	pseu-do-pod
un-hy-gien-ic	un-hy-gi-en-ic
preschool	pre-school
catalep-sy	cat-a-lep-sy
re-vival	re-viv-al
mega-lith	meg-a-lith
strate-gic	stra-te-gic
over-crowd-ed	o-ver-crow-ded
in-tra-venous	in-tra-ve-nous
gateau	ga-teau
ephemeris	e-phem-er-is
palm-istry	palm-is-try
in-de-pen-dence	in-de-pend-ence
bian-nu-al	bi-an-nu-al
satin	sat-in
in-vari-ably	in-var-i-a-bly
denizen	den-i-zen
lacteal	lac-te-al
footwear	foot-wear
over-sup-ply	o-ver-sup-ply
forestry	for-est-ry
cel-ery	cel-er-y
moral-ly	mor-al-ly
graver	grav-er
lauda-to-ry	laud-a-to-ry
un-opened	un-o-pened
eerie	ee-rie
hostler	hos-tler
leisure-ly	lei-sure-ly
share-able	share-a-ble
pre-cau-tion-ary	pre-cau-tion-ar-y
coast-ing	coasting
es-timable	es-ti-ma-ble
con-nect-ing	con-nec-ting
pygmy	pyg-my
quencher	quench-er
arrange-ment	ar-range-ment
blun-der-ing	blundering
over-pass	o-ver-pass
polypropy-lene	pol-y-pro-pyl-ene
isother-mal	i-so-ther-mal
pael-la	pa-el-la
chrono-log-i-cal-ly	chron-o-log-i-cal-ly
painful	pain-ful
awning	awn-ing
aware-ness	a-ware-ness
para-troop-er	par-a-troop-er
more-over	more-o-ver
rege-late	re-ge-late
dusky	dusk-y
singsong	sing-song
spiky	spik-y
panz-er	pan-zer
ivory	i-vo-ry
un-der-study	un-der-stud-y
ally	al-ly
chi-ropodist	chi-rop-o-dist
homage	hom-age
puni-tive	pu-ni-tive
ar-cana	ar-ca-na
mantrap	man-trap
ir-re-place-able	ir-re-place-a-ble
cy-clotron	cy-clo-tron
tri-bune	trib-une
de-mo-graph-ics	dem-o-graph-ics
ef-fron-tery	ef-fron-ter-y
vari-cose	var-i-cose
eigen-state	ei-gen-state
poly-syl-la-ble	pol-y-syl-la-ble
ranter	rant-er
earshot	ear-shot
slob-ber-ing	slobbering
dinky	dink-y
bire-frin-gent	bi-re-frin-gent
veg-etable	veg-e-ta-ble
bony	bon-y
alarm	a-larm
cliffhang-er	cliff-hang-er
fa-nati-cism	fa-nat-i-cism
equi-lib-ri-um	e-qui-lib-ri-um
laden	lad-en
promi-nent-ly	prom-i-nent-ly
ptarmi-gan	ptar-mi-gan
unim-peach-able	un-im-peach-a-ble
cashier	cash-ier
sever-i-ty	se-ver-i-ty
garter	gar-ter
elas-tic-i-ty	e-las-tic-i-ty
ex-clu-sion-ary	ex-clu-sion-ar-y
he-li-copter	hel-i-cop-ter
free-lancer	free-lanc-er
epit-o-me	e-pit-o-me
un-fore-see-able	un-fore-see-a-ble
averse	a-verse
cityscape	cit-y-scape
plucky	pluck-y
goody	good-y
feath-ery	feath-er-y
rasper	rasp-er
mis-spellings	mis-spel-lings
un-fa-mil-iar-i-ty	un-fa-mil-i-ar-i-ty
retsi-na	ret-si-na
palin-drome	pal-in-drome
in-di-vid-ual	in-di-vid-u-al
para-med-ical	par-a-med-i-cal
froward	fro-ward
swindler	swin-dler
epis-tle	e-pis-tle
racist	rac-ist
translit-er-ate	trans-lit-er-ate
quartzite	quartz-ite
feal-ty	fe-al-ty
me-nial	me-ni-al
episode	ep-i-sode
un-al-ter-able	un-al-ter-a-ble
over-cast	o-ver-cast
satel-lite	sat-el-lite
elu-ci-date	e-lu-ci-date
minaret	min-a-ret
solo	so-lo
kalei-do-scope	ka-lei-do-scope
oblig-ing	o-blig-ing
charge-able	charge-a-ble
es-teemed	e-steemed
obelisk	ob-e-lisk
elit-ist	e-lit-ist
he-do-nism	he-don-ism
ra-dio-met-ric	ra-di-o-met-ric
pre-dictably	pre-dict-a-bly
in-ex-press-ible	in-ex-press-i-ble
synapse	syn-apse
ir-re-ducible	ir-re-duc-i-ble
able	a-ble
os-teopa-thy	os-te-op-a-thy
turnip	tur-nip
over-sleep	o-ver-sleep
stormy	storm-y
mid-wifery	mid-wife-ry
fidu-cia-ry	fi-du-ci-ar-y
minke	min-ke
de-fen-dant	de-fend-ant
ple-nary	ple-na-ry
pol-lard-ed	pollarded
beachy	beach-y
techno-pho-bia	tech-no-pho-bia
over-whelm-ing-ly	o-ver-whelm-ing-ly
physic	phys-ic
icon-o-clas-tic	i-con-o-clas-tic
meringue	me-ringue
kilo-byte	kil-o-byte
oblig-a-tion	ob-li-ga-tion
rapid-ly	rap-id-ly
redac-tion	re-dac-tion
in-dictable	in-dict-a-ble
tiara	ti-ar-a
stodgy	stodg-y
dereg-u-late	de-reg-u-late
manikin	man-i-kin
bib-lio-phile	bib-li-o-phile
ep-silon	ep-si-lon
dial-y-sis	di-al-y-sis
plur-al	plu-ral
hia-tus	hi-a-tus
present-ly	pres-ent-ly
astir	a-stir
ques-tion-able	ques-tion-a-ble
sooty	soot-y
dig-ni-tary	dig-ni-tar-y
su-perla-tive	su-per-la-tive
restau-rant	res-tau-rant
antler	ant-ler
flamin-go	fla-min-go
per-e-stroi-ka	pe-re-stroi-ka
con-toured	contoured
nonessen-tial	non-es-sen-tial
paragon	par-a-gon
but-tery	but-ter-y
un-record-ed	un-re-cord-ed
bur-bling	burbling
anom-alous	a-nom-a-lous
lumpy	lump-y
viceroy	vice-roy
lo-quaci-ty	lo-quac-i-ty
in-equitable	in-eq-ui-ta-ble
promise	prom-ise
bo-hemi-an	bo-he-mi-an
pom-padour	pom-pa-dour
breezy	breez-y
dis-obe-di-ence	dis-o-be-di-ence
thorny	thorn-y
cat-a-clysmic	cat-a-clys-mic
com-men-tary	com-men-tar-y
steamship	steam-ship
per-me-abil-i-ty	per-me-a-bil-i-ty
over-land	o-ver-land
shoring	shor-ing
bion-ics	bi-on-ics
flus-tered	flustered
sinewy	sin-ew-y
de-cay-ing	decaying
sparkler	spar-kler
velo-drome	ve-lo-drome
dowa-ger	dow-a-ger
mirac-u-lous	mi-rac-u-lous
autarchy	au-tar-chy
con-tigu-ous	con-tig-u-ous
odi-um	o-di-um
piv-otal	piv-ot-al
coro-na-tion	cor-o-na-tion
geo-syn-chro-nous	ge-o-syn-chro-nous
domi-cile	dom-i-cile
de-cayed	decayed
prepara-to-ry	pre-par-a-to-ry
overkill	o-ver-kill
tirade	ti-rade
thread-ed	threaded
smudgy	smudg-y
uni-fy	u-ni-fy
specif-i-cal-ly	spe-cif-i-cal-ly
peanut	pea-nut
hack-able	hack-a-ble
ele-phant	el-e-phant
taran-tu-la	ta-ran-tu-la
beget	be-get
equip-ment	e-quip-ment
elec-tri-fi-ca-tion	e-lec-tri-fi-ca-tion
dyad	dy-ad
body	bod-y
liny	lin-y
elec-torate	e-lec-tor-ate
fisticuffs	fist-i-cuffs
spher-oid	sphe-roid
ego-ma-ni-ac	e-go-ma-ni-ac
minu-ti-ae	mi-nu-ti-ae
elec-tron-i-cal-ly	e-lec-tron-i-cal-ly
inca	in-ca
guille-mot	guil-le-mot
hooky	hook-y
biop-sy	bi-op-sy
howler	howl-er
heater	heat-er
geo-cen-tric	ge-o-cen-tric
un-san-i-tary	un-san-i-tar-y
cuneiform	cu-ne-i-form
in-sis-tence	in-sist-ence
bevy	bev-y
con-fec-tionery	con-fec-tion-er-y
supreme	su-preme
plushy	plush-y
ingress	in-gress
un-nat-ur-al	un-nat-u-ral
poly-chro-mat-ic	pol-y-chro-mat-ic
li-censee	li-cen-see
trans-for-ma-tive	trans-form-a-tive
scal-able	scal-a-ble
hy-drochlo-ride	hy-dro-chlo-ride
un-work-able	un-work-a-ble
chrono-log-i-cal	chron-o-log-i-cal
nec-es-sary	nec-es-sar-y
slater	slat-er
liveli-hood	live-li-hood
gecko	geck-o
japon-i-ca	ja-pon-i-ca
han-dover	hand-o-ver
iso-late	i-so-late
punch-line	punchline
axis	ax-is
sub-ur-bia	sub-ur-bi-a
sofa	so-fa
gro-cery	gro-cer-y
sce-nario	sce-nar-i-o
cur-tained	curtained
even-tide	e-ven-tide
tenac-i-ty	te-nac-i-ty
so-lace	sol-ace
co-ex-is-tent	co-ex-ist-ent
ju-bilee	ju-bi-lee
gener-ic	ge-ner-ic
ed-uca-tive	ed-u-ca-tive
salaried	sal-a-ried
debonair	deb-o-nair
dis-com-fort-ing	discomforting
ex-porta-bil-i-ty	ex-por-ta-bi-li-ty
gratic-ule	grat-i-cule
killer	kil-ler
maisonette	mai-son-ette
gelati-nous	ge-lat-i-nous
li-bido	li-bi-do
no-to-ri-ety	no-to-ri-e-ty
un-avail-abil-i-ty	un-a-vail-a-bil-i-ty
buf-foon-ery	buf-foon-er-y
liftoff	lift-off
downy	down-y
turnover	turn-o-ver
macron	ma-cron
slouch-ing	slouching
ini-tial	in-i-tial
api-ary	a-pi-ar-y
im-pro-visato-ry	im-pro-vi-sa-to-ry
diplo-mat	dip-lo-mat
cal-care-ous	cal-car-e-ous
fifti-eth	fif-ti-eth
dactyl	dac-tyl
ge-o-mag-net-i-cal-ly	ge-o-mag-ne-ti-cal-ly
ho-n-our	ho-nour
chancy	chanc-y
omega	o-me-ga
finicky	fin-ick-y
pro-ce-du-ral-ly	pro-ce-dur-al-ly
or-di-nary	or-di-nar-y
lager	la-ger
mar-ketable	mar-ket-a-ble
mis-ery	mis-er-y
pro-cre-ation	pro-cre-a-tion
pes-simist	pes-si-mist
yeti	yet-i
com-bi-na-to-r-i-al	com-bi-na-to-ri-al
steeply	steep-ly
for-warder	for-ward-er
un-sea-son-ably	un-sea-son-a-bly
philo-soph-i-cal-ly	phil-o-soph-i-cal-ly
cy-tochrome	cy-to-chrome
undis-turbed	un-dis-turbed
volt-meter	volt-me-ter
retro-fit	ret-ro-fit
muslin	mus-lin
adult	a-dult
trea-sury	treas-ur-y
un-even-ly	un-e-ven-ly
rant-i-ng	ranting
uniden-ti-fied	un-i-den-ti-fied
duchess	duch-ess
ter-ri-to-r-i-al	ter-ri-to-ri-al
chaot-ic	cha-ot-ic
le-gionary	le-gion-ar-y
restau-ra-teur	res-tau-ra-teur
emet-ic	e-met-ic
om-nipo-tence	om-nip-o-tence
chamomile	cham-o-mile
napoleon	na-po-le-on
un-treat-able	un-treat-a-ble
un-re-pen-tant	un-re-pent-ant
in-her-i-ta-ble	in-her-it-a-ble
cater	ca-ter
breast-feed-ing	breastfeeding
en-durable	en-dur-a-ble
platelet	plate-let
rhetor-i-cal	rhe-tor-i-cal
over-done	o-ver-done
count-able	count-a-ble
over-re-acts	o-ver-re-acts
reshow	re-show
un-nec-es-sary	un-nec-es-sar-y
cre-ator	cre-a-tor
di-nosaur	di-no-saur
scalar	sca-lar
mar-chioness	mar-chion-ess
de-ni-able	de-ni-a-ble
re-vival-ism	re-viv-al-ism
el-der-flower	el-der-flow-er
equine	e-quine
salu-tary	sal-u-tar-y
hys-te-ria	hys-te-ri-a
inane	in-ane
defam-a-to-ry	de-fam-a-to-ry
mine-strone	min-e-stro-ne
upon	up-on
amaze	a-maze
ri-ot-ing	ri-o-ting
vet-eri-nary	vet-er-i-nar-y
saver	sav-er
un-car-ed	un-cared
tremo-lo	trem-o-lo
ex-tra-galac-tic	ex-tra-ga-lac-tic
col-lec-tivi-sa-tion	col-lec-ti-vi-sa-tion
sul-tana	sul-tan-a
wicked	wick-ed
itchy	itch-y
au-tomat	au-to-mat
ringer	ring-er
ni-hilis-tic	ni-hil-is-tic
un-e-d-u-cat-ed	un-ed-u-cat-ed
po-litesse	pol-i-tesse
un-re-peat-able	un-re-peat-a-ble
cobalt	co-balt
phil-an-thropic	phil-an-throp-ic
eques-tri-an-ism	e-ques-tri-an-ism
trib-u-tary	trib-u-tar-y
lieu-tenant	lieu-ten-ant
in-alien-able	in-al-ien-a-ble
hal-lelu-jah	hal-le-lu-jah
pig-ment-ed	pig-men-ted
lul-la-by	lull-a-by
condi-ment	con-di-ment
mi-crochip	mi-cro-chip
diplo-ma	di-plo-ma
back-bencher	back-bench-er
platy-pus	plat-y-pus
de-nial	de-ni-al
apolo-gia	ap-o-lo-gi-a
eatery	eat-er-y
snowy	snow-y
spooky	spook-y
velour	ve-lour
pantry	pan-try
hexag-o-nal	hex-ag-o-nal
mi-croor-gan-ism	mi-cro-or-gan-ism
as-pirin	as-pi-rin
perdi-tion	per-di-tion
archery	ar-cher-y
courtship	court-ship
leviathan	le-vi-a-than
con-trivance	con-triv-ance
sala-mi	sa-la-mi
mid-dleweight	mid-dle-weight
un-for-get-table	un-for-get-ta-ble
apace	a-pace
avail-abil-i-ty	a-vail-a-bil-i-ty
kina	ki-na
bac-teri-um	bac-te-ri-um
con-sis-tent	con-sist-ent
taber-na-cle	tab-er-nac-le
op-ti-mistic	op-ti-mis-tic
tachy-car-dia	tach-y-car-di-a
crazi-ly	cra-zi-ly
de-flower	de-flow-er
metaphor-i-cal-ly	met-a-phor-i-cal-ly
pul-monary	pul-mo-nar-y
asi-nine	as-i-nine
willpow-er	will-pow-er
dairy-ing	dair-y-ing
en-vi-able	en-vi-a-ble
frontage	front-age
viaduct	vi-a-duct
mutiny	mu-ti-ny
friendlily	friend-li-ly
lido	li-do
baroque	ba-roque
un-ready	un-read-y
gaudy	gaud-y
dosage	dos-age
prove-nance	prov-e-nance
con-fronta-tion	con-fron-ta-tion
omit	o-mit
un-print-able	un-print-a-ble
psy-chother-a-py	psy-cho-ther-a-py
nestling	nest-ling
pub-lished	published
barter	bar-ter
ketchup	ketch-up
coro-nary	cor-o-nar-y
sniff-ing	sniffing
sta-t-ics	stat-ics
lino	li-no
dud-geon	dudg-eon
genoa	gen-o-a
malty	malt-y
aqua	aq-ua
eva-sive	e-va-sive
hermeneu-tics	her-me-neu-tics
redi-rect	re-di-rect
un-usu-al-ly	un-u-su-al-ly
body-build-ing	bod-y-build-ing
in-con-testable	in-con-test-a-ble
benefice	ben-e-fice
uni-cel-lu-lar	u-ni-cel-lu-lar
un-abashed-ly	un-a-bash-ed-ly
in-sou-ciant	in-sou-ci-ant
papil-la	pa-pil-la
mul-ti-pro-cess-ing	mul-ti-proc-ess-ing
tara-masala-ta	ta-ra-ma-sa-la-ta
se-quencer	se-quenc-er
hys-teric	hys-ter-ic
ap-proach-ing	approaching
drama-tist	dram-a-tist
elixir	e-lix-ir
col-le-gial	col-le-gi-al
break-away	break-a-way
speci-fici-ty	spec-i-fic-i-ty
dili-gent-ly	dil-i-gent-ly
bom-bardier	bom-bar-dier
ex-porter	ex-port-er
church-war-den	church-ward-en
crino-line	crin-o-line
en-force-able	en-force-a-ble
suf-fragette	suf-fra-gette
tropopause	trop-o-pause
sepia	se-pi-a
chiefly	chief-ly
evap-o-ra-tion	e-vap-o-ra-tion
chival-ry	chiv-al-ry
sycamore	syc-a-more
pedi-gree	ped-i-gree
psy-choso-cial	psy-cho-so-cial
joyrid-ing	joy-rid-ing
creamy	cream-y
orig-i-nal	o-rig-i-nal
overnight	o-ver-night
par-a-sitism	par-a-sit-ism
in-ter-locu-tor	in-ter-loc-u-tor
com-mu-nica-tive-ness	com-mu-ni-ca-tive-ness
email	e-mail
tantrum	tan-trum
felon	fel-on
ge-neti-cist	ge-net-i-cist
dirty	dirt-y
green-ery	green-er-y
inim-itable	in-im-i-ta-ble
eu-pho-ria	eu-pho-ri-a
kilo-ton	kil-o-ton
taxi-dermy	tax-i-der-my
crick-eter	crick-et-er
con-stituen-cy	con-stit-u-en-cy
anorex-ic	an-o-rex-ic
manes	ma-nes
her-mitage	her-mit-age
in-jury	in-ju-ry
giro	gi-ro
swingy	swing-y
easy-go-ing	eas-y-go-ing
calami-tous	ca-lam-i-tous
heart-en-ing	heartening
casi-no	ca-si-no
deluxe	de-luxe
di-alect	di-a-lect
elide	e-lide
coolant	cool-ant
howdy	how-dy
proac-tive	pro-ac-tive
filthy	filth-y
re-unite	re-u-nite
de-pen-den-cy	de-pend-en-cy
lover	lov-er
ves-ti-gial	ves-tig-i-al
squally	squal-ly
starlight	star-light
frip-pery	frip-per-y
harshen	harsh-en
di-gestible	di-gest-i-ble
height-ened	heightened
em-bed-d-a-ble	em-bed-da-ble
defuse	de-fuse
joust-ing	jousting
there-after	there-af-ter
ex-igu-ous	ex-ig-u-ous
cre-ation-ism	cre-a-tion-ism
draftee	draft-ee
cut-lery	cut-ler-y
parox-ysm	par-ox-ysm
un-equiv-o-cal	un-e-quiv-o-cal
um-bili-cus	um-bil-i-cus
un-re-cov-er-able	un-re-cov-er-a-ble
lemur	le-mur
samu-rai	sam-u-rai
cur-able	cur-a-ble
tarsal	tar-sal
in-ex-haustible	in-ex-haust-i-ble
bothy	both-y
spir-i-tu-al-ist	spir-it-u-al-ist
mon-e-tary	mon-e-tar-y
calorif-ic	cal-o-rif-ic
elec-tro-mo-tive	e-lec-tro-mo-tive
eval-u-ate	e-val-u-ate
awak-en-ing	a-wak-en-ing
zebu	ze-bu
artis-tic	ar-tis-tic
un-ser-vice-able	un-ser-vice-a-ble
hy-pox-ia	hy-pox-i-a
re-ceiver-ship	re-ceiv-er-ship
de-c-la-ra-tion	dec-la-ra-tion
ex-pen-di-ture	ex-pend-i-ture
plateau	pla-teau
comber	comb-er
lin-ear	lin-e-ar
stratos-pher-i-cal-ly	stratospherically
teleg-ra-phy	te-leg-ra-phy
id-i-olect	id-i-o-lect
ever-last-ing	ev-er-last-ing
valid-ly	val-id-ly
tute-lage	tu-te-lage
re-mark-able	re-mark-a-ble
monog-a-mous-ly	mo-nog-a-mous-ly
wadi	wa-di
mag-is-te-r-i-al	mag-is-te-ri-al
un-en-vi-able	un-en-vi-a-ble
cam-corder	cam-cord-er
kitchen-ware	kitch-en-ware
dra-con-ian	dra-co-ni-an
dul-cimer	dul-ci-mer
en-tourage	en-tou-rage
col-umn	co-lumn
pup-petry	pup-pet-ry
her-i-tabil-i-ty	her-it-a-bil-i-ty
pinkie	pink-ie
pop-ulism	pop-u-lism
garbage	gar-bage
along	a-long
tri-atom-ic	tri-a-tom-ic
droplet	drop-let
vino	vi-no
verisimil-i-tude	ver-i-si-mil-i-tude
mata-dor	mat-a-dor
jokey	jok-ey
saucy	sau-cy
hy-gien-ic	hy-gi-en-ic
modal-i-ty	mo-dal-i-ty
clien-tele	cli-en-tele
archdea-con	arch-dea-con
debtor	debt-or
amuse	a-muse
cho-les-terol	cho-les-ter-ol
spi-dery	spi-der-y
ma-jorette	ma-jor-ette
id-iom	id-i-om
bloody	blood-y
good-night	goodnight
haiku	hai-ku
regi-cide	reg-i-cide
per-mafrost	per-ma-frost
mer-cury	mer-cu-ry
clema-tis	clem-a-tis
baldy	bald-y
cat-tery	cat-te-ry
shifter	shift-er
di-lata-tion	dil-a-ta-tion
uni-ver-sal-ly	u-ni-ver-sal-ly
spon-tane-ity	spon-ta-ne-i-ty
ra-dio-ther-a-py	ra-di-o-ther-a-py
ex-i-gency	ex-i-gen-cy
an-tipa-thet-ic	an-ti-pa-thet-ic
raga-muf-fin	rag-a-muf-fin
facet	fac-et
an-tithe-sis	an-tith-e-sis
touristy	tour-ist-y
as-cetic	as-cet-ic
painful-ly	pain-ful-ly
askance	a-skance
poly-cyclic	pol-y-cy-clic
kestrel	kes-trel
bur-geon-ing	burgeoning
stock-bro-ker	stock-brok-er
cologne	co-logne
calum-ny	cal-um-ny
ima-go	i-ma-go
copy-writer	cop-y-writ-er
loosen	loos-en
un-at-tain-able	un-at-tain-a-ble
un-con-scionable	un-con-scion-a-ble
reval-ue	re-val-ue
cor-dial	cor-di-al
carpal	car-pal
teller	tell-er
data-base	da-ta-base
breath-able	breath-a-ble
hazel	ha-zel
ra-di-ogram	ra-di-o-gram
ghana	ghana
dauber	daub-er
sala-man-der	sal-a-man-der
gun-metal	gun-met-al
in-tu-itive	in-tu-i-tive
un-palat-able	un-pal-at-a-ble
tele-path-ic	tel-e-path-ic
un-ob-ser-vant	un-ob-serv-ant
pruri-ent	pru-ri-ent
iambus	i-am-bus
balustrade	bal-us-trade
logo	lo-go
com-fort-able	com-fort-a-ble
ni-hilism	ni-hil-ism
fid-get	fidg-et
warthog	wart-hog
de-tectably	de-tect-a-bly
repro-bate	rep-ro-bate
livid	liv-id
takeover	take-o-ver
forepaw	fore-paw
bi-modal	bi-mod-al
geno-ci-dal	gen-o-cid-al
aper-i-tif	a-pe-ri-tif
ex-citable	ex-cit-a-ble
catgut	cat-gut
avion-ics	a-vi-on-ics
maple	ma-ple
florin	flor-in
colo-nial-ism	co-lo-ni-al-ism
unit	u-nit
cordage	cord-age
dis-pen-sary	dis-pen-sa-ry
peri-patet-ic	per-i-pa-tet-ic
sawmill	saw-mill
culi-nary	cu-li-nar-y
any-where	an-y-where
con-san-guineous	con-san-guin-e-ous
melo-dra-ma	mel-o-dra-ma
catheter	cath-e-ter
foot-baller	foot-ball-er
classy	class-y
dri-ve	drive
moral-i-ty	mo-ral-i-ty
over-ground	o-ver-ground
di-atom-ic	di-a-tom-ic
sur-viv-abil-i-ty	sur-viv-a-bil-i-ty
ridicu-lous-ly	ri-dic-u-lous-ly
palette	pal-ette
spaniel	span-iel
hec-tor-ing	hectoring
bur-nished	burnished
bola	bo-la
un-learned	un-learn-ed
suit-ably	suit-a-bly
switchgear	switch-gear
metic-u-lous	me-tic-u-lous
jerkin	jer-kin
ge-nial	ge-ni-al
hab-it-able	hab-it-a-ble
in-ex-orable	in-ex-o-ra-ble
tau-tol-ogy	tau-tol-o-gy
leisurewear	lei-sure-wear
type-writer	type-writ-er
rear-ma-ment	re-ar-ma-ment
fool-ery	fool-er-y
maya	ma-ya
mod-ernism	mod-ern-ism
rodeo	ro-de-o
edi-tion	e-di-tion
salver	sal-ver
toluene	tol-u-ene
give-away	give-a-way
ra-tio-nale	ra-tion-ale
stipen-di-ary	sti-pen-di-ar-y
tes-ta-men-tary	tes-ta-men-ta-ry
gusty	gust-y
kismet	kis-met
no-tary	no-ta-ry
metal-lic	me-tal-lic
in-ter-dis-ci-pli-nary	in-ter-dis-ci-pli-nar-y
manor	man-or
loca-tive	loc-a-tive
busi-ly	bus-i-ly
iso-la-tion	i-so-la-tion
di-ure-sis	di-u-re-sis
polyg-a-mous	po-lyg-a-mous
celi-bate	cel-i-bate
sun-burned	sunburned
tardy	tar-dy
bio-morph	bi-o-morph
javelin	jave-lin
ex-oti-cism	ex-ot-i-cism
carouse	ca-rouse
dolomite	do-lo-mite
murky	murk-y
polypep-tide	pol-y-pep-tide
tithing	tith-ing
re-assess-ment	re-as-sess-ment
over-sen-si-tive	o-ver-sen-si-tive
ir-recov-er-able	ir-re-cov-er-a-ble
necrophil-ia	nec-ro-phil-i-a
epi-ge-net-ic	ep-i-ge-net-ic
bour-geoisie	bour-geoi-sie
equa-tor	e-qua-tor
melan-choly	mel-an-chol-y
con-flict-ed	conflicted
recharge-able	re-charge-a-ble
sta-t-ic	stat-ic
parochial	pa-ro-chi-al
milord	mi-lord
malev-o-lence	ma-lev-o-lence
stoma	sto-ma
eclec-ti-cism	ec-lec-ti-cism
seclu-sion	se-clu-sion
view-able	view-a-ble
redo	re-do
phys-iog-no-my	phys-i-og-no-my
oviduct	o-vi-duct
mono-plane	mon-o-plane
pharaoh	phar-aoh
tangy	tang-y
mod-icum	mod-i-cum
con-sum-able	con-sum-a-ble
thaw-ing	thawing
vivi-sec-tion	viv-i-sec-tion
dopey	dope-y
pic-turesque	pic-tur-esque
menar-che	men-ar-che
high-lighter	high-ligh-ter
elec-trophore-sis	e-lec-tro-pho-re-sis
april	a-pril
pre-sen-ta-tion	pres-en-ta-tion
car-bona-ceous	car-bo-na-ceous
ashy	ash-y
prepa-ra-tion	prep-a-ra-tion
fugi-tive	fu-gi-tive
sniper	snip-er
palate	pal-ate
leucine	leu-cine
bubon-ic	bu-bon-ic
arable	ar-a-ble
reim-ple-ment-ed	reimplemented
fleecy	fleec-y
about	a-bout
facile	fac-ile
aviary	a-vi-ar-y
in-fi-deli-ty	in-fi-del-i-ty
je-junum	je-ju-num
pasty	past-y
prodi-gal	prod-i-gal
mis-shapen	mis-shap-en
an-ti-body	an-ti-bod-y
visa	vi-sa
hoary	hoar-y
feb-ru-ary	feb-ru-ar-y
hys-terec-to-my	hys-ter-ec-to-my
mil-i-tarism	mil-i-ta-rism
ar-chaeopteryx	ar-chae-op-ter-yx
reroutes	re-routes
the-atri-cal-ly	the-at-ri-cal-ly
ceme-tery	cem-e-ter-y
man-i-cured	ma-ni-cured
naked	na-ked
soupy	soup-y
pro-peller	pro-pel-ler
periscope	per-i-scope
in-tegri-ty	in-teg-ri-ty
floury	flour-y
crotch-ety	crotch-et-y
remix	re-mix
pre-ventable	pre-vent-a-ble
predilec-tion	pre-di-lec-tion
pavil-ion	pa-vil-ion
wadding	wad-ding
hus-bandry	hus-band-ry
ca-su-al-ty	cas-u-al-ty
artist	art-ist
hi-ero-glyph-ic	hi-er-o-glyph-ic
scapu-la	scap-u-la
ir-res-olute	ir-res-o-lute
vinyl	vi-nyl
civil-ian	ci-vil-ian
spongy	spon-gy
merid-ion-al	me-rid-i-o-nal
pep-pery	pep-per-y
poly-mor-phism	pol-y-mor-phism
over-fly	o-ver-fly
over-write	o-ver-write
cursed	curs-ed
dis-agree-able	dis-a-gree-a-ble
bur-sary	bur-sa-ry
in-de-fin-able	in-de-fin-a-ble
voyeurism	vo-yeur-ism
sinew	sin-ew
cool-ing	cooling
marked-ly	mark-ed-ly
cameo	cam-e-o
nowa-days	now-a-days
lachry-mose	lach-ry-mose
damper	damp-er
crater	cra-ter
legate	leg-ate
male-fac-tor	mal-e-fac-tor
pro-pa-gan-da	prop-a-gan-da
cer-ti-fi-able	cer-ti-fi-a-ble
euro	eu-ro
opine	o-pine
evis-cer-ate	e-vis-cer-ate
rein-vest-ment	re-in-vest-ment
per-pe-tu-ity	per-pe-tu-i-ty
aper-ture	ap-er-ture
kiosk	ki-osk
redo-lent	red-o-lent
leer-ing	leering
au-r-al	au-ral
detox-i-fi-ca-tion	de-tox-i-fi-ca-tion
iso-la-tion-ism	i-so-la-tion-ism
ap-plica-tive	ap-pli-ca-tive
tele-ol-o-gy	tel-e-ol-o-gy
grimy	grim-y
quotable	quot-a-ble
id-io-cy	id-i-o-cy
atyp-i-cal	a-typ-i-cal
hangar	hang-ar
po-ten-tiome-ter	po-ten-ti-om-e-ter
glasshouse	glass-house
stinky	stink-y
gener-i-cal-ly	ge-ner-i-cal-ly
in-elas-tic	in-e-las-tic
ob-se-quious	ob-se-qui-ous
archive	ar-chive
mini	min-i
re-tain-ing	retaining
boa	bo-a
megawatt	meg-a-watt
crofter	croft-er
in-quisi-to-r-i-al	in-quis-i-to-ri-al
bi-car-bon-ate	bi-car-bo-nate
syco-phan-tic	syc-o-phan-tic
over-am-bi-tious	o-ver-am-bi-tious
nonethe-less	none-the-less
rosary	ro-sa-ry
of-fend-ing	of-fen-ding
bur-ial	bur-i-al
forego	fore-go
ethics	eth-ics
whaler	whal-er
un-ut-ter-able	un-ut-ter-a-ble
semi-cir-cle	sem-i-cir-cle
un-achiev-able	un-a-chiev-a-ble
ele-phan-tine	el-e-phan-tine
con-ti-nu-ity	con-ti-nu-i-ty
petro-chem-i-cal	pet-ro-chem-i-cal
any-thing	an-y-thing
he-li-pad	hel-i-pad
con-formist	con-form-ist
fifty	fif-ty
jam-boree	jam-bo-ree
bawdy	bawd-y
bunker	bun-ker
charis-mat-ic	char-is-mat-ic
mandible	man-di-ble
aquifer	aq-ui-fer
evolve	e-volve
syn-chrony	syn-chro-ny
lumpen	lum-pen
here-abouts	here-a-bouts
pre-sum-ably	pre-sum-a-bly
cho-ris-ter	chor-is-ter
askew	a-skew
pre-dict-ed	predicted
rapi-er	ra-pi-er
over-heat	o-ver-heat
eu-phemistic	eu-phe-mis-tic
but-tered	buttered
declam-a-to-ry	de-clam-a-to-ry
de-f-i-n-i-tion	def-i-ni-tion
metic-u-lous-ly	me-tic-u-lous-ly
gooey	goo-ey
prowler	prowl-er
deeply	deep-ly
psy-cho-analy-sis	psy-cho-a-nal-y-sis
busker	busk-er
caldera	cal-de-ra
corset	cor-set
rep-til-ian	rep-til-i-an
dimer	di-mer
dim-pled	dimpled
bidi-rec-tion-al	bi-di-rec-tion-al
gofer	go-fer
beach-comber	beach-comb-er
in-nocu-ous	in-noc-u-ous
cheva-lier	chev-a-lier
en-doge-nous	en-dog-e-nous
elope	e-lope
fre-quent-ed	frequented
polic-ing	policing
hon-esty	hon-es-ty
even-tu-al-ly	e-ven-tu-al-ly
iso-bar	i-so-bar
necro-mancer	nec-ro-man-cer
meta-lan-guage	met-a-lan-guage
over-in-flat-ed	o-ver-in-flat-ed
un-der-stand-ably	un-der-stand-a-bly
over-grown	o-ver-grown
or-tho-doxy	or-tho-dox-y
penance	pen-ance
geom-e-try	ge-om-e-try
nifty	nif-ty
au-tonomous-ly	au-ton-o-mous-ly
repli-ca-tion	rep-li-ca-tion
derelict	der-e-lict
ob-streper-ous	ob-strep-er-ous
salmon	salm-on
sleepi-ness	sleep-i-ness
over-spend	o-ver-spend
teenaged	teen-aged
re-bury	re-bur-y
over-growth	o-ver-growth
geo-sta-tion-ary	ge-o-sta-tion-ar-y
reclu-sive	re-clu-sive
elastin	e-las-tin
scat-tered	scattered
aro-matic-i-ty	ar-o-ma-tic-i-ty
touris-tic	tour-is-tic
sibyl	sib-yl
cyan	cy-an
spec-tropho-tome-ter	spec-tro-pho-tom-e-ter
ephemer-al	e-phem-er-al
deuteron	deu-ter-on
gazelle	ga-zelle
weepy	weep-y
bad-minton	bad-min-ton
re-for-esta-tion	re-for-est-a-tion
fusible	fu-si-ble
con-tention	con-ten-tion
over-dose	o-ver-dose
pass-able	pass-a-ble
in-testi-nal	in-tes-ti-nal
col-liery	col-lier-y
pity	pit-y
as-pidis-tra	as-pi-dis-tra
welder	weld-er
coinage	coin-age
obei-sance	o-bei-sance
meta-physics	met-a-phys-ics
roguery	ro-guer-y
anonymi-ty	an-o-nym-i-ty
creepy	creep-y
stranger	stran-ger
elu-ci-da-tion	e-lu-ci-da-tion
colonic	co-lon-ic
penin-su-la	pen-in-su-la
propul-sion	pro-pul-sion
bene-fac-tion	ben-e-fac-tion
ra-tio-nal-ism	ra-tion-al-ism
sapling	sap-ling
stager	stag-er
pathos	pa-thos
kwacha	kwa-cha
equal-i-ty	e-qual-i-ty
astride	a-stride
toi-letries	toi-let-ries
wildlife	wild-life
in-vert-ed	inverted
brassy	brass-y
para-dox-i-cal	par-a-dox-i-cal
quiet-ness	qui-et-ness
naive-ly	na-ive-ly
com-mend-ably	com-mend-a-bly
cur-ricu-lum	cur-ric-u-lum
morass	mo-rass
sec-toral	sec-tor-al
di-uret-ic	di-u-ret-ic
in-con-sid-er-able	in-con-sid-er-a-ble
lit-er-ary	lit-er-ar-y
her-bi-cide	herb-i-cide
unloved	un-loved
herbal-ism	her-bal-ism
flota-tion	flo-ta-tion
corky	cork-y
rosy	ros-y
salu-ta-tion	sal-u-ta-tion
aton-al	a-ton-al
ir-re-triev-able	ir-re-triev-a-ble
teeter	tee-ter
un-sa-vory	un-sa-vor-y
payable	pay-a-ble
solemn	sol-emn
think-able	think-a-ble
skua	sku-a
in-fantry	in-fan-try
lano-lin	lan-o-lin
di-vorcee	di-vor-cee
un-am-bigu-ous-ly	un-am-big-u-ous-ly
causative	caus-a-tive
halite	hal-ite
salin-i-ty	sa-lin-i-ty
elec-tric-i-ty	e-lec-tric-i-ty
aver	a-ver
raider	raid-er
lacy	lac-y
fetish	fet-ish
mas-culin-i-ty	mas-cu-lin-i-ty
ori-en-tal	o-ri-en-tal
en-docrine	en-do-crine
dis-ci-pli-nary	dis-ci-pli-nar-y
necro-man-tic	nec-ro-man-tic
so-ciopo-lit-i-cal	so-ci-o-po-lit-i-cal
hubris	hu-bris
up-hol-stery	up-hol-ster-y
im-porter	im-port-er
steady	stead-y
causal-i-ty	cau-sal-i-ty
cen-trifu-ga-tion	cen-trif-u-ga-tion
rum-pled	rumpled
pogrom	po-grom
rooftop	roof-top
touchy	touch-y
eques-tri-an	e-ques-tri-an
caiman	cai-man
asym-met-ri-cal	a-sym-met-ri-cal
naughty	naugh-ty
con-certi-na	con-cer-ti-na
for-syth-ia	for-syth-i-a
mankind	man-kind
covert-ly	cov-ert-ly
macro-eco-nom-ic	mac-ro-ec-o-nom-ic
de-signed-ly	de-sign-ed-ly
portage	por-tage
spiny	spin-y
makeshift	make-shift
ex-trater-ri-to-r-i-al	ex-tra-ter-ri-to-ri-al
in-ap-plic-a-ble	in-ap-pli-ca-ble
over-shad-ow	o-ver-shad-ow
foothold	foot-hold
tint-ed	tinted
econ-o-mist	e-con-o-mist
video-tape	vid-e-o-tape
vic-arage	vic-ar-age
un-man-age-able	un-man-age-a-ble
grotesque	gro-tesque
cog-nizance	cog-ni-zance
axon	ax-on
sadis-tic	sa-dis-tic
tableau	tab-leau
dis-heart-ened	dis-hear-tened
schooner	schoon-er
doughty	dough-ty
sleepy	sleep-y
en-treaty	en-treat-y
sewage	sew-age
panoply	pan-o-ply
okapi	o-ka-pi
de-pen-dence	de-pend-ence
blus-ter-ing	blustering
con-vivial	con-viv-i-al
un-lac-ing	un-lacing
in-sur-gency	in-sur-gen-cy
re-galia	re-ga-li-a
in-erad-i-ca-ble	in-e-rad-i-ca-ble
cladding	clad-ding
eroge-nous	e-rog-e-nous
er-ro-neous-ly	er-ro-ne-ous-ly
en-gi-neered	engineered
flagon	flag-on
racy	rac-y
disin-gen-u-ous	dis-in-gen-u-ous
baronet	bar-on-et
rein-car-nate	re-in-car-nate
brawler	brawl-er
con-juror	con-ju-ror
foamy	foam-y
piercer	pierc-er
quest-ing	questing
any-more	an-y-more
gra-tu-itous-ly	gra-tu-i-tous-ly
stowage	stow-age
positron	pos-i-tron
flat-tery	flat-ter-y
orac-u-lar	o-rac-u-lar
su-per-hero	su-per-he-ro
wrinkly	wrin-kly
ragged	rag-ged
coun-terof-fen-sive	coun-ter-of-fen-sive
readi-ness	read-i-ness
idly	i-dly
in-con-sis-tent	in-con-sist-ent
com-muter	com-mut-er
unto	un-to
un-adorned	un-a-dorned
repar-tee	rep-ar-tee
padre	pa-dre
vestal	ves-tal
flan-nelette	flan-nel-ette
linger	lin-ger
con-struc-tivist	con-struc-tiv-ist
rarebit	rare-bit
courage	cour-age
enu-mer-ate	e-nu-mer-ate
basalt	ba-salt
monoc-u-lar	mo-noc-u-lar
phooey	phoo-ey
reti-na	ret-i-na
delin-quen-cy	de-lin-quen-cy
union	un-ion
cata-ma-ran	cat-a-ma-ran
cor-po-ratism	cor-po-rat-ism
promis-cu-ity	prom-is-cu-i-ty
navvy	nav-vy
omi-nous	om-i-nous
freighter	freight-er
tur-bocharg-er	tur-bo-charg-er
method-olog-i-cal	meth-od-o-log-i-cal
pan-icky	pan-ick-y
prophet	proph-et
amount	a-mount
pal-isade	pal-i-sade
paraglid-ing	par-a-glid-ing
silage	si-lage
mono-phon-ic	mon-o-phon-ic
tele-phone	tel-e-phone
ren-dezvous	ren-dez-vous
reg-istry	reg-is-try
fil-i-buster	fil-i-bus-ter
coupon	cou-pon
over-reach	o-ver-reach
ripen	rip-en
con-spir-a-to-r-i-al	con-spir-a-to-ri-al
golfer	golf-er
idle-ness	i-dle-ness
needle-work	nee-dle-work
over-sim-pli-fy	o-ver-sim-pli-fy
rhetor-i-cal-ly	rhe-tor-i-cal-ly
un-de-ni-able	un-de-ni-a-ble
weari-ness	wea-ri-ness
di-ver-sion-ary	di-ver-sion-ar-y
project	proj-ect
hon-orary	hon-or-ar-y
unashamed	un-a-shamed
with-ered	withered
medul-la	me-dul-la
plaza	pla-za
lapel	la-pel
copy-right	cop-y-right
diskette	disk-ette
sub-species	sub-spe-cies
waspish	wasp-ish
limpid	lim-pid
eq-ui-table	eq-ui-ta-ble
sta-tion-ary	sta-tion-ar-y
ex-e-cutable	ex-e-cut-a-ble
balder-dash	bal-der-dash
pornog-ra-ph-er	por-nog-ra-pher
blowup	blow-up
im-puni-ty	im-pu-ni-ty
dumpling	dump-ling
whichev-er	which-ev-er
ethanol	eth-a-nol
spicy	spic-y
arith-metic	a-rith-me-tic
shady	shad-y
resin	res-in
in-dis-pens-able	in-dis-pen-sa-ble
melo-di-ous	me-lo-di-ous
op-por-tunism	op-por-tun-ism
mori-bund	mor-i-bund
petrol-o-gy	pe-trol-o-gy
in-ca-pable	in-ca-pa-ble
ex-is-tence	ex-ist-ence
in-cen-di-ary	in-cen-di-ar-y
genre	gen-re
ax-iomat-ic	ax-i-o-mat-ic
inessen-tial	in-es-sen-tial
farmer	farm-er
mo-nop-oly	mo-nop-o-ly
me-te-o-rol-o-gy	me-te-or-ol-o-gy
chid-ing	chiding
ru-ined	ruined
elon-gate	e-lon-gate
trousers	trou-sers
prosce-ni-um	pro-sce-ni-um
no-madic	no-mad-ic
postlude	post-lude
avi-ate	a-vi-ate
lugubri-ous	lu-gu-bri-ous
elim-i-na-tion	e-lim-i-na-tion
dodgy	dodg-y
dip-so-ma-nia	dip-so-ma-ni-a
itin-er-ary	i-tin-er-ar-y
delu-sion	de-lu-sion
anom-aly	a-nom-a-ly
ma-chete	ma-chet-e
ten-antry	ten-ant-ry
duchy	duch-y
avian	a-vi-an
astray	a-stray
cryo-genic	cry-o-gen-ic
chi-ropody	chi-rop-o-dy
por-traitist	por-trait-ist
bushy	bush-y
in-ex-tin-guish-able	in-ex-tin-guish-a-ble
colonist	col-o-nist
physi-cian	phy-si-cian
dotage	dot-age
de-liv-er-able	de-liv-er-a-ble
client	cli-ent
manome-ter	ma-nom-e-ter
dither	dith-er
coun-ter-in-tu-itive	coun-ter-in-tu-i-tive
lava	la-va
copy-ist	cop-y-ist
cin-e-matog-ra-ph-er	cin-e-ma-tog-ra-pher
ini-tial-ly	in-i-tial-ly
archivist	ar-chi-vist
steeple	stee-ple
pen-i-ten-tiary	pen-i-ten-tia-ry
de-po-si-tion	dep-o-si-tion
scenic	sce-nic
busi-ness-woman	busi-ness-wom-an
stargaze	star-gaze
bailiff	bail-iff
marigold	mar-i-gold
chorea	cho-re-a
cordite	cord-ite
quater-nion	qua-ter-ni-on
di-choto-mous	di-chot-o-mous
lender	lend-er
sil-vered	silvered
unin-spir-ing	un-in-spir-ing
im-prison	im-pris-on
para-dox	par-a-dox
coloured	co-loured
nest-ing	nesting
atom	at-om
dodo	do-do
vestry	ves-try
delir-i-um	de-lir-i-um
duik-er	dui-ker
chore-o-graph-ic	cho-re-o-graph-ic
ab-solute-ly	ab-so-lute-ly
he-lios-phere	he-li-o-sphere
tetra-he-dron	tet-ra-he-dron
re-uni-fy	re-u-ni-fy
heron	her-on
emir	e-mir
sacral	sa-cral
markup	mark-up
ho-mo-gene-ity	ho-mo-ge-ne-i-ty
smoother	smooth-er
de-press-ing	de-pres-sing
el-e-men-tary	el-e-men-ta-ry
eu-pho-nious	eu-pho-ni-ous
se-lectee	se-lect-ee
con-vert-ible	con-vert-i-ble
wa-terbed	wa-ter-bed
rephras-es	re-phra-ses
fanci-er	fan-ci-er
stony	ston-y
avenger	a-veng-er
az-imuth	az-i-muth
un-con-ge-nial	un-con-gen-ial
porcine	por-cine
her-i-ta-ble	her-it-a-ble
biotech-nol-o-gy	bi-o-tech-nol-o-gy
cred-itable	cred-it-a-ble
so-cio-bi-ol-o-gy	so-ci-o-bi-ol-o-gy
wealthy	wealth-y
dis-con-ti-nu-ity	dis-con-ti-nu-i-ty
hashish	hash-ish
metaphor-i-cal	met-a-phor-i-cal
click-ing	clicking
ria	ri-a
medal	med-al
lament-ed	la-ment-ed
re-dis-tri-b-u-tion	re-dis-tri-bu-tion
makeweight	make-weight
dogs-body	dogs-bod-y
zealot	zeal-ot
ex-pi-ra-to-ry	ex-pir-a-to-ry
fur-rowed	furrowed
lucky	luck-y
isosce-les	i-sos-ce-les
grandios-i-ty	gran-di-os-i-ty
eroti-cism	e-rot-i-cism
vi-sion-ary	vi-sion-ar-y
charis-ma	cha-ris-ma
cli-toris	clit-o-ris
pu-rifi-ca-tion	pu-ri-fi-ca-tion
deco-rum	de-co-rum
servi-ette	ser-vi-ette
pauci-ty	pau-ci-ty
dumper	dump-er
fi-nis	fin-is
sym-po-sium	sym-po-si-um
idyll	i-dyll
equal	e-qual
eman-ci-pat-ed	e-man-ci-pat-ed
dis-cernible	dis-cern-i-ble
ju-nior	jun-ior
soli-tary	sol-i-tar-y
para-mag-net-ic	par-a-mag-net-ic
apogee	ap-o-gee
his-togram	his-to-gram
ha-rass-ing	harassing
loutish	lout-ish
unan-i-mous	u-nan-i-mous
agree	a-gree
flut-ter-ing	fluttering
lig-and	li-gand
bromine	bro-mine
labyrinth	lab-y-rinth
necro-man-cy	nec-ro-man-cy
ia-tro-genic	i-at-ro-gen-ic
lan-der	land-er
hit-table	hit-ta-ble
faulty	fault-y
over-weight	o-ver-weight
reat-tempt	re-at-tempt
guano	gua-no
over-shot	o-ver-shot
ex-plana-to-ry	ex-plan-a-to-ry
prodi-gy	prod-i-gy
damask	dam-ask
os-tracism	os-tra-cism
tri-umphant-ly	tri-um-phant-ly
an-tipa-thy	an-tip-a-thy
ergo	er-go
blender	blend-er
muti-nous	mu-ti-nous
hy-per-boloid	hy-per-bo-loid
nugget	nug-get
protest	pro-test
recipe	rec-i-pe
layabout	lay-a-bout
jiffy	jif-fy
apery	ap-er-y
geezer	gee-zer
con-cil-iar	con-cil-i-ar
straight-away	straight-a-way
cradling	cra-dling
no-ti-fi-able	no-ti-fi-a-ble
pre-cooked	precooked
stu-dious	stu-di-ous
wil-lowy	wil-low-y
telex	tel-ex
inkwell	ink-well
dis-tin-guish-able	dis-tin-guish-a-ble
dodgem	dodg-em
tyrant	ty-rant
unim-pres-sive	un-im-pres-sive
un-easi-ness	un-eas-i-ness
gua-camole	gua-ca-mo-le
lunchtime	lunch-time
man-darin	man-da-rin
de-bat-able	de-bat-a-ble
fri-ary	fri-ar-y
rar-efac-tion	rar-e-fac-tion
phil-an-thropist	phi-lan-thro-pist
re-assert	re-as-sert
un-abat-ed	un-a-bat-ed
broadleaved	broad-leaved
se-nior-i-ty	sen-ior-i-ty
baobab	ba-o-bab
loader	load-er
auger	au-ger
relict	rel-ict
re-tini-tis	ret-i-ni-tis
sketchy	sketch-y
vol-un-tary	vol-un-tar-y
ide-al	i-de-al
devo-tee	dev-o-tee
boxy	box-y
dairy	dair-y
de-lec-table	de-lec-ta-ble
elu-sive	e-lu-sive
inat-ten-tive	in-at-ten-tive
there-abouts	there-a-bouts
rachis	ra-chis
mal-adroit	mal-a-droit
zenith	ze-nith
holis-ti-cal-ly	ho-lis-ti-cal-ly
sub-mersible	sub-mers-i-ble
polypho-ny	po-lyph-o-ny
wormy	worm-y
wardrobe	ward-robe
tena-cious	te-na-cious
ma-te-r-i-al	ma-te-ri-al
an-ti-quary	an-ti-quar-y
aris-to-crat-ic	a-ris-to-crat-ic
dark-ened	dar-kened
reprise	re-prise
pa-troness	pa-tron-ess
radix	ra-dix
koala	ko-a-la
pilchard	pil-chard
va-pid	vap-id
mela-tonin	mel-a-to-nin
zither	zith-er
misog-y-nist	mi-sog-y-nist
lantern	lan-tern
key-boardist	key-board-ist
unin-sured	un-in-sured
clement	clem-ent
weapon	weap-on
con-trast-ing	contrasting
lisp-ing	lis-ping
fever-ish	fe-ver-ish
eigen-func-tion	ei-gen-func-tion
di-atom	di-a-tom
cog-nizant	cog-ni-zant
rub-bery	rub-ber-y
notwith-stand-ing	not-with-stand-ing
beta	be-ta
promis-cu-ous	pro-mis-cu-ous
pho-bia	pho-bi-a
enor-mous-ly	e-nor-mous-ly
piezo-elec-tric	pi-e-zo-e-lec-tric
unan-swered	un-an-swered
ruler	rul-er
demon-stra-ble	de-mon-stra-ble
canal	ca-nal
mo-torist	mo-tor-ist
hostel-ry	hos-tel-ry
stilet-to	sti-let-to
tyran-ni-cide	ty-ran-ni-cide
lectern	lec-tern
un-mis-tak-ably	un-mis-tak-a-bly
parish	par-ish
woodsmoke	wood-smoke
sponger	spong-er
blaster	blast-er
syn-onymy	syn-on-y-my
tav-er-na	ta-ver-na
ther-mome-ter	ther-mom-e-ter
monas-tic	mo-nas-tic
kilo-volt	kil-o-volt
quadru-ply	quad-ru-ply
pout-ing	pouting
un-remit-ting	un-re-mit-ting
vary	var-y
yippee	yip-pee
in-no-v-a-tive	in-no-va-tive
pre-tender	pre-tend-er
barefaced	bare-faced
stat-uette	stat-u-ette
phone-mic	pho-ne-mic
pow-dery	pow-der-y
rheumat-ic	rheu-mat-ic
foxy	fox-y
arranger	ar-rang-er
sa-tanism	sa-tan-ism
repos-i-to-ry	re-pos-i-to-ry
mar-i-onette	mar-i-on-ette
seascape	sea-scape
en-durance	en-dur-ance
tidi-ness	ti-di-ness
ir-re-solv-able	ir-re-solv-a-ble
mas-sacre	mas-sa-cre
yardage	yard-age
im-muno-sup-pres-sive	im-mu-no-sup-pres-sive
im-mea-sur-ably	im-meas-ur-a-bly
in-di-gestible	in-di-gest-i-ble
toady	toad-y
ca-nary	ca-nar-y
elec-toral	e-lec-tor-al
un-premed-i-tat-ed	un-pre-med-i-tat-ed
ide-o-log-i-cal	i-de-o-log-i-cal
moral	mor-al
dowdy	dow-dy
tweedy	tweed-y
Words with errors: 1796
Words with incorrect number of syllables: 1712
Total evluated: 6500
Perfect accuracy: 0.72
Number of syllables accuracy: 0.74
Average Levenshtein Distance(across incorrect words): 1.19
