Attempt	Real
un-apolo-getic	un-a-pol-o-get-ic
mono-lith-ic	mon-o-lith-ic
wag-gery	wag-ger-y
psy-chother-a-py	psy-cho-ther-a-py
pas-toral	pas-to-ral
mucky	muck-y
unar-guable	un-ar-gu-a-ble
com-man-der	com-mand-er
sa-tanism	sa-tan-ism
melee	me-lee
islet	is-let
uni-form-ly	u-ni-form-ly
chamomile	cham-o-mile
ally	al-ly
un-con-scionable	un-con-scion-a-ble
prospec-tive	pro-spec-tive
avens	av-ens
choline	cho-line
metempsy-chosis	me-tem-psy-cho-sis
monomol-e-c-u-lar	mon-o-mo-lec-u-lar
moped	mo-ped
delict	de-lict
wel-com-ing	wel-co-ming
far-away	far-a-way
mediocre	me-di-o-cre
necrop-o-lis	ne-crop-o-lis
schema	sche-ma
dis-pens-able	dis-pen-sa-ble
gloat-ing	gloating
in-scrutable	in-scru-ta-ble
over-shoot	o-ver-shoot
squally	squal-ly
delin-quen-cy	de-lin-quen-cy
recre-ation-al	rec-re-a-tion-al
ini-ti-ate	in-i-ti-ate
geno-cide	gen-o-cide
rub-bishy	rub-bish-y
gnom-ic	gno-mic
bi-modal	bi-mod-al
racism	rac-ism
poly-tech-nic	pol-y-tech-nic
in-valid	in-va-lid
cu-rare	cu-ra-re
beau-teous	beau-te-ous
machi-na-tion	mach-i-na-tion
epis-te-mo-log-i-cal	e-pis-te-mo-log-i-cal
bluesy	blues-y
spokes-woman	spokes-wom-an
cy-tochrome	cy-to-chrome
foot-balling	foot-ball-ing
flow-ery	flow-er-y
rel-a-tivis-tic	rel-a-tiv-is-tic
monothe-ism	mon-o-the-ism
con-cil-ia-tor	con-cil-i-a-tor
re-seller	re-sell-er
goa-tee	goat-ee
im-pro-pri-ety	im-pro-pri-e-ty
lifestyle	life-style
sky-scraper	sky-scrap-er
stratos-pher-ic	strat-o-spher-ic
mono-chro-mat-ic	mon-o-chro-mat-ic
novice	nov-ice
sav-agery	sav-age-ry
fetishism	fet-ish-ism
polypep-tide	pol-y-pep-tide
atoll	at-oll
panache	pa-nache
mid-wifery	mid-wife-ry
roughage	rough-age
up-lift-ed	uplifted
tablet	tab-let
romper	romp-er
in-ter-preter	in-ter-pret-er
bac-te-r-i-al	bac-te-ri-al
ra-tio-nal	ra-tion-al
ingress	in-gress
toady	toad-y
pre-sen-ta-tion-al	pres-en-ta-tion-al
un-der-e-d-u-cat-ed	un-der-ed-u-cat-ed
un-en-vi-able	un-en-vi-a-ble
paving	pav-ing
em-bolism	em-bo-lism
un-en-durable	un-en-dur-a-ble
in-de-pen-dence	in-de-pend-ence
con-vert-ible	con-vert-i-ble
tremo-lo	trem-o-lo
uniden-ti-fied	un-i-den-ti-fied
sus-tain-able	sus-tain-a-ble
semi-fi-nal	sem-i-fi-nal
catholic	cath-o-lic
eleventh	e-lev-enth
in-ter-op-er-abil-i-ty	in-ter-op-er-a-bil-i-ty
frip-pery	frip-per-y
tetrox-ide	te-trox-ide
oph-thalmic	oph-thal-mic
quest-ing	questing
in-de-scrib-able	in-de-scrib-a-ble
rapi-er	ra-pi-er
duress	du-ress
black-ened	blackened
plenipo-ten-tiary	plen-i-po-ten-ti-ar-y
ethno-graph-ic	eth-no-graph-ic
un-suit-able	un-suit-a-ble
furtive	fur-tive
blus-tery	blus-ter-y
oxy-moron	ox-y-mo-ron
no-tably	no-ta-bly
vagabond	vag-a-bond
opin-ion	o-pin-ion
baby-ish	ba-by-ish
eat-able	eat-a-ble
able	a-ble
gua-camole	gua-ca-mo-le
ini-tia-tor	in-i-ti-a-tor
es-pi-onage	es-pi-o-nage
dirty	dirt-y
fore-see-able	fore-see-a-ble
im-pass-able	im-pass-a-ble
flanker	flank-er
el-e-men-tary	el-e-men-ta-ry
dis-putable	dis-put-a-ble
shandy	shan-dy
pesti-len-tial	pes-ti-len-tial
de-viance	de-vi-ance
celeb	ce-leb
throaty	throat-y
hoard-ed	hoarded
repa-tri-a-tion	re-pa-tri-a-tion
dis-tri-b-u-tion	dis-tri-bu-tion
damni-fy	dam-ni-fy
syl-labus	syl-la-bus
pussy	pus-sy
re-li-able	re-li-a-ble
renum-ber	re-num-ber
tur-bocharg-er	tur-bo-charg-er
gherkin	gher-kin
scarci-ty	scar-ci-ty
spir-i-tu-al-ism	spir-it-u-al-ism
me-te-oric	me-te-or-ic
venue	ven-ue
eli-sion	e-li-sion
fidu-cia-ry	fi-du-ci-ar-y
un-trans-lat-able	un-trans-lat-a-ble
dis-ori-ent-ed	disoriented
de-ni-able	de-ni-a-ble
eti-quette	et-i-quette
turquoise	tur-quoise
ir-ra-tional-i-ty	ir-ra-tion-al-i-ty
vial	vi-al
trace-able	trace-a-ble
hair-styling	hairstyling
verisimil-i-tude	ver-i-si-mil-i-tude
con-trol-lable	con-trol-la-ble
miser-li-ness	mi-ser-li-ness
tib-ia	tib-i-a
deco-rum	de-co-rum
gai-ety	gai-e-ty
in-ter-change-ably	in-ter-change-a-bly
in-vari-ant	in-var-i-ant
tropopause	trop-o-pause
hi-jack-ing	hi-jac-king
pen-tathlon	pen-tath-lon
murky	murk-y
re-cidi-vist	re-cid-i-vist
ir-re-press-ible	ir-re-press-i-ble
lessee	les-see
tetchy	tetch-y
apoth-e-o-sis	a-poth-e-o-sis
over-whelm	o-ver-whelm
satin	sat-in
per-ineum	per-i-ne-um
despo-tism	des-pot-ism
pol-luter	pol-lut-er
verdi-gris	ver-di-gris
hazel	ha-zel
sapling	sap-ling
unau-dit-ed	un-au-dit-ed
pavil-ion	pa-vil-ion
piti-less	pit-i-less
un-nerv-ing	unnerving
front-ed	fronted
sloven-ly	slov-en-ly
im-pri-matur	im-pri-ma-tur
poignant-ly	poign-ant-ly
jus-ti-fi-able	jus-ti-fi-a-ble
sitar	si-tar
weary-ing	wea-ry-ing
psy-chopathol-o-gy	psy-cho-pa-thol-o-gy
con-ser-v-a-tive	con-serv-a-tive
aquar-i-um	a-quar-i-um
vac-uole	vac-u-ole
ple-beian	ple-be-ian
warthog	wart-hog
nugget	nug-get
com-pan-ion-able	com-pan-ion-a-ble
detox-i-fy	de-tox-i-fy
foamy	foam-y
ple-nary	ple-na-ry
be-atif-ic	be-a-tif-ic
best-selling	best-sell-ing
retroac-tive	ret-ro-ac-tive
breathy	breath-y
mega	meg-a
dis-agree-ment	dis-a-gree-ment
biop-sy	bi-op-sy
funky	funk-y
diploid	dip-loid
quater-nion	qua-ter-ni-on
stormer	storm-er
de-spon-den-cy	de-spond-en-cy
trea-son-able	trea-son-a-ble
com-paction	com-pac-tion
in-suf-fer-able	in-suf-fer-a-ble
apoplexy	ap-o-plex-y
markup	mark-up
he-li-copter	hel-i-cop-ter
undy-ing	un-dy-ing
censer	cen-ser
repast	re-past
mo-torist	mo-tor-ist
deep-en-ing	deepening
pro-pa-gan-da	prop-a-gan-da
springy	spring-y
epis-co-pa-cy	e-pis-co-pa-cy
slinky	slink-y
playfel-low	play-fel-low
semi-fi-nal-ist	sem-i-fi-nal-ist
wrestler	wres-tler
coleslaw	cole-slaw
repro-bate	rep-ro-bate
satire	sat-ire
gam-bling	gam-bling
fetish	fet-ish
eggshell	egg-shell
willpow-er	will-pow-er
imag-i-nary	im-ag-i-nar-y
post-mortem	post-mor-tem
ca-cao	ca-ca-o
lava	la-va
cam-era	cam-er-a
her-i-ta-ble	her-it-a-ble
gourmet	gour-met
en-vi-able	en-vi-a-ble
dosage	dos-age
prof-i-teer-ing	profiteering
un-com-fort-ably	un-com-fort-a-bly
en-doge-nous	en-dog-e-nous
bul-gy	bulg-y
zany	za-ny
shaven	shav-en
pur-port-ed	purported
curie	cu-rie
sub-servient	sub-ser-vi-ent
con-stab-u-lary	con-stab-u-lar-y
reis-sue	re-is-sue
umpteen	ump-teen
ex-cus-able	ex-cus-a-ble
slob-ber-ing	slobbering
mo-lesta-tion	mo-les-ta-tion
sur-vival	sur-viv-al
bracelet	brace-let
re-union	re-un-ion
wartime	war-time
poly-mor-phism	pol-y-mor-phism
ni-hilism	ni-hil-ism
reti-na	ret-i-na
im-mea-sur-ably	im-meas-ur-a-bly
heater	heat-er
wavelet	wave-let
ta-per-ing	ta-pe-ring
so-porif-ic	sop-o-rif-ic
chal-lenger	chal-leng-er
ge-ot-her-mal	ge-o-ther-mal
rescale	re-scale
astray	a-stray
owlet	owl-et
eigen-func-tion	ei-gen-func-tion
di-ary	di-a-ry
protest-ing	protesting
su-prema-cy	su-prem-a-cy
de-scend-ing	descending
rum-pled	rumpled
waxy	wax-y
surly	sur-ly
in-frared	in-fra-red
desider-a-tum	de-sid-er-a-tum
up-hol-stery	up-hol-ster-y
dy-namo	dy-na-mo
nurs-ery-man	nurs-er-y-man
marcher	march-er
stringy	string-y
unasked	un-asked
leader	lead-er
my-opia	my-o-pi-a
hys-terec-to-my	hys-ter-ec-to-my
metaphor	met-a-phor
con-juror	con-ju-ror
hostler	hos-tler
elic-it	e-lic-it
poly-merase	pol-y-mer-ase
balder-dash	bal-der-dash
at-ten-dant	at-tend-ant
phono-graph	pho-no-graph
se-lectee	se-lect-ee
peri	pe-ri
snowflake	snow-flake
cityscape	cit-y-scape
con-traindi-ca-tion	con-tra-in-di-ca-tion
bribery	brib-er-y
equip-ment	e-quip-ment
re-al-ness	real-ness
poly-the-is-tic	pol-y-the-is-tic
liken	lik-en
bizarre	bi-zarre
viol	vi-ol
tele-vise	tel-e-vise
midriff	mid-riff
rege-late	re-ge-late
un-frozen	un-fro-zen
manger	man-ger
piv-otal	piv-ot-al
retroac-tive-ly	ret-ro-ac-tive-ly
ren-dered	rendered
mesos-phere	mes-o-sphere
con-sid-er-able	con-sid-er-a-ble
gener-ic	ge-ner-ic
ex-oge-nous	ex-og-e-nous
blither-ing	blith-er-ing
briefer	brief-er
hege-mo-ny	he-gem-o-ny
phoneme	pho-neme
cast-away	cast-a-way
sophistry	soph-ist-ry
em-bryo	em-bry-o
elec-trode	e-lec-trode
di-gestible	di-gest-i-ble
para-sol	par-a-sol
sym-po-sium	sym-po-si-um
man-ager-ess	man-ag-er-ess
par-a-sitism	par-a-sit-ism
hypochon-dri-a-cal	hy-po-chon-dri-a-cal
en-tropy	en-tro-py
quan-tifi-ca-tion	quan-ti-fi-ca-tion
weaver	weav-er
un-san-i-tary	un-san-i-tar-y
seal-ing	sealing
su-perbly	su-perb-ly
unre-deemed	un-re-deemed
wicked-ness	wick-ed-ness
crenel-la-tions	cren-el-la-tions
cheesy	chees-y
apos-tolic	ap-os-tol-ic
book-binder	book-bind-er
podgy	podg-y
mer-cu-r-ial	mer-cu-ri-al
refugee	ref-u-gee
poly-phon-ic	pol-y-phon-ic
sala-cious	sa-la-cious
de-bauch-ery	de-bauch-er-y
ruin	ru-in
premis-es	prem-is-es
neonate	ne-o-nate
lazy	la-zy
epicy-cloid	ep-i-cy-cloid
transna-tion-al	trans-na-tion-al
telethon	tel-e-thon
where-abouts	where-a-bouts
restora-tive	re-stor-a-tive
white-washed	whitewashed
scur-rilous	scur-ril-ous
tripoli	trip-o-li
necro-man-cy	nec-ro-man-cy
rock-ery	rock-er-y
hermeneu-tic	her-me-neu-tic
re-sis-tant	re-sist-ant
eroti-cism	e-rot-i-cism
asym-met-ri-cal	a-sym-met-ri-cal
elec-tion	e-lec-tion
id-i-olect	id-i-o-lect
seg-ment-ed	seg-men-ted
prog-es-terone	pro-ges-ter-one
ined-i-ble	in-ed-i-ble
ashen	ash-en
in-ho-mo-ge-neous	in-ho-mo-ge-ne-ous
erec-tile	e-rec-tile
lament	la-ment
gelig-nite	gel-ig-nite
over-pass	o-ver-pass
over-step	o-ver-step
techno-pho-bia	tech-no-pho-bia
obe-di-ent-ly	o-be-di-ent-ly
onion	on-ion
ape-ri-od-ic	a-pe-ri-od-ic
en-treaty	en-treat-y
lulu	lu-lu
cryo-genic	cry-o-gen-ic
hos-pitable	hos-pi-ta-ble
frisky	frisk-y
over-am-bi-tious	o-ver-am-bi-tious
math-e-mati-cian	math-e-ma-ti-cian
diplo-ma-cy	di-plo-ma-cy
caramel	car-a-mel
hero-ic	he-ro-ic
user	us-er
lethal-ly	le-thal-ly
herbage	herb-age
as-cetic	as-cet-ic
louis	lou-is
ra-dionu-clide	ra-di-o-nu-clide
re-vo-ca-tion	rev-o-ca-tion
omega	o-me-ga
zealotry	zeal-ot-ry
union-ist	un-ion-ist
elab-o-ra-tion	e-lab-o-ra-tion
con-tem-po-rary	con-tem-po-rar-y
cheer-leader	cheer-lead-er
dullard	dull-ard
en-gi-neered	engineered
over-e-mo-tion-al	o-ver-e-mo-tion-al
vel-veteen	vel-vet-een
rely	re-ly
buoy	bu-oy
in-flat-able	in-flat-a-ble
rein-ven-tion	re-in-ven-tion
car-rion	car-ri-on
meta-mor-pho-sis	met-a-mor-pho-sis
discog-ra-phy	dis-cog-ra-phy
bazooka	ba-zoo-ka
plan-e-tary	plan-e-tar-y
bubon-ic	bu-bon-ic
sub-terfuge	sub-ter-fuge
colonist	col-o-nist
inkling	ink-ling
ravi-o-li	ra-vi-o-li
livid	liv-id
nineti-eth	nine-ti-eth
en-cycli-cal	en-cyc-li-cal
bristly	bris-tly
melody	mel-o-dy
theoc-ra-cy	the-oc-ra-cy
over-due	o-ver-due
per-ish-able	per-ish-a-ble
tun-able	tun-a-ble
squalor	squal-or
avoid	a-void
nadir	na-dir
lisp-ing	lis-ping
de-for-mi-ty	de-form-i-ty
wringer	wring-er
showy	show-y
sisal	si-sal
eman-ci-pa-tion	e-man-ci-pa-tion
par-a-sitic	par-a-sit-ic
perdi-tion	per-di-tion
ob-lig-ate	ob-li-gate
pinafore	pin-a-fore
serol-o-gy	se-rol-o-gy
ide-o-log-i-cal-ly	i-de-o-log-i-cal-ly
deathbed	death-bed
mas-cara	mas-car-a
bak-ery	bak-er-y
melan-cho-lia	mel-an-cho-li-a
decile	dec-ile
ex-plorato-ry	ex-plor-a-to-ry
un-print-able	un-print-a-ble
fri-ary	fri-ar-y
layabout	lay-a-bout
wash-er-woman	wash-er-wom-an
in-escapably	in-es-cap-a-bly
uri-nary	u-ri-nar-y
scruti-ny	scru-ti-ny
lava-to-ry	lav-a-to-ry
bion-ic	bi-on-ic
servi-tude	ser-vi-tude
oldie	old-ie
fly-over	fly-o-ver
mis-cel-lanea	mis-cel-la-ne-a
peremp-to-ry	per-emp-to-ry
degra-da-tion	deg-ra-da-tion
dumpy	dump-y
exe-unt	ex-e-unt
re-mark-ably	re-mark-a-bly
frosty	frost-y
run-away	run-a-way
va-grancy	va-gran-cy
overkill	o-ver-kill
in-stan-ta-neous	in-stan-ta-ne-ous
beanstalks	bean-stalks
place-bo	pla-ce-bo
atroc-i-ty	a-troc-i-ty
mag-ne-tos-phere	mag-ne-to-sphere
gleam-ing	gleaming
twofold	two-fold
stopover	stop-o-ver
ar-senic	ar-se-nic
trick-ery	trick-er-y
eclec-ti-cism	ec-lec-ti-cism
in-stan-ta-neous-ly	in-stan-ta-ne-ous-ly
in-nocu-ous	in-noc-u-ous
un-ob-serv-able	un-ob-serv-a-ble
show-ery	show-er-y
there-upon	there-up-on
dri-ver-less	driv-er-less
manes	ma-nes
chi-ropodist	chi-rop-o-dist
in-sipid	in-sip-id
ush-erette	ush-er-ette
litotes	li-to-tes
re-cov-ery	re-cov-er-y
drinker	drink-er
stron-tium	stron-ti-um
as-segai	as-se-gai
bio-chem-istry	bi-o-chem-is-try
bal-alai-ka	bal-a-lai-ka
in-spi-ra-tional	in-spi-ra-tion-al
grassy	grass-y
idio-syn-crat-ic	id-i-o-syn-crat-ic
triple	tri-ple
lamb-swool	lambs-wool
buf-foon-ery	buf-foon-er-y
an-swer-able	an-swer-a-ble
ex-pe-di-tionary	ex-pe-di-tion-ar-y
spon-tane-ity	spon-ta-ne-i-ty
elo-cu-tion	el-o-cu-tion
as-phyx-ia	as-phyx-i-a
es-capism	es-cap-ism
con-strict-ed	constricted
beefy	beef-y
man-dolin	man-do-lin
mor-tu-ary	mor-tu-ar-y
rhodo-den-dron	rho-do-den-dron
sor-cery	sor-cer-y
over-rate	o-ver-rate
princess	prin-cess
meringue	me-ringue
pleat-ed	pleated
re-alpoli-tik	re-al-po-li-tik
polon-aise	pol-o-naise
viril-i-ty	vi-ril-i-ty
hooray	hoo-ray
stovepipe	stove-pipe
baron-age	bar-on-age
cough-ing	coughing
spinal	spi-nal
ob-serv-able	ob-serv-a-ble
cradling	cra-dling
piti-ful-ly	pit-i-ful-ly
debonair	deb-o-nair
sce-nario	sce-nar-i-o
in-sa-tiable	in-sa-tia-ble
speller	spell-er
sales-woman	sales-wom-an
en-chant-ed	enchanted
hori-zon	ho-ri-zon
enig-ma	e-nig-ma
kosher	ko-sher
dis-hon-esty	dis-hon-es-ty
deli	del-i
un-quan-tifi-able	un-quan-ti-fi-a-ble
rein-car-nate	re-in-car-nate
pe-riphrastic	per-i-phras-tic
greasy	greas-y
any	an-y
along	a-long
jugu-lar	jug-u-lar
eon	e-on
awning	awn-ing
windswept	wind-swept
un-de-tectable	un-de-tect-a-ble
os-teopath	os-te-o-path
broadsword	broad-sword
erup-tion	e-rup-tion
aban-don	a-ban-don
vale-dic-tion	val-e-dic-tion
tenet	ten-et
as-cen-dant	as-cend-ant
schoolmistress	school-mis-tress
snig-ger-ing	sniggering
con-sum-able	con-sum-a-ble
di-ver-sion-ary	di-ver-sion-ar-y
par-tici-ple	par-ti-ci-ple
sinewy	sin-ew-y
hasti-ly	hast-i-ly
sec-toral	sec-tor-al
mili-tia-man	mi-li-tia-man
ovary	o-va-ry
over-haul	o-ver-haul
fi-deli-ty	fi-del-i-ty
apron	a-pron
seedbed	seed-bed
fum-bling	fumbling
di-rec-to-r-i-al	di-rec-to-ri-al
ia-tro-genic	i-at-ro-gen-ic
equable	eq-ua-ble
genoa	gen-o-a
risot-to	ri-sot-to
juicy	juic-y
ide-al-is-tic	i-de-al-is-tic
es-capist	es-cap-ist
in-ves-tiga-tive	in-ves-ti-ga-tive
macabre	ma-ca-bre
mul-ti-me-ter	mul-tim-e-ter
punter	punt-er
smoky	smok-y
heifer	heif-er
uvu-la	u-vu-la
icon-ic	i-con-ic
nar-ra-tol-ogy	nar-ra-tol-o-gy
baronet	bar-on-et
mer-chantable	mer-chant-a-ble
aton-ic	a-ton-ic
manome-ter	ma-nom-e-ter
cashew	cash-ew
pur-suant	pur-su-ant
meri-no	me-ri-no
colosto-my	co-los-to-my
com-modore	com-mo-dore
fetishis-tic	fet-ish-is-tic
unimag-in-able	un-im-ag-i-na-ble
elec-tri-cal	e-lec-tri-cal
ar-guably	ar-gu-a-bly
seance	se-ance
megawatt	meg-a-watt
patchy	patch-y
perky	perk-y
reusable	re-us-a-ble
sier-ra	si-er-ra
un-de-sir-able	un-de-sir-a-ble
april	a-pril
reci-procity	rec-i-proc-i-ty
killing	kill-ing
reser-voir	res-er-voir
so-lace	sol-ace
sabra	sa-bra
rein-car-na-tion	re-in-car-na-tion
aban-don-ment	a-ban-don-ment
eval-u-a-tive	e-val-u-a-tive
ever-last-ing	ev-er-last-ing
trans-for-ma-tive	trans-form-a-tive
un-processed	un-proc-essed
re-gret-table	re-gret-ta-ble
welder	weld-er
ionos-phere	i-on-o-sphere
busker	busk-er
spillage	spill-age
hec-tor-ing	hectoring
over-sight	o-ver-sight
shaman-ic	sha-man-ic
an-tifreeze	an-ti-freeze
syl-labub	syl-la-bub
emis-sion	e-mis-sion
foible	foi-ble
whiskey	whis-key
arch-dio-cese	arch-di-o-cese
unso-cial	un-so-cial
stager	stag-er
elastin	e-las-tin
oa-sis	o-a-sis
debu-tante	deb-u-tante
atri-um	a-tri-um
retic-u-lum	re-tic-u-lum
forepaw	fore-paw
prepar-a-tive	pre-par-a-tive
inim-itable	in-im-i-ta-ble
un-prov-able	un-prov-a-ble
aware-ness	a-ware-ness
mighty	might-y
ar-bi-trari-ness	ar-bi-trar-i-ness
gazelle	ga-zelle
gloomy	gloom-y
dais	da-is
pro-tease	pro-te-ase
undis-mayed	un-dis-mayed
boatswain	boat-swain
sub-ur-bia	sub-ur-bi-a
trea-sur-er	treas-ur-er
nascent	nas-cent
sev-ered	severed
mod-ernism	mod-ern-ism
un-re-solv-able	un-re-solv-a-ble
statu-to-ry	stat-u-to-ry
fora-men	fo-ra-men
rangy	rang-y
mirac-u-lous	mi-rac-u-lous
con-spir-a-to-r-i-al	con-spir-a-to-ri-al
award	a-ward
pro-tea	pro-te-a
lawyer	law-yer
ugly	ug-ly
sub-servience	sub-ser-vi-ence
cesspit	cess-pit
floozy	floo-zy
un-charis-mat-ic	un-char-is-mat-ic
odor-ous	o-dor-ous
over	o-ver
aton-al	a-ton-al
deluxe	de-luxe
teatime	tea-time
power-boat	pow-er-boat
dean-ery	dean-er-y
in-ter-plan-e-tary	in-ter-plan-e-tar-y
ini-ti-a-tion	in-i-ti-a-tion
agree-ment	a-gree-ment
in-ex-press-ible	in-ex-press-i-ble
over-pro-duced	overproduced
con-stituent	con-stit-u-ent
api-an	a-pi-an
un-for-giv-able	un-for-giv-a-ble
paren-the-sis	pa-ren-the-sis
pig-ment-ed	pig-men-ted
isosce-les	i-sos-ce-les
velum	ve-lum
causal-ly	caus-al-ly
abuse	a-buse
no-ti-fi-able	no-ti-fi-a-ble
winger	wing-er
tri-umphant	tri-um-phant
oner	on-er
cesspool	cess-pool
skimpy	skimp-y
bre-viary	bre-vi-ar-y
preva-lent	prev-a-lent
lucky	luck-y
pan-golin	pan-go-lin
de-gauss-ing	degaussing
print-able	print-a-ble
lapel	la-pel
out-stretched	outstretched
deca-dence	dec-a-dence
maxi	max-i
steeple-chase	stee-ple-chase
isother-mal	i-so-ther-mal
wafer	wa-fer
read-abil-i-ty	read-a-bil-i-ty
as-pirin	as-pi-rin
ver-biage	ver-bi-age
hauli-er	haul-ier
notepad	note-pad
com-plain-ing	complaining
in-dis-tin-guish-able	in-dis-tin-guish-a-ble
evan-gel-i-cal	e-van-gel-i-cal
blis-tered	blistered
clavi-chord	clav-i-chord
epi-graph	ep-i-graph
soma	so-ma
bal-cony	bal-co-ny
gas-troin-testi-nal	gas-tro-in-tes-ti-nal
di-ana	di-an-a
spec-troscopy	spec-tros-co-py
iso-tope	i-so-tope
neo-prene	ne-o-prene
shilling	shil-ling
culi-nary	cu-li-nar-y
filmic	film-ic
con-fec-tionery	con-fec-tion-er-y
gen-er-a-tional	gen-er-a-tion-al
union	un-ion
an-techam-ber	an-te-cham-ber
re-assess	re-as-sess
ge-o-mag-net-i-cal-ly	ge-o-mag-ne-ti-cal-ly
telling	tell-ing
pe-cu-niary	pe-cu-ni-ar-y
mar-tinet	mar-ti-net
wear-able	wear-a-ble
ob-tain-able	ob-tain-a-ble
atyp-i-cal	a-typ-i-cal
humerus	hu-mer-us
ki-mono	ki-mo-no
un-nat-ur-al	un-nat-u-ral
con-sular	con-su-lar
fo-liage	fo-li-age
pigsty	pig-sty
uni-ver-si-ty	u-ni-ver-si-ty
veni-son	ven-i-son
avid-i-ty	a-vid-i-ty
phy-loge-ny	phy-log-e-ny
promi-nence	prom-i-nence
grouchy	grouch-y
penul-ti-mate	pe-nul-ti-mate
halon	hal-on
biotech-nol-o-gy	bi-o-tech-nol-o-gy
risky	risk-y
dy-nasty	dy-nas-ty
gu-nite	gun-ite
in-de-pen-dent-ly	in-de-pend-ent-ly
arise	a-rise
decla-ma-tion	dec-la-ma-tion
tri-tium	trit-i-um
debtor	debt-or
pelvis	pel-vis
so-ci-ety	so-ci-e-ty
halo-gen	hal-o-gen
whisker	whisk-er
gen-i-talia	gen-i-ta-li-a
antonym	an-to-nym
ex-pi-ra-to-ry	ex-pir-a-to-ry
give-away	give-a-way
bailiff	bail-iff
dis-parate	dis-pa-rate
leg-isla-tive	leg-is-la-tive
tute-lage	tu-te-lage
midair	mid-air
against	a-gainst
iden-ti-fy	i-den-ti-fy
mar-ke-teer	mar-ket-eer
busi-ness-woman	busi-ness-wom-an
preschool	pre-school
squeaky	squeak-y
clam-p-down	clamp-down
slater	slat-er
im-prison	im-pris-on
macro	mac-ro
teenage	teen-age
raspy	rasp-y
psalmody	psal-mo-dy
freely	free-ly
chrono-log-i-cal-ly	chron-o-log-i-cal-ly
block-buster	block-bust-er
uni-lat-er-al	u-ni-lat-er-al
astern	a-stern
anger	an-ger
me-nial	me-ni-al
be-whiskered	be-whisk-ered
rainy	rain-y
diskette	disk-ette
valiant-ly	val-iant-ly
askance	a-skance
cor-morant	cor-mo-rant
toughie	tough-ie
promis-so-ry	prom-is-so-ry
in-de-ter-minable	in-de-ter-mi-na-ble
sneer-ing	sneering
opi-ate	o-pi-ate
stu-dentship	stu-dent-ship
silky	silk-y
ego-ma-nia	e-go-ma-ni-a
ion-ic	i-on-ic
herba-ceous	her-ba-ceous
so-cio-bi-ol-o-gy	so-ci-o-bi-ol-o-gy
in-ad-vis-able	in-ad-vis-a-ble
at-trib-ut-able	at-trib-ut-a-ble
reap-pear-ance	re-ap-pear-ance
arable	ar-a-ble
rooftop	roof-top
wretched	wretch-ed
feath-ery	feath-er-y
axle	ax-le
ethics	eth-ics
video-taped	videotaped
colon-nade	col-on-nade
bodice	bod-ice
baby	ba-by
stat-uette	stat-u-ette
mag-ne-sium	mag-ne-si-um
valid-ly	val-id-ly
penin-su-la	pen-in-su-la
tum-bled	tumbled
meta-bol-ic	met-a-bol-ic
emer-ald	em-er-ald
quizzi-cal	quiz-zi-cal
aphid	a-phid
ashy	ash-y
emer-i-tus	e-mer-i-tus
itin-er-ary	i-tin-er-ar-y
wom-ankind	wom-an-kind
counter	coun-ter
salty	salt-y
bases	ba-ses
callable	call-a-ble
car-cino-gen-e-sis	car-cin-o-gen-e-sis
fusil-lade	fu-sil-lade
melod-ic	me-lod-ic
scat-tered	scattered
glossy	gloss-y
in-san-i-tary	in-san-i-tar-y
car-cino-genic	car-cin-o-gen-ic
oculist	oc-u-list
rein-ter-pre-ta-tion	re-in-ter-pre-ta-tion
in-ter-roga-tor	in-ter-ro-ga-tor
pre-pared-ness	pre-par-ed-ness
io-dine	i-o-dine
loft-ed	lofted
re-arrange	re-ar-range
steve-dore	ste-ve-dore
salaried	sal-a-ried
grapeshot	grape-shot
sphyg-mo-manome-ter	sphyg-mo-ma-nom-e-ter
re-sis-tance	re-sist-ance
lazy-bones	la-zy-bones
con-sumer	con-sum-er
shaman	sha-man
pedantry	ped-ant-ry
brazen	bra-zen
lit-er-ary	lit-er-ar-y
giro	gi-ro
chi-ropody	chi-rop-o-dy
neme-sis	nem-e-sis
lurid	lu-rid
damper	damp-er
im-preg-nable	im-preg-na-ble
ex-ult-ing	exulting
turn-about	turn-a-bout
legal-ly	le-gal-ly
dimwit	dim-wit
lira	li-ra
napoleon	na-po-le-on
re-strain-ing	restraining
edit-ed	edited
repli-ca	rep-li-ca
in-ter-lock-ing	in-ter-loc-king
util-i-tar-i-an-ism	u-til-i-tar-i-an-ism
felo-nious	fe-lo-ni-ous
wardrobe	ward-robe
bad-minton	bad-min-ton
aca-d-e-m-ic	ac-a-dem-ic
warmer	warm-er
triage	tri-age
monog-a-mous	mo-nog-a-mous
col-lec-tivi-sa-tion	col-lec-ti-vi-sa-tion
mini-bar	min-i-bar
writer	writ-er
madri-gal	mad-ri-gal
ef-fron-tery	ef-fron-ter-y
or-ga-nized	or-gan-ized
spoilage	spoil-age
bib-lio-phile	bib-li-o-phile
flut-tery	flut-ter-y
lech-ery	lech-er-y
melan-choly	mel-an-chol-y
japon-i-ca	ja-pon-i-ca
bond-ing	bonding
hy-drangea	hy-dran-gea
undis-tin-guished	un-dis-tin-guished
gob-bledy-gook	gob-ble-dy-gook
cu-rios-i-ty	cu-ri-os-i-ty
schemer	schem-er
bur-geon-ing	burgeoning
babysit-ter	ba-by-sit-ter
over-loaded	overloaded
javelin	jave-lin
vinyl	vi-nyl
stag-ger-ing	staggering
cred-itable	cred-it-a-ble
in-cen-di-ary	in-cen-di-ar-y
restora-tion	res-to-ra-tion
fundrais-ing	fund-rais-ing
con-fronta-tion	con-fron-ta-tion
data	da-ta
apol-o-gy	a-pol-o-gy
dumpling	dump-ling
dactylic	dac-tyl-ic
over-dra-mat-ic	o-ver-dra-mat-ic
barony	bar-o-ny
gumshoe	gum-shoe
monas-tic	mo-nas-tic
com-mend-ably	com-mend-a-bly
de-riva-tion	der-i-va-tion
owlish	owl-ish
in-es-timable	in-es-ti-ma-ble
satel-lite	sat-el-lite
moral	mor-al
hubris-tic	hu-bris-tic
jokey	jok-ey
breather	breath-er
re-ori-en-ta-tion	re-o-ri-en-ta-tion
un-rea-son-ably	un-rea-son-a-bly
ap-proach-ing	approaching
strate-gist	strat-e-gist
cour-t-house	court-house
glitzy	glitz-y
mi-mosa	mi-mo-sa
om-ni-science	om-nis-cience
veto	ve-to
fa-nati-cism	fa-nat-i-cism
dili-gent-ly	dil-i-gent-ly
pa-pri-ka	pap-ri-ka
the-o-reti-cian	the-o-re-ti-cian
cer-tifi-cate	cer-tif-i-cate
pec-toral	pec-to-ral
aper-i-tif	a-pe-ri-tif
felon	fel-on
para-mount	par-a-mount
pyrite	py-rite
urchin	ur-chin
pectin	pec-tin
elfin	elf-in
gaucherie	gau-che-rie
py-rotech-nic	py-ro-tech-nic
moorhen	moor-hen
shoring	shor-ing
here-abouts	here-a-bouts
crypt-analy-sis	crypt-a-nal-y-sis
un-linked	unlinked
painkiller	pain-kil-ler
bur-sary	bur-sa-ry
hauler	haul-er
retro-fit	ret-ro-fit
desul-to-ry	des-ul-to-ry
id-io-cy	id-i-o-cy
laugh-able	laugh-a-ble
stipen-di-ary	sti-pen-di-ar-y
wran-gling	wrangling
al-ready	al-read-y
whichev-er	which-ev-er
gui-tarist	gui-tar-ist
do-lerite	dol-er-ite
as-cen-dan-cy	as-cend-an-cy
any-one	an-y-one
con-ceiv-able	con-ceiv-a-ble
mon-e-tarism	mon-e-ta-rism
su-prema-cist	su-prem-a-cist
en-crust-ed	encrusted
wa-ver-ing	wavering
ir-res-olute	ir-res-o-lute
lov-able	lov-a-ble
un-du-lat-ing	un-du-la-ting
iron-works	i-ron-works
an-tithe-sis	an-tith-e-sis
pur-suance	pur-su-ance
wa-terbed	wa-ter-bed
growl-ing	growling
dis-am-biguate	dis-am-big-u-ate
brava-do	bra-va-do
averse	a-verse
com-mis-sioned	commissioned
squeegee	squee-gee
agree	a-gree
en-treat-ing	entreating
tonal-i-ty	to-nal-i-ty
meta-lan-guage	met-a-lan-guage
be-lea-guered	beleaguered
un-ques-tion-able	un-ques-tion-a-ble
gavial	ga-vi-al
anony-mous	a-non-y-mous
rapid-ly	rap-id-ly
opera	o-pe-ra
any-way	an-y-way
song-writer	song-writ-er
ate-lier	at-el-ier
har-mo-nious	har-mo-ni-ous
playable	play-a-ble
elec-trophore-sis	e-lec-tro-pho-re-sis
delir-i-um	de-lir-i-um
chasti-ty	chas-ti-ty
semi-con-duct-ing	sem-i-con-duct-ing
pho-to-genic	pho-to-gen-ic
par-si-mo-nious	par-si-mo-ni-ous
droplet	drop-let
chrono-log-i-cal	chron-o-log-i-cal
helper	help-er
styl-is-tics	sty-lis-tics
stiffly	stiff-ly
clam-orous	clam-or-ous
syrup	syr-up
liftoff	lift-off
glac-i-er	gla-cier
evoca-tive	e-voc-a-tive
hero-ical-ly	he-ro-i-cal-ly
over-drive	o-ver-drive
po-ten-tial-i-ty	po-ten-ti-al-i-ty
found-ing	founding
gos-sipy	gos-sip-y
di-nosaur	di-no-saur
va-ri-etal	va-ri-e-tal
over-throw	o-ver-throw
pre-dictabil-i-ty	pre-dict-a-bil-i-ty
im-peri-um	im-pe-ri-um
panoply	pan-o-ply
thiev-ery	thiev-er-y
no-table	no-ta-ble
crisper	crisp-er
sander	sand-er
pinkie	pink-ie
choral	cho-ral
un-der-stand-ably	un-der-stand-a-bly
gale-na	ga-le-na
sodi-um	so-di-um
ru-ina-tion	ru-in-a-tion
in-vig-o-rat-ing	in-vig-or-at-ing
po-litesse	pol-i-tesse
re-assess-ment	re-as-sess-ment
ex-tra-or-di-nary	ex-traor-di-nar-y
mono-pole	mon-o-pole
paci-fy	pac-i-fy
statute	stat-ute
psy-cho-me-t-ric	psy-cho-met-ric
satyr	sa-tyr
re-stroom	rest-room
phrenol-o-gy	phre-nol-o-gy
colos-sus	co-los-sus
pro-to-zoan	pro-to-zo-an
snifter	snif-ter
fi-nale	fi-na-le
me-thio-n-ine	me-thi-o-nine
ogre	o-gre
uni-cy-cle	u-ni-cy-cle
my-ocar-dial	my-o-car-di-al
post-mod-ernist	post-mod-ern-ist
ini-tial	in-i-tial
spinach	spin-ach
detox-i-fi-ca-tion	de-tox-i-fi-ca-tion
randy	rand-y
telecom-mu-ni-ca-tion	tel-e-com-mu-ni-ca-tion
saucy	sau-cy
pen-i-ten-tiary	pen-i-ten-tia-ry
raisin	rai-sin
di-aphanous	di-aph-a-nous
idio-syn-crasy	id-i-o-syn-cra-sy
over-pay-ment	o-ver-pay-ment
athe-ist	a-the-ist
cos-mopoli-tan	cos-mo-pol-i-tan
caprice	ca-price
diplo-mat	dip-lo-mat
tai-lorable	tai-lor-a-ble
viceroy	vice-roy
blaster	blast-er
elvish	elv-ish
mantling	man-tling
vary	var-y
avail-able	a-vail-a-ble
boyfriend	boy-friend
eigen-state	ei-gen-state
un-elect-ed	un-e-lect-ed
padding	pad-ding
also	al-so
beaver	bea-ver
elude	e-lude
con-fi-den-tial-i-ty	con-fi-den-ti-al-i-ty
stock-bro-ker	stock-brok-er
trencher	trench-er
doubtless-ly	doubt-less-ly
holy	ho-ly
phys-io-ther-a-py	phys-i-o-ther-a-py
at-tribute	at-trib-ute
inkwell	ink-well
vestibu-lar	ves-tib-u-lar
ero-sion	e-ro-sion
su-per-cil-ious	su-per-cil-i-ous
pouter	pout-er
tourni-quet	tour-ni-quet
doyen	doy-en
an-te-dilu-vian	an-te-di-lu-vi-an
hedgerow	hedge-row
silo	si-lo
over-stretch	o-ver-stretch
in-evitabil-i-ty	in-ev-i-ta-bil-i-ty
liq-uida-tor	liq-ui-da-tor
promi-nent-ly	prom-i-nent-ly
dizzi-ness	diz-zi-ness
fre-quent-ed	frequented
hexa-gram	hex-a-gram
over-land	o-ver-land
renowned	re-nowned
un-ob-ser-vant	un-ob-serv-ant
unassertive	un-as-ser-tive
psy-chi-atric	psy-chi-at-ric
deben-ture	de-ben-ture
holdall	hold-all
con-sumerist	con-sum-er-ist
preser-va-tion	pres-er-va-tion
haver-sack	hav-er-sack
co-pra	cop-ra
rock-et-ing	rocketing
ser-vant	serv-ant
balmy	balm-y
quiv-er-ing	quivering
im-muno-com-pro-mised	im-mu-no-com-pro-mised
astride	a-stride
epig-ra-phy	e-pig-ra-phy
defy	de-fy
scream-ing	screaming
trust-ed	trusted
per-ilous-ly	per-il-ous-ly
arthro-pod	ar-thro-pod
mar-riage-able	mar-riage-a-ble
hunter	hunt-er
for-warder	for-ward-er
mi-croor-gan-ism	mi-cro-or-gan-ism
in-equal-i-ty	in-e-qual-i-ty
platy-pus	plat-y-pus
melt-ing	melting
groupie	group-ie
prophet-ic	pro-phet-ic
re-dis-cov-ery	re-dis-cov-er-y
un-sink-able	un-sink-a-ble
un-e-lec-table	un-e-lect-a-ble
testis	tes-tis
de-pen-den-cy	de-pend-en-cy
bonobo	bo-no-bo
de-ser-ti-fi-ca-tion	de-sert-i-fi-ca-tion
real	re-al
usury	u-su-ry
tri-bunal	tri-bu-nal
green-ery	green-er-y
con-sul-tan-cy	con-sult-an-cy
seren-i-ty	se-ren-i-ty
mores	mo-res
de-pen-dent	de-pend-ent
badtem-pered	bad-tem-pered
eu-phemism	eu-phe-mism
oviduct	o-vi-duct
re-place-able	re-place-a-ble
lack-adaisi-cal	lack-a-dai-si-cal
draftee	draft-ee
holo-caust	hol-o-caust
over-heat	o-ver-heat
at-tack-ing	attacking
grouper	group-er
qua-dru-pli-cate	quad-ru-pli-cate
cli-toris	clit-o-ris
breast-feed-ing	breastfeeding
per-pe-tu-ity	per-pe-tu-i-ty
sala-man-der	sal-a-man-der
bio-morph	bi-o-morph
lul-la-by	lull-a-by
judo	ju-do
flamin-go	fla-min-go
laden	lad-en
gospel	gos-pel
machis-mo	ma-chis-mo
crazi-ness	cra-zi-ness
aque-duct	aq-ue-duct
glut-tony	glut-ton-y
euro	eu-ro
toluene	tol-u-ene
re-versed	reversed
una-nim-i-ty	u-na-nim-i-ty
hourly	hour-ly
sharp-en-er	shar-pen-er
foren-sic	fo-ren-sic
un-usu-al-ly	un-u-su-al-ly
aqua-ma-rine	aq-ua-ma-rine
over-win-ter	o-ver-win-ter
ex-is-tence	ex-ist-ence
ge-nom-ic	ge-no-mic
castel-lat-ed	cas-tel-lat-ed
crevice	crev-ice
hosan-na	ho-san-na
mar-que	marque
pre-sentable	pre-sent-a-ble
blessed	bless-ed
molten	mol-ten
reuse	re-use
friendlily	friend-li-ly
elab-o-rate	e-lab-o-rate
geezer	gee-zer
nestling	nest-ling
au-dio-vi-su-al	au-di-o-vis-u-al
moist-en	mois-ten
navvy	nav-vy
kitch-enette	kitch-en-ette
so-lic-it-ing	soliciting
over-es-ti-ma-tion	o-ver-es-ti-ma-tion
in-elas-tic	in-e-las-tic
springer	spring-er
un-men-tion-able	un-men-tion-a-ble
orca	or-ca
sepul-chral	se-pul-chral
philoso-pher	phi-los-o-pher
climber	climb-er
arrange	ar-range
goatskin	goat-skin
ra-dia-tive	ra-di-a-tive
hussy	hus-sy
in-hibitor	in-hib-i-tor
semi-cir-cu-lar	sem-i-cir-cu-lar
armpit	arm-pit
bio-chemist	bi-o-chem-ist
in-ter-dis-ci-pli-nary	in-ter-dis-ci-pli-nar-y
prepo-si-tion-al	prep-o-si-tion-al
over-sen-si-tive	o-ver-sen-si-tive
marten	mar-ten
surgery	sur-ger-y
eatery	eat-er-y
mankind	man-kind
poly-atom-ic	pol-y-a-tom-ic
un-avoid-ably	un-a-void-a-bly
recheck	re-check
ref-er-ee-ing	re-fe-ree-ing
moray	mo-ray
para-met-ric	par-a-met-ric
atom-ic	a-tom-ic
goofy	goof-y
tele-scop-ic	tel-e-scop-ic
elec-tric-i-ty	e-lec-tric-i-ty
slimy	slim-y
lega-tor	le-ga-tor
kilo-ton	kil-o-ton
flashy	flash-y
sleepy	sleep-y
radar	ra-dar
spooky	spook-y
julep	ju-lep
rheumat-ics	rheu-mat-ics
punch-line	punchline
sender	send-er
un-con-quer-able	un-con-quer-a-ble
pre-de-ter-mined	predetermined
sawyer	saw-yer
bio-engi-neer-ing	bi-o-en-gi-neer-ing
unabridged	un-a-bridged
zona-tion	zo-na-tion
ravine	ra-vine
poly-syl-lab-ic	pol-y-syl-lab-ic
symp-to-matic	symp-to-mat-ic
lol-lipop	lol-li-pop
gestalt	ge-stalt
fleshy	flesh-y
arranger	ar-rang-er
un-be-liev-able	un-be-liev-a-ble
com-pen-sato-ry	com-pen-sa-to-ry
pornog-ra-phy	por-nog-ra-phy
turnout	turn-out
haulage	haul-age
propul-sive	pro-pul-sive
table-cloth	ta-ble-cloth
qui-etus	qui-e-tus
utopi-an	u-to-pi-an
charge-able	charge-a-ble
in-fantry-man	in-fan-try-man
coax-ing	coaxing
preterite	pret-er-ite
coca	co-ca
re-pairable	re-pair-a-ble
billing	bil-ling
frailty	frail-ty
quixot-ic	quix-ot-ic
astir	a-stir
jour-nalese	jour-nal-ese
mine-strone	min-e-stro-ne
lament-ed	la-ment-ed
courage	cour-age
sporran	spor-ran
taxi	tax-i
poly-mer	pol-y-mer
corky	cork-y
pro-tean	pro-te-an
in-vol-un-tary	in-vol-un-tar-y
oily	oil-y
pho-tog-ra-ph-er	pho-tog-ra-pher
mem-o-rable	mem-o-ra-ble
garter	gar-ter
co-gency	co-gen-cy
elec-tro-sta-t-ics	e-lec-tro-stat-ics
skew-ered	skewered
rigid-i-ty	ri-gid-i-ty
berserk	ber-serk
chock-ablock	chock-a-block
hon-esty	hon-es-ty
cryp-togram	cryp-to-gram
muti-nous	mu-ti-nous
aper-ture	ap-er-ture
di-ure-sis	di-u-re-sis
bac-carat	bac-ca-rat
liquor	liq-uor
in-con-tro-vert-ible	in-con-tro-vert-i-ble
re-cidi-vism	re-cid-i-vism
tawdry	taw-dry
de-mo-graph-ics	dem-o-graph-ics
eardrum	ear-drum
ap-proval	ap-prov-al
in-ter-vie-wee	in-ter-view-ee
con-queror	con-quer-or
sabo-teur	sab-o-teur
habi-tat	hab-i-tat
charis-mat-ic	char-is-mat-ic
per-fidy	per-fi-dy
ju-di-cia-ry	ju-di-ci-ar-y
vivi-sec-tion	viv-i-sec-tion
diesel	die-sel
sali-va	sa-li-va
em-ploy-able	em-ploy-a-ble
mono-graph	mon-o-graph
chaos	cha-os
pewter	pew-ter
evan-ge-lis-tic	e-van-ge-lis-tic
felony	fel-o-ny
kinswoman	kins-wom-an
hectare	hec-tare
ex-clu-sion-ary	ex-clu-sion-ar-y
top-i-ary	to-pi-ar-y
cu-rat-ed	curated
palace	pal-ace
oblig-ing-ly	o-blig-ing-ly
heavy-weight	heav-y-weight
the-atri-cals	the-at-ri-cals
ir-re-versible	ir-re-vers-i-ble
twitchy	twitch-y
coro-nary	cor-o-nar-y
pop-ulism	pop-u-lism
atop	a-top
in-fir-mary	in-fir-ma-ry
groom-ing	grooming
in-ex-haustible	in-ex-haust-i-ble
ar-biter	ar-bi-ter
unan-swered	un-an-swered
ra-bid	rab-id
laity	la-i-ty
chas-ten-ing	chastening
rounder	round-er
overop-ti-mistic	o-ver-op-ti-mis-tic
medic	med-ic
palimpsest	pal-imp-sest
ter-raform	ter-ra-form
oxy-gen	ox-y-gen
provo-ca-tion	prov-o-ca-tion
un-no-tice-able	un-no-tice-a-ble
labyrinth	lab-y-rinth
some-body	some-bod-y
menswear	mens-wear
as-bestos	as-bes-tos
asun-der	a-sun-der
tiny	ti-ny
monogamy	mo-nog-a-my
icon-o-clast	i-con-o-clast
un-ortho-doxy	un-or-tho-dox-y
azure	az-ure
crin-kled	crinkled
promon-to-ry	prom-on-to-ry
mel-liflu-ous	mel-lif-lu-ous
ban-knote	bank-note
un-ordered	un-or-dered
hy-drazine	hy-dra-zine
evac-u-a-tion	e-vac-u-a-tion
lava-to-r-i-al	lav-a-to-ri-al
lam-plit	lamp-lit
eter-nal	e-ter-nal
evil	e-vil
in-equitable	in-eq-ui-ta-ble
rec-i-p-ro-cate	re-cip-ro-cate
over-pay	o-ver-pay
coro-ner	cor-o-ner
ro-mancer	ro-manc-er
asyn-chro-nous	a-syn-chro-nous
un-so-licit-ed	un-so-lic-it-ed
hy-per-bole	hy-per-bo-le
atavism	at-a-vism
homi-ly	hom-i-ly
dio-cese	di-o-cese
tempter	tempt-er
resched-ule	re-sched-ule
kitchen	kitch-en
roulette	rou-lette
me-te-o-ro-log-i-cal	me-te-or-o-log-i-cal
le-gionary	le-gion-ar-y
lop-sided	lop-sid-ed
dis-able	dis-a-ble
ru-inous	ru-in-ous
unloved	un-loved
slip-pery	slip-per-y
renter	rent-er
equal-ly	e-qual-ly
di-atom-ic	di-a-tom-ic
tsuna-mi	tsu-na-mi
polit-buro	po-lit-bu-ro
re-liance	re-li-ance
an-thracite	an-thra-cite
de-press-ing	de-pres-sing
think-able	think-a-ble
mytho-log-i-cal	myth-o-log-i-cal
vic-to-ria	vic-to-ri-a
aris-to-crat-ic	a-ris-to-crat-ic
sideshow	side-show
testos-terone	tes-tos-ter-one
shiny	shin-y
ocean	o-cean
babes	babes
the-saurus	the-sau-rus
boater	boat-er
recom-mence	re-com-mence
prison	pris-on
ha-track	hat-rack
baleen	ba-leen
dis-ori-ent	dis-o-ri-ent
un-opened	un-o-pened
avi-ate	a-vi-ate
philol-o-gy	phi-lol-o-gy
pedestal	ped-es-tal
poli-ty	pol-i-ty
cadet	ca-det
domi-no	dom-i-no
cider	ci-der
snorkel	snor-kel
rein-sert	re-in-sert
amused	a-mused
stretchy	stretch-y
fash-ion-able	fash-ion-a-ble
stargaze	star-gaze
gymkhana	gym-kha-na
ma-hogany	ma-hog-a-ny
stature	stat-ure
moral-ist	mor-al-ist
ob-jec-tion-able	ob-jec-tion-a-ble
eva-sive	e-va-sive
per-e-stroi-ka	pe-re-stroi-ka
silken	silk-en
fleecy	fleec-y
undis-closed	un-dis-closed
glit-tery	glit-ter-y
dis-tillery	dis-till-er-y
seafood	sea-food
gravedig-ger	grave-dig-ger
vex-ing	vexing
sys-temic	sys-tem-ic
thruster	thrust-er
over-charge	o-ver-charge
syn-chrony	syn-chro-ny
pirou-ette	pir-ou-ette
com-menter	com-ment-er
tu-ition	tu-i-tion
hang-glid-ed	hang-gli-ded
canon-i-cal	ca-non-i-cal
catheter	cath-e-ter
cuprous	cu-prous
bound-ary	bound-a-ry
sportive	spor-tive
guille-mot	guil-le-mot
pikestaff	pike-staff
sum-mery	sum-mer-y
tuba	tu-ba
chunky	chunk-y
porno-graph-ic	por-no-graph-ic
weasel	wea-sel
lad-dered	laddered
anvil	an-vil
monar-chy	mon-ar-chy
un-bridge-able	un-bridge-a-ble
pro-pri-etor-ship	pro-pri-e-tor-ship
in-fini-tive	in-fin-i-tive
is-lander	is-land-er
metro	met-ro
in-ter-change-able	in-ter-change-a-ble
as-sured-ly	as-sur-ed-ly
duet	du-et
uten-sil	u-ten-sil
re-gret-tably	re-gret-ta-bly
avalanche	av-a-lanche
aro-matic-i-ty	ar-o-ma-tic-i-ty
idol	i-dol
doorstop	door-stop
foghorn	fog-horn
aphro-disi-ac	aph-ro-dis-i-ac
radix	ra-dix
over-ween-ing	o-ver-ween-ing
ra-di-ograph	ra-di-o-graph
scan-dalous	scan-dal-ous
es-tu-ary	es-tu-ar-y
baroque	ba-roque
gecko	geck-o
cy-tol-ogy	cy-tol-o-gy
pro-tec-torate	pro-tec-tor-ate
fundrais-er	fund-rais-er
apart	a-part
vis-i-ta-tion	vis-it-a-tion
salver	sal-ver
wrap-around	wrap-a-round
hero-in	her-o-in
eval-u-a-tion	e-val-u-a-tion
nifty	nif-ty
turn-around	turn-a-round
uniden-ti-fi-able	un-i-den-ti-fi-a-ble
par-enter-al	par-en-ter-al
sausage	sau-sage
coun-ter-in-tu-itive	coun-ter-in-tu-i-tive
athe-is-tic	a-the-is-tic
ephemera	e-phem-er-a
aro-mather-a-py	a-ro-ma-ther-a-py
lyric	lyr-ic
mar-chioness	mar-chion-ess
over-act-ing	overacting
scoundrel	scoun-drel
diplo-mat-ic	dip-lo-mat-ic
colo-nial	co-lo-ni-al
fold-ing	folding
her-itage	her-it-age
mantrap	man-trap
mis-ery	mis-er-y
arrange-ment	ar-range-ment
hawthorn	haw-thorn
ra-dio-car-bon	ra-di-o-car-bon
um-bili-cus	um-bil-i-cus
pastis	pas-tis
brinkman-ship	brink-man-ship
gan-glion	gan-gli-on
satiny	sat-in-y
marshy	marsh-y
ca-ress-ing	ca-res-sing
poly-gon	pol-y-gon
meta-phys-i-cal	met-a-phys-i-cal
fil-ial	fil-i-al
pho-to-volta-ic	pho-to-vol-ta-ic
soupy	soup-y
can-taloupe	can-ta-loupe
pos-i-tivism	pos-i-tiv-ism
physi-cian	phy-si-cian
irony	i-ro-ny
vet-eri-nary	vet-er-i-nar-y
foam-ing	foaming
fig-u-ra-tive	fig-ur-a-tive
elan	e-lan
an-thro-pogenic	an-thro-po-gen-ic
liveli-hood	live-li-hood
derelict	der-e-lict
tar-ty	tart-y
celiba-cy	cel-i-ba-cy
stuffy	stuff-y
razzmatazz	razz-ma-tazz
tear-away	tear-a-way
dis-turbing-ly	dis-turb-ing-ly
seaboard	sea-board
penury	pen-u-ry
in-quiry	in-quir-y
tsetse	tset-se
wadi	wa-di
lauda-to-ry	laud-a-to-ry
con-denser	con-dens-er
unan-i-mous-ly	u-nan-i-mous-ly
wun-derkind	wun-der-kind
over-writ-ing	overwriting
killer	kil-ler
es-cha-tol-ogy	es-cha-tol-o-gy
cas-sowary	cas-so-war-y
retell	re-tell
equiv-o-ca-tion	e-quiv-o-ca-tion
re-spon-der	re-spond-er
trel-lised	trellised
rene-gade	ren-e-gade
can-tilever	can-ti-le-ver
unlov-ing	un-lov-ing
re-open	re-o-pen
be-liev-abil-i-ty	be-liev-a-bil-i-ty
ir-re-ducible	ir-re-duc-i-ble
creak-ing	creaking
madras	mad-ras
un-handy	un-hand-y
hy-draulics	hy-drau-lics
beery	beer-y
apery	ap-er-y
erad-i-ca-tion	e-rad-i-ca-tion
poly-he-dron	pol-y-he-dron
re-align	re-a-lign
en-thalpy	en-thal-py
de-odor-ant	de-o-dor-ant
uni-ver-sal-ist	u-ni-ver-sal-ist
tri-atom-ic	tri-a-tom-ic
per-centile	per-cen-tile
nice-ty	ni-ce-ty
papule	pap-ule
monothe-is-tic	mon-o-the-is-tic
recharge	re-charge
com-mu-nion	com-mun-ion
crazi-ly	cra-zi-ly
se-nior-i-ty	sen-ior-i-ty
tem-pera	tem-per-a
painful	pain-ful
uni-ver-sal	u-ni-ver-sal
un-equiv-o-cal-ly	un-e-quiv-o-cal-ly
many	man-y
junker	jun-ker
electro-mechan-i-cal	e-lec-tro-me-chan-i-cal
tyran-ni-cide	ty-ran-ni-cide
saga	sa-ga
en-dother-mic	en-do-ther-mic
rosin	ros-in
autarchy	au-tar-chy
se-ca-teurs	sec-a-teurs
re-align-ment	re-a-lign-ment
lar-ynx-es	la-rynx-es
mod-esty	mod-es-ty
pho-bia	pho-bi-a
sub-scriber	sub-scrib-er
talkie	talk-ie
aorist	a-o-rist
iso-la-tion-ist	i-so-la-tion-ist
elec-tri-cian	e-lec-tri-cian
about	a-bout
dairy-ing	dair-y-ing
potas-si-um	po-tas-si-um
api-ary	a-pi-ar-y
idle-ness	i-dle-ness
in-dec-lin-able	in-de-clin-a-ble
su-per-nu-mer-ary	su-per-nu-mer-ar-y
pari-etal	pa-ri-e-tal
sponger	spong-er
slouch-ing	slouching
bud-get	budg-et
flick-er-ing	flickering
pedol-o-gy	pe-dol-o-gy
smelly	smell-y
lofty	loft-y
wigeon	wig-eon
apogee	ap-o-gee
poly-thene	pol-y-thene
calami-ty	ca-lam-i-ty
plaza	pla-za
boun-teous	boun-te-ous
rein-tro-duc-tion	re-in-tro-duc-tion
spaniel	span-iel
ex-tend-able	ex-tend-a-ble
out-lier	out-li-er
com-bi-na-to-r-i-al	com-bi-na-to-ri-al
in-for-mant	in-form-ant
masseur	mas-seur
oblate	ob-late
but-tressed	buttressed
quadruped	quad-ru-ped
skul-dug-gery	skul-dug-ger-y
mati-nee	mat-i-nee
length-en-ing	lengthening
pos-i-tivist	pos-i-tiv-ist
trashy	trash-y
linen	lin-en
foothill	foot-hill
ju-rispru-dence	ju-ris-pru-dence
provin-cial	pro-vin-cial
artery	ar-ter-y
dioce-san	di-oc-e-san
cou-pled	coupled
dis-com-fort-ing	discomforting
leisured	lei-sured
net-work-ing	networking
elixir	e-lix-ir
chi-canery	chi-can-er-y
loca-tive	loc-a-tive
macaque	ma-caque
malev-o-lent	ma-lev-o-lent
mauler	maul-er
satir-i-cal	sa-tir-i-cal
avenger	a-veng-er
de-mo-c-ra-t-i-cal-ly	dem-o-crat-i-cal-ly
rook-ery	rook-er-y
trapeze	tra-peze
over-load	o-ver-load
hy-draulic	hy-drau-lic
ni-troge-nous	ni-trog-e-nous
silt-ing	silting
in-de-pen-dent	in-de-pend-ent
piezo-elec-tric	pi-e-zo-e-lec-tric
undi-lut-ed	un-di-lut-ed
pic-turesque	pic-tur-esque
glaciat-ed	gla-ci-at-ed
uvu-lar	u-vu-lar
parent-age	par-ent-age
hye-na	hy-e-na
char-woman	char-wom-an
polypropy-lene	pol-y-pro-pyl-ene
velour	ve-lour
pumice	pum-ice
rhodi-um	rho-di-um
omis-sion	o-mis-sion
for-get-table	for-get-ta-ble
mi-crochip	mi-cro-chip
dredger	dredg-er
he-lios-phere	he-li-o-sphere
lachry-mose	lach-ry-mose
banker	bank-er
across	a-cross
redo-lent	red-o-lent
hand-picked	handpicked
blocky	block-y
steadi-ness	stead-i-ness
scholas-ti-cism	scho-las-ti-cism
co-pro-lite	cop-ro-lite
undis-trib-uted	un-dis-trib-ut-ed
gov-er-nance	gov-ern-ance
paraf-fin	par-af-fin
es-timable	es-ti-ma-ble
taunt-ing	taunting
apace	a-pace
poly-eth-yl-ene	pol-y-eth-yl-ene
bank-able	bank-a-ble
re-silience	re-sil-ience
cedil-la	ce-dil-la
retic-u-lar	re-tic-u-lar
nomen-cla-ture	no-men-cla-ture
sandy	sand-y
unlov-able	un-lov-a-ble
copy-writer	cop-y-writ-er
hys-te-ria	hys-te-ri-a
backchat	back-chat
polyurethane	pol-y-u-re-thane
telex	tel-ex
handrail	hand-rail
op-ti-misti-cal-ly	op-ti-mis-ti-cal-ly
reread	re-read
starlight	star-light
pu-ri-tanism	pu-ri-tan-ism
over-sup-ply	o-ver-sup-ply
sym-biont	sym-bi-ont
prankster	prank-ster
retic-u-la-tion	re-tic-u-la-tion
tubu-lar	tu-bu-lar
pick-pock-et-ing	pickpocketing
fla-gel-late	flag-el-late
ho-n-our	ho-nour
drafty	draft-y
char-cu-terie	char-cu-te-rie
golfer	golf-er
cel-ery	cel-er-y
naked	na-ked
for-tu-itous-ly	for-tu-i-tous-ly
roadmap	road-map
coven	cov-en
hypocrisy	hy-poc-ri-sy
in-signia	in-sig-ni-a
dis-may-ing	dismaying
or-ga-nize	or-gan-ize
in-tractable	in-trac-ta-ble
rack-e-teer-ing	rack-et-eer-ing
les-bian	les-bi-an
ir-re-proach-able	ir-re-proach-a-ble
ge-nial	ge-ni-al
demigod	dem-i-god
here-inafter	here-in-af-ter
over-seas	o-ver-seas
cor-duroy	cor-du-roy
so-bri-ety	so-bri-e-ty
lever-age	lev-er-age
amus-ing	a-mus-ing
au-thoress	au-thor-ess
spo-radic	spo-rad-ic
patel-la	pa-tel-la
rein-vest-ment	re-in-vest-ment
lantern	lan-tern
claus-tro-pho-bia	claus-tro-pho-bi-a
creaky	creak-y
semi-de-tached	sem-i-de-tached
ma-joli-ca	ma-jol-i-ca
visa	vi-sa
ocean-ic	o-ce-an-ic
as-tronomer	as-tron-o-mer
unim-paired	un-im-paired
avail	a-vail
posit	pos-it
epiphe-nom-e-non	ep-i-phe-nom-e-non
yokel	yo-kel
holo-graph-ic	hol-o-graph-ic
par-venu	par-ve-nu
alone	a-lone
erad-i-cate	e-rad-i-cate
tele-graph	tel-e-graph
epic	ep-ic
tax-able	tax-a-ble
ot-toman	ot-to-man
glis-ten-ing	gli-ste-ning
ar-te-r-i-al	ar-te-ri-al
oblique	o-blique
mono-graph-ic	mon-o-graph-ic
ele-phan-tine	el-e-phan-tine
in-fi-deli-ty	in-fi-del-i-ty
chameleon	cha-me-le-on
meta-mor-phose	met-a-mor-phose
newslet-ter	news-let-ter
duchy	duch-y
copi-lot	co-pi-lot
Words with errors: 1855
Words with incorrect number of syllables: 1757
Total evluated: 6500
Perfect accuracy: 0.71
Number of syllables accuracy: 0.73
Average Levenshtein Distance(across incorrect words): 1.20
