Attempt	Real
gloomy	gloom-y
deduct	de-duct
theta	the-ta
para-dox-i-cal	par-a-dox-i-cal
baron-age	bar-on-age
aton-ic	a-ton-ic
how-itzer	how-itz-er
lachry-mose	lach-ry-mose
loco	lo-co
de-cay-ing	decaying
grandeur	gran-deur
declam-a-to-ry	de-clam-a-to-ry
un-playable	un-play-a-ble
refu-ta-tion	ref-u-ta-tion
di-ure-sis	di-u-re-sis
sen-a-to-r-i-al	sen-a-to-ri-al
di-gestible	di-gest-i-ble
ra-di-ogram	ra-di-o-gram
test-ing	testing
thriller	thrill-er
rock-ery	rock-er-y
med-ical	med-i-cal
hideous	hid-e-ous
cleavers	cleav-ers
taboo	ta-boo
mildew	mil-dew
eat-able	eat-a-ble
platelet	plate-let
achieve-ment	a-chieve-ment
car-away	car-a-way
boron	bo-ron
stony	ston-y
poli-ty	pol-i-ty
firearm	fire-arm
com-mis-sari-at	com-mis-sar-i-at
as-cen-dant	as-cend-ant
mort-gagee	mort-ga-gee
ten-able	ten-a-ble
toluene	tol-u-ene
golfer	golf-er
stat-u-ary	stat-u-ar-y
kinky	kink-y
stodgy	stodg-y
causal-i-ty	cau-sal-i-ty
demigod	dem-i-god
palette	pal-ette
pep-pered	peppered
con-ceiv-able	con-ceiv-a-ble
koala	ko-a-la
elo-quent	el-o-quent
gale-na	ga-le-na
totem	to-tem
moder-ni-ty	mo-der-ni-ty
slant-ed	slanted
hang-over	hang-o-ver
un-con-t-a-m-i-nat-ed	un-con-tam-i-nat-ed
there-after	there-af-ter
his-toric	his-tor-ic
mul-ti-me-dia	mul-ti-me-di-a
agree	a-gree
pres-ti-gious	pres-tig-ious
brushy	brush-y
coac-tion	co-ac-tion
washy	wash-y
rein-vest-ment	re-in-vest-ment
cheesy	chees-y
het-ero-gene-ity	het-er-o-ge-ne-i-ty
un-pre-dictably	un-pre-dict-a-bly
su-per-tanker	su-per-tank-er
retroac-tive-ly	ret-ro-ac-tive-ly
iso-la-tion-ism	i-so-la-tion-ism
qua-dru-pli-cate	quad-ru-pli-cate
di-rec-torate	di-rec-to-rate
cough-ing	coughing
millpond	mill-pond
calorime-ter	cal-o-rim-e-ter
propen-si-ty	pro-pen-si-ty
his-t-a-mine	his-ta-mine
steamy	steam-y
in-spi-ra-tional	in-spi-ra-tion-al
dri-ving	driv-ing
cred-it-wor-thy	cred-it-worth-y
servi-ette	ser-vi-ette
bondage	bond-age
dul-cimer	dul-ci-mer
uni-form	u-ni-form
rein-tro-duc-tion	re-in-tro-duc-tion
splashy	splash-y
valu-able	val-u-a-ble
hon-esty	hon-es-ty
leisure	lei-sure
give-away	give-a-way
mesca-line	mes-ca-line
cetacean	ce-ta-cean
gavial	ga-vi-al
nau-tilus	nau-ti-lus
dinky	dink-y
re-sis-tance	re-sist-ance
trans-paren-cy	trans-par-en-cy
medal	med-al
redi-rec-tion	re-di-rec-tion
bean-ery	bean-er-y
dili-gent-ly	dil-i-gent-ly
ugly	ug-ly
into	in-to
reis-sue	re-is-sue
evap-o-rate	e-vap-o-rate
eclipse	e-clipse
nymp-holep-sy	nym-pho-lep-sy
con-cussed	concussed
over-hand	o-ver-hand
avoid	a-void
streaky	streak-y
coro-ner	cor-o-ner
fi-nis	fin-is
amount	a-mount
para-medic	par-a-med-ic
so-cio-bi-ol-o-gy	so-ci-o-bi-ol-o-gy
in-con-gruity	in-con-gru-i-ty
touristy	tour-ist-y
ben-e-fi-cia-ry	ben-e-fi-ci-ar-y
phys-iog-no-my	phys-i-og-no-my
at-tempt-ed	at-temp-ted
con-sul-tant	con-sult-ant
odi-ous	o-di-ous
metatarsal	met-a-tar-sal
seedling	seed-ling
curvy	curv-y
piglet	pig-let
ob-jec-tion-able	ob-jec-tion-a-ble
leg-erde-main	leg-er-de-main
blessed-ness	bless-ed-ness
laud-able	laud-a-ble
sero-tonin	ser-o-to-nin
bauble	bau-ble
basalt	ba-salt
laun-derette	laun-der-ette
in-de-pen-dence	in-de-pend-ence
tiler	til-er
axle	ax-le
mi-crowave	mi-cro-wave
mud-dling	muddling
vel-veteen	vel-vet-een
masseuse	mas-seuse
backpedal	back-ped-al
mel-liflu-ous	mel-lif-lu-ous
knitwear	knit-wear
baby	ba-by
ex-plorato-ry	ex-plor-a-to-ry
re-liance	re-li-ance
joyrid-ing	joy-rid-ing
cryo-gen-ics	cry-o-gen-ics
sen-tinel	sen-ti-nel
breath-able	breath-a-ble
signet	sig-net
kitch-enette	kitch-en-ette
un-com-mu-nica-tive	un-com-mu-ni-ca-tive
emer-ald	em-er-ald
aver-sive	a-ver-sive
pres-bytery	pres-by-ter-y
over-sexed	o-ver-sexed
iron-works	i-ron-works
asymp-to-matic	a-symp-to-mat-ic
machi-na-tion	mach-i-na-tion
java	ja-va
geom-e-try	ge-om-e-try
mir-ror-ing	mirroring
wildlife	wild-life
func-tionary	func-tion-ar-y
mildewy	mil-dew-y
as-siduity	as-si-du-i-ty
mi-crodot	mi-cro-dot
cast-away	cast-a-way
col-le-gial	col-le-gi-al
snob-bery	snob-ber-y
stroller	stroll-er
thruster	thrust-er
op-er-a-tional	op-er-a-tion-al
augite	au-gite
mar-quetry	mar-que-try
in-cur-able	in-cur-a-ble
raven	ra-ven
geo-syn-chro-nous	ge-o-syn-chro-nous
minaret	min-a-ret
in-hab-it-able	in-hab-it-a-ble
guru	gu-ru
pold-er	pol-der
char-i-o-teer	char-i-ot-eer
gov-er-nance	gov-ern-ance
un-e-lec-table	un-e-lect-a-ble
take-away	take-a-way
poly-chrome	pol-y-chrome
elab-o-ra-tion	e-lab-o-ra-tion
gen-uine-ly	gen-u-ine-ly
de-scen-dant	de-scend-ant
monoc-u-lar	mo-noc-u-lar
in-ter-de-pen-dent	in-ter-de-pend-ent
en-abled	e-na-bled
un-re-solv-able	un-re-solv-a-ble
hy-drazine	hy-dra-zine
coro-nal	cor-o-nal
sce-nario	sce-nar-i-o
stratos-pher-ic	strat-o-spher-ic
id-i-olect	id-i-o-lect
lega-cy	leg-a-cy
heinous	hei-nous
jus-ti-fi-ably	jus-ti-fi-a-bly
palmy	palm-y
di-uret-ic	di-u-ret-ic
re-pro-ducibil-i-ty	re-pro-duc-i-bil-i-ty
bene-dic-tion	ben-e-dic-tion
styl-is-tic	sty-lis-tic
grandios-i-ty	gran-di-os-i-ty
defama-tion	def-a-ma-tion
pyri-dine	pyr-i-dine
sym-bio-sis	sym-bi-o-sis
temer-i-ty	te-mer-i-ty
colos-sal	co-los-sal
balustrade	bal-us-trade
napoleon	na-po-le-on
genome	ge-nome
jiffy	jif-fy
pe-riphra-sis	pe-riph-ra-sis
seedbed	seed-bed
rea-son-able-ness	rea-son-a-ble-ness
wily	wil-y
jerky	jerk-y
bindweed	bind-weed
ap-petite	ap-pe-tite
prophe-cy	proph-e-cy
artis-tic	ar-tis-tic
leav-ened	leavened
uni-fy	u-ni-fy
cor-dial	cor-di-al
con-nect-ing	con-nec-ting
semi-con-scious	sem-i-con-scious
friendlily	friend-li-ly
tonight	to-night
plenipo-ten-tiary	plen-i-po-ten-ti-ar-y
teacher	teach-er
frisky	frisk-y
beloved	be-lov-ed
im-moral	im-mor-al
fo-liage	fo-li-age
arc-ing	arcing
col-lec-tivist	col-lec-tiv-ist
con-t-a-m-i-nant	con-tam-i-nant
ghana	ghana
every-where	eve-ry-where
re-tal-ia-to-ry	re-tal-i-a-to-ry
man-ager-ess	man-ag-er-ess
archangel	arch-an-gel
kestrel	kes-trel
swelling	swell-ing
be-witch-ing	bewitching
un-fath-omable	un-fath-om-a-ble
dinghy	din-ghy
trea-sur-er	treas-ur-er
ex-pect-ed	expected
ar-guable	ar-gu-a-ble
iden-ti-cal-ly	i-den-ti-cal-ly
babysit	ba-by-sit
dele-te-ri-ous	del-e-te-ri-ous
lim-iter	lim-it-er
surly	sur-ly
in-tra-venous	in-tra-ve-nous
en-doge-nous	en-dog-e-nous
agent	a-gent
syn-onym	syn-o-nym
mayfly	may-fly
foible	foi-ble
de-ter-minable	de-ter-mi-na-ble
sari	sa-ri
mini-cab	min-i-cab
retic-u-lar	re-tic-u-lar
delir-i-um	de-lir-i-um
sub-ter-ranean	sub-ter-ra-ne-an
vil-lainy	vil-lain-y
rec-om-mend-ed	recommended
he-do-nist	he-don-ist
or-ga-nized	or-gan-ized
his-togram	his-to-gram
in-sis-tent	in-sist-ent
hy-dro-elec-tric	hy-dro-e-lec-tric
based	based
busy	bus-y
iso-met-ric	i-so-met-ric
im-pass-able	im-pass-a-ble
ide-al-ist	i-de-al-ist
nephri-tis	ne-phri-tis
mega-phone	meg-a-phone
su-per-natant	su-per-na-tant
chore-o-g-ra-ph-er	cho-re-og-ra-pher
mimet-ic	mi-met-ic
teller	tell-er
in-for-mant	in-form-ant
client	cli-ent
operand	op-er-and
domi-cil-iary	dom-i-cil-i-ar-y
triage	tri-age
de-nier	de-ni-er
elec-trode	e-lec-trode
un-tidy	un-ti-dy
ego	e-go
scur-rilous	scur-ril-ous
fa-ther-ing	fathering
aro-mather-a-py	a-ro-ma-ther-a-py
in-ter-ci-ty	in-ter-cit-y
pre-cooked	precooked
en-counter	en-coun-ter
reroute	re-route
palate	pal-ate
shaky	shak-y
in-ter-vie-wee	in-ter-view-ee
hearti-ly	heart-i-ly
equidis-tant	e-qui-dis-tant
lager	la-ger
mela-tonin	mel-a-to-nin
un-apolo-getic	un-a-pol-o-get-ic
serendip-i-tous	ser-en-dip-i-tous
mid-wifery	mid-wife-ry
hu-mankind	hu-man-kind
holis-ti-cal-ly	ho-lis-ti-cal-ly
repack	re-pack
melee	me-lee
stoa	sto-a
dreamy	dream-y
un-war-rantable	un-war-rant-a-ble
iso-late	i-so-late
chrono-log-i-cal	chron-o-log-i-cal
talon	tal-on
over-sight	o-ver-sight
robin	rob-in
canon-ic	ca-non-ic
the-atri-cal	the-at-ri-cal
reify	re-i-fy
chloro-phyll	chlo-ro-phyll
grapevine	grape-vine
more-over	more-o-ver
im-pressed	impressed
alive	a-live
plexus	plex-us
pes-simistic	pes-si-mis-tic
motile	mo-tile
ini-tial-ly	in-i-tial-ly
espres-so	es-pres-so
penol-o-gy	pe-nol-o-gy
legal-ly	le-gal-ly
for-syth-ia	for-syth-i-a
parochial-ism	pa-ro-chi-al-ism
gal-vanome-ter	gal-va-nom-e-ter
cys-teine	cys-te-ine
de-po-si-tion	dep-o-si-tion
un-in-hab-it-able	un-in-hab-it-a-ble
hap-py-golucky	hap-py-go-luck-y
ox-alate	ox-a-late
welly	wel-ly
un-hesi-tat-ing	un-hes-i-tat-ing
away	a-way
bur-sary	bur-sa-ry
eu-kary-ote	eu-kar-y-ote
satir-i-cal	sa-tir-i-cal
asleep	a-sleep
su-perla-tive	su-per-la-tive
bac-teri-um	bac-te-ri-um
colo-nial	co-lo-ni-al
ele-phant	el-e-phant
phy-loge-ny	phy-log-e-ny
dis-abling	disabling
episode	ep-i-sode
chromi-um	chro-mi-um
changeover	change-o-ver
lifebelt	life-belt
scalar	sca-lar
ma-chin-ery	ma-chin-er-y
stat-uesque	stat-u-esque
fermi-on	fer-mi-on
beanie	bean-ie
breather	breath-er
in-de-ci-pher-able	in-de-ci-pher-a-ble
left-over	left-o-ver
baloney	ba-lo-ney
econo-met-rics	e-con-o-met-rics
ax-il-lary	ax-il-lar-y
va-ri-etal	va-ri-e-tal
wiper	wip-er
doc-u-men-tary	doc-u-men-ta-ry
dis-pos-able	dis-pos-a-ble
macro-eco-nom-ic	mac-ro-ec-o-nom-ic
promi-nence	prom-i-nence
in-signia	in-sig-ni-a
blowup	blow-up
ego-tis-ti-cal	e-go-tis-ti-cal
con-t-a-m-i-nate	con-tam-i-nate
ra-dius	ra-di-us
mica	mi-ca
epis-co-pa-cy	e-pis-co-pa-cy
tripoli	trip-o-li
in-ter-locu-tor	in-ter-loc-u-tor
whomev-er	whom-ev-er
bud-get	budg-et
para-mag-net-ic	par-a-mag-net-ic
rat-tlesnake	rat-tle-snake
router	rout-er
unis-sued	un-is-sued
chamomile	cham-o-mile
ir-rec-on-cil-able	ir-rec-on-cil-a-ble
parental	pa-ren-tal
elec-tron-i-cal-ly	e-lec-tron-i-cal-ly
ge-nealog-i-cal	ge-ne-a-log-i-cal
uned-i-fy-ing	un-ed-i-fy-ing
metaphor-i-cal-ly	met-a-phor-i-cal-ly
marcher	march-er
eeri-ly	ee-ri-ly
pen-sion-able	pen-sion-a-ble
supreme	su-preme
etui	e-tui
sharp-en-er	shar-pen-er
ex-tra-mur-al	ex-tra-mu-ral
wispy	wisp-y
con-sular	con-su-lar
inkwell	ink-well
bleat-ing	bleating
dis-abuse	dis-a-buse
any-body	an-y-bod-y
scruffy	scruff-y
mas-sacre	mas-sa-cre
best-selling	best-sell-ing
nifty	nif-ty
retro	ret-ro
blitzkrieg	blitz-krieg
iris	i-ris
symp-to-matic	symp-to-mat-ic
ebul-lience	e-bul-lience
deca-dent	dec-a-dent
lisp-ing	lis-ping
joey	jo-ey
ro-mancer	ro-manc-er
beat-i-tude	be-at-i-tude
bac-te-rio-phage	bac-te-ri-o-phage
in-her-i-ta-ble	in-her-it-a-ble
lodestar	lode-star
so-cialite	so-cial-ite
he-liotrope	he-li-o-trope
im-pon-der-able	im-pon-der-a-ble
de-scend-ing	descending
school-teacher	school-teach-er
privy	priv-y
soma	so-ma
afraid	a-fraid
farad	far-ad
gatepost	gate-post
foundry	found-ry
con-temptible	con-tempt-i-ble
undiplo-mat-ic	un-dip-lo-mat-ic
carat	car-at
chilblain	chil-blain
trel-lised	trellised
sycamore	syc-a-more
equiv-o-ca-tion	e-quiv-o-ca-tion
les-bian	les-bi-an
as-segai	as-se-gai
stuffy	stuff-y
wiz-ardry	wiz-ard-ry
gramo-phone	gram-o-phone
in-san-i-tary	in-san-i-tar-y
trainee	train-ee
lethal	le-thal
coitus	co-i-tus
paean	pae-an
both-ered	bothered
pe-tit	pet-it
sub-terfuge	sub-ter-fuge
sep-a-ratism	sep-a-ra-tism
apos-tate	a-pos-tate
in-cisor	in-ci-sor
con-tigu-ous	con-tig-u-ous
coura-geous	cou-ra-geous
palu-dal	pa-lu-dal
over-fly	o-ver-fly
fussy	fuss-y
igua-na	i-gua-na
over-wrought	o-ver-wrought
puerile	pu-er-ile
razzmatazz	razz-ma-tazz
freaky	freak-y
sloven-ly	slov-en-ly
tyran-ni-cide	ty-ran-ni-cide
clam-orous	clam-or-ous
un-con-trol-lably	un-con-trol-la-bly
cyclic	cy-clic
techno-pho-bia	tech-no-pho-bia
chock-ablock	chock-a-block
portage	por-tage
by-stander	by-stand-er
tidal	tid-al
mo-lasses	mo-las-ses
cyanide	cy-a-nide
dis-tiller	dis-till-er
obe-di-ence	o-be-di-ence
preser-va-tion	pres-er-va-tion
elec-trolyte	e-lec-tro-lyte
vana-di-um	va-na-di-um
detox	de-tox
hobo	ho-bo
meta-mor-phose	met-a-mor-phose
stag-ger-ing	staggering
com-bi-na-to-r-i-al	com-bi-na-to-ri-al
scaly	scal-y
laity	la-i-ty
chateau	cha-teau
rewire	re-wire
tu-mul-tuous	tu-mul-tu-ous
avenger	a-veng-er
reval-ue	re-val-ue
mili-tia-man	mi-li-tia-man
eleventh	e-lev-enth
vac-uole	vac-u-ole
song-writer	song-writ-er
staphy-lo-coc-cus	staph-y-lo-coc-cus
creak-ing	creaking
stringer	string-er
weaver	weav-er
oblit-er-a-tion	ob-lit-er-a-tion
grandee	gran-dee
specu-lum	spec-u-lum
elas-ti-cat-ed	e-las-ti-cat-ed
siren	si-ren
di-vider	di-vid-er
decla-ma-tion	dec-la-ma-tion
hi-er-ar-ch	hi-er-arch
screen-writer	screen-writ-er
steeply	steep-ly
por-traitist	por-trait-ist
in-frared	in-fra-red
dauber	daub-er
hit-table	hit-ta-ble
re-sis-tant	re-sist-ant
literati	lit-e-ra-ti
benev-o-lence	be-nev-o-lence
mileage	mile-age
kilo-hertz	kil-o-hertz
spanker	spank-er
opi-um	o-pi-um
di-ar-rhea	di-ar-rhe-a
cerise	ce-rise
in-ge-nious	in-gen-ious
slav-ery	slav-er-y
evolve	e-volve
des-tiny	des-ti-ny
donor	do-nor
elon-gate	e-lon-gate
pul-monary	pul-mo-nar-y
over-seer	o-ver-se-er
lilac	li-lac
brassiere	bras-siere
quiv-er-ing	quivering
duo-logue	du-o-logue
oblate	ob-late
cornea	cor-ne-a
thorny	thorn-y
unim-paired	un-im-paired
hairy	hair-y
resin	res-in
restora-tion	res-to-ra-tion
seafront	sea-front
spokes-woman	spokes-wom-an
echid-na	e-chid-na
touchy	touch-y
so-ci-etal	so-ci-e-tal
frilly	frill-y
rub-bishy	rub-bish-y
carouse	ca-rouse
shiv-ery	shiv-er-y
an-tifreeze	an-ti-freeze
un-re-li-able	un-re-li-a-ble
dis-heart-en-ing	dis-hear-te-ning
re-seller	re-sell-er
crafty	craft-y
cordage	cord-age
tractable	trac-ta-ble
un-at-tain-able	un-at-tain-a-ble
de-ser-ti-fi-ca-tion	de-sert-i-fi-ca-tion
litur-gy	lit-ur-gy
de-f-i-n-i-tion	def-i-ni-tion
top-i-ary	to-pi-ar-y
prepo-si-tion	prep-o-si-tion
easy	eas-y
es-tu-ary	es-tu-ar-y
record-ed	re-cor-ded
con-cil-iar	con-cil-i-ar
sub-cu-ta-neous	sub-cu-ta-ne-ous
hy-gien-ic	hy-gi-en-ic
elite	e-lite
pop-ulism	pop-u-lism
pi-tu-itary	pi-tu-i-tar-y
reper-cus-sion	re-per-cus-sion
com-mu-nica-tive	com-mu-ni-ca-tive
lousy	lous-y
pedantry	ped-ant-ry
crater	cra-ter
pe-ri-od-ic-i-ty	pe-ri-o-dic-i-ty
unadul-ter-at-ed	un-a-dul-ter-at-ed
dereg-u-la-tion	de-reg-u-lation
un-con-scionable	un-con-scion-a-ble
halo	ha-lo
di-atom	di-a-tom
in-ter-plan-e-tary	in-ter-plan-e-tar-y
us-abil-i-ty	us-a-bil-i-ty
in-de-struc-tible	in-de-struct-i-ble
alarm	a-larm
basil-i-ca	ba-sil-i-ca
stager	stag-er
filthy	filth-y
dimwit	dim-wit
hy-dropho-bia	hy-dro-pho-bi-a
lit-toral	lit-to-ral
gerund	ger-und
colonist	col-o-nist
me-nial	me-ni-al
spongy	spon-gy
cor-ti-cos-teroid	cor-ti-co-ster-oid
su-per-fluity	su-per-flu-i-ty
ever-more	ev-er-more
un-re-peat-able	un-re-peat-a-ble
spher-oid	sphe-roid
open	o-pen
awhile	a-while
holism	ho-lism
vestibule	ves-ti-bule
de-pend-able	de-pend-a-ble
echoic	e-cho-ic
tepid	tep-id
im-pri-matur	im-pri-ma-tur
para-dox	par-a-dox
re-cruiter	re-cruit-er
frag-men-tary	frag-men-tar-y
ru-ina-tion	ru-in-a-tion
dredger	dredg-er
blowfly	blow-fly
flat-tery	flat-ter-y
dahlia	dahl-ia
pitiable	pit-i-a-ble
hy-drochlo-ride	hy-dro-chlo-ride
ret-inue	ret-i-nue
re-spon-dent	re-spond-ent
surfer	surf-er
un-shaven	un-shav-en
scrapie	scrap-ie
delu-sive	de-lu-sive
pe-riphrastic	per-i-phras-tic
ex-ult-ing	exulting
residu-um	re-sid-u-um
com-paction	com-pac-tion
auto	au-to
catalep-sy	cat-a-lep-sy
distaff	dis-taff
spiky	spik-y
un-sus-tain-able	un-sus-tain-a-ble
omit	o-mit
debone	de-bone
itchy	itch-y
wafer	wa-fer
as-tro-physics	as-tro-phys-ics
theoc-ra-cy	the-oc-ra-cy
present-ly	pres-ent-ly
orate	o-rate
brav-ery	brav-er-y
any-thing	an-y-thing
del-i-catessen	del-i-ca-tes-sen
duet	du-et
re-dis-tri-b-u-tion	re-dis-tri-bu-tion
pout-ing	pouting
as-tro-physi-cist	as-tro-phys-i-cist
en-cycli-cal	en-cyc-li-cal
arch-dio-cese	arch-di-o-cese
pyrite	py-rite
sus-tain-abil-i-ty	sus-tain-a-bil-i-ty
unsweet-ened	un-sweet-ened
in-deli-bly	in-del-i-bly
doyen	doy-en
aloud	a-loud
mushy	mush-y
io-dine	i-o-dine
lun-cheon	lunch-eon
her-bi-cide	herb-i-cide
vol-cano	vol-ca-no
re-volver	re-volv-er
schoolmistress	school-mis-tress
fuzzy	fuzz-y
mo-les-ter	mo-lest-er
starlight	star-light
plumy	plum-y
elic-it	e-lic-it
pati-na-tion	pat-i-na-tion
steril-i-ty	ste-ril-i-ty
pre-sentable	pre-sent-a-ble
pop-ulist	pop-u-list
flow-ery	flow-er-y
in-staller	in-stall-er
lethar-gic	le-thar-gic
or-ga-nize	or-gan-ize
ta-per-ing	ta-pe-ring
spaghet-ti	spa-ghet-ti
un-car-ed	un-cared
be-trothal	be-troth-al
stripy	strip-y
union-i-sa-tion	un-ion-i-sa-tion
telepa-thy	te-lep-a-thy
tacho-graph	tach-o-graph
healthy	health-y
regress	re-gress
mul-ti-plica-tive	mul-ti-pli-ca-tive
plea-sur-able	pleas-ur-a-ble
limpid	lim-pid
neo-plasm	ne-o-plasm
hayloft	hay-loft
mu-cosa	mu-co-sa
man-i-cured	ma-ni-cured
seafood	sea-food
owlet	owl-et
op-por-tunist	op-por-tun-ist
fetid	fet-id
cy-clotron	cy-clo-tron
to-bac-conist	to-bac-co-nist
puree	pu-ree
saver	sav-er
scarab	scar-ab
patel-la	pa-tel-la
jan-u-ary	jan-u-ar-y
spinal	spi-nal
un-der-stand-ably	un-der-stand-a-bly
clement	clem-ent
helper	help-er
warthog	wart-hog
howdy	how-dy
reser-voir	res-er-voir
synapse	syn-apse
usurp	u-surp
meta-physics	met-a-phys-ics
viaduct	vi-a-duct
imag-i-na-tion	im-ag-i-na-tion
rewind	re-wind
basil	bas-il
over-rate	o-ver-rate
ban-dage	band-age
pota-to	po-ta-to
pa-pyrus	pa-py-rus
un-de-ni-ably	un-de-ni-a-bly
notwith-stand-ing	not-with-stand-ing
en-gi-neered	engineered
obelisk	ob-e-lisk
over-full	o-ver-full
open-ness	o-pen-ness
crazi-ly	cra-zi-ly
ovu-la-tion	ov-u-la-tion
exe-unt	ex-e-unt
pre-dictable	pre-dict-a-ble
brevi-ty	brev-i-ty
giblets	gib-lets
pineap-ple	pine-ap-ple
hero-ine	her-o-ine
ban-knote	bank-note
ar-senide	ar-se-nide
maple	ma-ple
polem-i-cal	po-lem-i-cal
pira-cy	pi-ra-cy
nomen-cla-ture	no-men-cla-ture
chi-ropody	chi-rop-o-dy
monomol-e-c-u-lar	mon-o-mo-lec-u-lar
poly-mor-phous	pol-y-mor-phous
slouch-ing	slouching
man-dolin	man-do-lin
dan-de-lion	dan-de-li-on
aviary	a-vi-ar-y
vig-i-lante	vig-i-lan-te
ar-cana	ar-ca-na
in-hab-i-tant	in-hab-it-ant
iota	i-o-ta
pe-rusal	pe-rus-al
re-spectable	re-spect-a-ble
footage	foot-age
bene-fac-tress	ben-e-fac-tress
chanteuse	chan-teuse
roundup	round-up
founder	found-er
com-plainant	com-plain-ant
caliph	ca-liph
un-equiv-o-cal-ly	un-e-quiv-o-cal-ly
ra-tio-nal-ly	ra-tion-al-ly
seago-ing	sea-go-ing
un-re-cov-er-able	un-re-cov-er-a-ble
the-atri-cal-ly	the-at-ri-cal-ly
de-scen-der	de-scend-er
turkey	tur-key
roofer	roof-er
diplo-mat-i-cal-ly	dip-lo-mat-i-cal-ly
positron	pos-i-tron
hearsay	hear-say
sabra	sa-bra
apoc-ryphal	a-poc-ry-phal
dodgy	dodg-y
gen-i-talia	gen-i-ta-li-a
noisy	nois-y
peanut	pea-nut
junker	jun-ker
per-jury	per-ju-ry
canyon	can-yon
lament-ed	la-ment-ed
poly-math	pol-y-math
preter-nat-ur-al	pre-ter-nat-u-ral
vari-ance	var-i-ance
video-tape	vid-e-o-tape
drea-ry	drear-y
crawler	crawl-er
milky	milk-y
elo-cu-tion	el-o-cu-tion
twofold	two-fold
over-come	o-ver-come
totemic	to-tem-ic
ex-pec-tant-ly	ex-pect-ant-ly
ri-fled	rifled
plaza	pla-za
wreck-ing	wrecking
steamship	steam-ship
lyri-cism	lyr-i-cism
apish	ap-ish
mono-chro-mat-ic	mon-o-chro-mat-ic
anti-gen	an-ti-gen
scrawny	scrawn-y
gera-ni-um	ge-ra-ni-um
moody	mood-y
weary-ing	wea-ry-ing
mantrap	man-trap
leader	lead-er
unas-sail-able	un-as-sail-a-ble
de-tectable	de-tect-a-ble
caiman	cai-man
semi-fi-nal	sem-i-fi-nal
baleen	ba-leen
civic	civ-ic
in-quisi-to-r-i-al	in-quis-i-to-ri-al
macabre	ma-ca-bre
oblig-a-tion	ob-li-ga-tion
nar-ra-tol-ogy	nar-ra-tol-o-gy
de-caf-feinate	de-caf-fein-ate
dodo	do-do
ram-shackle	ram-shack-le
sedi-tious	se-di-tious
query	que-ry
limo	lim-o
weasel	wea-sel
hooli-gan-ism	hoo-li-gan-ism
chasti-ty	chas-ti-ty
mauler	maul-er
deluxe	de-luxe
cranky	crank-y
en-tre-pre-neur-ial	en-tre-pre-neur-i-al
flutist	flut-ist
crevasse	cre-vasse
neu-ronal	neu-ron-al
tourism	tour-ism
detox-i-fi-ca-tion	de-tox-i-fi-ca-tion
maxi	max-i
haven	ha-ven
every	eve-ry
the-atri-cal-i-ty	the-at-ri-cal-i-ty
cordillera	cor-dil-le-ra
flower	flow-er
un-pro-nounce-able	un-pro-nounce-a-ble
ter-ri-to-r-i-al	ter-ri-to-ri-al
oral-ly	o-ral-ly
elec-tron	e-lec-tron
crum-bling	crumbling
uni-lat-er-al-ist	u-ni-lat-er-al-ist
resur-gent	re-sur-gent
loathing	loath-ing
leak-ing	leaking
ra-tio-nal-ism	ra-tion-al-ism
askew	a-skew
felo-nious	fe-lo-ni-ous
un-change-able	un-change-a-ble
swimwear	swim-wear
recharge-able	re-charge-a-ble
puni-tive	pu-ni-tive
boater	boat-er
iron-ing	i-ron-ing
pen-tathlon	pen-tath-lon
su-per-in-ten-dence	su-per-in-tend-ence
area	ar-e-a
filet	fi-let
cos-set-ed	cosseted
anon	a-non
corol-lary	cor-ol-lar-y
over-pro-duced	overproduced
eval-u-a-tion	e-val-u-a-tion
pekan	pek-an
tureen	tu-reen
hilly	hill-y
melo-di-ous	me-lo-di-ous
poly-phon-ic	pol-y-phon-ic
re-cov-ery	re-cov-er-y
doubter	doubt-er
ide-o-logue	i-de-o-logue
flood-ing	flooding
mil-lenar-i-an	mil-le-nar-i-an
fisticuffs	fist-i-cuffs
facile	fac-ile
chalet	cha-let
in-fante	in-fan-te
hadron	had-ron
elec-tro	e-lec-tro
corky	cork-y
punch-line	punchline
un-e-d-u-cat-ed	un-ed-u-cat-ed
co-eval	co-e-val
elec-toral	e-lec-tor-al
chamois	cham-ois
ruler	rul-er
ra-di-og-ra-ph-er	ra-di-og-ra-pher
tun-able	tun-a-ble
salver	sal-ver
iden-ti-fi-er	i-den-ti-fi-er
anony-mous-ly	a-non-y-mous-ly
pros-e-cu-to-r-i-al	pros-e-cu-to-ri-al
awake	a-wake
equine	e-quine
mono-lay-er	mon-o-lay-er
wastage	wast-age
primeval	pri-me-val
linkup	link-up
mantra	man-tra
over-sim-pli-fi-ca-tion	o-ver-sim-pli-fi-ca-tion
in-scrutable	in-scru-ta-ble
lin-eage	lin-e-age
demise	de-mise
un-re-served-ly	un-re-serv-ed-ly
asep-tic	a-sep-tic
kilo-ton	kil-o-ton
mac-a-roni	mac-a-ro-ni
em-bo-som	em-bos-om
lyrist	lyr-ist
coro-na-tion	cor-o-na-tion
pion	pi-on
choline	cho-line
labur-num	la-bur-num
liftoff	lift-off
pre-s-e-lect	pre-se-lect
bailout	bail-out
dis-rep-utable	dis-rep-u-ta-ble
moun-taineer	moun-tain-eer
an-thracite	an-thra-cite
re-process	re-proc-ess
ditch-ing	ditching
pover-ty	pov-er-ty
retro-fit	ret-ro-fit
sonor-i-ty	so-nor-i-ty
nodal	nod-al
un-com-fort-able	un-com-fort-a-ble
atri-um	a-tri-um
chal-lenger	chal-leng-er
semi-colon	sem-i-co-lon
dado	da-do
ir-ra-tional-ly	ir-ra-tion-al-ly
postage	post-age
sacra-ment	sac-ra-ment
pu-gna-cious	pug-na-cious
in-stan-ta-neous	in-stan-ta-ne-ous
chaos	cha-os
mover	mov-er
unassertive	un-as-ser-tive
res-olute	res-o-lute
ex-pan-sion-ary	ex-pan-sion-ar-y
trousers	trou-sers
miser	mi-ser
bound-ary	bound-a-ry
para-dox-i-cal-ly	par-a-dox-i-cal-ly
bushel	bush-el
covert-ly	cov-ert-ly
iambic	i-am-bic
vengeance	venge-ance
sapi-ent	sa-pi-ent
gelig-nite	gel-ig-nite
bel-liger-ent	bel-lig-er-ent
strate-gic	stra-te-gic
dogged	dog-ged
pinafore	pin-a-fore
fevered	fe-vered
an-tipodes	an-tip-o-des
rheo-stat	rhe-o-stat
rewrap	re-wrap
oblig-ing	o-blig-ing
wicked	wick-ed
ole-an-der	o-le-an-der
winnable	win-na-ble
kerosene	ker-o-sene
geron-toc-ra-cy	ger-on-toc-ra-cy
sporran	spor-ran
mys-tery	mys-ter-y
in-de-pen-dent	in-de-pend-ent
over-lord	o-ver-lord
baldy	bald-y
dis-parag-ing	dis-par-ag-ing
elec-tive	e-lec-tive
saga	sa-ga
amuse	a-muse
over-re-acts	o-ver-re-acts
salmon	salm-on
copi-lot	co-pi-lot
unan-tic-i-pat-ed	un-an-tic-i-pat-ed
trashy	trash-y
re-cov-er-able	re-cov-er-a-ble
over-es-ti-ma-tion	o-ver-es-ti-ma-tion
elan	e-lan
poly-sac-cha-ride	pol-y-sac-cha-ride
stinky	stink-y
cas-sowary	cas-so-war-y
in-audi-ble	in-au-di-ble
psy-chi-atric	psy-chi-at-ric
baroque	ba-roque
un-du-lat-ing	un-du-la-ting
over-crowd-ed	o-ver-crow-ded
pogo	po-go
apo-lit-i-cal	a-po-lit-i-cal
pre-tender	pre-tend-er
trib-u-tary	trib-u-tar-y
big-otry	big-ot-ry
pirou-ette	pir-ou-ette
evil-do-er	e-vil-do-er
plat-i-tudi-nous	plat-i-tu-di-nous
colum-nar	co-lum-nar
pavil-ion	pa-vil-ion
phil-an-thropist	phi-lan-thro-pist
mesos-phere	mes-o-sphere
duchess	duch-ess
pro-tean	pro-te-an
perime-ter	pe-rim-e-ter
re-cidi-vist	re-cid-i-vist
dizzy	diz-zy
tribu-la-tion	trib-u-la-tion
mul-ti-me-ter	mul-tim-e-ter
aphid	a-phid
monas-tic	mo-nas-tic
statu-to-ry	stat-u-to-ry
lack-adaisi-cal	lack-a-dai-si-cal
ool-o-gy	o-ol-o-gy
be-liev-abil-i-ty	be-liev-a-bil-i-ty
ego-ism	e-go-ism
prosce-ni-um	pro-sce-ni-um
idol-a-try	i-dol-a-try
re-tiree	re-tir-ee
repo-si-tion	re-po-si-tion
pro-bity	pro-bi-ty
stranger	stran-ger
herbal	herb-al
dy-namo	dy-na-mo
briefly	brief-ly
species	spe-cies
apol-o-gy	a-pol-o-gy
re-vival	re-viv-al
nobly	no-bly
ashamed	a-shamed
balus-ter	bal-us-ter
valen-tine	val-en-tine
debu-tant	deb-u-tant
loopy	loop-y
brunette	bru-nette
kaiser	kai-ser
per-cu-ta-neous	per-cu-ta-ne-ous
clemen-cy	clem-en-cy
face-tious	fa-ce-tious
chunky	chunk-y
raven-ing	rav-en-ing
un-print-able	un-print-a-ble
wolfish	wolf-ish
elec-tro-mo-tive	e-lec-tro-mo-tive
chorale	cho-rale
blis-tered	blistered
im-pres-sion-able	im-pres-sion-a-ble
seroneg-a-tive	se-ro-neg-a-tive
melo-dra-ma	mel-o-dra-ma
sou-venir	sou-ve-nir
over-es-ti-mate	o-ver-es-ti-mate
cider	ci-der
homi-ly	hom-i-ly
con-sum-able	con-sum-a-ble
prospec-tus	pro-spec-tus
physi-cist	phys-i-cist
serene	se-rene
de-signed-ly	de-sign-ed-ly
up-hol-stery	up-hol-ster-y
re-former	re-form-er
cor-po-ratism	cor-po-rat-ism
quadru-pole	quad-ru-pole
un-afraid	un-a-fraid
proph-esy	proph-e-sy
pesky	pes-ky
corset	cor-set
gawky	gawk-y
statute	stat-ute
en-v-i-ron	en-vi-ron
sar-to-r-i-al	sar-to-ri-al
mil-i-tarism	mil-i-ta-rism
barom-e-ter	ba-rom-e-ter
marzi-pan	mar-zi-pan
gen-uine	gen-u-ine
shopfront	shop-front
gallery	gal-ler-y
orang-utan	o-rang-u-tan
silage	si-lage
cir-cum-lo-cu-to-ry	cir-cum-loc-u-to-ry
painstak-ing-ly	pains-tak-ing-ly
meta-mor-phic	met-a-mor-phic
berry	ber-ry
emis-sary	em-is-sar-y
in-con-ceiv-able	in-con-ceiv-a-ble
mishap	mis-hap
par-al-lelepiped	par-al-lel-e-pi-ped
seal-ing	sealing
phone-mic	pho-ne-mic
in-tu-itive-ly	in-tu-i-tive-ly
sumo	su-mo
metic-u-lous	me-tic-u-lous
newsprint	news-print
key-boardist	key-board-ist
bal-alai-ka	bal-a-lai-ka
ranker	rank-er
ex-is-tent	ex-ist-ent
feb-ru-ary	feb-ru-ar-y
calum-ny	cal-um-ny
bitmap	bit-map
re-ceiver-ship	re-ceiv-er-ship
per-ilous-ly	per-il-ous-ly
cat-a-clysmic	cat-a-clys-mic
con-for-mi-ty	con-form-i-ty
schemat-ic	sche-mat-ic
stron-tium	stron-ti-um
vino	vi-no
squea-mish	squeam-ish
mega	meg-a
cater	ca-ter
gaga	ga-ga
boast-ing	boas-ting
asi-nine	as-i-nine
per-ora-tion	per-o-ra-tion
iso-la-tion	i-so-la-tion
pen-i-ten-tiary	pen-i-ten-tia-ry
over-lap	o-ver-lap
epic	ep-ic
damper	damp-er
pael-la	pa-el-la
ocean-ic	o-ce-an-ic
pro-tect-ed	protected
uni-ty	u-ni-ty
stu-dio	stu-di-o
cata-ma-ran	cat-a-ma-ran
spunky	spunk-y
tithing	tith-ing
evoke	e-voke
un-fet-tered	unfettered
toka-mak	to-ka-mak
verisimil-i-tude	ver-i-si-mil-i-tude
re-moval	re-mov-al
elec-tri-cal	e-lec-tri-cal
econ-o-mist	e-con-o-mist
papa	pa-pa
mazy	ma-zy
rock-etry	rock-et-ry
par-al-lelism	par-al-lel-ism
dispir-it-ed	dis-pir-it-ed
watch-able	watch-a-ble
ass-es	as-ses
prostaglandin	pros-ta-glan-din
in-ter-op-er-abil-i-ty	in-ter-op-er-a-bil-i-ty
up-end-ed	upended
mini-bar	min-i-bar
tourni-quet	tour-ni-quet
im-mea-sur-ably	im-meas-ur-a-bly
herbage	herb-age
horsey	hors-ey
feath-erlight	feath-er-light
scathing	scath-ing
habi-ta-tion	hab-i-ta-tion
hy-pox-ia	hy-pox-i-a
mores	mo-res
aver-sion	a-ver-sion
sonorous	so-no-rous
triv-ia	triv-i-a
cola	co-la
hermeneu-tic	her-me-neu-tic
in-hibitor	in-hib-i-tor
dy-nasty	dy-nas-ty
armpit	arm-pit
hosepipe	hose-pipe
con-troller	con-trol-ler
asun-der	a-sun-der
rein-sert	re-in-sert
seaboard	sea-board
up-lift-ed	uplifted
ap-nea	ap-ne-a
opales-cent	o-pal-es-cent
dassie	das-sie
epi-graph	ep-i-graph
foot-balling	foot-ball-ing
unin-sured	un-in-sured
tri-umphal	tri-um-phal
breezy	breez-y
plea-sure	pleas-ure
bion-ic	bi-on-ic
tidy	ti-dy
utopia	u-to-pi-a
over-am-bi-tious	o-ver-am-bi-tious
chill-ing	chilling
suf-frag-ist	suf-fra-gist
ar-rhyth-mia	ar-rhyth-mi-a
poem	po-em
pam-phle-teer	pam-phlet-eer
irid-i-um	i-rid-i-um
fetishism	fet-ish-ism
antler	ant-ler
steeple-chase	stee-ple-chase
pi-rat-ed	pirated
en-cy-clo-pe-dia	en-cy-clo-pe-di-a
sundry	sun-dry
opin-ion	o-pin-ion
iambus	i-am-bus
iron-i-cal-ly	i-ron-i-cal-ly
cho-les-terol	cho-les-ter-ol
epochal	ep-och-al
byprod-uct	by-prod-uct
bond-ing	bonding
propo-si-tion-al	prop-o-si-tion-al
plushy	plush-y
ovum	o-vum
reshow	re-show
lan-guorous	lan-guor-ous
pla-cen-tae	pla-cen-tae
avul-sion	a-vul-sion
poseur	po-seur
sahib	sa-hib
nightlife	night-life
frailty	frail-ty
radon	ra-don
pro-ce-du-ral-ly	pro-ce-dur-al-ly
reprint	re-print
liv-ery	liv-er-y
over-act-ing	overacting
im-pro-visato-ry	im-pro-vi-sa-to-ry
ar-guably	ar-gu-a-bly
welder	weld-er
sacro-sanct	sac-ro-sanct
em-anate	em-a-nate
de-sir-abil-i-ty	de-sir-a-bil-i-ty
colos-sus	co-los-sus
smoky	smok-y
para-sol	par-a-sol
over-loaded	overloaded
overt	o-vert
un-bo-som	un-bos-om
peri-patet-ic	per-i-pa-tet-ic
slant-i-ng	slant-ing
change-able	change-a-ble
epis-co-pal	e-pis-co-pal
in-dis-tin-guish-able	in-dis-tin-guish-a-ble
hy-pother-mia	hy-po-ther-mi-a
pho-to-genic	pho-to-gen-ic
prison	pris-on
ema-ci-at-ed	e-ma-ci-at-ed
pes-simist	pes-si-mist
lop-sided	lop-sid-ed
im-port-ed	imported
uni-cy-cle	u-ni-cy-cle
sto-ical-ly	sto-i-cal-ly
merid-ion-al	me-rid-i-o-nal
rep-til-ian	rep-til-i-an
der-ma-tol-ogy	der-ma-tol-o-gy
tele-vised	televised
pho-to-copy	pho-to-cop-y
rel-a-tivism	rel-a-tiv-ism
ge-nial	ge-ni-al
orig-i-nal-i-ty	o-rig-i-nal-i-ty
bury	bur-y
un-even-ly	un-e-ven-ly
out-lier	out-li-er
apos-tle	a-pos-tle
kook-abur-ra	kook-a-bur-ra
ne-go-tiable	ne-go-ti-a-ble
un-us-able	un-us-a-ble
transept	tran-sept
reg-istry	reg-is-try
ob-lig-ate	ob-li-gate
cream-ery	cream-er-y
in-suf-fer-able	in-suf-fer-a-ble
hostage	hos-tage
melt-ed	melted
cataract	cat-a-ract
awash	a-wash
hab-er-dash-ery	hab-er-dash-er-y
ca-nary	ca-nar-y
mag-ne-sium	mag-ne-si-um
de-bauch-ery	de-bauch-er-y
com-man-der	com-mand-er
evade	e-vade
over-state	o-ver-state
sub-sis-tence	sub-sist-ence
reser-va-tion	res-er-va-tion
heavy-weight	heav-y-weight
bomber	bomb-er
snowflake	snow-flake
re-silience	re-sil-ience
deu-teri-um	deu-te-ri-um
avowed-ly	a-vow-ed-ly
penu-ri-ous	pe-nu-ri-ous
mal-odor-ous	mal-o-dor-ous
can-nery	can-ner-y
dis-senter	dis-sent-er
brawny	brawn-y
tib-ia	tib-i-a
babysit-ter	ba-by-sit-ter
flota-tion	flo-ta-tion
pro-to-zoan	pro-to-zo-an
triple	tri-ple
di-atom-ic	di-a-tom-ic
dacha	da-cha
ori-en-tal	o-ri-en-tal
ru-ined	ruined
sober	so-ber
vine-gar	vin-e-gar
con-denser	con-dens-er
fi-nale	fi-na-le
dopey	dope-y
rounder	round-er
stopover	stop-o-ver
there-upon	there-up-on
avari-cious	av-a-ri-cious
catal-y-sis	ca-tal-y-sis
liv-able	liv-a-ble
se-r-i-al	se-ri-al
cour-t-house	court-house
epi-demi-ol-o-gy	ep-i-de-mi-ol-o-gy
torus	to-rus
rec-on-cil-able	rec-on-cil-a-ble
crossover	cross-o-ver
poly-car-bon-ate	pol-y-car-bon-ate
tuner	tun-er
un-adorned	un-a-dorned
celi-bate	cel-i-bate
in-vesti-ture	in-ves-ti-ture
re-galia	re-ga-li-a
coleslaw	cole-slaw
bio-rhythm	bi-o-rhythm
serai	se-ra-i
rant-i-ng	ranting
soror-i-ty	so-ror-i-ty
regi-cide	reg-i-cide
mar-ke-teer	mar-ket-eer
in-tu-ition	in-tu-i-tion
racism	rac-ism
promi-nent	prom-i-nent
neur-al	neu-ral
tele-ol-o-gy	tel-e-ol-o-gy
triplet	tri-plet
crazy	cra-zy
para-mil-i-tary	par-a-mil-i-tar-y
doyenne	doy-enne
hip-popota-mus	hip-po-pot-a-mus
dotage	dot-age
homi-cide	hom-i-cide
dullard	dull-ard
so-lace	sol-ace
any-how	an-y-how
clema-tis	clem-a-tis
im-placa-ble	im-plac-a-ble
glos-sary	glos-sa-ry
is-suance	is-su-ance
mea-sure-ment	meas-ure-ment
stenog-ra-phy	ste-nog-ra-phy
gaucherie	gau-che-rie
bur-glary	bur-gla-ry
beanstalk	bean-stalk
aplomb	a-plomb
un-af-ford-able	un-af-ford-a-ble
slimy	slim-y
cashew	cash-ew
pager	pag-er
rasper	rasp-er
emen-da-tion	e-men-da-tion
pathogen	path-o-gen
moth-er-stobe	mo-ther-stobe
de-posit	de-pos-it
grasshop-per	grass-hop-per
car-cino-genic	car-cin-o-gen-ic
pre-his-toric	pre-his-tor-ic
purview	pur-view
ital-ic	i-tal-ic
mim-ic-k-er	mim-ick-er
promis-so-ry	prom-is-so-ry
babes	babes
equip-ment	e-quip-ment
finicky	fin-ick-y
open-hand-ed	o-pen-hand-ed
groupie	group-ie
spillage	spill-age
unloved	un-loved
eleven	e-lev-en
over-sam-pling	o-ver-sam-pling
opi-oid	o-pi-oid
fusil-lade	fu-sil-lade
puer-per-al	pu-er-per-al
hal-ibut	hal-i-but
over-pay-ment	o-ver-pay-ment
com-mend-able	com-mend-a-ble
un-opened	un-o-pened
sagac-i-ty	sa-gac-i-ty
around	a-round
neuter	neu-ter
un-wary	un-war-y
ibis	i-bis
buzzer	buzz-er
raider	raid-er
stron-groom	strong-room
ir-re-mov-able	ir-re-mov-a-ble
monau-r-al	mon-au-ral
breakup	break-up
me-dieval	me-di-e-val
union-ism	un-ion-ism
sec-toral	sec-tor-al
dis-hon-esty	dis-hon-es-ty
crier	cri-er
apos-tolic	ap-os-tol-ic
dis-ci-pli-nary	dis-ci-pli-nar-y
doorstop	door-stop
hunter	hunt-er
un-ac-count-able	un-ac-count-a-ble
ephor	eph-or
au-gury	au-gu-ry
con-for-mance	con-form-ance
dri-ver-less	driv-er-less
quixot-ic	quix-ot-ic
or-ga-ni-za-tion	or-gan-i-za-tion
re-uni-fy	re-u-ni-fy
in-testi-nal	in-tes-ti-nal
unso-cial	un-so-cial
su-prema-cist	su-prem-a-cist
milk-shake	milkshake
anus	a-nus
where-abouts	where-a-bouts
in-con-tro-vert-ible	in-con-tro-vert-i-ble
de-for-mi-ty	de-form-i-ty
scrib-bling	scribbling
on-toge-ny	on-tog-e-ny
el-dest	eld-est
pre-dict-ed	predicted
earnest-ly	ear-nest-ly
ashen	ash-en
basilisk	bas-i-lisk
kinswoman	kins-wom-an
beryl	ber-yl
colony	col-o-ny
in-signif-i-cant	in-sig-nif-i-cant
usu-al	u-su-al
grandiose	gran-di-ose
smudgy	smudg-y
un-rea-son-able	un-rea-son-a-ble
usu-ri-ous	u-su-ri-ous
fiendish	fiend-ish
painkiller	pain-kil-ler
con-sid-er-ably	con-sid-er-a-bly
clavi-chord	clav-i-chord
breast-feed	breastfeed
blotchy	blotch-y
screwy	screw-y
fifty	fif-ty
uni-son	u-ni-son
trac-ery	trac-er-y
there-abouts	there-a-bouts
dis-tillery	dis-till-er-y
im-par-tial-i-ty	im-par-ti-al-i-ty
sim-u-lacrum	sim-u-la-crum
steve-dore	ste-ve-dore
florid	flor-id
un-de-ni-able	un-de-ni-a-ble
type-writer	type-writ-er
hege-mon-ic	heg-e-mon-ic
re-versed	reversed
chancy	chanc-y
harem	har-em
stilet-to	sti-let-to
wrap-around	wrap-a-round
maudlin	maud-lin
dairy-ing	dair-y-ing
hor-mon-al	hor-mo-nal
lanky	lank-y
reprise	re-prise
uni-ver-sal-ist	u-ni-ver-sal-ist
groom-ing	grooming
ini-ti-ate	in-i-ti-ate
beeswax	bees-wax
beret	be-ret
dauphin	dau-phin
pumice	pum-ice
racist	rac-ist
va-sec-to-my	vas-ec-to-my
foxy	fox-y
mega-volt	meg-a-volt
re-stroom	rest-room
dishar-mo-ny	dis-har-mo-ny
vel-vety	vel-vet-y
ionos-phere	i-on-o-sphere
capri-cious	ca-pri-cious
spindly	spin-dly
coy-ote	coy-o-te
bistro	bis-tro
carafe	ca-rafe
labyrinthine	lab-y-rin-thine
char-cu-terie	char-cu-te-rie
apoth-e-o-sis	a-poth-e-o-sis
equal-i-ty	e-qual-i-ty
deep-en-ing	deepening
vex-ing	vexing
mono-cul-ture	mon-o-cul-ture
colan-der	col-an-der
ar-biter	ar-bi-ter
sepia	se-pi-a
graver	grav-er
remix	re-mix
ir-re-place-able	ir-re-place-a-ble
mea-sur-able	meas-ur-a-ble
trawler	trawl-er
nowa-days	now-a-days
telling-ly	tell-ing-ly
im-pre-sario	im-pre-sa-ri-o
con-fronta-tion-al	con-fron-ta-tion-al
creduli-ty	cre-du-li-ty
frat-ri-ci-dal	frat-ri-cid-al
iri-des-cent	ir-i-des-cent
painter	paint-er
equi-lib-ri-um	e-qui-lib-ri-um
di-ary	di-a-ry
metempsy-chosis	me-tem-psy-cho-sis
myx-o-mato-sis	myx-o-ma-to-sis
re-word-ings	re-word-ings
bes-tial-i-ty	bes-ti-al-i-ty
apos-ta-sy	a-pos-ta-sy
idler	i-dler
omis-sion	o-mis-sion
turnkey	turn-key
con-t-a-m-i-na-tion	con-tam-i-na-tion
ver-biage	ver-bi-age
ide-al	i-de-al
recheck	re-check
sober-ing	sobering
odome-ter	o-dom-e-ter
satchel	satch-el
taber-na-cle	tab-er-nac-le
vulpine	vul-pine
laugh-ably	laugh-a-bly
diesel	die-sel
slater	slat-er
ever-last-ing	ev-er-last-ing
mono-lith-ic	mon-o-lith-ic
fum-bling	fumbling
civil-ian	ci-vil-ian
qua-drat-ic	quad-rat-ic
bevy	bev-y
soapy	soap-y
coxswain	cox-swain
matins	mat-ins
hero-ical-ly	he-ro-i-cal-ly
philoso-pher	phi-los-o-pher
eigen-state	ei-gen-state
sim-per-ing	simpering
holo-caust	hol-o-caust
lot-tery	lot-ter-y
re-new-able	re-new-a-ble
trilin-gual	tri-lin-gual
quiver	quiv-er
turquoise	tur-quoise
fla-gel-la-tion	flag-el-la-tion
ringlet	ring-let
sausage	sau-sage
fatu-ous	fat-u-ous
ir-re-sistible	ir-re-sist-i-ble
tapas	ta-pas
auburn	au-burn
en-joy-ably	en-joy-a-bly
tru-cu-lent	truc-u-lent
dis-putable	dis-put-a-ble
bari-tone	bar-i-tone
pari-etal	pa-ri-e-tal
turmer-ic	tur-mer-ic
palin-drome	pal-in-drome
ap-plic-a-bil-i-ty	ap-pli-ca-bil-i-ty
resid-uary	re-sid-u-ar-y
ge-nial-i-ty	ge-ni-al-i-ty
kine-mat-ics	kin-e-mat-ics
poignan-cy	poign-an-cy
tran-scen-dent	tran-scend-ent
un-hy-gien-ic	un-hy-gi-en-ic
bony	bon-y
break-able	break-a-ble
enun-ci-ate	e-nun-ci-ate
stowage	stow-age
os-teopath	os-te-o-path
jovial	jo-vi-al
tra-verse	trav-erse
flagon	flag-on
lantern	lan-tern
baili-wick	bail-i-wick
flighty	flight-y
over-ac-tive	o-ver-ac-tive
mas-culin-i-ty	mas-cu-lin-i-ty
skele-ton	skel-e-ton
guardian-ship	guard-i-an-ship
il-menite	il-men-ite
plateau	pla-teau
em-body	em-bod-y
over-spill	o-ver-spill
cagoule	ca-goule
apery	ap-er-y
be-wil-der-ing	bewildering
saki	sa-ki
whirligig	whirl-i-gig
bowlder	bowl-der
run-away	run-a-way
briny	brin-y
reti-nal	ret-i-nal
cryp-tol-ogy	cryp-tol-o-gy
heifer	heif-er
thumbprint	thumb-print
stu-dious-ly	stu-di-ous-ly
bar-l-ey-corn	bar-ley-corn
doer	do-er
ex-pand-able	ex-pand-a-ble
peafowl	pea-fowl
sanc-ti-mo-nious	sanc-ti-mo-ni-ous
in-evitable	in-ev-i-ta-ble
bo-som	bos-om
icon-o-clast	i-con-o-clast
mari-nade	mar-i-nade
ahead	a-head
ovoid	o-void
ex-is-tence	ex-ist-ence
peas-antry	peas-ant-ry
crick-eter	crick-et-er
equiv-a-lent	e-quiv-a-lent
aphro-disi-ac	aph-ro-dis-i-ac
sol-diery	sol-dier-y
prosody	pros-o-dy
telex	tel-ex
ob-streper-ous	ob-strep-er-ous
mis-ery	mis-er-y
hindquar-ters	hind-quar-ters
bo-hemi-an	bo-he-mi-an
mag-is-te-r-i-al	mag-is-te-ri-al
im-pro-vi-sa-tion	im-prov-i-sa-tion
hyp-ocrite	hyp-o-crite
newsy	news-y
over-in-flat-ed	o-ver-in-flat-ed
para-troop-er	par-a-troop-er
forest-ed	forested
pho-tore-cep-tor	pho-to-re-cep-tor
rec-i-p-ro-cate	re-cip-ro-cate
pri-mar-i-ly	pri-ma-ri-ly
grenade	gre-nade
weighty	weight-y
glut-to-nous	glut-ton-ous
plan-e-tary	plan-e-tar-y
chirpy	chirp-y
shekel	shek-el
au-thoress	au-thor-ess
lik-able	lik-a-ble
sup-ple-men-tary	sup-ple-men-ta-ry
om-nipres-ence	om-ni-pres-ence
shoplifter	shop-lift-er
per-fidy	per-fi-dy
ra-dio-ther-a-py	ra-di-o-ther-a-py
pithy	pith-y
ure-thra	u-re-thra
at-ten-dant	at-tend-ant
sto-icism	sto-i-cism
uni-verse	u-ni-verse
stipen-di-ary	sti-pen-di-ar-y
rook-ery	rook-er-y
iso-mer	i-so-mer
bristling	bris-tling
cryp-togram	cryp-to-gram
lava-to-ry	lav-a-to-ry
timid-i-ty	ti-mid-i-ty
or-tho-doxy	or-tho-dox-y
monomer	mon-o-mer
slushy	slush-y
som-brero	som-bre-ro
hon-orif-ic	hon-or-if-ic
gooey	goo-ey
over-do	o-ver-do
emo-tion-less	e-mo-tion-less
sub-stan-dard	sub-stand-ard
au-tonomous-ly	au-ton-o-mous-ly
mus-cu-loskele-tal	mus-cu-lo-skel-e-tal
timescale	time-scale
au-toma-ton	au-tom-a-ton
dyad	dy-ad
un-remit-ting	un-re-mit-ting
linger	lin-ger
sawyer	saw-yer
galaxy	gal-ax-y
un-beat-able	un-beat-a-ble
whiten	whit-en
naval	na-val
retell	re-tell
mov-able	mov-a-ble
politic	pol-i-tic
con-vict-ed	convicted
salary	sal-a-ry
prov-ably	prov-a-bly
moral-i-ty	mo-ral-i-ty
ship-builder	ship-build-er
man-darin	man-da-rin
co-pra	cop-ra
liquor	liq-uor
herbal-ism	her-bal-ism
spon-ta-neous	spon-ta-ne-ous
pro-ject-ing	projecting
ni-hilism	ni-hil-ism
copy	cop-y
nympho-ma-nia	nym-pho-ma-ni-a
un-bear-able	un-bear-a-ble
de-ify	de-i-fy
psalmist	psalm-ist
cam-era-man	cam-er-a-man
cleanup	clean-up
gecko	geck-o
hi-jack-ing	hi-jac-king
equip	e-quip
cra-nial	cra-ni-al
phono-graph	pho-no-graph
malev-o-lence	ma-lev-o-lence
iso-la-tion-ist	i-so-la-tion-ist
bol-stered	bolstered
causative	caus-a-tive
gluten	glu-ten
turfy	turf-y
mega-lo-ma-nia	meg-a-lo-ma-ni-a
liar	li-ar
in-trauter-ine	in-tra-u-ter-ine
oph-thalmic	oph-thal-mic
athe-is-tic	a-the-is-tic
ring-leader	ring-lead-er
pos-i-tivist	pos-i-tiv-ist
over-act	o-ver-act
chester-field	ches-ter-field
em-bell-ish-ment	em-bel-lish-ment
rani	ra-ni
hooray	hoo-ray
re-al-ness	real-ness
urol-o-gist	u-rol-o-gist
mis-sion-ary	mis-sion-ar-y
re-assess	re-as-sess
deficit	def-i-cit
con-duc-tance	con-duct-ance
eru-dite	er-u-dite
pigsty	pig-sty
restau-rant	res-tau-rant
biofeed-back	bi-o-feed-back
disin-gen-u-ous	dis-in-gen-u-ous
spiny	spin-y
min-uet	min-u-et
aright	a-right
astir	a-stir
seraph-ic	se-raph-ic
moist-en	mois-ten
easel	ea-sel
pup-peteer	pup-pet-eer
dri-v-el	driv-el
turntable	turn-ta-ble
re-sul-tant	re-sult-ant
evoca-tive	e-voc-a-tive
poly-syl-lab-ic	pol-y-syl-lab-ic
im-peri-um	im-pe-ri-um
rhodo-den-dron	rho-do-den-dron
grid-iron	grid-i-ron
inane	in-ane
cathe-dral	ca-the-dral
lazi-ness	la-zi-ness
aria	a-ri-a
awak-en	a-wak-en
marten	mar-ten
moc-casin	moc-ca-sin
em-piri-cist	em-pir-i-cist
expo	ex-po
oa-sis	o-a-sis
guardian	guard-i-an
starfish	star-fish
canal	ca-nal
legged	leg-ged
un-healthy	un-health-y
ren-dered	rendered
ca-ress-ing	ca-res-sing
emer-sion	e-mer-sion
fortress	for-tress
pro-pa-gan-dist	prop-a-gan-dist
liny	lin-y
nugget	nug-get
peri	pe-ri
emi-rate	e-mir-ate
pol-lard-ed	pollarded
reper-toire	rep-er-toire
rhetor-i-cal	rhe-tor-i-cal
ran-corous	ran-cor-ous
boa	bo-a
shandy	shan-dy
glia	gli-a
var-ie-gat-ed	var-i-e-gat-ed
april	a-pril
per-sis-tent-ly	per-sist-ent-ly
nonex-is-tence	non-ex-ist-ence
tute-lary	tu-te-lar-y
bromine	bro-mine
iden-ti-fi-ca-tion	i-den-ti-fi-ca-tion
tri-maran	tri-ma-ran
retest	re-test
tri-umvi-rate	tri-um-vi-rate
con-comi-tant	con-com-i-tant
oval	o-val
he-do-nism	he-don-ism
un-proven	un-prov-en
weari-ly	wea-ri-ly
an-tithe-sis	an-tith-e-sis
sac-risty	sac-ris-ty
para-nor-mal	par-a-nor-mal
placid	plac-id
epis-te-mol-o-gy	e-pis-te-mol-o-gy
crispy	crisp-y
dis-turbing-ly	dis-turb-ing-ly
mandible	man-di-ble
elfin	elf-in
apart-ment	a-part-ment
com-forter	com-fort-er
misty	mist-y
galling	gall-ing
sur-vivor	sur-vi-vor
sewage	sew-age
bridal	brid-al
meanie	mean-ie
iso-bar	i-so-bar
fid-get	fidg-et
un-abat-ed	un-a-bat-ed
ob-scu-ran-tism	ob-scu-rant-ism
squeaky	squeak-y
bedrock	bed-rock
prophet-ess	proph-et-ess
idly	i-dly
opera	o-pe-ra
vivi-sec-tion	viv-i-sec-tion
un-de-mo-c-ra-t-ic	un-dem-o-crat-ic
mata-dor	mat-a-dor
pelvis	pel-vis
cas-tanets	cas-ta-nets
pat-terned	patterned
decade	dec-ade
ho-muncu-lus	ho-mun-cu-lus
re-quiem	req-ui-em
ex-per-i-menter	ex-per-i-ment-er
scriptwriter	script-writ-er
is-lander	is-land-er
trapeze	tra-peze
bat-tery	bat-ter-y
height-ened	heightened
ther-mome-ter	ther-mom-e-ter
wretched	wretch-ed
in-ex-orable	in-ex-o-ra-ble
dis-pen-sary	dis-pen-sa-ry
inim-itable	in-im-i-ta-ble
geome-ter	ge-om-e-ter
teleprint-er	tel-e-print-er
ve-loci-pede	ve-loc-i-pede
derelict	der-e-lict
even-tu-al	e-ven-tu-al
emo-tion-al-ly	e-mo-tion-al-ly
Words with errors: 1880
Words with incorrect number of syllables: 1760
Total evluated: 6500
Perfect accuracy: 0.71
Number of syllables accuracy: 0.73
Average Levenshtein Distance(across incorrect words): 1.17
