Attempt	Real
gloomy	gloom-y
d-educ-t	de-duct
theta	the-ta
para-dox-i-cal	par-a-dox-i-cal
baron-age	bar-on-age
how-itzer	how-itz-er
lachry-mose	lach-ry-mose
d-war-f	dwarf
de-cay-ing	decaying
grandeur	gran-deur
declam-a-to-ry	de-clam-a-to-ry
foot-bal-l	foot-ball
un-playable	un-play-a-ble
refu-ta-tion	ref-u-ta-tion
di-ure-sis	di-u-re-sis
di-gestible	di-gest-i-ble
ra-dio-gram	ra-di-o-gram
test-ing	testing
thriller	thrill-er
rock-ery	rock-er-y
s-lob-ber	slob-ber
hideous	hid-e-ous
cleaver-s	cleav-ers
taboo	ta-boo
mildew	mil-dew
eat-able	eat-a-ble
platelet	plate-let
g-lid-ing	glid-ing
achieve-men-t	a-chieve-ment
car-away	car-a-way
boron	bo-ron
s-traw-ber-ry	straw-ber-ry
stony	ston-y
poli-ty	pol-i-ty
firear-m	fire-arm
dis-burse-men-t	dis-burse-ment
com-mis-sari-at	com-mis-sar-i-at
as-cen-dan-t	as-cend-ant
mort-gagee	mort-ga-gee
s-lum-ber	slum-ber
ten-able	ten-a-ble
toluene	tol-u-ene
golfer	golf-er
s-tat-u-ary	stat-u-ar-y
kinky	kink-y
s-tool	stool
s-todgy	stodg-y
causal-i-ty	cau-sal-i-ty
demigod	dem-i-god
pep-pered	peppered
con-ceiv-able	con-ceiv-a-ble
koala	ko-a-la
s-cores	scores
elo-quen-t	el-o-quent
gale-na	ga-le-na
totem	to-tem
mas-t	mast
n-ev-er	nev-er
moder-ni-ty	mo-der-ni-ty
s-lant-ed	slanted
hang-over	hang-o-ver
there-after	there-af-ter
his-toric	his-tor-ic
k-er-chief	ker-chief
burn-t	burnt
pres-ti-gious	pres-tig-ious
brushy	brush-y
coac-tion	co-ac-tion
s-mug-ness	smug-ness
washy	wash-y
rein-vest-men-t	re-in-vest-ment
cheesy	chees-y
het-ero-gene-ity	het-er-o-ge-ne-i-ty
s-lant-wise	slant-wise
un-pre-dictably	un-pre-dict-a-bly
su-per-tanker	su-per-tank-er
head-quar-ter-s	head-quar-ters
retroac-tive-ly	ret-ro-ac-tive-ly
iso-la-tion-is-m	i-so-la-tion-ism
qua-dru-pli-cate	quad-ru-pli-cate
di-rec-torate	di-rec-to-rate
cough-ing	coughing
millpond	mill-pond
s-tok-er	stok-er
s-cope	scope
calorime-ter	cal-o-rim-e-ter
ca-cophonous	ca-coph-o-nous
propen-si-ty	pro-pen-si-ty
his-tamine	his-ta-mine
steamy	steam-y
in-spi-ra-tional	in-spi-ra-tion-al
cred-it-wor-thy	cred-it-worth-y
servi-ette	ser-vi-ette
bondage	bond-age
dul-cimer	dul-ci-mer
u-ni-for-m	u-ni-form
s-tore	store
rein-tro-duc-tion	re-in-tro-duc-tion
s-plashy	splash-y
valu-able	val-u-a-ble
hon-esty	hon-es-ty
k-ing-ly	king-ly
pol-l	poll
leisure	lei-sure
es-carp-men-t	es-carp-ment
s-cowl	scowl
give-away	give-a-way
mesca-line	mes-ca-line
g-naw	gnaw
c-etacean	ce-ta-cean
gavial	ga-vi-al
nau-tilus	nau-ti-lus
dinky	dink-y
ban-ish-men-t	ban-ish-ment
re-sis-tance	re-sist-ance
trans-paren-cy	trans-par-en-cy
medal	med-al
re-di-rect-ion	re-di-rec-tion
bean-ery	bean-er-y
s-tate-hood	state-hood
dili-gent-ly	dil-i-gent-ly
reis-sue	re-is-sue
nymp-holep-sy	nym-pho-lep-sy
en-joy-men-t	en-joy-ment
con-cussed	concussed
over-hand	o-ver-hand
fon-dan-t	fon-dant
avoid	a-void
s-losh	slosh
fa-tal-is-m	fa-tal-ism
streaky	streak-y
coro-ner	cor-o-ner
fi-nis	fin-is
amoun-t	a-mount
para-medic	par-a-med-ic
so-cio-bi-ol-o-gy	so-ci-o-bi-ol-o-gy
in-con-gruity	in-con-gru-i-ty
touristy	tour-ist-y
ben-e-fi-cia-ry	ben-e-fi-ci-ar-y
s-tu-pe-fac-tion	stu-pe-fac-tion
phys-iog-no-my	phys-i-og-no-my
at-tempt-ed	at-temp-ted
con-sul-tan-t	con-sult-ant
metatarsal	met-a-tar-sal
seedling	seed-ling
curvy	curv-y
s-carp	scarp
piglet	pig-let
ob-jec-tion-able	ob-jec-tion-a-ble
leg-erde-main	leg-er-de-main
b-lessed-ness	bless-ed-ness
con-sen-t	con-sent
laud-able	laud-a-ble
sero-tonin	ser-o-to-nin
bauble	bau-ble
s-now-fal-l	snow-fall
af-ter-ward-s	af-ter-wards
basalt	ba-salt
laun-derette	laun-der-ette
in-de-pen-dence	in-de-pend-ence
tiler	til-er
axle	ax-le
s-pear-head	spear-head
mi-crowave	mi-cro-wave
mud-dling	muddling
vel-veteen	vel-vet-een
masseuse	mas-seuse
tan-ta-moun-t	tan-ta-mount
backpedal	back-ped-al
mel-liflu-ous	mel-lif-lu-ous
i-n-ad-e-qua-cy	in-ad-e-qua-cy
knitwear	knit-wear
fron-t	front
ex-plorato-ry	ex-plor-a-to-ry
re-liance	re-li-ance
joyrid-ing	joy-rid-ing
cryo-gen-ic-s	cry-o-gen-ics
sen-tinel	sen-ti-nel
k-lick	klick
breath-able	breath-a-ble
n-in-com-poop	nin-com-poop
signet	sig-net
brun-t	brunt
s-nug-ly	snug-ly
con-ver-gen-t	con-ver-gent
k-itch-enette	kitch-en-ette
door-bel-l	door-bell
un-com-mu-nica-tive	un-com-mu-ni-ca-tive
s-calp	scalp
e-mer-ald	em-er-ald
aver-sive	a-ver-sive
pres-bytery	pres-by-ter-y
s-tran-gles	stran-gles
iron-work-s	i-ron-works
asymp-to-matic	a-symp-to-mat-ic
machi-na-tion	mach-i-na-tion
mir-ror-ing	mirroring
wildlife	wild-life
func-tionary	func-tion-ar-y
s-lay	slay
mildewy	mil-dew-y
as-siduity	as-si-du-i-ty
mi-crodot	mi-cro-dot
cast-away	cast-a-way
e-n-ac-t	en-act
col-le-gial	col-le-gi-al
s-nob-bery	snob-ber-y
brain-stor-m	brain-storm
stroller	stroll-er
thruster	thrust-er
hy-gien-e	hy-giene
op-er-a-tional	op-er-a-tion-al
augite	au-gite
s-core	score
war-ran-t	war-rant
hellish	hell-ish
mar-quetry	mar-que-try
in-cur-able	in-cur-a-ble
raven	ra-ven
geosyn-chronous	ge-o-syn-chro-nous
minaret	min-a-ret
in-hab-it-able	in-hab-it-a-ble
pold-er	pol-der
char-i-o-teer	char-i-ot-eer
gov-er-nance	gov-ern-ance
un-electable	un-e-lect-a-ble
take-away	take-a-way
poly-chrome	pol-y-chrome
gen-uine-ly	gen-u-ine-ly
de-scen-dan-t	de-scend-ant
clam-p	clamp
s-lip-way	slip-way
monoc-u-lar	mo-noc-u-lar
c-it-ric	cit-ric
in-ter-de-pen-den-t	in-ter-de-pend-ent
en-abled	e-na-bled
un-re-solv-able	un-re-solv-a-ble
hy-drazine	hy-dra-zine
coro-nal	cor-o-nal
s-ce-nari-o	sce-nar-i-o
s-trato-spher-ic	strat-o-spher-ic
id-i-olec-t	id-i-o-lect
lega-cy	leg-a-cy
heinous	hei-nous
re-cip-i-en-t	re-cip-i-ent
jus-ti-fi-ably	jus-ti-fi-a-bly
palmy	palm-y
di-uret-ic	di-u-ret-ic
in-her-en-t	in-her-ent
re-pro-ducibil-i-ty	re-pro-duc-i-bil-i-ty
bene-dic-tion	ben-e-dic-tion
stylis-tic	sty-lis-tic
grandios-i-ty	gran-di-os-i-ty
defama-tion	def-a-ma-tion
pyri-dine	pyr-i-dine
sym-bio-sis	sym-bi-o-sis
temer-i-ty	te-mer-i-ty
in-fre-quen-t	in-fre-quent
colos-sal	co-los-sal
balustrade	bal-us-trade
fiz-z	fizz
napoleon	na-po-le-on
genome	ge-nome
jiffy	jif-fy
pe-riphra-sis	pe-riph-ra-sis
seedbed	seed-bed
rea-son-able-ness	rea-son-a-ble-ness
wily	wil-y
s-lack-en	slack-en
jerky	jerk-y
bindweed	bind-weed
ap-petite	ap-pe-tite
lop-per-s	lop-pers
prophe-cy	proph-e-cy
en-force-men-t	en-force-ment
artis-tic	ar-tis-tic
leav-ened	leavened
con-ven-t	con-vent
cor-dial	cor-di-al
con-nect-ing	con-nec-ting
s-mudge	smudge
semi-con-scious	sem-i-con-scious
friendlily	friend-li-ly
s-cuf-f	scuff
tonight	to-night
plenipo-ten-tiary	plen-i-po-ten-ti-ar-y
frisky	frisk-y
c-it-i-zen-ry	cit-i-zen-ry
beloved	be-lov-ed
im-moral	im-mor-al
s-in-cer-i-ty	sin-cer-i-ty
fo-liage	fo-li-age
arc-ing	arcing
se-quen-t	se-quent
ril-l	rill
s-lur	slur
col-lec-tivist	col-lec-tiv-ist
con-tam-i-nan-t	con-tam-i-nant
ghana	ghana
s-trap	strap
ev-ery-where	eve-ry-where
i-n-ac-ces-si-ble	in-ac-ces-si-ble
re-tal-ia-to-ry	re-tal-i-a-to-ry
n-ear-ly	near-ly
man-ager-ess	man-ag-er-ess
archangel	arch-an-gel
kestrel	kes-trel
swelling	swell-ing
be-witch-ing	bewitching
un-fath-omable	un-fath-om-a-ble
d-inghy	din-ghy
jean-s	jeans
trea-sur-er	treas-ur-er
ex-pect-ed	expected
ar-guable	ar-gu-a-ble
cryp-t	crypt
babysit	ba-by-sit
dele-te-ri-ous	del-e-te-ri-ous
lim-iter	lim-it-er
surly	sur-ly
in-tra-venous	in-tra-ve-nous
en-doge-nous	en-dog-e-nous
a-gen-t	a-gent
syn-onym	syn-o-nym
mayfly	may-fly
foible	foi-ble
s-cone	scone
in-tac-t	in-tact
de-ter-minable	de-ter-mi-na-ble
sar-i	sa-ri
mini-cab	min-i-cab
retic-u-lar	re-tic-u-lar
delir-i-um	de-lir-i-um
sub-ter-ranean	sub-ter-ra-ne-an
vil-lainy	vil-lain-y
rec-om-mend-ed	recommended
he-do-nist	he-don-ist
or-ga-nized	or-gan-ized
his-togram	his-to-gram
in-sis-ten-t	in-sist-ent
hy-dro-elec-tric	hy-dro-e-lec-tric
based	based
busy	bus-y
im-pass-able	im-pass-a-ble
ide-al-ist	i-de-al-ist
nephri-tis	ne-phri-tis
mega-phone	meg-a-phone
su-per-natan-t	su-per-na-tant
chore-og-ra-pher	cho-re-og-ra-pher
e-s-pe-cial	es-pe-cial
i-n-ac-cu-rate	in-ac-cu-rate
b-room-stick	broom-stick
mimet-ic	mi-met-ic
in-for-man-t	in-form-ant
clien-t	cli-ent
domi-cil-iary	dom-i-cil-i-ar-y
ren-t	rent
s-pat-ter	spat-ter
re-state-men-t	re-state-ment
triage	tri-age
de-nier	de-ni-er
elec-trode	e-lec-trode
s-neak-i-ly	sneak-i-ly
un-tidy	un-ti-dy
ego	e-go
s-cur-rilous	scur-ril-ous
wa-ter-fron-t	wa-ter-front
fa-ther-ing	fathering
aro-mather-a-py	a-ro-ma-ther-a-py
in-ter-ci-ty	in-ter-cit-y
pre-cooked	precooked
en-counter	en-coun-ter
reroute	re-route
palate	pal-ate
shaky	shak-y
t-hou-sand	thou-sand
s-mite	smite
black-bal-l	black-ball
in-ter-vie-wee	in-ter-view-ee
gal-lan-t	gal-lant
sen-sa-tion-al-is-m	sen-sa-tion-al-ism
hearti-ly	heart-i-ly
e-quidis-tan-t	e-qui-dis-tant
lager	la-ger
mela-tonin	mel-a-to-nin
u-n-apolo-get-ic	un-a-pol-o-get-ic
serendip-i-tous	ser-en-dip-i-tous
mid-wifer-y	mid-wife-ry
hu-mankind	hu-man-kind
holis-ti-cal-ly	ho-lis-ti-cal-ly
repack	re-pack
melee	me-lee
s-toa	sto-a
dreamy	dream-y
un-war-rantable	un-war-rant-a-ble
iso-late	i-so-late
chrono-log-i-cal	chron-o-log-i-cal
rad-i-cal-is-m	rad-i-cal-ism
talon	tal-on
over-sight	o-ver-sight
robin	rob-in
in-fir-m	in-firm
canon-ic	ca-non-ic
the-atri-cal	the-at-ri-cal
reify	re-i-fy
s-ap-per	sap-per
chloro-phyl-l	chlo-ro-phyll
grapevine	grape-vine
more-over	more-o-ver
hy-drome-chan-ic-s	hy-dro-me-chan-ics
im-pressed	impressed
alive	a-live
plexus	plex-us
pes-simistic	pes-si-mis-tic
motile	mo-tile
ini-tial-ly	in-i-tial-ly
e-spres-so	es-pres-so
mimicry	mim-ic-ry
penol-o-gy	pe-nol-o-gy
legal-ly	le-gal-ly
for-syth-ia	for-syth-i-a
parochial-is-m	pa-ro-chi-al-ism
n-im-bly	nim-bly
gal-vanome-ter	gal-va-nom-e-ter
cys-teine	cys-te-ine
de-po-si-tion	dep-o-si-tion
un-in-hab-it-able	un-in-hab-it-a-ble
n-ode	node
hap-py-goluck-y	hap-py-go-luck-y
ox-alate	ox-a-late
welly	wel-ly
un-hesi-tat-ing	un-hes-i-tat-ing
away	a-way
bur-sary	bur-sa-ry
met-ric-s	met-rics
eu-kary-ote	eu-kar-y-ote
suf-fi-cien-t	suf-fi-cient
satir-i-cal	sa-tir-i-cal
asleep	a-sleep
su-perla-tive	su-per-la-tive
bac-teri-um	bac-te-ri-um
som-no-len-t	som-no-lent
chlo-ro-for-m	chlo-ro-form
colo-nial	co-lo-ni-al
ele-phan-t	el-e-phant
corp-s	corps
phy-loge-ny	phy-log-e-ny
dis-abling	disabling
episode	ep-i-sode
chromi-um	chro-mi-um
changeover	change-o-ver
lifebelt	life-belt
s-calar	sca-lar
ma-chin-ery	ma-chin-er-y
s-tat-uesque	stat-u-esque
fermion	fer-mi-on
beanie	bean-ie
breather	breath-er
in-de-ci-pher-able	in-de-ci-pher-a-ble
left-over	left-o-ver
good-s	goods
baloney	ba-lo-ney
e-cono-met-ric-s	e-con-o-met-rics
ax-il-lary	ax-il-lar-y
va-ri-etal	va-ri-e-tal
wiper	wip-er
doc-u-men-tary	doc-u-men-ta-ry
dis-pos-able	dis-pos-a-ble
macroe-co-nom-ic	mac-ro-ec-o-nom-ic
promi-nence	prom-i-nence
in-signi-a	in-sig-ni-a
blowup	blow-up
ra-dius	ra-di-us
s-tair-case	stair-case
s-nipe	snipe
epis-co-pa-cy	e-pis-co-pa-cy
tripoli	trip-o-li
in-ter-locu-tor	in-ter-loc-u-tor
whomev-er	whom-ev-er
bud-get	budg-et
para-m-ag-net-ic	par-a-mag-net-ic
num-b	numb
rat-tlesnake	rat-tle-snake
i-n-un-date	in-un-date
router	rout-er
u-nis-sued	un-is-sued
chamomile	cham-o-mile
ir-rec-on-cil-able	ir-rec-on-cil-a-ble
parental	pa-ren-tal
elec-tron-i-cal-ly	e-lec-tron-i-cal-ly
ge-nealog-i-cal	ge-ne-a-log-i-cal
s-pa	spa
uned-i-fy-ing	un-ed-i-fy-ing
metaphor-i-cal-ly	met-a-phor-i-cal-ly
marcher	march-er
eeri-ly	ee-ri-ly
pen-sion-able	pen-sion-a-ble
ar-chi-tec-tural	ar-chi-tec-tur-al
supreme	su-preme
e-tu-i	e-tui
sharp-en-er	shar-pen-er
wispy	wisp-y
con-sular	con-su-lar
inkwell	ink-well
gym-nas-tic-s	gym-nas-tics
bleat-ing	bleating
dis-abuse	dis-a-buse
any-body	an-y-bod-y
scruffy	scruff-y
mas-sacre	mas-sa-cre
best-selling	best-sell-ing
nifty	nif-ty
retro	ret-ro
blitzkrieg	blitz-krieg
thril-l	thrill
iris	i-ris
symp-to-matic	symp-to-mat-ic
deca-den-t	dec-a-dent
re-con-nec-t	re-con-nect
y-o-del	yo-del
lisp-ing	lis-ping
stin-t	stint
joey	jo-ey
ro-mancer	ro-manc-er
beat-i-tude	be-at-i-tude
bac-te-rio-phage	bac-te-ri-o-phage
in-her-i-ta-ble	in-her-it-a-ble
lodestar	lode-star
so-cialite	so-cial-ite
he-liotrope	he-li-o-trope
im-pon-der-able	im-pon-der-a-ble
de-scend-ing	descending
school-teacher	school-teach-er
privy	priv-y
s-low-ness	slow-ness
afraid	a-fraid
farad	far-ad
gatepost	gate-post
en-cam-p	en-camp
foundry	found-ry
con-temptible	con-tempt-i-ble
undiplo-mat-ic	un-dip-lo-mat-ic
hin-t	hint
carat	car-at
chilblain	chil-blain
re-com-bi-nan-t	re-com-bi-nant
trel-lised	trellised
sycamore	syc-a-more
s-tain	stain
les-bian	les-bi-an
pit-fal-l	pit-fall
as-segai	as-se-gai
stuffy	stuff-y
wiz-ardry	wiz-ard-ry
gramo-phone	gram-o-phone
in-san-i-tary	in-san-i-tar-y
trainee	train-ee
lethal	le-thal
coitus	co-i-tus
ar-ran-t	ar-rant
paean	pae-an
s-low-down	slow-down
both-ered	bothered
pe-tit	pet-it
sub-terfuge	sub-ter-fuge
sep-a-ratism	sep-a-ra-tism
ex-u-ber-an-t	ex-u-ber-ant
in-cisor	in-ci-sor
con-tigu-ous	con-tig-u-ous
im-pair-men-t	im-pair-ment
s-tork	stork
coura-geous	cou-ra-geous
palu-dal	pa-lu-dal
over-fly	o-ver-fly
s-tar-dom	star-dom
e-s-o-ter-i-ca	es-o-ter-i-ca
k-er-nel	ker-nel
fussy	fuss-y
igua-na	i-gua-na
de-jec-t	de-ject
u-nat-tend-ed	un-at-tend-ed
over-wrought	o-ver-wrought
puerile	pu-er-ile
d-is-fig-ure	dis-fig-ure
razzmataz-z	razz-ma-tazz
f-reaky	freak-y
sloven-ly	slov-en-ly
tyran-ni-cide	ty-ran-ni-cide
clam-orous	clam-or-ous
un-con-trol-lably	un-con-trol-la-bly
cyclic	cy-clic
techno-pho-bi-a	tech-no-pho-bia
chock-ablock	chock-a-block
portage	por-tage
by-stander	by-stand-er
tidal	tid-al
mo-lasses	mo-las-ses
cyanide	cy-a-nide
nightwear	night-wear
dis-tiller	dis-till-er
s-nort	snort
obe-di-ence	o-be-di-ence
p-reser-va-tion	pres-er-va-tion
elec-trolyte	e-lec-tro-lyte
vana-di-um	va-na-di-um
detox	de-tox
ven-t	vent
hobo	ho-bo
meta-mor-phose	met-a-mor-phose
stag-ger-ing	staggering
catch-men-t	catch-ment
s-caly	scal-y
laity	la-i-ty
s-naf-fle	snaf-fle
chateau	cha-teau
s-cape	scape
tu-mul-tuous	tu-mul-tu-ous
avenger	a-veng-er
reval-ue	re-val-ue
ser-pen-t	ser-pent
mili-tia-man	mi-li-tia-man
eleventh	e-lev-enth
vac-uole	vac-u-ole
d-if-fu-siv-i-ty	dif-fu-siv-i-ty
staphy-lo-coc-cus	staph-y-lo-coc-cus
s-tate-less	state-less
creak-ing	creaking
stringer	string-er
weaver	weav-er
oblit-er-a-tion	ob-lit-er-a-tion
grandee	gran-dee
specu-lum	spec-u-lum
u-n-at-tached	un-at-tached
siren	si-ren
fire-bom-b	fire-bomb
ex-tin-guish-men-t	ex-tin-guish-ment
di-vider	di-vid-er
decla-ma-tion	dec-la-ma-tion
hi-er-ar-ch	hi-er-arch
rain-stor-m	rain-storm
em-ploy-men-t	em-ploy-ment
s-teeply	steep-ly
por-traitist	por-trait-ist
in-frared	in-fra-red
dauber	daub-er
s-tiff-ness	stiff-ness
sus-pec-t	sus-pect
hit-table	hit-ta-ble
re-sis-tan-t	re-sist-ant
literati	lit-e-ra-ti
benev-o-lence	be-nev-o-lence
mileage	mile-age
k-ilo-hertz	kil-o-hertz
s-panker	spank-er
opi-um	o-pi-um
di-ar-rhea	di-ar-rhe-a
cerise	ce-rise
in-ge-nious	in-gen-ious
slav-ery	slav-er-y
s-plash-down	splash-down
des-tiny	des-ti-ny
donor	do-nor
pul-monary	pul-mo-nar-y
o-ver-seer	o-ver-se-er
fore-fron-t	fore-front
lilac	li-lac
s-tove	stove
p-re-serve	pre-serve
brassiere	bras-siere
quiv-er-ing	quivering
math-e-mat-ic-s	math-e-mat-ics
duo-logue	du-o-logue
oblate	ob-late
cornea	cor-ne-a
thorny	thorn-y
u-nim-paired	un-im-paired
hairy	hair-y
resin	res-in
restora-tion	res-to-ra-tion
s-care-mon-ger-ing	scare-mon-ger-ing
seafron-t	sea-front
spokes-woman	spokes-wom-an
echid-na	e-chid-na
s-peak-er	speak-er
touchy	touch-y
so-ci-etal	so-ci-e-tal
frilly	frill-y
rub-bishy	rub-bish-y
carouse	ca-rouse
shiv-ery	shiv-er-y
an-tifreeze	an-ti-freeze
un-re-li-able	un-re-li-a-ble
dis-heart-en-ing	dis-hear-te-ning
re-seller	re-sell-er
crafty	craft-y
cordage	cord-age
tractable	trac-ta-ble
u-nattain-able	un-at-tain-a-ble
de-ser-ti-fi-ca-tion	de-sert-i-fi-ca-tion
de-pic-t	de-pict
l-itur-gy	lit-ur-gy
in-stan-t	in-stant
top-i-ary	to-pi-ar-y
dis-si-den-t	dis-si-dent
prepo-si-tion	prep-o-si-tion
in-co-her-en-t	in-co-her-ent
easy	eas-y
es-tu-ary	es-tu-ar-y
record-ed	re-cor-ded
c-on-cil-iar	con-cil-i-ar
sub-cu-ta-neous	sub-cu-ta-ne-ous
hy-gien-ic	hy-gi-en-ic
elite	e-lite
pop-ulis-m	pop-u-lism
pi-tu-itary	pi-tu-i-tar-y
im-pinge-men-t	im-pinge-ment
reper-cus-sion	re-per-cus-sion
com-mu-nica-tive	com-mu-ni-ca-tive
aug-men-t	aug-ment
lousy	lous-y
d-u-al-is-tic	du-al-is-tic
pedantry	ped-ant-ry
crater	cra-ter
pe-ri-od-ic-i-ty	pe-ri-o-dic-i-ty
u-nadul-ter-at-ed	un-a-dul-ter-at-ed
dereg-u-la-tion	de-reg-u-lation
un-con-scionable	un-con-scion-a-ble
di-atom	di-a-tom
in-ter-plan-e-tary	in-ter-plan-e-tar-y
tread-mil-l	tread-mill
us-abil-i-ty	us-a-bil-i-ty
in-de-struc-tible	in-de-struct-i-ble
qui-es-cen-t	qui-es-cent
min-i-mal-is-m	min-i-mal-ism
scruf-f	scruff
luke-war-m	luke-warm
alar-m	a-larm
basil-i-ca	ba-sil-i-ca
sym-bol-is-m	sym-bol-ism
stager	stag-er
filthy	filth-y
ro-man-ti-cis-m	ro-man-ti-cism
dimwit	dim-wit
hy-dropho-bi-a	hy-dro-pho-bi-a
peas-an-t	peas-ant
s-tar-board	star-board
lit-toral	lit-to-ral
en-tan-gle-men-t	en-tan-gle-ment
gerund	ger-und
we-b	web
s-cle-ro-sis	scle-ro-sis
colonist	col-o-nist
me-nial	me-ni-al
spongy	spon-gy
cor-ti-cos-teroid	cor-ti-co-ster-oid
en-chant-men-t	en-chant-ment
s-lip-stream	slip-stream
w-hole-sale	whole-sale
dis-band-men-t	dis-band-ment
su-per-fluity	su-per-flu-i-ty
un-re-peat-able	un-re-peat-a-ble
s-pank-ing	spank-ing
spher-oid	sphe-roid
open	o-pen
awhile	a-while
holis-m	ho-lism
vestibule	ves-ti-bule
s-plat-ter	splat-ter
s-traight-for-ward	straight-for-ward
de-pend-able	de-pend-a-ble
e-choic	e-cho-ic
tepid	tep-id
im-pri-matur	im-pri-ma-tur
para-dox	par-a-dox
re-cruiter	re-cruit-er
frag-men-tary	frag-men-tar-y
ru-ina-tion	ru-in-a-tion
dredger	dredg-er
blowfly	blow-fly
flat-tery	flat-ter-y
dahli-a	dahl-ia
pitiable	pit-i-a-ble
hy-drochlo-ride	hy-dro-chlo-ride
ret-inue	ret-i-nue
re-spon-den-t	re-spond-ent
surfer	surf-er
un-shaven	un-shav-en
scrapie	scrap-ie
delu-sive	de-lu-sive
pe-riphrastic	per-i-phras-tic
ex-ult-ing	exulting
flesh-pot-s	flesh-pots
residu-um	re-sid-u-um
s-teel-work-s	steel-works
dis-moun-t	dis-mount
com-paction	com-pac-tion
catalep-sy	cat-a-lep-sy
distaff	dis-taff
au-tum-n	au-tumn
spiky	spik-y
un-sus-tain-able	un-sus-tain-a-ble
con-strain-t	con-straint
omit	o-mit
debone	de-bone
itchy	itch-y
wafer	wa-fer
as-tro-physic-s	as-tro-phys-ics
s-trafe	strafe
theoc-ra-cy	the-oc-ra-cy
p-resent-ly	pres-ent-ly
brav-ery	brav-er-y
any-thing	an-y-thing
del-i-catessen	del-i-ca-tes-sen
her-s	hers
duet	du-et
con-ti-nen-t	con-ti-nent
pout-ing	pouting
as-tro-physi-cist	as-tro-phys-i-cist
en-cycli-cal	en-cyc-li-cal
arch-dio-cese	arch-di-o-cese
pyrite	py-rite
un-pleas-an-t	un-pleas-ant
sus-tain-abil-i-ty	sus-tain-a-bil-i-ty
unsweet-ened	un-sweet-ened
in-deli-bly	in-del-i-bly
doyen	doy-en
aloud	a-loud
mushy	mush-y
post-pone-men-t	post-pone-ment
io-dine	i-o-dine
lun-cheon	lunch-eon
her-bi-cide	herb-i-cide
vol-cano	vol-ca-no
per-fec-t	per-fect
re-volver	re-volv-er
s-neak	sneak
s-lay-er	slay-er
schoolmistress	school-mis-tress
fuzzy	fuzz-y
mo-lester	mo-lest-er
s-tarlight	star-light
fore-ar-m	fore-arm
plumy	plum-y
u-nattrac-tive	un-at-trac-tive
s-tud-ied	stud-ied
elic-it	e-lic-it
con-ver-san-t	con-ver-sant
pati-na-tion	pat-i-na-tion
s-teril-i-ty	ste-ril-i-ty
p-re-sentable	pre-sent-a-ble
pop-ulist	pop-u-list
flow-ery	flow-er-y
lethar-gic	le-thar-gic
le-gal-is-m	le-gal-ism
or-ga-nize	or-gan-ize
ta-per-ing	ta-pe-ring
s-paghet-ti	spa-ghet-ti
sign-er-s	sign-ers
foot-light-s	foot-lights
sub-trop-ic-s	sub-trop-ics
un-car-ed	un-cared
be-trothal	be-troth-al
as-trin-gen-t	as-trin-gent
stripy	strip-y
t-in-pot	tin-pot
u-nion-i-sa-tion	un-ion-i-sa-tion
telepa-thy	te-lep-a-thy
tacho-graph	tach-o-graph
healthy	health-y
s-paced	spaced
s-toope-d	stooped
regress	re-gress
mul-ti-plica-tive	mul-ti-pli-ca-tive
ef-fec-t	ef-fect
plea-sur-able	pleas-ur-a-ble
limpid	lim-pid
neo-plas-m	ne-o-plasm
k-ilt	kilt
s-lipped	slipped
hayloft	hay-loft
mu-cosa	mu-co-sa
man-i-cured	ma-ni-cured
mis-s	miss
con-cep-t	con-cept
seafood	sea-food
owlet	owl-et
op-por-tunist	op-por-tun-ist
fetid	fet-id
cy-clotron	cy-clo-tron
to-bac-conist	to-bac-co-nist
puree	pu-ree
saver	sav-er
s-carab	scar-ab
s-lob	slob
patel-la	pa-tel-la
jan-u-ary	jan-u-ar-y
spinal	spi-nal
un-der-stand-ably	un-der-stand-a-bly
s-toked	stoked
clemen-t	clem-ent
s-tor-age	stor-age
helper	help-er
warthog	wart-hog
howdy	how-dy
reser-voir	res-er-voir
synapse	syn-apse
usurp	u-surp
un-kep-t	un-kept
meta-physic-s	met-a-phys-ics
viaduc-t	vi-a-duct
imag-i-na-tion	im-ag-i-na-tion
rewind	re-wind
basil	bas-il
over-rate	o-ver-rate
ban-dage	band-age
pota-to	po-ta-to
pa-pyrus	pa-py-rus
un-de-ni-ably	un-de-ni-a-bly
en-gi-neered	engineered
s-core-board	score-board
o-belisk	ob-e-lisk
over-ful-l	o-ver-full
open-ness	o-pen-ness
crazi-ly	cra-zi-ly
s-nip-pet	snip-pet
ovu-la-tion	ov-u-la-tion
s-mash-er	smash-er
exe-un-t	ex-e-unt
pre-dictable	pre-dict-a-ble
brevi-ty	brev-i-ty
giblet-s	gib-lets
pineap-ple	pine-ap-ple
hero-ine	her-o-ine
l-it-i-gan-t	lit-i-gant
ban-knote	bank-note
ar-senide	ar-se-nide
maple	ma-ple
polem-i-cal	po-lem-i-cal
pira-cy	pi-ra-cy
schis-m	schism
ap-par-en-t	ap-par-ent
nomen-cla-ture	no-men-cla-ture
chi-ropody	chi-rop-o-dy
monomolec-u-lar	mon-o-mo-lec-u-lar
al-l	all
con-flu-en-t	con-flu-ent
shal-l	shall
mu-tan-t	mu-tant
poly-mor-phous	pol-y-mor-phous
nib-s	nibs
s-louch-ing	slouching
man-dolin	man-do-lin
dan-de-lion	dan-de-li-on
in-cite-men-t	in-cite-ment
aviary	a-vi-ar-y
vig-i-lante	vig-i-lan-te
ar-cana	ar-ca-na
s-ab-bath	sab-bath
in-hab-i-tan-t	in-hab-it-ant
con-tac-t	con-tact
io-ta	i-o-ta
y-acht	yacht
wave-fron-t	wave-front
shrim-p	shrimp
pe-rusal	pe-rus-al
re-spectable	re-spect-a-ble
s-trand	strand
per-tur-b	per-turb
footage	foot-age
na-tion-al-is-m	na-tion-al-ism
bene-fac-tress	ben-e-fac-tress
chanteuse	chan-teuse
roundup	round-up
de-tec-t	de-tect
de-file-men-t	de-file-ment
founder	found-er
com-plainan-t	com-plain-ant
caliph	ca-liph
un-equiv-o-cal-ly	un-e-quiv-o-cal-ly
s-coff	scoff
s-pade	spade
short-fal-l	short-fall
ra-tio-nal-ly	ra-tion-al-ly
s-cud	scud
seago-ing	sea-go-ing
dom-i-nan-t	dom-i-nant
un-re-cov-er-able	un-re-cov-er-a-ble
lu-mi-nes-cen-t	lu-mi-nes-cent
in-ter-cep-t	in-ter-cept
the-atri-cal-ly	the-at-ri-cal-ly
de-scen-der	de-scend-er
ma-lig-nan-t	ma-lig-nant
s-tate-men-t	state-ment
roofer	roof-er
diplo-mat-i-cal-ly	dip-lo-mat-i-cal-ly
positron	pos-i-tron
hearsay	hear-say
sabra	sa-bra
apoc-ryphal	a-poc-ry-phal
dodgy	dodg-y
gen-i-tali-a	gen-i-ta-li-a
noisy	nois-y
peanut	pea-nut
s-tim-u-la-tor	stim-u-la-tor
junker	jun-ker
per-jury	per-ju-ry
canyon	can-yon
lament-ed	la-ment-ed
poly-math	pol-y-math
d-if-fu-sion	dif-fu-sion
dipole	di-pole
ful-mi-nan-t	ful-mi-nant
preter-nat-u-ral	pre-ter-nat-u-ral
vari-ance	var-i-ance
video-tape	vid-e-o-tape
s-tack	stack
drea-ry	drear-y
crawler	crawl-er
milky	milk-y
e-lo-cu-tion	el-o-cu-tion
t-wofold	two-fold
over-come	o-ver-come
totemic	to-tem-ic
ex-pec-tant-ly	ex-pect-ant-ly
ri-fled	rifled
plaza	pla-za
wreck-ing	wrecking
steamship	steam-ship
lyri-cis-m	lyr-i-cism
em-i-nen-t	em-i-nent
apish	ap-ish
monochro-mat-ic	mon-o-chro-mat-ic
anti-gen	an-ti-gen
s-e-lec-t	se-lect
scrawny	scrawn-y
gera-ni-um	ge-ra-ni-um
s-nug	snug
moody	mood-y
fuz-z	fuzz
strol-l	stroll
weary-ing	wea-ry-ing
mantrap	man-trap
re-cen-t	re-cent
u-nas-sail-able	un-as-sail-a-ble
de-tectable	de-tect-a-ble
caiman	cai-man
semi-fi-nal	sem-i-fi-nal
baleen	ba-leen
re-sen-t	re-sent
civic	civ-ic
in-quisi-to-ri-al	in-quis-i-to-ri-al
macabre	ma-ca-bre
obli-ga-tion	ob-li-ga-tion
de-caf-feinate	de-caf-fein-ate
b-lis-ter-ing	blis-ter-ing
nu-tri-men-t	nu-tri-ment
s-cuf-fle	scuf-fle
s-tunned	stunned
ram-shackle	ram-shack-le
sedi-tious	se-di-tious
query	que-ry
limo	lim-o
pon-tif-f	pon-tiff
weasel	wea-sel
hooli-gan-is-m	hoo-li-gan-ism
chasti-ty	chas-ti-ty
mauler	maul-er
delux-e	de-luxe
cranky	crank-y
en-tre-pre-neur-ial	en-tre-pre-neur-i-al
flutist	flut-ist
crevasse	cre-vasse
neu-ronal	neu-ron-al
touris-m	tour-ism
detox-i-fi-ca-tion	de-tox-i-fi-ca-tion
haven	ha-ven
ev-ery	eve-ry
the-atri-cal-i-ty	the-at-ri-cal-i-ty
cordiller-a	cor-dil-le-ra
s-trap-less	strap-less
in-di-rec-t	in-di-rect
un-pro-nounce-able	un-pro-nounce-a-ble
elec-tron	e-lec-tron
crum-bling	crumbling
resur-gen-t	re-sur-gent
workspace	work-space
loathing	loath-ing
leak-ing	leaking
ra-tio-nal-is-m	ra-tion-al-ism
askew	a-skew
re-sol-ven-t	re-sol-vent
felo-nious	fe-lo-ni-ous
un-change-able	un-change-a-ble
ac-t	act
swimwear	swim-wear
din-t	dint
recharge-able	re-charge-a-ble
s-pac-er	spac-er
puni-tive	pu-ni-tive
s-tupid-ly	stu-pid-ly
g-lyph	glyph
boater	boat-er
iron-ing	i-ron-ing
pen-tathlon	pen-tath-lon
su-per-in-ten-dence	su-per-in-tend-ence
area	ar-e-a
filet	fi-let
cos-set-ed	cosseted
anon	a-non
corol-lary	cor-ol-lar-y
y-oung	young
over-pro-duced	overproduced
pekan	pek-an
tureen	tu-reen
run-t	runt
hilly	hill-y
melo-di-ous	me-lo-di-ous
in-ter-dic-t	in-ter-dict
re-plen-ish-men-t	re-plen-ish-ment
s-mut	smut
poly-phon-ic	pol-y-phon-ic
re-cov-ery	re-cov-er-y
doubter	doubt-er
en-cryp-t	en-crypt
ide-o-logue	i-de-o-logue
flood-ing	flooding
mil-lenar-i-an	mil-le-nar-i-an
fisticuff-s	fist-i-cuffs
facile	fac-ile
chalet	cha-let
im-per-ti-nen-t	im-per-ti-nent
l-la-ma	lla-ma
in-fante	in-fan-te
hadron	had-ron
elec-tro	e-lec-tro
corky	cork-y
punch-line	punchline
un-e-d-u-cat-ed	un-ed-u-cat-ed
chas-m	chasm
co-eval	co-e-val
elec-toral	e-lec-tor-al
chamois	cham-ois
ruler	rul-er
ev-i-den-t	ev-i-dent
ra-dio-g-ra-pher	ra-di-og-ra-pher
tun-able	tun-a-ble
salver	sal-ver
anony-mous-ly	a-non-y-mous-ly
awake	a-wake
mono-lay-er	mon-o-lay-er
wastage	wast-age
primeval	pri-me-val
linkup	link-up
mantra	man-tra
over-sim-pli-fi-ca-tion	o-ver-sim-pli-fi-ca-tion
dis-in-fec-t	dis-in-fect
in-scrutable	in-scru-ta-ble
es-cu-d-o	es-cu-do
lin-eage	lin-e-age
demise	de-mise
un-re-served-ly	un-re-serv-ed-ly
as-pec-t	as-pect
asep-tic	a-sep-tic
k-ilo-ton	kil-o-ton
mac-a-roni	mac-a-ro-ni
in-dis-tinc-t	in-dis-tinct
em-bo-som	em-bos-om
lyrist	lyr-ist
coro-na-tion	cor-o-na-tion
pi-o-n	pi-on
s-ly-ly	sly-ly
choline	cho-line
labur-num	la-bur-num
liftof-f	lift-off
p-re-s-e-lec-t	pre-se-lect
the-is-m	the-ism
bailout	bail-out
dis-rep-utable	dis-rep-u-ta-ble
moun-taineer	moun-tain-eer
an-thracite	an-thra-cite
nar-cis-sis-m	nar-cis-sism
re-pro-cess	re-proc-ess
ditch-ing	ditching
pover-ty	pov-er-ty
retro-fit	ret-ro-fit
sonor-i-ty	so-nor-i-ty
n-odal	nod-al
c-it-rate	cit-rate
un-com-fort-able	un-com-fort-a-ble
chal-lenger	chal-leng-er
semi-colon	sem-i-co-lon
ob-so-les-cen-t	ob-so-les-cent
ir-ra-tional-ly	ir-ra-tion-al-ly
ath-let-ic-s	ath-let-ics
s-teer-ing	steer-ing
h-es-i-tan-cy	hes-i-tan-cy
postage	post-age
sacra-men-t	sac-ra-ment
sec-u-lar-is-m	sec-u-lar-ism
in-stan-ta-neous	in-stan-ta-ne-ous
chaos	cha-os
mover	mov-er
u-nassertive	un-as-ser-tive
ex-pan-sion-ary	ex-pan-sion-ar-y
trouser-s	trou-sers
miser	mi-ser
s-tac-ca-to	stac-ca-to
bound-ary	bound-a-ry
para-dox-i-cal-ly	par-a-dox-i-cal-ly
bushel	bush-el
s-mol-der	smol-der
covert-ly	cov-ert-ly
i-ambic	i-am-bic
vengeance	venge-ance
s-api-en-t	sa-pi-ent
gelig-nite	gel-ig-nite
bel-liger-en-t	bel-lig-er-ent
s-trate-gic	stra-te-gic
dogged	dog-ged
pinafore	pin-a-fore
fevered	fe-vered
flash-bul-b	flash-bulb
an-tipodes	an-tip-o-des
rheo-stat	rhe-o-stat
pave-men-t	pave-ment
s-lum	slum
oblig-ing	o-blig-ing
wicked	wick-ed
ole-an-der	o-le-an-der
put-t	putt
winnable	win-na-ble
wave-for-m	wave-form
kerosene	ker-o-sene
geron-toc-ra-cy	ger-on-toc-ra-cy
s-porran	spor-ran
mys-tery	mys-ter-y
in-de-pen-den-t	in-de-pend-ent
over-lord	o-ver-lord
baldy	bald-y
dis-parag-ing	dis-par-ag-ing
elec-tive	e-lec-tive
phleg-m	phlegm
saga	sa-ga
er-r	err
over-re-act-s	o-ver-re-acts
salmon	salm-on
copi-lot	co-pi-lot
ul-tra-son-ic-s	ul-tra-son-ics
u-nan-tic-i-pat-ed	un-an-tic-i-pat-ed
trashy	trash-y
re-cov-er-able	re-cov-er-a-ble
over-es-ti-ma-tion	o-ver-es-ti-ma-tion
ob-struc-t	ob-struct
s-e-lec-tion	se-lec-tion
n-im-ble	nim-ble
s-ter-ile	ster-ile
s-laugh-ter-house	slaugh-ter-house
polysac-cha-ride	pol-y-sac-cha-ride
stinky	stink-y
cas-sowary	cas-so-war-y
in-audi-ble	in-au-di-ble
psy-chi-atric	psy-chi-at-ric
baroque	ba-roque
whif-f	whiff
un-du-lat-ing	un-du-la-ting
over-crowd-ed	o-ver-crow-ded
pogo	po-go
apo-lit-i-cal	a-po-lit-i-cal
pre-tender	pre-tend-er
trib-u-tary	trib-u-tar-y
big-otry	big-ot-ry
pirou-ette	pir-ou-ette
man-age-men-t	man-age-ment
evil-do-er	e-vil-do-er
plat-i-tudi-nous	plat-i-tu-di-nous
colum-nar	co-lum-nar
pavil-ion	pa-vil-ion
im-per-ma-nen-t	im-per-ma-nent
phi-lan-thropist	phi-lan-thro-pist
s-lim-line	slim-line
meso-sphere	mes-o-sphere
duchess	duch-ess
pro-tean	pro-te-an
mis-coun-t	mis-count
perime-ter	pe-rim-e-ter
re-cidi-vist	re-cid-i-vist
stylist	styl-ist
dizzy	diz-zy
duc-t	duct
hu-man-is-m	hu-man-ism
tribu-la-tion	trib-u-la-tion
me-chan-ic-s	me-chan-ics
mul-ti-me-ter	mul-tim-e-ter
aphid	a-phid
monas-tic	mo-nas-tic
s-tatu-to-ry	stat-u-to-ry
lack-adaisi-cal	lack-a-dai-si-cal
ool-o-gy	o-ol-o-gy
be-liev-abil-i-ty	be-liev-a-bil-i-ty
e-go-is-m	e-go-ism
prosce-ni-um	pro-sce-ni-um
re-tiree	re-tir-ee
pro-bity	pro-bi-ty
s-tranger	stran-ger
herbal	herb-al
dy-namo	dy-na-mo
briefly	brief-ly
re-fine-men-t	re-fine-ment
n-im-ble-ness	nim-ble-ness
species	spe-cies
apol-o-gy	a-pol-o-gy
re-vival	re-viv-al
nobly	no-bly
ashamed	a-shamed
balus-ter	bal-us-ter
valen-tine	val-en-tine
debu-tan-t	deb-u-tant
loopy	loop-y
brunette	bru-nette
kaiser	kai-ser
sup-plan-t	sup-plant
per-cu-ta-neous	per-cu-ta-ne-ous
clemen-cy	clem-en-cy
s-lough	slough
ser-f	serf
face-tious	fa-ce-tious
chunky	chunk-y
raven-ing	rav-en-ing
be-muse-men-t	be-muse-ment
chau-vin-is-m	chau-vin-ism
un-print-able	un-print-a-ble
wolfish	wolf-ish
elec-tro-mo-tive	e-lec-tro-mo-tive
chorale	cho-rale
s-now-man	snow-man
b-lis-tered	blistered
im-pres-sion-able	im-pres-sion-a-ble
prag-mat-ic-s	prag-mat-ics
re-dun-dan-t	re-dun-dant
methy-lene	meth-yl-ene
seroneg-a-tive	se-ro-neg-a-tive
melo-dra-ma	mel-o-dra-ma
sou-venir	sou-ve-nir
coun-t	count
over-es-ti-mate	o-ver-es-ti-mate
cider	ci-der
homi-ly	hom-i-ly
con-sum-able	con-sum-a-ble
prospec-tus	pro-spec-tus
physi-cist	phys-i-cist
serene	se-rene
grand-par-en-t	grand-par-ent
de-signed-ly	de-sign-ed-ly
up-hol-stery	up-hol-ster-y
re-former	re-form-er
ball-s	balls
s-mack	smack
cor-po-ratism	cor-po-rat-ism
quadrupole	quad-ru-pole
u-n-afraid	un-a-fraid
proph-esy	proph-e-sy
pesky	pes-ky
sovereign-ty	sov-er-eign-ty
corset	cor-set
s-lug-gard	slug-gard
gawky	gawk-y
s-tatute	stat-ute
en-v-i-ron	en-vi-ron
d-win-dle	dwin-dle
mil-i-taris-m	mil-i-ta-rism
barom-e-ter	ba-rom-e-ter
ex-pe-di-en-t	ex-pe-di-ent
b-i-fo-cal	bi-fo-cal
marzi-pan	mar-zi-pan
s-ta-tis-tics	sta-tis-tics
gen-uine	gen-u-ine
shopfron-t	shop-front
gallery	gal-ler-y
s-ca-lene	sca-lene
o-rang-utan	o-rang-u-tan
h-es-i-tant-ly	hes-i-tant-ly
silage	si-lage
cir-cum-lo-cu-to-ry	cir-cum-loc-u-to-ry
painstak-ing-ly	pains-tak-ing-ly
meta-mor-phic	met-a-mor-phic
berry	ber-ry
trans-for-m	trans-form
e-mis-sary	em-is-sar-y
in-con-ceiv-able	in-con-ceiv-a-ble
mishap	mis-hap
s-ling-shot	sling-shot
par-al-lelepiped	par-al-lel-e-pi-ped
pro-cure-men-t	pro-cure-ment
seal-ing	sealing
tight-s	tights
in-tu-itive-ly	in-tu-i-tive-ly
sumo	su-mo
metic-u-lous	me-tic-u-lous
newsprint	news-print
key-boardis-t	key-board-ist
bal-alai-ka	bal-a-lai-ka
ranker	rank-er
ex-is-ten-t	ex-ist-ent
feb-ru-ary	feb-ru-ar-y
calum-ny	cal-um-ny
re-ceiver-ship	re-ceiv-er-ship
per-ilous-ly	per-il-ous-ly
cat-a-clysmic	cat-a-clys-mic
s-pline	spline
con-form-ity	con-form-i-ty
schemat-ic	sche-mat-ic
stron-tium	stron-ti-um
squea-mish	squeam-ish
mega	meg-a
s-nick	snick
cater	ca-ter
gaga	ga-ga
boast-ing	boas-ting
asi-nine	as-i-nine
per-ora-tion	per-o-ra-tion
iso-la-tion	i-so-la-tion
pen-i-ten-tiary	pen-i-ten-tia-ry
re-liv-e	re-live
over-lap	o-ver-lap
epic	ep-ic
damper	damp-er
pael-la	pa-el-la
o-cean-ic	o-ce-an-ic
pro-tect-ed	protected
im-pru-den-t	im-pru-dent
n-erd	nerd
i-n-ac-ti-va-tion	in-ac-ti-va-tion
s-tu-dio	stu-di-o
s-care-crow	scare-crow
com-b	comb
cata-ma-ran	cat-a-ma-ran
lin-t	lint
spunky	spunk-y
tithing	tith-ing
im-peach-men-t	im-peach-ment
un-fet-tered	unfettered
toka-mak	to-ka-mak
verisimil-i-tude	ver-i-si-mil-i-tude
in-ter-na-tion-al-is-m	in-ter-na-tion-al-ism
re-moval	re-mov-al
elec-tri-cal	e-lec-tri-cal
as-cen-t	as-cent
mazy	ma-zy
rock-etry	rock-et-ry
in-nard-s	in-nards
dispir-it-ed	dis-pir-it-ed
watch-able	watch-a-ble
ass-es	as-ses
as-p	asp
prostaglandin	pros-ta-glan-din
in-ter-op-er-abil-i-ty	in-ter-op-er-a-bil-i-ty
lam-ben-t	lam-bent
u-p-end-ed	upended
re-ac-t	re-act
mini-bar	min-i-bar
tourni-quet	tour-ni-quet
im-mea-sur-ably	im-meas-ur-a-bly
herbage	herb-age
horsey	hors-ey
s-car	scar
feath-erlight	feath-er-light
par-tic-u-lar-is-m	par-tic-u-lar-ism
s-cathing	scath-ing
habi-ta-tion	hab-i-ta-tion
mores	mo-res
aver-sion	a-ver-sion
sonorous	so-no-rous
hermeneu-tic	her-me-neu-tic
in-hibitor	in-hib-i-tor
dy-nasty	dy-nas-ty
armpit	arm-pit
sex-is-m	sex-ism
hosepipe	hose-pipe
con-troller	con-trol-ler
t-in-gle	tin-gle
rein-sert	re-in-sert
seaboard	sea-board
in-ter-men-t	in-ter-ment
u-p-lift-ed	uplifted
s-tur-geon	stur-geon
ap-nea	ap-ne-a
chaf-f	chaff
opales-cen-t	o-pal-es-cent
dassie	das-sie
de-pres-san-t	de-pres-sant
epi-graph	ep-i-graph
foot-balling	foot-ball-ing
unin-sured	un-in-sured
tri-umphal	tri-um-phal
s-ti-fling	sti-fling
breezy	breez-y
s-tud-ded	stud-ded
squin-t	squint
s-caf-fold-ing	scaf-fold-ing
plea-sure	pleas-ure
bion-ic	bi-on-ic
tidy	ti-dy
quif-f	quiff
u-topi-a	u-to-pi-a
over-am-bi-tious	o-ver-am-bi-tious
chill-ing	chilling
suf-frag-ist	suf-fra-gist
pam-phle-teer	pam-phlet-eer
frag-men-t	frag-ment
irid-i-um	i-rid-i-um
fetishis-m	fet-ish-ism
de-struc-t	de-struct
antler	ant-ler
s-teeple-chase	stee-ple-chase
pi-rat-ed	pirated
sundry	sun-dry
opin-ion	o-pin-ion
i-ambus	i-am-bus
iron-i-cal-ly	i-ron-i-cal-ly
c-holes-terol	cho-les-ter-ol
im-pris-on-men-t	im-pris-on-ment
e-pochal	ep-och-al
byprod-uc-t	by-prod-uct
bond-ing	bonding
propo-si-tion-al	prop-o-si-tion-al
plushy	plush-y
ovum	o-vum
reshow	re-show
lan-guorous	lan-guor-ous
pla-cen-tae	pla-cen-tae
avul-sion	a-vul-sion
poseur	po-seur
mis-con-duc-t	mis-con-duct
sahib	sa-hib
nightlife	night-life
s-tim-u-lat-ing	stim-u-lat-ing
frailty	frail-ty
radon	ra-don
pro-ce-du-ral-ly	pro-ce-dur-al-ly
s-pace-ship	space-ship
liv-ery	liv-er-y
over-act-ing	overacting
chap-s	chaps
im-pro-visato-ry	im-pro-vi-sa-to-ry
ar-guably	ar-gu-a-bly
welder	weld-er
sacro-sanc-t	sac-ro-sanct
pen-i-ten-t	pen-i-tent
e-m-anate	em-a-nate
de-sir-abil-i-ty	de-sir-a-bil-i-ty
colos-sus	co-los-sus
smoky	smok-y
s-care	scare
para-sol	par-a-sol
over-load-ed	overloaded
wom-b	womb
overt	o-vert
un-bo-som	un-bos-om
peri-patet-ic	per-i-pa-tet-ic
land-fil-l	land-fill
s-lant-ing	slant-ing
change-able	change-a-ble
t-ed	ted
epis-co-pal	e-pis-co-pal
in-dis-tin-guish-able	in-dis-tin-guish-a-ble
hy-pother-mi-a	hy-po-ther-mi-a
pho-to-genic	pho-to-gen-ic
prison	pris-on
sud-s	suds
ema-ci-at-ed	e-ma-ci-at-ed
pes-simist	pes-si-mist
s-tair-head	stair-head
im-port-ed	imported
s-to-ical-ly	sto-i-cal-ly
merid-ion-al	me-rid-i-o-nal
rep-til-ian	rep-til-i-an
s-low	slow
tele-vised	televised
pho-to-copy	pho-to-cop-y
rel-a-tivis-m	rel-a-tiv-ism
ge-nial	ge-ni-al
in-er-ti-a	in-er-tia
bury	bur-y
un-even-ly	un-e-ven-ly
s-tor-m	storm
kook-abur-ra	kook-a-bur-ra
ne-go-tiable	ne-go-ti-a-ble
un-us-able	un-us-a-ble
transep-t	tran-sept
reg-istry	reg-is-try
crit-i-cis-m	crit-i-cism
cream-ery	cream-er-y
hand-cuf-f	hand-cuff
in-suf-fer-able	in-suf-fer-a-ble
s-tar-tling	star-tling
hostage	hos-tage
melt-ed	melted
catarac-t	cat-a-ract
awash	a-wash
hab-er-dash-ery	hab-er-dash-er-y
ca-nary	ca-nar-y
mag-ne-sium	mag-ne-si-um
de-bauch-ery	de-bauch-er-y
com-man-der	com-mand-er
over-state	o-ver-state
sub-sis-tence	sub-sist-ence
reser-va-tion	res-er-va-tion
heavy-weight	heav-y-weight
bomber	bomb-er
s-nowflake	snow-flake
re-silience	re-sil-ience
deu-teri-um	deu-te-ri-um
avowed-ly	a-vow-ed-ly
penu-ri-ous	pe-nu-ri-ous
mal-odor-ous	mal-o-dor-ous
can-nery	can-ner-y
op-t	opt
dis-senter	dis-sent-er
brawny	brawn-y
lib-er-tar-i-an-is-m	lib-er-tar-i-an-ism
babysit-ter	ba-by-sit-ter
flota-tion	flo-ta-tion
pro-to-zoan	pro-to-zo-an
triple	tri-ple
di-atom-ic	di-a-tom-ic
men-di-can-t	men-di-cant
dacha	da-cha
ori-en-tal	o-ri-en-tal
ru-ined	ruined
sober	so-ber
vine-gar	vin-e-gar
con-denser	con-dens-er
fi-nale	fi-na-le
dopey	dope-y
rounder	round-er
stopover	stop-o-ver
there-upon	there-up-on
avari-cious	av-a-ri-cious
catal-y-sis	ca-tal-y-sis
liv-able	liv-a-ble
fir-m	firm
epi-demi-ol-o-gy	ep-i-de-mi-ol-o-gy
torus	to-rus
rec-on-cil-able	rec-on-cil-a-ble
caseload	case-load
cross-over	cross-o-ver
poly-car-bon-ate	pol-y-car-bon-ate
tuner	tun-er
u-n-adorned	un-a-dorned
im-prov-i-den-t	im-prov-i-dent
celi-bate	cel-i-bate
res-i-den-t	res-i-dent
in-vesti-ture	in-ves-ti-ture
re-gali-a	re-ga-li-a
coleslaw	cole-slaw
biorhyth-m	bi-o-rhythm
serai	se-ra-i
rant-ing	ranting
soror-i-ty	so-ror-i-ty
regi-cide	reg-i-cide
mar-ke-teer	mar-ket-eer
in-tu-ition	in-tu-i-tion
racis-m	rac-ism
tri-den-t	tri-dent
w-hole-some	whole-some
tele-ol-o-gy	tel-e-ol-o-gy
triplet	tri-plet
de-cryp-t	de-crypt
crazy	cra-zy
para-mil-i-tary	par-a-mil-i-tar-y
doyenne	doy-enne
hip-popota-mus	hip-po-pot-a-mus
par-tic-i-pan-t	par-tic-i-pant
dotage	dot-age
homi-cide	hom-i-cide
dullard	dull-ard
so-lace	sol-ace
any-how	an-y-how
clema-tis	clem-a-tis
im-pla-ca-ble	im-plac-a-ble
glos-sary	glos-sa-ry
is-suance	is-su-ance
mea-sure-men-t	meas-ure-ment
ex-per-i-men-t	ex-per-i-ment
stenog-ra-phy	ste-nog-ra-phy
gaucherie	gau-che-rie
bur-glary	bur-gla-ry
rap-t	rapt
beanstalk	bean-stalk
aplom-b	a-plomb
fu-tur-is-m	fu-tur-ism
u-n-af-ford-able	un-af-ford-a-ble
nut-s	nuts
plu-per-fec-t	plu-per-fect
s-pleen	spleen
s-limy	slim-y
s-trag-gle	strag-gle
cashew	cash-ew
pager	pag-er
s-pam	spam
rasper	rasp-er
hu-man-i-tar-i-an-is-m	hu-man-i-tar-i-an-ism
in-ward-s	in-wards
pathogen	path-o-gen
moth-er-stobe	mo-ther-stobe
de-posit	de-pos-it
grasshop-per	grass-hop-per
car-cino-genic	car-cin-o-gen-ic
pre-his-toric	pre-his-tor-ic
purview	pur-view
sub-trac-t	sub-tract
prom-is-sory	prom-is-so-ry
babes	babes
e-quip-men-t	e-quip-ment
finick-y	fin-ick-y
open-hand-ed	o-pen-hand-ed
groupie	group-ie
spillage	spill-age
unloved	un-loved
eleven	e-lev-en
over-sam-pling	o-ver-sam-pling
fusil-lade	fu-sil-lade
puer-per-al	pu-er-per-al
hal-ibut	hal-i-but
drol-l	droll
over-pay-men-t	o-ver-pay-ment
c-om-mend-able	com-mend-a-ble
un-opened	un-o-pened
sagac-i-ty	sa-gac-i-ty
tal-c	talc
ex-hi-bi-tion-is-m	ex-hi-bi-tion-ism
around	a-round
neuter	neu-ter
un-wary	un-war-y
ibis	i-bis
buzzer	buzz-er
raider	raid-er
stron-groom	strong-room
ir-re-mov-able	ir-re-mov-a-ble
monau-ral	mon-au-ral
breakup	break-up
c-it-i-zen-ship	cit-i-zen-ship
me-dieval	me-di-e-val
bil-l	bill
u-nion-is-m	un-ion-ism
sec-toral	sec-tor-al
pris-m	prism
dis-hon-esty	dis-hon-es-ty
crier	cri-er
a-pos-tolic	ap-os-tol-ic
dis-ci-plinary	dis-ci-pli-nar-y
doorstop	door-stop
re-plan-t	re-plant
hunter	hunt-er
u-n-ac-count-able	un-ac-count-a-ble
ephor	eph-or
un-wrap-s	un-wraps
au-gury	au-gu-ry
con-for-mance	con-form-ance
driver-less	driv-er-less
gov-ern-men-t	gov-ern-ment
re-de-vel-op-men-t	re-de-vel-op-ment
quixot-ic	quix-ot-ic
or-ga-ni-za-tion	or-gan-i-za-tion
re-uni-fy	re-u-ni-fy
s-lip-per	slip-per
in-testi-nal	in-tes-ti-nal
bowl-s	bowls
unso-cial	un-so-cial
milk-shake	milkshake
hand-bil-l	hand-bill
g-nat	gnat
k-lax-on	klax-on
anus	a-nus
where-about-s	where-a-bouts
gaun-t	gaunt
in-con-tro-vert-ible	in-con-tro-vert-i-ble
de-for-mi-ty	de-form-i-ty
scrib-bling	scribbling
on-toge-ny	on-tog-e-ny
el-dest	eld-est
pre-dict-ed	predicted
earnest-ly	ear-nest-ly
ashen	ash-en
basilisk	bas-i-lisk
co-her-en-t	co-her-ent
kinswom-an	kins-wom-an
beryl	ber-yl
colony	col-o-ny
in-signif-i-can-t	in-sig-nif-i-cant
bur-p	burp
usu-al	u-su-al
grandiose	gran-di-ose
s-mudgy	smudg-y
un-rea-son-able	un-rea-son-a-ble
usu-ri-ous	u-su-ri-ous
fiendish	fiend-ish
se-man-tic-s	se-man-tics
ver-b	verb
painkiller	pain-kil-ler
con-sid-er-ably	con-sid-er-a-bly
clavi-chord	clav-i-chord
breast-feed	breastfeed
blotchy	blotch-y
s-tow	stow
screwy	screw-y
s-cab-bard	scab-bard
fifty	fif-ty
trac-ery	trac-er-y
there-about-s	there-a-bouts
dis-tillery	dis-till-er-y
im-par-tial-i-ty	im-par-ti-al-i-ty
sim-u-lacrum	sim-u-la-crum
steve-dore	ste-ve-dore
florid	flor-id
un-de-ni-able	un-de-ni-a-ble
hege-mon-ic	heg-e-mon-ic
re-versed	reversed
chancy	chanc-y
con-jec-tural	con-jec-tur-al
harem	har-em
stilet-to	sti-let-to
wrap-around	wrap-a-round
maudlin	maud-lin
dairy-ing	dair-y-ing
hor-mon-al	hor-mo-nal
pro-tec-t	pro-tect
lanky	lank-y
reprise	re-prise
es-tab-lish-men-t	es-tab-lish-ment
at-temp-t	at-tempt
groom-ing	grooming
ini-ti-ate	in-i-ti-ate
beeswax	bees-wax
duck-bil-l	duck-bill
beret	be-ret
dauphin	dau-phin
pumice	pum-ice
re-frig-er-an-t	re-frig-er-ant
laud-s	lauds
racist	rac-ist
ef-flu-en-t	ef-flu-ent
va-sec-to-my	vas-ec-to-my
en-fran-chise-men-t	en-fran-chise-ment
foxy	fox-y
mega-volt	meg-a-volt
s-neeze	sneeze
re-stroom	rest-room
dishar-mo-ny	dis-har-mo-ny
vel-vety	vel-vet-y
iono-sphere	i-on-o-sphere
capri-cious	ca-pri-cious
spindly	spin-dly
coy-ote	coy-o-te
bistro	bis-tro
re-pen-t	re-pent
bil-liard-s	bil-liards
carafe	ca-rafe
s-lump	slump
labyrinthine	lab-y-rin-thine
char-cu-terie	char-cu-te-rie
apoth-e-o-sis	a-poth-e-o-sis
deep-en-ing	deepening
vex-ing	vexing
mono-cul-ture	mon-o-cul-ture
colan-der	col-an-der
ar-biter	ar-bi-ter
sepi-a	se-pi-a
ease-men-t	ease-ment
graver	grav-er
remix	re-mix
ir-re-place-able	ir-re-place-a-ble
down-sid-e	down-side
mea-sur-able	meas-ur-a-ble
trawler	trawl-er
litho-graph	lith-o-graph
nowa-days	now-a-days
telling-ly	tell-ing-ly
im-pre-sari-o	im-pre-sa-ri-o
con-fronta-tion-al	con-fron-ta-tion-al
asymp-tote	as-ymp-tote
creduli-ty	cre-du-li-ty
frat-ri-ci-dal	frat-ri-cid-al
s-teep-en	steep-en
iri-des-cen-t	ir-i-des-cent
painter	paint-er
di-ary	di-a-ry
metempsy-chosis	me-tem-psy-cho-sis
myx-o-mato-sis	myx-o-ma-to-sis
re-word-ings	re-word-ings
bes-tial-i-ty	bes-ti-al-i-ty
s-cu-ba	scu-ba
omis-sion	o-mis-sion
turnkey	turn-key
c-leg	cleg
clair-voy-an-t	clair-voy-ant
ver-biage	ver-bi-age
ide-al	i-de-al
recheck	re-check
s-ports-man	sports-man
sober-ing	sobering
odome-ter	o-dom-e-ter
satchel	satch-el
taber-na-cle	tab-er-nac-le
vulpine	vul-pine
laugh-ably	laugh-a-bly
k-ing-ship	king-ship
diesel	die-sel
y-ore	yore
s-to-ic	sto-ic
s-later	slat-er
mono-lith-ic	mon-o-lith-ic
fum-bling	fumbling
civil-ian	ci-vil-ian
qua-drat-ic	quad-rat-ic
bevy	bev-y
de-cen-t	de-cent
soapy	soap-y
re-flec-t	re-flect
con-sti-tu-tion-al-is-m	con-sti-tu-tion-al-ism
coxswain	cox-swain
matin-s	mat-ins
hero-ical-ly	he-ro-i-cal-ly
philoso-pher	phi-los-o-pher
s-loshed	sloshed
eigen-state	ei-gen-state
sim-per-ing	simpering
holo-caust	hol-o-caust
lot-tery	lot-ter-y
re-new-able	re-new-a-ble
trilin-gual	tri-lin-gual
quiver	quiv-er
dul-l	dull
turquoise	tur-quoise
ringlet	ring-let
sausage	sau-sage
fatu-ous	fat-u-ous
ir-re-sistible	ir-re-sist-i-ble
tapas	ta-pas
pa-gan-is-m	pa-gan-ism
auburn	au-burn
en-joy-ably	en-joy-a-bly
tru-cu-len-t	truc-u-lent
dis-putable	dis-put-a-ble
bari-tone	bar-i-tone
pari-etal	pa-ri-e-tal
turmer-ic	tur-mer-ic
palin-drome	pal-in-drome
s-cal-a-bil-i-ty	scal-a-bil-i-ty
resid-uary	re-sid-u-ar-y
ge-nial-i-ty	ge-ni-al-i-ty
s-lot-ted	slot-ted
kine-mat-ic-s	kin-e-mat-ics
poignan-cy	poign-an-cy
tran-scen-den-t	tran-scend-ent
un-hy-gien-ic	un-hy-gi-en-ic
bony	bon-y
break-able	break-a-ble
s-towage	stow-age
os-teopath	os-te-o-path
jovial	jo-vi-al
tra-verse	trav-erse
flagon	flag-on
lantern	lan-tern
baili-wick	bail-i-wick
flighty	flight-y
over-ac-tive	o-ver-ac-tive
mas-culin-i-ty	mas-cu-lin-i-ty
skele-ton	skel-e-ton
guardian-ship	guard-i-an-ship
il-menite	il-men-ite
plateau	pla-teau
em-body	em-bod-y
s-ki	ski
re-len-t	re-lent
over-spill	o-ver-spill
cagoule	ca-goule
apery	ap-er-y
oc-tagon	oc-ta-gon
hal-l	hall
be-wil-der-ing	bewildering
fre-quen-t	fre-quent
sa-k-i	sa-ki
pay-rol-l	pay-roll
whirligig	whirl-i-gig
bowlder	bowl-der
s-ten-cil	sten-cil
run-away	run-a-way
briny	brin-y
com-men-t	com-ment
reti-nal	ret-i-nal
heifer	heif-er
e-d-u-cate	ed-u-cate
o-r-a-cle	or-a-cle
thumbprint	thumb-print
s-tu-dious-ly	stu-di-ous-ly
bar-l-ey-corn	bar-ley-corn
ex-pand-able	ex-pand-a-ble
peafowl	pea-fowl
sanc-ti-mo-nious	sanc-ti-mo-ni-ous
s-mall-hold-ing	small-hold-ing
in-evitable	in-ev-i-ta-ble
bo-som	bos-om
mari-nade	mar-i-nade
re-in-force-men-t	re-in-force-ment
ovoid	o-void
com-mu-ni-can-t	com-mu-ni-cant
ex-is-tence	ex-ist-ence
p-re-serv-er	pre-serv-er
peas-antry	peas-ant-ry
crick-eter	crick-et-er
e-quiv-a-len-t	e-quiv-a-lent
aphro-disi-ac	aph-ro-dis-i-ac
sol-diery	sol-dier-y
prosody	pros-o-dy
telex	tel-ex
ob-streper-ous	ob-strep-er-ous
mis-ery	mis-er-y
hindquar-ter-s	hind-quar-ters
cur-b	curb
bo-hemi-an	bo-he-mi-an
limou-sine	lim-ou-sine
f-reak-ish	freak-ish
em-bank-men-t	em-bank-ment
scrol-l	scroll
im-pro-vi-sa-tion	im-prov-i-sa-tion
sig-nif-i-can-t	sig-nif-i-cant
s-lur-p	slurp
hyp-ocrite	hyp-o-crite
newsy	news-y
over-in-flat-ed	o-ver-in-flat-ed
para-troop-er	par-a-troop-er
forest-ed	forested
pho-tore-cep-tor	pho-to-re-cep-tor
pri-mar-i-ly	pri-ma-ri-ly
se-can-t	se-cant
grenade	gre-nade
weighty	weight-y
per-ma-nen-t	per-ma-nent
g-lut-tonous	glut-ton-ous
plan-e-tary	plan-e-tar-y
chirpy	chirp-y
shekel	shek-el
au-thoress	au-thor-ess
lik-able	lik-a-ble
s-tam-mer	stam-mer
sup-ple-men-tary	sup-ple-men-ta-ry
in-ter-fer-e	in-ter-fere
om-nipres-ence	om-ni-pres-ence
s-tiff	stiff
pa-tien-t	pa-tient
shoplifter	shop-lift-er
per-fidy	per-fi-dy
in-sol-ven-t	in-sol-vent
judg-men-t	judg-ment
ra-dio-ther-a-py	ra-di-o-ther-a-py
p-ithy	pith-y
ure-thra	u-re-thra
at-ten-dan-t	at-tend-ant
s-to-icis-m	sto-i-cism
stipen-di-ary	sti-pen-di-ar-y
rook-ery	rook-er-y
bristling	bris-tling
cat-a-com-b	cat-a-comb
ab-sen-t	ab-sent
lava-to-ry	lav-a-to-ry
as-sort-men-t	as-sort-ment
timid-i-ty	ti-mid-i-ty
or-tho-doxy	or-tho-dox-y
monomer	mon-o-mer
s-lushy	slush-y
s-tar-ship	star-ship
som-brero	som-bre-ro
hon-orif-ic	hon-or-if-ic
gooey	goo-ey
over-do	o-ver-do
sub-stan-dard	sub-stand-ard
au-tonomous-ly	au-ton-o-mous-ly
mus-cu-loskele-tal	mus-cu-lo-skel-e-tal
timescale	time-scale
dyad	dy-ad
un-remit-ting	un-re-mit-ting
linger	lin-ger
cen-tral-is-m	cen-tral-ism
sawyer	saw-yer
gal-axy	gal-ax-y
un-beat-able	un-beat-a-ble
whiten	whit-en
jaz-z	jazz
naval	na-val
retel-l	re-tell
rock-fal-l	rock-fall
mov-able	mov-a-ble
politic	pol-i-tic
con-vict-ed	convicted
salary	sal-a-ry
prov-ably	prov-a-bly
flip-pan-t	flip-pant
rec-ol-lec-t	rec-ol-lect
moral-i-ty	mo-ral-i-ty
ship-builder	ship-build-er
man-darin	man-da-rin
s-word	sword
co-pra	cop-ra
liquor	liq-uor
herbal-is-m	her-bal-ism
spon-ta-neous	spon-ta-ne-ous
pro-ject-ing	projecting
ni-hilis-m	ni-hil-ism
glin-t	glint
copy	cop-y
nympho-ma-ni-a	nym-pho-ma-ni-a
un-bear-able	un-bear-a-ble
de-ify	de-i-fy
p-salmist	psalm-ist
cam-era-man	cam-er-a-man
cleanup	clean-up
hi-jack-ing	hi-jac-king
s-tu-pen-dous	stu-pen-dous
cra-nial	cra-ni-al
phono-graph	pho-no-graph
malev-o-lence	ma-lev-o-lence
iso-la-tion-ist	i-so-la-tion-ist
bol-stered	bolstered
causative	caus-a-tive
g-luten	glu-ten
turfy	turf-y
re-fur-bish-men-t	re-fur-bish-ment
in-duc-t	in-duct
mega-lo-ma-ni-a	meg-a-lo-ma-ni-a
cur-tail-men-t	cur-tail-ment
liar	li-ar
in-trauter-ine	in-tra-u-ter-ine
s-mile	smile
oph-thalmic	oph-thal-mic
athe-is-tic	a-the-is-tic
ring-leader	ring-lead-er
pos-i-tivist	pos-i-tiv-ist
over-ac-t	o-ver-act
chester-field	ches-ter-field
em-bel-lish-men-t	em-bel-lish-ment
rani	ra-ni
hooray	hoo-ray
re-al-ness	real-ness
urol-o-gist	u-rol-o-gist
mis-sion-ary	mis-sion-ar-y
re-assess	re-as-sess
d-eficit	def-i-cit
con-duc-tance	con-duct-ance
eru-dite	er-u-dite
pigsty	pig-sty
restau-ran-t	res-tau-rant
for-man-t	for-mant
b-land	bland
il-l	ill
s-cam-p	scamp
biofeed-back	bi-o-feed-back
s-i-nus	si-nus
disin-gen-u-ous	dis-in-gen-u-ous
spiny	spin-y
min-uet	min-u-et
aright	a-right
seraph-ic	se-raph-ic
s-tar-ling	star-ling
moist-en	mois-ten
easel	ea-sel
pream-pli-fi-er	pre-am-pli-fi-er
pup-peteer	pup-pet-eer
turntable	turn-ta-ble
re-sul-tan-t	re-sult-ant
e-voca-tive	e-voc-a-tive
co-ef-fi-cien-t	co-ef-fi-cient
poly-syl-lab-ic	pol-y-syl-lab-ic
im-peri-um	im-pe-ri-um
naugh-t	naught
s-pas-m	spasm
rhodo-den-dron	rho-do-den-dron
s-tock-tak-ing	stock-tak-ing
y-on	yon
grid-iron	grid-i-ron
i-nane	in-ane
cathe-dral	ca-the-dral
s-mash-ing	smash-ing
lazi-ness	la-zi-ness
s-cis-sors	scis-sors
s-nore	snore
ari-a	a-ri-a
awak-en	a-wak-en
marten	mar-ten
i-n-ac-cu-rate-ly	in-ac-cu-rate-ly
moc-casin	moc-ca-sin
em-piri-cist	em-pir-i-cist
oa-sis	o-a-sis
s-port	sport
guardian	guard-i-an
spen-t	spent
s-tarfish	star-fish
moth-bal-l	moth-ball
canal	ca-nal
legged	leg-ged
un-healthy	un-health-y
bal-lis-tic-s	bal-lis-tics
ren-dered	rendered
ca-ress-ing	ca-res-sing
skil-l	skill
el-e-men-t	el-e-ment
fortress	for-tress
foun-t	fount
pro-pa-gan-dis-t	prop-a-gan-dist
liny	lin-y
cur-d	curd
nugget	nug-get
per-i	pe-ri
gen-t	gent
e-u-pho-ni-um	eu-pho-ni-um
emi-rate	e-mir-ate
pol-lard-ed	pollarded
reper-toire	rep-er-toire
s-loop	sloop
rhetor-i-cal	rhe-tor-i-cal
ran-corous	ran-cor-ous
per-hap-s	per-haps
down-fal-l	down-fall
boa	bo-a
shandy	shan-dy
var-ie-gat-ed	var-i-e-gat-ed
april	a-pril
per-sis-tent-ly	per-sist-ent-ly
nonex-is-tence	non-ex-ist-ence
tute-lary	tu-te-lar-y
sar-cas-m	sar-casm
bromine	bro-mine
n-od-dy	nod-dy
tri-maran	tri-ma-ran
bul-b	bulb
dis-mis-s	dis-miss
retest	re-test
tri-umvi-rate	tri-um-vi-rate
con-comi-tan-t	con-com-i-tant
he-do-nis-m	he-don-ism
un-proven	un-prov-en
weari-ly	wea-ri-ly
an-tithe-sis	an-tith-e-sis
sac-risty	sac-ris-ty
para-nor-mal	par-a-nor-mal
placid	plac-id
s-lake	slake
epis-te-mol-o-gy	e-pis-te-mol-o-gy
ex-i-gen-t	ex-i-gent
crispy	crisp-y
dis-turbing-ly	dis-turb-ing-ly
mandible	man-di-ble
elfin	elf-in
a-part-men-t	a-part-ment
com-forter	com-fort-er
misty	mist-y
galling	gall-ing
gneis-s	gneiss
sur-vivor	sur-vi-vor
sewage	sew-age
bridal	brid-al
meanie	mean-ie
iso-bar	i-so-bar
s-hears	shears
fid-get	fidg-et
un-abat-ed	un-a-bat-ed
ob-scu-ran-tism	ob-scu-rant-ism
squeaky	squeak-y
bedrock	bed-rock
prophet-ess	proph-et-ess
idly	i-dly
oper-a	o-pe-ra
ax-e	axe
vivi-sec-tion	viv-i-sec-tion
un-demo-crat-ic	un-dem-o-crat-ic
mata-dor	mat-a-dor
pelvis	pel-vis
cas-tanet-s	cas-ta-nets
pat-terned	patterned
decade	dec-ade
ho-muncu-lus	ho-mun-cu-lus
re-quiem	req-ui-em
ex-per-i-menter	ex-per-i-ment-er
scriptwrit-er	script-writ-er
is-lander	is-land-er
char-m	charm
trapeze	tra-peze
bat-tery	bat-ter-y
height-ened	heightened
ther-mome-ter	ther-mom-e-ter
in-ex-orable	in-ex-o-ra-ble
dis-pen-sary	dis-pen-sa-ry
inim-itable	in-im-i-ta-ble
ge-ome-ter	ge-om-e-ter
teleprint-er	tel-e-print-er
ve-loci-pede	ve-loc-i-pede
derelic-t	der-e-lict
s-nuf-f	snuff
even-tu-al	e-ven-tu-al
Words with errors: 2299
Words with incorrect number of syllables: 2071
Total evluated: 6500
Perfect accuracy: 0.65
Number of syllables accuracy: 0.68
Average Levenshtein Distance(across incorrect words): 1.21
