Attempt	Real
crawler	crawl-er
pol-luter	pol-lut-er
su-per-fi-cial-i-ty	su-per-fi-ci-al-i-ty
fussy	fuss-y
salu-bri-ous	sa-lu-bri-ous
un-count-able	un-count-a-ble
trans-mo-gri-fy	trans-mog-ri-fy
ec-to-plas-m	ec-to-plasm
reap-ply	re-ap-ply
s-tunt-man	stunt-man
pa-tien-t	pa-tient
im-pinge-men-t	im-pinge-ment
s-mudge	smudge
easy	eas-y
bel-liger-en-t	bel-lig-er-ent
sander	sand-er
hy-draulic-s	hy-drau-lics
patis-serie	pa-tis-se-rie
an-tipa-thy	an-tip-a-thy
or-biter	or-bit-er
he-lio-sphere	he-li-o-sphere
l-it-i-gan-t	lit-i-gant
hand-picked	handpicked
reser-voir	res-er-voir
needy	need-y
e-vo-ca-tion	ev-o-ca-tion
pan-das	pan-das
round-about	round-a-bout
deep-en-ing	deepening
specu-lum	spec-u-lum
s-cat-ter	scat-ter
facet	fac-et
s-lip-shod	slip-shod
gos-sipy	gos-sip-y
re-cessed	recessed
s-tu-dentship	stu-dent-ship
de-ify	de-i-fy
s-mile	smile
di-nosaur	di-no-saur
char-i-o-teer	char-i-ot-eer
mil-lenar-i-an	mil-le-nar-i-an
dis-so-nan-t	dis-so-nant
repack-age	re-pack-age
demon-stra-ble	de-mon-stra-ble
breath-able	breath-a-ble
for-tu-itous-ly	for-tu-i-tous-ly
gaze-bo	ga-ze-bo
omega	o-me-ga
block-buster	block-bust-er
phys-iog-no-my	phys-i-og-no-my
claret	clar-et
col-lec-t	col-lect
dis-tin-guish-able	dis-tin-guish-a-ble
un-ortho-dox	un-or-tho-dox
heady	head-y
mar-ketable	mar-ket-a-ble
cider	ci-der
assig-na-tion	as-sig-na-tion
mis-treat-men-t	mis-treat-ment
fer-n	fern
de-crepit	de-crep-it
chival-ry	chiv-al-ry
s-tatute	stat-ute
paci-fist	pac-i-fist
rap-proche-men-t	rap-proche-ment
sus-tain-abil-i-ty	sus-tain-a-bil-i-ty
cur-tained	curtained
boxy	box-y
dis-tillery	dis-till-er-y
s-plen-did	splen-did
phe-nomenol-o-gy	phe-nom-e-nol-o-gy
c-holes-terol	cho-les-ter-ol
iron-work	i-ron-work
u-nas-suaged	un-as-suaged
im-agery	im-age-ry
lifebelt	life-belt
whoop-s	whoops
mono-graph	mon-o-graph
get-away	get-a-way
duf-f	duff
kril-l	krill
dis-cernible	dis-cern-i-ble
mid-dleweight	mid-dle-weight
retry	re-try
d-e-duce	de-duce
over-run	o-ver-run
po-ten-tiome-ter	po-ten-ti-om-e-ter
psy-chopathol-o-gy	psy-cho-pa-thol-o-gy
fluffy	fluff-y
s-cared	scared
procla-ma-tion	proc-la-ma-tion
pelvis	pel-vis
de-liv-er-able	de-liv-er-a-ble
twitchy	twitch-y
au-tomat	au-to-mat
pan-t	pant
topo-graph-i-cal	top-o-graph-i-cal
derelic-t	der-e-lict
in-ten-t	in-tent
aper-i-tif	a-pe-ri-tif
in-de-pen-dence	in-de-pend-ence
in-con-solable	in-con-sol-a-ble
pedi-gree	ped-i-gree
labur-num	la-bur-num
parental	pa-ren-tal
i-n-ad-vis-able	in-ad-vis-a-ble
s-cud	scud
in-valu-able	in-val-u-a-ble
halo-gen	hal-o-gen
apoplexy	ap-o-plex-y
paunchy	paunch-y
re-volver	re-volv-er
cu-rat-ed	curated
pi-anola	pi-a-no-la
chamois	cham-ois
prepar-a-tive	pre-par-a-tive
giro	gi-ro
ju-bilee	ju-bi-lee
any-one	an-y-one
sub-ur-bia	sub-ur-bi-a
ri-boflavin	ri-bo-fla-vin
navy	na-vy
bleat-ing	bleating
kudu	ku-du
geno-type	gen-o-type
sinewy	sin-ew-y
cabri-o-let	cab-ri-o-let
mov-able	mov-a-ble
in-cip-i-en-t	in-cip-i-ent
dig-ni-tary	dig-ni-tar-y
s-tra-tum	stra-tum
em-broi-dery	em-broi-der-y
s-pam	spam
seabird	sea-bird
best-selling	best-sell-ing
b-lench	blench
detox-i-fy	de-tox-i-fy
gaslight	gas-light
s-tran-gles	stran-gles
ini-ti-a-tion	in-i-ti-a-tion
quixot-ic	quix-ot-ic
con-tem-po-rary	con-tem-po-rar-y
readi-ness	read-i-ness
as-siduity	as-si-du-i-ty
s-e-lec-tion	se-lec-tion
cologne	co-logne
ap-palling-ly	ap-pall-ing-ly
paraf-fin	par-af-fin
in-her-i-tance	in-her-it-ance
flick-er-ing	flickering
con-cate-nate	con-cat-e-nate
elec-tro-stat-ic	e-lec-tro-stat-ic
e-t-y-mo-log-i-cal	et-y-mo-log-i-cal
athe-is-m	a-the-ism
in-sid-e	in-side
con-denser	con-dens-er
out-cal-l	out-call
geno-ci-dal	gen-o-cid-al
minke	min-ke
rapid-ly	rap-id-ly
d-if-fer-en-tial	dif-fer-en-tial
un-con-tain-able	un-con-tain-a-ble
zona-tion	zo-na-tion
lo-quac-ity	lo-quac-i-ty
un-sol-d	un-sold
s-cat-tered	scattered
gravy	gra-vy
omen	o-men
place-men-t	place-ment
monar-chist	mon-ar-chist
de-func-t	de-funct
s-tore-house	store-house
su-per-scrip-t	su-per-script
book-able	book-a-ble
rewritable	re-writ-a-ble
emet-ic	e-met-ic
racial	ra-cial
quiet-ness	qui-et-ness
an-tithe-sis	an-tith-e-sis
u-n-avail-abil-i-ty	un-a-vail-a-bil-i-ty
decre-men-t	dec-re-ment
en-vi-ron-men-t	en-vi-ron-ment
jester	jest-er
s-ta-tion-ary	sta-tion-ar-y
herbal-is-m	her-bal-ism
s-pace-suit	space-suit
steve-dore	ste-ve-dore
cara-pace	car-a-pace
dis-ci-plinary	dis-ci-pli-nar-y
in-ge-nious	in-gen-ious
re-ceiver-ship	re-ceiv-er-ship
dairy-ing	dair-y-ing
seedling	seed-ling
frica-tive	fric-a-tive
squirearchy	squire-ar-chy
bulky	bulk-y
re-former	re-form-er
any-where	an-y-where
de-fend-ing	defending
g-naw	gnaw
junker	jun-ker
ap-pendage	ap-pend-age
cus-p	cusp
apery	ap-er-y
s-tol-id	stol-id
un-trans-lat-able	un-trans-lat-a-ble
grouper	group-er
spunky	spunk-y
fem-i-nis-m	fem-i-nism
oc-tagon	oc-ta-gon
con-fronta-tion-al	con-fron-ta-tion-al
su-per-hero	su-per-he-ro
rein-vest-men-t	re-in-vest-ment
s-played	splayed
hye-na	hy-e-na
deathbed	death-bed
down-fal-l	down-fall
s-tom-achache	stom-ach-ache
aware-ness	a-ware-ness
bil-l	bill
un-in-for-ma-tive	un-in-form-a-tive
n-erve	nerve
over-throw	o-ver-throw
labi-al	la-bi-al
col-um-n	co-lumn
mis-er-able	mis-er-a-ble
s-cathing	scath-ing
s-core-board	score-board
k-er-nel	ker-nel
bagatelle	bag-a-telle
at-mo-spher-ic-s	at-mos-pher-ics
min-der	mind-er
de-fec-t	de-fect
sup-plan-t	sup-plant
rheo-stat	rhe-o-stat
p-salm	psalm
tremo-lo	trem-o-lo
p-re-sentable	pre-sent-a-ble
elec-tro-mo-tive	e-lec-tro-mo-tive
ante	an-te
un-der-gar-men-t	un-der-gar-ment
s-ketch	sketch
in-tu-itive	in-tu-i-tive
l-o-go	lo-go
un-der-cur-ren-t	un-der-cur-rent
ball-s	balls
dark-ened	dar-kened
punc-til-ious	punc-til-i-ous
hal-l	hall
over-board	o-ver-board
s-now-drop	snow-drop
cle-f	clef
frag-men-t	frag-ment
hu-mankind	hu-man-kind
t-wo	two
onyx	on-yx
tri-maran	tri-ma-ran
brio	bri-o
clever	clev-er
valet	val-et
chas-ten-ing	chastening
tru-is-m	tru-ism
rev-enue	rev-e-nue
hatch-ery	hatch-er-y
sus-pender-s	sus-pend-ers
hand-bal-l	hand-ball
courtier	cour-ti-er
usurp-er	u-surp-er
s-culp-ture	sculp-ture
gen-i-tali-a	gen-i-ta-li-a
palm-istry	palm-is-try
wag-gery	wag-ger-y
avul-sion	a-vul-sion
an-niver-sary	an-ni-ver-sa-ry
gob-bledy-gook	gob-ble-dy-gook
beeswax	bees-wax
wash-basin	wash-ba-sin
grandeur	gran-deur
purview	pur-view
semi-con-duct-ing	sem-i-con-duct-ing
s-park	spark
diskette	disk-ette
mo-lesta-tion	mo-les-ta-tion
phe-nomeno-log-i-cal	phe-nom-e-no-log-i-cal
mam-malian	mam-ma-li-an
ingress	in-gress
s-cal-lop	scal-lop
colon	co-lon
para-met-ric	par-a-met-ric
shopfron-t	shop-front
dauber	daub-er
cham-p	champ
black-bal-l	black-ball
con-duct-ed	conducted
diox-in	di-ox-in
karate	ka-ra-te
choral	cho-ral
as-cetic	as-cet-ic
e-mis-sary	em-is-sar-y
soapy	soap-y
sher-if-f	sher-iff
ca-cao	ca-ca-o
per-ma-nen-t	per-ma-nent
di-vider	di-vid-er
shoplift	shop-lift
over-draft	o-ver-draft
var-ie-gat-ed	var-i-e-gat-ed
teleprint-er	tel-e-print-er
sign-er-s	sign-ers
de-liv-ery	de-liv-er-y
re-liance	re-li-ance
promp-t	prompt
del-i-catessen	del-i-ca-tes-sen
hypochon-dri-ac	hy-po-chon-dri-ac
con-tretemp-s	con-tre-temps
deroga-to-ry	de-rog-a-to-ry
s-neak-ing	sneak-ing
stenog-ra-pher	ste-nog-ra-pher
u-n-avail-ing	un-a-vail-ing
un-bridge-able	un-bridge-a-ble
miser-ly	mi-ser-ly
taxi-dermy	tax-i-der-my
s-tun	stun
a-gen-t	a-gent
trel-lised	trellised
re-state-men-t	re-state-ment
mankind	man-kind
ori-en-t	o-ri-ent
retsi-na	ret-si-na
monarch	mon-arch
treaty	trea-ty
de-gauss-ing	degaussing
demon-stra-tive	de-mon-stra-tive
ig-no-min-ious	ig-no-min-i-ous
brew-ery	brew-er-y
tilde	til-de
su-per-in-ten-dence	su-per-in-tend-ence
linen	lin-en
crick-eter	crick-et-er
in-ter-po-lat-able	in-ter-po-la-ta-ble
for-get-table	for-get-ta-ble
mi-crodot	mi-cro-dot
pi-caresque	pic-a-resque
bowlder	bowl-der
fire-bal-l	fire-ball
grun-t	grunt
yokel	yo-kel
mu-tan-t	mu-tant
phi-late-ly	phi-lat-e-ly
cen-trifuge	cen-tri-fuge
pari-ah	pa-ri-ah
den-drochronol-o-gy	den-dro-chro-nol-o-gy
zealotry	zeal-ot-ry
liar	li-ar
in-suf-fi-cien-t	in-suf-fi-cient
pavil-ion	pa-vil-ion
in-scrutable	in-scru-ta-ble
se-nior-i-ty	sen-ior-i-ty
sub-sis-tence	sub-sist-ence
dis-trac-t	dis-tract
lo-bot-omy	lo-bot-o-my
cam-p	camp
covenan-t	cov-e-nant
tri-bune	trib-une
pro-nounce-men-t	pro-nounce-ment
weapon	weap-on
re-al-is-m	re-al-ism
pe-riphra-sis	pe-riph-ra-sis
premis-es	prem-is-es
bilin-gual	bi-lin-gual
defam-a-to-ry	de-fam-a-to-ry
centi-grade	cen-ti-grade
in-flat-able	in-flat-a-ble
de-noue-men-t	de-noue-ment
s-tun-ning	stun-ning
o-h	oh
neu-tral-is-m	neu-tral-ism
vis-i-ta-tion	vis-it-a-tion
bomb-shel-l	bomb-shell
s-tut-ter	stut-ter
paragon	par-a-gon
raver	rav-er
epic	ep-ic
rem-i-nis-cen-t	rem-i-nis-cent
in-di-can-t	in-di-cant
k-ilo-volt	kil-o-volt
tourni-quet	tour-ni-quet
f-reaky	freak-y
feldspar	feld-spar
s-tam-p	stamp
in-ter-change-ably	in-ter-change-a-bly
layper-son	lay-per-son
in-signif-i-cance	in-sig-nif-i-cance
dumper	dump-er
le-gal-is-m	le-gal-ism
pager	pag-er
cheeky	cheek-y
mus-cle-d	mus-cled
con-trast-ing	contrasting
paraglid-ing	par-a-glid-ing
muslin	mus-lin
ob-streper-ous	ob-strep-er-ous
unedit-ed	un-ed-it-ed
e-s-pousal	es-pous-al
glos-sary	glos-sa-ry
med-dling	meddling
paramount-cy	par-a-mount-cy
l-la-ma	lla-ma
de-odor-an-t	de-o-dor-ant
scholas-ti-cis-m	scho-las-ti-cism
ver-i-fi-able	ver-i-fi-a-ble
wary	war-y
semi-fi-nal	sem-i-fi-nal
hare-bel-l	hare-bell
hand-cuf-f	hand-cuff
aplen-ty	a-plen-ty
pam-phle-teer	pam-phlet-eer
an-tag-o-nis-m	an-tag-o-nism
desert-s	de-serts
con-sular	con-su-lar
con-trivance	con-triv-ance
clayey	clay-ey
dis-cov-ery	dis-cov-er-y
grenadier	gren-a-dier
rene-go-ti-ate	re-ne-go-ti-ate
u-p-land	up-land
dis-mal-l-y	dis-mal-ly
basilisk	bas-i-lisk
c-og-nizance	cog-ni-zance
cowherd	cow-herd
s-pat-u-la	spat-u-la
in-ter-ac-t	in-ter-act
elec-tive	e-lec-tive
in-hibitor	in-hib-i-tor
re-freshed	refreshed
handrail	hand-rail
de-sir-able	de-sir-a-ble
her-bi-cide	herb-i-cide
backspace	back-space
pharao-h	phar-aoh
baldy	bald-y
e-vac-uee	e-vac-u-ee
im-pa-tien-t	im-pa-tient
despot-ic	des-pot-ic
ap-pre-cia-bly	ap-pre-ci-a-bly
phooey	phoo-ey
in-ge-nu-ity	in-ge-nu-i-ty
e-vanes-cen-t	ev-a-nes-cent
in-fringe-men-t	in-fringe-ment
oint-men-t	oint-ment
o-culist	oc-u-list
taboo	ta-boo
s-train	strain
u-nion-ist	un-ion-ist
c-on-cil-i-ate	con-cil-i-ate
piebald	pie-bald
s-ap-per	sap-per
pre-sum-ably	pre-sum-a-bly
sinis-tral	sin-is-tral
dis-tric-t	dis-trict
kamikaze	ka-mi-ka-ze
away	a-way
out-sel-l	out-sell
in-ex-ac-t	in-ex-act
en-force-men-t	en-force-ment
vari-a-tion	var-i-a-tion
apron	a-pron
in-jury	in-ju-ry
m-is-fit	mis-fit
re-fresh-men-t	re-fresh-ment
firmware	firm-ware
s-low-ly	slow-ly
craven	cra-ven
burly	bur-ly
clien-tele	cli-en-tele
rar-efac-tion	rar-e-fac-tion
per-ti-nen-t	per-ti-nent
crit-i-cis-m	crit-i-cism
teardrop	tear-drop
swindler	swin-dler
elvish	elv-ish
polemic	po-lem-ic
s-tunt-ed	stunted
hoary	hoar-y
ta-pes-try	tap-es-try
u-ni-for-m	u-ni-form
cagey	cag-ey
count-able	count-a-ble
con-cussed	concussed
g-ly-col	gly-col
duchess	duch-ess
mono-mi-al	mo-no-mi-al
or-nithol-o-gy	or-ni-thol-o-gy
manes	ma-nes
del-i-ques-cen-t	del-i-ques-cent
dis-ar-ma-men-t	dis-ar-ma-ment
platelet	plate-let
re-cip-i-en-t	re-cip-i-ent
un-de-sir-able	un-de-sir-a-ble
im-memo-ri-al	im-me-mo-ri-al
chore-og-ra-pher	cho-re-og-ra-pher
cau-tion-ary	cau-tion-ar-y
theoc-ra-cy	the-oc-ra-cy
poly-glot	pol-y-glot
specif-i-cal-ly	spe-cif-i-cal-ly
trumpery	trump-er-y
par-tial-i-ty	par-ti-al-i-ty
far-m	farm
erased	e-rased
suprema-cy	su-prem-a-cy
cham-pi-onship	cham-pi-on-ship
spindly	spin-dly
serendip-i-ty	ser-en-dip-i-ty
re-hearsal	re-hears-al
s-pate	spate
tapir	ta-pir
aquiline	aq-ui-line
playable	play-a-ble
translu-cen-t	trans-lu-cent
nurs-ery-man	nurs-er-y-man
op-er-a-tional	op-er-a-tion-al
hangar	hang-ar
re-align-men-t	re-a-lign-ment
transat-lantic	trans-at-lan-tic
u-n-ac-quaint-ed	un-ac-quaint-ed
guilty	guilt-y
perime-ter	pe-rim-e-ter
rein-sur-ance	re-in-sur-ance
tasty	tast-y
brasserie	bras-se-rie
bazaar	ba-zaar
s-teeple-jack	stee-ple-jack
open-er	o-pen-er
mistyp-ings	mis-ty-pings
barom-e-ter	ba-rom-e-ter
taber-na-cle	tab-er-nac-le
un-prov-able	un-prov-a-ble
hawser	haw-ser
colan-der	col-an-der
les-bian	les-bi-an
clas-si-cis-m	clas-si-cism
so-bri-ety	so-bri-e-ty
re-sent-men-t	re-sent-ment
s-ling-shot	sling-shot
in-ter-ci-ty	in-ter-cit-y
key-boardis-t	key-board-ist
im-pres-sion-is-m	im-pres-sion-ism
triple	tri-ple
s-hear-wa-ter	shear-wa-ter
in-stan-ta-neous	in-stan-ta-ne-ous
un-abat-ed	un-a-bat-ed
poky	pok-y
fac-t	fact
s-tock-y	stock-y
un-break-able	un-break-a-ble
s-tok-er	stok-er
tren-chan-t	trench-ant
w-hole-wheat	wholewheat
trapeze	tra-peze
apoc-a-lyp-tic	a-poc-a-lyp-tic
tachy-car-dia	tach-y-car-di-a
ethnog-ra-phy	eth-nog-ra-phy
s-car	scar
i-n-ad-e-quate-ly	in-ad-e-quate-ly
pen-t	pent
re-pen-t	re-pent
ra-dius	ra-di-us
sauer-kraut	sau-er-kraut
e-pochal	ep-och-al
stag-ger-s	stag-gers
his-toric	his-tor-ic
tam-p	tamp
beat-i-tude	be-at-i-tude
anony-mous-ly	a-non-y-mous-ly
cowslip	cow-slip
sergean-t	ser-geant
s-cut-tle	scut-tle
hal-ibut	hal-i-but
me-te-o-rol-o-gist	me-te-or-ol-o-gist
per-mafrost	per-ma-frost
bil-liard-s	bil-liards
b-lessed-ness	bless-ed-ness
de-pen-den-t	de-pend-ent
overop-ti-mistic	o-ver-op-ti-mis-tic
bony	bon-y
jour-nal-is-m	jour-nal-ism
golfer	golf-er
conur-ba-tion	con-ur-ba-tion
sunken	sunk-en
read-able	read-a-ble
limpet	lim-pet
car-roty	car-rot-y
gestalt	ge-stalt
case-men-t	case-ment
pho-to-elec-tric	pho-to-e-lec-tric
apho-ris-m	aph-o-rism
melan-choly	mel-an-chol-y
sus-pend-ed	sus-pen-ded
se-can-t	se-cant
con-sis-ten-t	con-sist-ent
depre-da-tion	dep-re-da-tion
chantry	chan-try
prebend	preb-end
shaky	shak-y
mas-sacre	mas-sa-cre
e-u-phoric	eu-phor-ic
re-peater	re-peat-er
thruster	thrust-er
s-tar-let	star-let
turquoise	tur-quoise
s-mog-gy	smog-gy
with-er-s	with-ers
melod-ic	me-lod-ic
darter	dart-er
lov-able	lov-a-ble
laugh-able	laugh-a-ble
avarice	av-a-rice
com-plainan-t	com-plain-ant
flinch-ing	flin-ching
recipe	rec-i-pe
anom-aly	a-nom-a-ly
colon-nade	col-on-nade
retic-u-lum	re-tic-u-lum
biomorph	bi-o-morph
s-parkler	spar-kler
wrin-kled	wrinkled
ac-cep-t	ac-cept
sur-viv-abil-i-ty	sur-viv-a-bil-i-ty
ques-tion-able	ques-tion-a-ble
elec-tro-mag-net-ic	e-lec-tro-mag-net-ic
over-growth	o-ver-growth
growl-ing	growling
roofer	roof-er
b-otany	bot-a-ny
lig-and	li-gand
ma-tri-lin-eal	mat-ri-lin-e-al
aquifer	aq-ui-fer
reprise	re-prise
epilep-sy	ep-i-lep-sy
haystack	hay-stack
cir-cum-lo-cu-to-ry	cir-cum-loc-u-to-ry
im-moral	im-mor-al
al-l	all
cur-able	cur-a-ble
sub-con-ti-nen-t	sub-con-ti-nent
sui-ci-dal	su-i-cid-al
dis-si-den-t	dis-si-dent
wom-ankind	wom-an-kind
co-conut	co-co-nut
re-frac-t	re-fract
s-mash	smash
s-in-gle	sin-gle
lim-b	limb
apothe-cary	a-poth-e-car-y
sup-ple-men-tary	sup-ple-men-ta-ry
s-teep	steep
sub-sidiary	sub-sid-i-ar-y
igua-na	i-gua-na
chrysalis	chrys-a-lis
purga-tive	pur-ga-tive
epi-gram-mat-ic	ep-i-gram-mat-ic
reim-ple-ment-ed	reimplemented
charis-ma	cha-ris-ma
con-sumeris-m	con-sum-er-ism
test-ing	testing
rein-car-nat-ed	reincarnated
t-wo-some	two-some
re-bury	re-bur-y
minu-ti-ae	mi-nu-ti-ae
demigod	dem-i-god
con-duc-t	con-duct
chivvy	chiv-vy
ev-ery-where	eve-ry-where
glit-tery	glit-ter-y
hori-zon	ho-ri-zon
mover	mov-er
handy	hand-y
iron-i-cal-ly	i-ron-i-cal-ly
change-able	change-a-ble
elic-it	e-lic-it
perquisite	per-qui-site
s-trap	strap
platy-pus	plat-y-pus
phle-boto-my	phle-bot-o-my
cyn-i-cis-m	cyn-i-cism
en-joy-men-t	en-joy-ment
even-tu-al	e-ven-tu-al
s-ketch-book	sketch-book
in-con-sid-er-able	in-con-sid-er-a-ble
mil-i-tan-t	mil-i-tant
s-cant-i-ly	scant-i-ly
treat-able	treat-a-ble
con-queror	con-quer-or
brioche	bri-oche
verdi-gris	ver-di-gris
t-in-pot	tin-pot
mist-ime	mis-time
chara-banc	char-a-banc
up-heaval	up-heav-al
s-tacked	stacked
flow-ery	flow-er-y
the-atri-cal	the-at-ri-cal
vary	var-y
coun-t	count
dogged-ly	dog-ged-ly
ap-pre-cia-ble	ap-pre-ci-a-ble
s-tate-craft	state-craft
pullover	pull-o-ver
body-build-ing	bod-y-build-ing
over-play	o-ver-play
over-writ-ing	overwriting
pubescen-t	pu-bes-cent
signet	sig-net
over-pay	o-ver-pay
opin-ion	o-pin-ion
hazy	ha-zy
im-paction	im-pac-tion
s-pawn	spawn
blither-ing	blith-er-ing
han-dover	hand-o-ver
en-large-men-t	en-large-ment
monochro-mat-ic	mon-o-chro-mat-ic
di-a-conal	di-ac-o-nal
ex-trem-is-m	ex-trem-ism
s-mug-ness	smug-ness
toma-to	to-ma-to
catarac-t	cat-a-ract
adap-t	a-dapt
or-di-nary	or-di-nar-y
sol-diery	sol-dier-y
s-moth-ered	smothered
moray	mo-ray
spher-oid	sphe-roid
bedrock	bed-rock
nougat	nou-gat
paramed-i-cal	par-a-med-i-cal
ex-pect-ed	expected
caviar	cav-i-ar
es-capist	es-cap-ist
dis-avow-al	dis-a-vow-al
d-if-fu-sion	dif-fu-sion
con-stric-t	con-strict
in-ter-dis-ci-pli-nary	in-ter-dis-ci-pli-nar-y
s-plin-ter	splin-ter
car-cino-gen-e-sis	car-cin-o-gen-e-sis
w-hole-some	whole-some
eye-d	eyed
c-om-mend	com-mend
par-alin-guis-tic	par-a-lin-guis-tic
arise	a-rise
car-bonyl	car-bon-yl
un-bo-som	un-bos-om
polon-aise	pol-o-naise
s-lab	slab
s-corcher	scorch-er
c-it-i-zen-ry	cit-i-zen-ry
elec-tri-cian	e-lec-tri-cian
glitzy	glitz-y
rudi-men-ta-ry	ru-di-men-ta-ry
lieu-tenan-t	lieu-ten-ant
in-vari-able	in-var-i-a-ble
b-land	bland
en-joy-able	en-joy-a-ble
wafer	wa-fer
en-trail-s	en-trails
shandy	shan-dy
bawdy	bawd-y
wiry	wir-y
armistice	ar-mi-stice
spinal	spi-nal
com-po-nen-t	com-po-nent
melo-dra-mat-ic	mel-o-dra-mat-ic
en-list-men-t	en-list-ment
retest	re-test
ema-ci-a-tion	e-ma-ci-a-tion
biom-e-try	bi-om-e-try
payable	pay-a-ble
garter	gar-ter
in-flammable	in-flam-ma-ble
s-ab-bat-i-cal	sab-bat-i-cal
aper-ture	ap-er-ture
bo-hemi-an	bo-he-mi-an
coau-thor	co-au-thor
ori-en-tal	o-ri-en-tal
di-lata-tion	dil-a-ta-tion
g-luti-nous	glu-ti-nous
in-fantry	in-fan-try
man-ner-is-m	man-ner-ism
innkeep-er	inn-keep-er
camel	cam-el
elec-tro	e-lec-tro
n-ode	node
un-ser-vice-able	un-ser-vice-a-ble
un-even-ly	un-e-ven-ly
pan-tomime	pan-to-mime
weasel	wea-sel
em-pow-er-men-t	em-pow-er-ment
quartzite	quartz-ite
prefer-ably	pref-er-a-bly
foundry	found-ry
tara-masala-ta	ta-ra-ma-sa-la-ta
over-sup-ply	o-ver-sup-ply
pun-t	punt
naive	na-ive
e-n-ac-t	en-act
es-capade	es-ca-pade
se-quencer	se-quenc-er
aza-lea	a-zal-ea
un-rea-son-able	un-rea-son-a-ble
glacier	gla-cier
rep-re-sen-t	rep-re-sent
u-n-armed	un-armed
cuf-f	cuff
leafy	leaf-y
bio-ta	bi-o-ta
con-sti-tu-tion-al-is-m	con-sti-tu-tion-al-ism
mar-malade	mar-ma-lade
nether-most	neth-er-most
e-go-is-m	e-go-ism
s-tub-born-ly	stub-born-ly
u-nau-then-ti-cat-ed	un-au-then-ti-cat-ed
s-cen-t	scent
cheer-ing	cheering
boathouse	boat-house
re-vival-is-m	re-viv-al-ism
nec-es-sary	nec-es-sar-y
carotid	ca-rot-id
as-besto-sis	as-bes-to-sis
milky	milk-y
ben-der	bend-er
de-ter-mi-nan-t	de-ter-mi-nant
sub-jec-tivis-m	sub-jec-tiv-ism
un-ob-serv-able	un-ob-serv-a-ble
over-take	o-ver-take
megabyte	meg-a-byte
e-u-phemisti-cal-ly	eu-phe-mis-ti-cal-ly
s-ly	sly
quencher	quench-er
cat-alyt-ic	cat-a-lyt-ic
de-spon-den-cy	de-spond-en-cy
im-porter	im-port-er
genome	ge-nome
ful-mi-nan-t	ful-mi-nant
e-choic	e-cho-ic
damsel	dam-sel
chi-nois-erie	chi-noi-se-rie
chom-p	chomp
far-away	far-a-way
diminu-tive	di-min-u-tive
ear-l	earl
ra-dio-ther-a-py	ra-di-o-ther-a-py
oc-tan-t	oc-tant
sober	so-ber
les-bian-is-m	les-bi-an-ism
aug-men-t	aug-ment
taxi-der-mist	tax-i-der-mist
b-room	broom
rip-pling	rippling
biped	bi-ped
en-trepreneur-ship	en-tre-pre-neur-ship
im-pri-matur	im-pri-ma-tur
viewfind-er	view-find-er
prof-itable	prof-it-a-ble
vana-di-um	va-na-di-um
tuxe-do	tux-e-do
u-nim-proved	un-im-proved
plumage	plum-age
u-n-ap-proach-able	un-ap-proach-a-ble
mar-i-onette	mar-i-on-ette
con-ceiv-ably	con-ceiv-a-bly
tele-pho-ny	te-leph-o-ny
madam	mad-am
clam-p-down	clamp-down
rhetoric	rhet-o-ric
but-t	butt
man-i-festo	man-i-fes-to
s-coff	scoff
colonic	co-lon-ic
or-tho-doxy	or-tho-dox-y
con-demned	condemned
op-ti-mistic	op-ti-mis-tic
di-choto-mous	di-chot-o-mous
tiling	til-ing
ashen	ash-en
a-tol-l	at-oll
un-stop-pable	un-stop-pa-ble
pe-rusal	pe-rus-al
trea-sur-er	treas-ur-er
polyp	pol-yp
psy-chi-atric	psy-chi-at-ric
s-tar	star
em-body	em-bod-y
lava-to-ri-al	lav-a-to-ri-al
ec-topic	ec-top-ic
e-quable	eq-ua-ble
char-cu-terie	char-cu-te-rie
lachry-mal	lach-ry-mal
hayloft	hay-loft
poly-gon	pol-y-gon
in-di-rec-t	in-di-rect
com-plain-ing	complaining
caseload	case-load
pres-tidig-i-ta-tion	pres-ti-dig-i-ta-tion
sec-u-lar-is-m	sec-u-lar-ism
xeno-phobe	xen-o-phobe
propul-sive	pro-pul-sive
gym-nas-tic-s	gym-nas-tics
nasty	nas-ty
u-p-load	up-load
pro-le-tari-at	pro-le-tar-i-at
bap-tismal	bap-tis-mal
shaman-ic	sha-man-ic
s-to-ry-line	sto-ry-line
s-lap	slap
sa-far-i	sa-fa-ri
at-mo-spher-ic	at-mos-pher-ic
io-dide	i-o-dide
collinear	col-lin-e-ar
dis-ori-en-ta-tion	dis-o-ri-en-ta-tion
comet	com-et
fiendish	fiend-ish
de-men-t	de-ment
con-for-m	con-form
leghorn	leg-horn
hu-man-is-m	hu-man-ism
cordage	cord-age
pro-tect-ed	protected
kaiser	kai-ser
twister	twist-er
brain-stor-m	brain-storm
for-tu-itous	for-tu-i-tous
ethos	e-thos
k-itch-enette	kitch-en-ette
sur-viv-able	sur-viv-a-ble
k-ing-fish-er	king-fish-er
min-istry	min-is-try
samu-rai	sam-u-rai
earplug	ear-plug
semi-con-scious	sem-i-con-scious
u-n-ap-pre-cia-tive	un-ap-pre-ci-a-tive
s-pore	spore
rooftop	roof-top
cor-re-spon-den-t	cor-re-spond-ent
sacra-men-t	sac-ra-ment
silken	silk-en
voodoo	voo-doo
reper-to-ry	rep-er-to-ry
wispy	wisp-y
s-porty	sport-y
mushy	mush-y
de-spi-ca-ble	des-pi-ca-ble
canopy	can-o-py
his-tamine	his-ta-mine
es-teemed	e-steemed
con-tender	con-tend-er
spillage	spill-age
s-tove	stove
s-cab-by	scab-by
tureen	tu-reen
kneecap	knee-cap
un-tidy	un-ti-dy
poli-ty	pol-i-ty
s-tu-pid-i-ty	stu-pid-i-ty
re-flec-t	re-flect
staphy-lo-coc-cus	staph-y-lo-coc-cus
debone	de-bone
im-mi-nen-t	im-mi-nent
ca-reerist	ca-reer-ist
con-traindi-ca-tion	con-tra-in-di-ca-tion
demise	de-mise
nobly	no-bly
thrilling	thrill-ing
gasi-fy	gas-i-fy
in-fante	in-fan-te
mini-cab	min-i-cab
video-tape	vid-e-o-tape
de-canter	de-cant-er
voyeuris-m	vo-yeur-ism
frizzy	friz-zy
antwer-p	antwerp
s-mug-gler	smug-gler
u-til-i-tar-i-an-is-m	u-til-i-tar-i-an-ism
s-noek	snoek
s-cor-pi-on	scor-pi-on
awake	a-wake
bur-bling	burbling
re-for-esta-tion	re-for-est-a-tion
be-twix-t	be-twixt
killjoy	kill-joy
velo-drome	ve-lo-drome
solem-ni-ty	so-lem-ni-ty
ten-able	ten-a-ble
sausage	sau-sage
crypt-anal-y-sis	crypt-a-nal-y-sis
tread-mil-l	tread-mill
pre-his-toric	pre-his-tor-ic
shaman	sha-man
ta-per-ing	ta-pe-ring
teenage	teen-age
busi-nesslike	busi-ness-like
radix	ra-dix
decile	dec-ile
wave-fron-t	wave-front
plenum	ple-num
funky	funk-y
goody	good-y
revenan-t	rev-e-nant
liftof-f	lift-off
face-tious	fa-ce-tious
tawny	taw-ny
re-as-sign-men-t	re-as-sign-ment
dis-moun-t	dis-mount
triathlon	tri-ath-lon
rounder	round-er
mishap	mis-hap
usury	u-su-ry
lethar-gic	le-thar-gic
beaker	beak-er
skul-l	skull
op-eretta	op-er-et-ta
e-lo-cu-tion	el-o-cu-tion
in-ca-pable	in-ca-pa-ble
raisin	rai-sin
reshow	re-show
con-flic-t	con-flict
lap-idary	lap-i-dar-y
ridicu-lous-ly	ri-dic-u-lous-ly
d-e-fi-cien-cy	de-fi-cien-cy
re-tal-ia-to-ry	re-tal-i-a-to-ry
un-treat-able	un-treat-a-ble
ref-er-ee-ing	re-fe-ree-ing
man-age-men-t	man-age-ment
avail-abil-i-ty	a-vail-a-bil-i-ty
in-ter-lock-ing	in-ter-loc-king
perdi-tion	per-di-tion
freely	free-ly
clemen-t	clem-ent
crofter	croft-er
crumbly	crum-bly
e-quiv-a-len-t	e-quiv-a-lent
maudlin	maud-lin
s-ta-tion	sta-tion
melo-dra-ma	mel-o-dra-ma
un-en-durable	un-en-dur-a-ble
avid	av-id
shril-l	shrill
u-nim-por-tance	un-im-por-tance
im-per-turbable	im-per-turb-a-ble
bene-dic-tion	ben-e-dic-tion
tiler	til-er
e-quidis-tan-t	e-qui-dis-tant
dis-rup-t	dis-rupt
ap-proval	ap-prov-al
tan-ta-moun-t	tan-ta-mount
hit-table	hit-ta-ble
s-traight-away	straight-a-way
apolo-get-ic	a-pol-o-get-ic
phys-io-ther-a-pist	phys-i-o-ther-a-pist
overindul-gence	o-ver-in-dul-gence
soli-taire	sol-i-taire
layabout	lay-a-bout
patchy	patch-y
vig-i-lan-t	vig-i-lant
un-car-ed	un-cared
e-d-u-ca-tion-al	ed-u-ca-tion-al
con-tigu-ous	con-tig-u-ous
bib-lio-phile	bib-li-o-phile
stric-t	strict
wis-p	wisp
gen-u-flec-t	gen-u-flect
wastrel	wast-rel
b-i-fo-cal	bi-fo-cal
zither	zith-er
s-trag-gly	strag-gly
se-ca-teurs	sec-a-teurs
f-reak	freak
litho-sphere	lith-o-sphere
frivol	friv-ol
s-nout	snout
whiskey	whis-key
simil-i-tude	si-mil-i-tude
siren	si-ren
pira-cy	pi-ra-cy
ex-ult-ing	exulting
stinker	stink-er
techno-pho-bic	tech-no-pho-bic
de-scen-dan-t	de-scend-ant
sawyer	saw-yer
lyri-cist	lyr-i-cist
hexa-dec-i-mal	hex-a-dec-i-mal
u-nattain-able	un-at-tain-a-ble
in-de-struc-tible	in-de-struct-i-ble
copi-lot	co-pi-lot
s-take	stake
body-work	bod-y-work
de-scend-ing	descending
y-olk	yolk
pol-lard-ed	pollarded
no-tice-ably	no-tice-a-bly
open-hand-ed	o-pen-hand-ed
per-ineum	per-i-ne-um
ex-pec-tant-ly	ex-pect-ant-ly
l-itur-gy	lit-ur-gy
plat-inum	plat-i-num
broody	brood-y
daffy	daf-fy
drink-able	drink-a-ble
join-t	joint
gaiter	gait-er
cos-set-ed	cosseted
ool-o-gy	o-ol-o-gy
cut-lery	cut-ler-y
pelvic	pel-vic
mil-i-tarist	mil-i-ta-rist
beanstalk-s	bean-stalks
mirac-u-lous-ly	mi-rac-u-lous-ly
s-pace-man	space-man
de-nial	de-ni-al
founder	found-er
teacup	tea-cup
coro-na-tion	cor-o-na-tion
hege-mo-ny	he-gem-o-ny
s-lur-p	slurp
lounger	loung-er
com-pe-ten-t	com-pe-tent
bo-som	bos-om
grimy	grim-y
crusty	crust-y
s-train-er	strain-er
syn-ony-mous	syn-on-y-mous
pe-ri-od-ic-i-ty	pe-ri-o-dic-i-ty
col-le-gial	col-le-gi-al
s-campi	scam-pi
detri-men-t	det-ri-ment
hep-tagon	hep-ta-gon
thyris-tor	thy-ris-tor
rhyth-m	rhythm
joust-ing	jousting
wind-surfer	wind-surf-er
rib-aldry	rib-ald-ry
tele-work-ing	teleworking
dis-heart-en-ing	dis-hear-te-ning
co-in-ci-den-t	co-in-ci-dent
legate	leg-ate
un-sellable	un-sell-a-ble
mater	ma-ter
batik	ba-tik
s-coff-in-g	scoffing
lozenge	loz-enge
aun-tie	aunt-ie
carafe	ca-rafe
undi-min-ished	un-di-min-ished
dra-mat-ic-s	dra-mat-ics
an-nu-ity	an-nu-i-ty
but-tressed	buttressed
serol-o-gy	se-rol-o-gy
s-lack-er	slack-er
glam-orous	glam-or-ous
turntable	turn-ta-ble
taffe-ta	taf-fe-ta
flat-u-len-t	flat-u-lent
un-clas-si-fi-able	un-clas-si-fi-a-ble
turmer-ic	tur-mer-ic
gaga	ga-ga
sav-agery	sav-age-ry
k-ing-dom	king-dom
spec-tropho-tome-ter	spec-tro-pho-tom-e-ter
s-cu-ba	scu-ba
a-gree-men-t	a-gree-ment
hyp-nother-a-py	hyp-no-ther-a-py
te-dious	te-di-ous
head-quar-ter-s	head-quar-ters
dairy	dair-y
mut-t	mutt
gen-uine-ly	gen-u-ine-ly
elec-troen-cephalo-gram	e-lec-tro-en-ceph-a-lo-gram
booty	boo-ty
s-neeze	sneeze
sisal	si-sal
u-niden-ti-fied	un-i-den-ti-fied
here-about-s	here-a-bouts
s-lump	slump
ap-pli-can-t	ap-pli-cant
tardy	tar-dy
light-s	lights
scrumhalf	scrum-half
steady-ing	steadying
delic-t	de-lict
essence	es-sence
bur-geon-ing	burgeoning
sibyl	sib-yl
re-assem-ble	re-as-sem-ble
galling	gall-ing
per-man-ganate	per-man-ga-nate
ne-go-tia-tor	ne-go-ti-a-tor
mod-e	mode
s-capu-la	scap-u-la
ca-cophonous	ca-coph-o-nous
de-pic-t	de-pict
en-dear-men-t	en-dear-ment
el-e-gan-t	el-e-gant
s-trate-gist	strat-e-gist
prepo-si-tion-al	prep-o-si-tion-al
bullfinch	bull-finch
in-stan-ta-neous-ly	in-stan-ta-ne-ous-ly
homi-ly	hom-i-ly
n-im-ble	nim-ble
scrupu-lous-ly	scru-pu-lous-ly
s-pan-ner	span-ner
ir-re-versible	ir-re-vers-i-ble
posy	po-sy
con-struc-tivist	con-struc-tiv-ist
shifter	shift-er
u-n-al-loyed	un-al-loyed
rheuma-tism	rheu-ma-tism
con-nec-t	con-nect
tiny	ti-ny
s-light-ing	slight-ing
en-chant-ed	enchanted
epi-dem-ic	ep-i-dem-ic
clumpy	clump-y
sig-nif-i-can-t	sig-nif-i-cant
pas-toral	pas-to-ral
at-tach-men-t	at-tach-ment
mon-u-men-t	mon-u-ment
per-sis-tent-ly	per-sist-ent-ly
u-nashamed-ly	un-a-sham-ed-ly
s-tan-dard	stand-ard
s-tun-ning-ly	stun-ning-ly
ur-ticari-a	ur-ti-car-i-a
re-sen-t	re-sent
medul-la	me-dul-la
re-can-t	re-cant
carat	car-at
bacil-lus	ba-cil-lus
fora-men	fo-ra-men
he-li-cal	hel-i-cal
quif-f	quiff
helper	help-er
rhetor-i-cal	rhe-tor-i-cal
moth-er-stobe	mo-ther-stobe
do-h	doh
wardrobe	ward-robe
di-etet-ic	di-e-tet-ic
con-ic-s	con-ics
polyurethane	pol-y-u-re-thane
pro-pa-gan-da	prop-a-gan-da
over-pass	o-ver-pass
cyclic	cy-clic
dreamy	dream-y
over-crowd	o-ver-crowd
repli-ca-tion	rep-li-ca-tion
s-now-fal-l	snow-fall
crevice	crev-ice
pronom-i-nal	pro-nom-i-nal
in-valid	in-va-lid
plunger	plung-er
baby-ish	ba-by-ish
con-fi-dan-t	con-fi-dant
waxy	wax-y
im-ma-nen-t	im-ma-nent
s-cat	scat
im-per-son-ator	im-per-son-a-tor
de-co	dec-o
e-co-log-i-cal	ec-o-log-i-cal
ir-ri-tan-t	ir-ri-tant
mist-imed	mis-timed
kook-abur-ra	kook-a-bur-ra
fil-l	fill
re-trac-t	re-tract
humbly	hum-bly
con-sul-tan-t	con-sult-ant
isother-mal	i-so-ther-mal
barter	bar-ter
cre-ative-ly	cre-a-tive-ly
smithereen-s	smith-er-eens
feath-erlight	feath-er-light
port-fo-lio	port-fo-li-o
padre	pa-dre
wind-mil-l	wind-mill
quaf-f	quaff
in-ter-locu-tor	in-ter-loc-u-tor
thau-maturge	thau-ma-turge
ot-toman	ot-to-man
timid	tim-id
mis-judg-men-t	mis-judg-ment
k-itsch	kitsch
s-traight-for-ward-ly	straight-for-ward-ly
nau-tilus	nau-ti-lus
in-vari-ably	in-var-i-a-bly
recharge	re-charge
som-brero	som-bre-ro
un-emo-tion-al	un-e-mo-tion-al
ranger	rang-er
m-nemon-ic	mne-mon-ic
mayflow-er	may-flow-er
babysit	ba-by-sit
astig-ma-tism	a-stig-ma-tism
fetishis-tic	fet-ish-is-tic
s-calp	scalp
mil-lenar-i-an-is-m	mil-le-nar-i-an-ism
over-cook	o-ver-cook
sum-mery	sum-mer-y
scrol-l	scroll
ir-ra-tional-i-ty	ir-ra-tion-al-i-ty
reg-istry	reg-is-try
illiq-uid	il-liq-uid
un-in-tel-li-gen-t	un-in-tel-li-gent
ledger	ledg-er
idio-syn-cratic	id-i-o-syn-crat-ic
l-ynx	lynx
tape-wor-m	tape-worm
duc-t	duct
bar-bel-l	bar-bell
emit	e-mit
charge-able	charge-a-ble
cun-nilin-gus	cun-ni-lin-gus
ar-rival	ar-ri-val
u-topi-an	u-to-pi-an
ben-e-fi-cia-ry	ben-e-fi-ci-ar-y
chrono-graph	chron-o-graph
ex-cel-len-t	ex-cel-lent
ap-proach-able	ap-proach-a-ble
racis-m	rac-ism
obli-ga-tion	ob-li-ga-tion
man-ager-ess	man-ag-er-ess
d-if-fi-cult	dif-fi-cult
il-lim-itable	il-lim-it-a-ble
pi-ran-ha	pi-ra-nha
repli-ca-tor	rep-li-ca-tor
mis-nomer	mis-no-mer
s-cald-ing	scald-ing
heresy	her-e-sy
pre-fab-ri-cat-ed	prefabricated
com-mis-sari-at	com-mis-sar-i-at
s-mart-ing	smart-ing
ex-em-plary	ex-em-pla-ry
s-lum	slum
su-per-fluity	su-per-flu-i-ty
oven	ov-en
de-men-ti-a	de-men-tia
igloo	ig-loo
rock-ery	rock-er-y
chemise	che-mise
tram-p	tramp
work-able	work-a-ble
s-tac-ca-to	stac-ca-to
in-creduli-ty	in-cre-du-li-ty
mono-gram	mon-o-gram
su-perla-tive	su-per-la-tive
valise	va-lise
ex-cep-tion-able	ex-cep-tion-a-ble
groupie	group-ie
leisurewear	lei-sure-wear
obe-di-ence	o-be-di-ence
ver-dan-t	ver-dant
poseur	po-seur
dosage	dos-age
side-re-al	si-de-re-al
omit	o-mit
there-about-s	there-a-bouts
sala-cious	sa-la-cious
stager	stag-er
mer-chantable	mer-chant-a-ble
s-par	spar
ma-lig-nan-t	ma-lig-nant
se-mi	sem-i
bean-ery	bean-er-y
ar-den-t	ar-dent
pre-ventable	pre-vent-a-ble
na-iad	nai-ad
cal-care-ous	cal-car-e-ous
camisole	cam-i-sole
palati-nate	pa-lat-i-nate
stag-nan-t	stag-nant
tri-umphal-is-m	tri-um-phal-ism
fil-a-men-t	fil-a-ment
damask	dam-ask
link-able	link-a-ble
s-tran-gu-la-tion	stran-gu-la-tion
recheck	re-check
tangy	tang-y
dis-sec-t	dis-sect
gin-sen-g	gin-seng
ev-i-den-t	ev-i-dent
rad-i-cal-is-m	rad-i-cal-ism
lectern	lec-tern
up-fron-t	up-front
resched-ule	re-sched-ule
foible	foi-ble
chi-canery	chi-can-er-y
sprayer	spray-er
e-s-pouse	es-pouse
hang-over	hang-o-ver
aris-to-crat-ic	a-ris-to-crat-ic
archer	arch-er
an-tivi-ral	an-ti-vi-ral
s-parse	sparse
nosy	nos-y
emir	e-mir
pun-gen-t	pun-gent
per-cu-ta-neous	per-cu-ta-ne-ous
ethe-re-al	e-the-re-al
roadmap	road-map
deliri-ous	de-lir-i-ous
avun-cu-lar	a-vun-cu-lar
fit-men-t	fit-ment
phleg-m	phlegm
rub-bishy	rub-bish-y
domi-no	dom-i-no
gos-samer	gos-sa-mer
pes-simist	pes-si-mist
semi-con-duc-tor	sem-i-con-duc-tor
mighty	might-y
phy-loge-ny	phy-log-e-ny
bes-tiary	bes-ti-ar-y
labi-um	la-bi-um
enor-mous-ly	e-nor-mous-ly
colos-sal	co-los-sal
poplar	pop-lar
chalky	chalk-y
thral-l	thrall
re-lax-ation	re-lax-a-tion
un-drink-able	un-drink-a-ble
courage	cour-age
in-de-ter-minable	in-de-ter-mi-na-ble
painkiller	pain-kil-ler
pester	pes-ter
cur-ricu-lum	cur-ric-u-lum
cack-ling	cackling
reaper	reap-er
es-tu-ary	es-tu-ar-y
mi-crocode	mi-cro-code
im-muno-sup-pres-sive	im-mu-no-sup-pres-sive
mag-ne-to-hy-dro-dy-nam-ic-s	mag-ne-to-hy-dro-dy-nam-ics
plu-per-fec-t	plu-per-fect
lessen	less-en
u-n-achiev-able	un-a-chiev-a-ble
s-mut	smut
con-cur-ren-t	con-cur-rent
crater	cra-ter
rarely	rare-ly
medal	med-al
oily	oil-y
fold-ing	folding
ob-struc-tion-is-m	ob-struc-tion-ism
traitor	trai-tor
en-tice-men-t	en-tice-ment
abuse	a-buse
over-ful-l	o-ver-full
ex-u-ber-an-t	ex-u-ber-ant
ro-den-t	ro-dent
de-rail-men-t	de-rail-ment
dis-putable	dis-put-a-ble
anvil	an-vil
neg-ligee	neg-li-gee
de-moun-t	de-mount
per-fidy	per-fi-dy
d-if-fi-dence	dif-fi-dence
schooner	schoon-er
polem-i-cal	po-lem-i-cal
s-e-lectee	se-lect-ee
s-tain	stain
wiring	wir-ing
u-n-am-bi-tious	un-am-bi-tious
springer	spring-er
elec-tri-cal	e-lec-tri-cal
rock-et-ing	rocketing
pael-la	pa-el-la
chimera	chi-me-ra
din-t	dint
athe-ist	a-the-ist
modal-i-ty	mo-dal-i-ty
doc-u-men-tary	doc-u-men-ta-ry
ogle	o-gle
bizarre	bi-zarre
sen-ti-men-t	sen-ti-ment
van-dal-is-m	van-dal-ism
dis-ap-proval	dis-ap-prov-al
k-nav-ish	knav-ish
g-narl	gnarl
het-ero-gene-ity	het-er-o-ge-ne-i-ty
cheater	cheat-er
necro-sis	ne-cro-sis
eigen-state	ei-gen-state
mega-volt	meg-a-volt
symp-to-matic	symp-to-mat-ic
polemi-cist	po-lem-i-cist
ca-su-al-ty	cas-u-al-ty
brawler	brawl-er
geo-ther-mal	ge-o-ther-mal
pru-den-t	pru-dent
per-for-m	per-form
en-treaty	en-treat-y
kil-l	kill
un-com-fort-able	un-com-fort-a-ble
in-deco-rous	in-dec-o-rous
stylist	styl-ist
fly-away	fly-a-way
suc-cu-len-t	suc-cu-lent
tren-chant-ly	trench-ant-ly
in-fre-quen-t	in-fre-quent
civic	civ-ic
fore-stal-l	fore-stall
s-tock-room	stock-room
myelin	my-e-lin
e-t-y-mol-o-gy	et-y-mol-o-gy
in-equity	in-eq-ui-ty
renter	rent-er
baoba-b	ba-o-bab
lusti-ly	lust-i-ly
hero-in	her-o-in
aorist	a-o-rist
tele-graph	tel-e-graph
tarsal	tar-sal
a-t-ro-phy	at-ro-phy
area	ar-e-a
bar-barous	bar-ba-rous
elec-tor	e-lec-tor
gramo-phone	gram-o-phone
un-electable	un-e-lect-a-ble
mata-dor	mat-a-dor
uned-i-fy-ing	un-ed-i-fy-ing
negate	ne-gate
u-ni-lat-er-al-is-m	u-ni-lat-er-al-ism
asym-me-try	a-sym-me-try
men-di-can-t	men-di-cant
bi-car-bon-ate	bi-car-bo-nate
s-lob-ber	slob-ber
un-re-solv-able	un-re-solv-a-ble
s-peak-ing	speak-ing
sched-uler	sched-ul-er
a-pos-tolic	ap-os-tol-ic
need-s	needs
bur-gundy	bur-gun-dy
som-no-len-t	som-no-lent
loathing	loath-ing
ex-cerp-t	ex-cerpt
over-act-ing	overacting
fes-ter-ing	festering
poly-crys-talline	pol-y-crys-tal-line
over-ture	o-ver-ture
stron-groom	strong-room
un-palat-able	un-pal-at-a-ble
prophet-ess	proph-et-ess
evo-lute	ev-o-lute
as-tro-physic-s	as-tro-phys-ics
ri-ot-ing	ri-o-ting
nympho-ma-ni-ac	nym-pho-ma-ni-ac
par-tic-u-lar-is-m	par-tic-u-lar-ism
deci-bel	dec-i-bel
non-con-for-mi-ty	non-con-form-i-ty
delu-sive	de-lu-sive
drainage	drain-age
pro-tec-torate	pro-tec-tor-ate
trencher	trench-er
respire	re-spire
rel-a-tivis-tic	rel-a-tiv-is-tic
vel-vety	vel-vet-y
ring-leader	ring-lead-er
geo-physic-s	ge-o-phys-ics
above	a-bove
bleary	blear-y
dilem-ma	di-lem-ma
patel-la	pa-tel-la
vac-uole	vac-u-ole
base-bal-l	base-ball
dizzi-ness	diz-zi-ness
cedar	ce-dar
s-teed	steed
s-mooch	smooch
chemist	chem-ist
drift-ing	drif-ting
sub-trac-t	sub-tract
d-if-fer-en-tial-ly	dif-fer-en-tial-ly
qua-drat-ic	quad-rat-ic
ax-e-man	axe-man
touristy	tour-ist-y
idio-syn-crasy	id-i-o-syn-cra-sy
de-flec-t	de-flect
rear-m	re-arm
he-do-nis-m	he-don-ism
ternary	ter-na-ry
trans-former	trans-form-er
over-heat-ed	overheated
di-gester	di-gest-er
hy-per-boloid	hy-per-bo-loid
jam-boree	jam-bo-ree
re-doubtable	re-doubt-a-ble
as-pirin	as-pi-rin
rub-bery	rub-ber-y
ni-hilist	ni-hil-ist
de-cen-t	de-cent
re-gret-table	re-gret-ta-ble
raven-ing	rav-en-ing
evil-do-er	e-vil-do-er
resin	res-in
al-ready	al-read-y
readap-t	re-a-dapt
s-naky	snak-y
raider	raid-er
fiz-z	fizz
malev-o-len-t	ma-lev-o-lent
head-mistress	head-mis-tress
in-com-press-ible	in-com-press-i-ble
in-signi-a	in-sig-ni-a
flaun-t	flaunt
land-fil-l	land-fill
biop-sy	bi-op-sy
teleg-ra-phy	te-leg-ra-phy
dis-con-ti-nu-ity	dis-con-ti-nu-i-ty
leg-isla-tive	leg-is-la-tive
bark-ing	barking
can-tilever	can-ti-le-ver
prepara-to-ry	pre-par-a-to-ry
u-n-awak-ened	un-a-wak-ened
im-pu-den-t	im-pu-dent
eat-able	eat-a-ble
ra-dio-graph	ra-di-o-graph
gamut	gam-ut
suc-cum-b	suc-cumb
in-vari-ant	in-var-i-ant
peanut	pea-nut
wave-for-m	wave-form
lech-ery	lech-er-y
s-cam-per	scamp-er
forcibly	for-ci-bly
syn-chronic-i-ty	syn-chro-nic-i-ty
wether	weth-er
chuf-f	chuff
ide-al	i-de-al
as-para-gus	as-par-a-gus
un-der-ar-m	un-der-arm
canal	ca-nal
bac-teri-um	bac-te-ri-um
mi-crosec-ond	mi-cro-sec-ond
grid-iron	grid-i-ron
wily	wil-y
s-plash	splash
whoso-ev-er	who-so-ev-er
opi-um	o-pi-um
con-san-guineous	con-san-guin-e-ous
wa-terbed	wa-ter-bed
ra-tio-nal-ly	ra-tion-al-ly
s-in-cere	sin-cere
harshen	harsh-en
hon-our	ho-nour
in-stan-t	in-stant
poly-chro-mat-ic	pol-y-chro-mat-ic
vam-p	vamp
dahli-a	dahl-ia
plaza	pla-za
re-versed	reversed
in-fir-mary	in-fir-ma-ry
cheesy	chees-y
aphro-disi-ac	aph-ro-dis-i-ac
het-ero-dox	het-er-o-dox
cryo-genic	cry-o-gen-ic
tar-if-f	tar-iff
con-nivance	con-niv-ance
cherub	cher-ub
cervix	cer-vix
s-tone	stone
manda-to-ry	man-da-to-ry
masochist	mas-och-ist
zaire	za-ire
in-cor-rec-t	in-cor-rect
ab-sen-t	ab-sent
midrif-f	mid-riff
u-niden-ti-fi-able	un-i-den-ti-fi-a-ble
event-ful	e-vent-ful
u-nis-sued	un-is-sued
er-bium	er-bi-um
rosette	ro-sette
bene-fac-tor	ben-e-fac-tor
d-e-fi-cien-t	de-fi-cient
hooli-gan-is-m	hoo-li-gan-ism
over-rate	o-ver-rate
a-tone-men-t	a-tone-ment
mil-i-tary	mil-i-tar-y
s-cis-sor	scis-sor
mul-ti-level	mul-ti-lev-el
s-lap-stick	slap-stick
schoolmistress	school-mis-tress
imag-i-na-tion	im-ag-i-na-tion
leisure	lei-sure
papule	pap-ule
el-l	ell
catal-y-sis	ca-tal-y-sis
di-rec-t	di-rect
s-culp-t	sculpt
n-ev-er	nev-er
mati-nee	mat-i-nee
s-low-poke	slow-poke
coolan-t	cool-ant
hul-la-baloo	hul-la-ba-loo
s-tim-u-lus	stim-u-lus
spe-cial-is-m	spe-cial-ism
elu-ci-date	e-lu-ci-date
brutish	brut-ish
en-fran-chise-men-t	en-fran-chise-ment
s-panker	spank-er
in-tractable	in-trac-ta-ble
dul-cimer	dul-ci-mer
rheuma-tol-o-gy	rheu-ma-tol-o-gy
petro-chem-i-cal	pet-ro-chem-i-cal
s-nipe	snipe
di-elec-tric	di-e-lec-tric
s-i-nu-soid	si-nus-oid
meta-phys-i-cal	met-a-phys-i-cal
over-heat	o-ver-heat
re-tain-ing	retaining
preva-len-t	prev-a-lent
mis-spel-l	mis-spell
sus-tain-able	sus-tain-a-ble
sus-pec-t	sus-pect
ranker	rank-er
over-done	o-ver-done
trav-el-ogue	trav-e-logue
sorghum	sor-ghum
ass-es	as-ses
ex-citable	ex-cit-a-ble
lethal-i-ty	le-thal-i-ty
topol-o-gy	to-pol-o-gy
glin-t	glint
cor-nu-copi-a	cor-nu-co-pi-a
sub-atom-ic	sub-a-tom-ic
hered-i-ty	he-red-i-ty
fal-ter-ing	fal-te-ring
greensward	green-sward
fermion	fer-mi-on
buoy-an-t	buoy-ant
look-ing	looking
good-s	goods
n-im-bus	nim-bus
neu-ro-science	neu-ro-sci-ence
s-tub-by	stub-by
pectin	pec-tin
knick-er-s	knick-ers
chore-a	cho-re-a
fifty	fif-ty
tra-chea	tra-che-a
vil-lager	vil-lag-er
sub-cu-ta-neous	sub-cu-ta-ne-ous
in-evitable	in-ev-i-ta-ble
poros-i-ty	po-ros-i-ty
ir-ra-tional-ly	ir-ra-tion-al-ly
over-long	o-ver-long
para-nor-mal	par-a-nor-mal
grass-root-s	grass-roots
fun-da-men-tal-is-m	fun-da-men-tal-ism
per-centile	per-cen-tile
s-cat-ter-ing	scat-ter-ing
re-main-s	re-mains
un-mis-tak-able	un-mis-tak-a-ble
im-pris-on-men-t	im-pris-on-ment
dis-ori-en-t	dis-o-ri-ent
s-nake-skin	snake-skin
non-vi-o-len-t	non-vi-o-lent
hia-tus	hi-a-tus
seal-ing	sealing
florist	flo-rist
brassiere	bras-siere
farad	far-ad
unlov-ing	un-lov-ing
re-for-m	re-form
decagon	dec-a-gon
provoca-tive-ly	pro-voc-a-tive-ly
melanin	mel-a-nin
mea-sure-less	meas-ure-less
con-sor-tium	con-sor-ti-um
yippee	yip-pee
spir-i-tu-al-ly	spir-it-u-al-ly
su-per-b	su-perb
dili-gence	dil-i-gence
rock-ing	rocking
di-ver-gen-t	di-ver-gent
car-bona-ceous	car-bo-na-ceous
un-taugh-t	un-taught
psy-choso-cial	psy-cho-so-cial
pass-ably	pass-a-bly
he-li-copter	hel-i-cop-ter
dumb-found-ed	dumbfounded
ion	i-on
op-po-nen-t	op-po-nent
poltroon	pol-troon
sex-tan-t	sex-tant
metal-lic	me-tal-lic
teapot	tea-pot
s-in-cer-i-ty	sin-cer-i-ty
out-per-for-m	out-per-form
sys-temic	sys-tem-ic
fault-ing	faulting
pen-i-ten-t	pen-i-tent
den-tistry	den-tis-try
grunter	grunt-er
tremor	trem-or
groovy	groov-y
re-place-men-t	re-place-ment
un-pre-dictably	un-pre-dict-a-bly
s-tave	stave
s-in-ter	sin-ter
s-can-dal	scan-dal
s-taunch	staunch
turtle-neck	tur-tle-neck
sepul-chral	se-pul-chral
s-link	slink
makeshift	make-shift
poly-atom-ic	pol-y-a-tom-ic
re-lax-an-t	re-lax-ant
rene-go-ti-a-tion	re-ne-go-ti-a-tion
in-flic-t	in-flict
de-sir-abil-i-ty	de-sir-a-bil-i-ty
u-n-avoid-ably	un-a-void-a-bly
rec-om-mend-ed	recommended
widescreen	wide-screen
vi-able	vi-a-ble
ar-chiv-ist	ar-chi-vist
sleepi-ness	sleep-i-ness
tepid	tep-id
re-ceip-t	re-ceipt
talkie	talk-ie
naked	na-ked
pread-o-les-cen-t	pre-ad-o-les-cent
condi-men-t	con-di-ment
foghorn	fog-horn
u-n-aligned	un-a-ligned
chim-panzee	chim-pan-zee
meat-bal-l	meat-ball
pho-to-genic	pho-to-gen-ic
codex	co-dex
an-thro-po-mor-phis-m	an-thro-po-mor-phism
calo-rie	cal-o-rie
hov-e	hove
gas-work-s	gas-works
elec-tric-i-ty	e-lec-tric-i-ty
respite	res-pite
boater	boat-er
sero-tonin	ser-o-to-nin
re-li-ably	re-li-a-bly
stopover	stop-o-ver
ro-mancer	ro-manc-er
puz-zle-men-t	puz-zle-ment
stealth-ily	stealth-i-ly
b-liss-ful-ly	bliss-ful-ly
ven-t	vent
dil-l	dill
de-pend-abil-i-ty	de-pend-a-bil-i-ty
py-rotech-nic	py-ro-tech-nic
ban-dage	band-age
fundrais-er	fund-rais-er
thinker	think-er
asi-nine	as-i-nine
eatery	eat-er-y
ex-ten-der	ex-tend-er
poly-the-is-m	pol-y-the-ism
tox-i-c-i-ty	tox-ic-i-ty
gooey	goo-ey
lava-to-ry	lav-a-to-ry
breast-feed	breastfeed
ephemer-al	e-phem-er-al
mufti	muf-ti
even-t	e-vent
mis-shapen	mis-shap-en
aviary	a-vi-ar-y
pupil	pu-pil
cycli-cal	cy-cli-cal
monox-ide	mon-ox-ide
whistler	whis-tler
astrad-dle	a-strad-dle
halite	hal-ite
cen-tral-is-m	cen-tral-ism
en-dow-men-t	en-dow-ment
con-se-quen-t	con-se-quent
haz-ardous	haz-ard-ous
s-narl	snarl
may-oral	may-or-al
gua-camole	gua-ca-mo-le
warmer	warm-er
re-deemer	re-deem-er
read-just-men-t	re-ad-just-ment
res-onate	res-o-nate
in-cre-men-t	in-cre-ment
em-bo-som	em-bos-om
school-teacher	school-teach-er
s-trat-i-fi-ca-tion	strat-i-fi-ca-tion
furtive-ly	fur-tive-ly
physic	phys-ic
mis-in-for-m	mis-in-form
d-ing	ding
bil-iary	bil-i-ar-y
om-ni-science	om-nis-cience
im-pon-der-able	im-pon-der-a-ble
over-write	o-ver-write
se-nior	sen-ior
high-t	hight
gra-tu-itous-ly	gra-tu-i-tous-ly
neme-sis	nem-e-sis
lantern	lan-tern
bub-blegum	bub-ble-gum
cred-it-wor-thy	cred-it-worth-y
retroac-tive-ly	ret-ro-ac-tive-ly
humerus	hu-mer-us
un-hope-d	un-hoped
moral-ly	mor-al-ly
quadrupole	quad-ru-pole
crisper	crisp-er
shal-l	shall
s-tra-tus	stra-tus
soli-tary	sol-i-tar-y
ex-ploita-tion	ex-ploi-ta-tion
an-thro-pogenic	an-thro-po-gen-ic
grad-u-al-is-m	grad-u-al-ism
palimpses-t	pal-imp-sest
ep-silon	ep-si-lon
retic-u-la-tion	re-tic-u-la-tion
cres-cen-t	cres-cent
colour	co-lour
azure	az-ure
s-chem-ing	schem-ing
skir-mish-ing	skirmishing
au-thoress	au-thor-ess
sacro-sanc-t	sac-ro-sanct
in-duc-t	in-duct
ouster	oust-er
kinder-garten	kin-der-gar-ten
thug-gery	thug-ger-y
s-pacey	spac-ey
buf-fer	buff-er
axle	ax-le
arthro-pod	ar-thro-pod
eva-sive	e-va-sive
com-press-ibil-i-ty	com-pres-si-bil-i-ty
ir-re-versibly	ir-re-vers-i-bly
dis-gust-ed	disgusted
u-n-aes-thet-ic	un-aes-thet-ic
mag-ne-tome-ter	mag-ne-tom-e-ter
s-mog	smog
sinew	sin-ew
de-pri-va-tion	dep-ri-va-tion
de-for-mi-ty	de-form-i-ty
bar-b	barb
gam-bling	gam-bling
mono-cul-ture	mon-o-cul-ture
s-mall-hold-ing	small-hold-ing
limo	lim-o
domi-cile	dom-i-cile
per-ish-able	per-ish-a-ble
s-i-nu-soidal	si-nus-oi-dal
celandine	cel-an-dine
sycamore	syc-a-more
binoc-u-lars	bin-oc-u-lars
aor-tic	a-or-tic
ob-struc-t	ob-struct
frontal	fron-tal
feu-dal-is-m	feu-dal-ism
piti-ful-ly	pit-i-ful-ly
es-capis-m	es-cap-ism
obey	o-bey
plumy	plum-y
ver-dic-t	ver-dict
s-carce-ly	scarce-ly
over-pro-duc-tion	o-ver-pro-duc-tion
jaun-t	jaunt
bubon-ic	bu-bon-ic
tropopause	trop-o-pause
sim-u-lacrum	sim-u-la-crum
monas-tic	mo-nas-tic
re-pairable	re-pair-a-ble
vestibule	ves-ti-bule
mag-nil-o-quen-t	mag-nil-o-quent
causal-ly	caus-al-ly
rea-son-ably	rea-son-a-bly
wear-able	wear-a-ble
wastage	wast-age
grotesque	gro-tesque
transcon-ti-nen-tal	trans-con-ti-nen-tal
cys-teine	cys-te-ine
weightlift-ing	weight-lift-ing
con-tention	con-ten-tion
por-phyrit-ic	por-phy-rit-ic
adult	a-dult
gateau	ga-teau
katy-did	ka-ty-did
s-tock-tak-ing	stock-tak-ing
where-about-s	where-a-bouts
tu-atara	tu-a-ta-ra
knowl-edge-able	knowl-edge-a-ble
n-erd	nerd
lithi-um	lith-i-um
im-per-ti-nen-t	im-per-ti-nent
so-cioe-co-nom-ic	so-ci-o-ec-o-nom-ic
siphon	si-phon
reify	re-i-fy
healthi-ly	health-i-ly
dactylic	dac-tyl-ic
mis-coun-t	mis-count
sauna	sau-na
tain-t	taint
ther-mo-elec-tric	ther-mo-e-lec-tric
there-after	there-af-ter
re-sol-ven-t	re-sol-vent
lega-cy	leg-a-cy
d-if-fu-siv-i-ty	dif-fu-siv-i-ty
in-vest-men-t	in-vest-ment
whiten	whit-en
dis-parate	dis-pa-rate
lam-plit	lamp-lit
clema-tis	clem-a-tis
en-cour-age-men-t	en-cour-age-ment
func-tion-al-is-m	func-tion-al-ism
floater	float-er
trac-t	tract
record-ing	re-cord-ing
s-pade	spade
blush-ing	blushing
basil	bas-il
exe-un-t	ex-e-unt
re-cruit-men-t	re-cruit-ment
projec-t	proj-ect
skew-ered	skewered
e-d-u-ca-tor	ed-u-ca-tor
de-cryp-t	de-crypt
bronchial	bron-chi-al
tur-f	turf
read-mis-sion	re-ad-mis-sion
undis-closed	un-dis-closed
li-bidi-nous	li-bid-i-nous
oakum	oa-kum
reac-qui-si-tion	re-ac-qui-si-tion
ma-chin-ery	ma-chin-er-y
s-plen-did-ly	splen-did-ly
ep-ithe-lial	ep-i-the-li-al
dis-tur-b	dis-turb
pago-da	pa-go-da
very	ver-y
howler	howl-er
repa-tri-ate	re-pa-tri-ate
speechi-fy-ing	speechifying
cre-ator	cre-a-tor
cleaver	cleav-er
ele-phan-t	el-e-phant
who-dunit	who-dun-it
n-od-dy	nod-dy
re-con-struc-t	re-con-struct
peas-antry	peas-ant-ry
habi-ta-tion	hab-i-ta-tion
servi-tude	ser-vi-tude
navel	na-vel
s-tam-mer	stam-mer
paral-y-sis	pa-ral-y-sis
xeno-pho-bic	xen-o-pho-bic
in-ces-t	in-cest
ex-po-nen-t	ex-po-nent
pen-tathlon	pen-tath-lon
op-por-tunis-m	op-por-tun-ism
as-sured-ly	as-sur-ed-ly
laser	la-ser
archival	ar-chi-val
de-ni-able	de-ni-a-ble
dal-liance	dal-li-ance
mildewy	mil-dew-y
hon-orif-ic	hon-or-if-ic
ar-bi-trari-ness	ar-bi-trar-i-ness
re-gret-tably	re-gret-ta-bly
ex-trater-res-tri-al	ex-tra-ter-res-tri-al
ridicu-lous-ness	ri-dic-u-lous-ness
s-caled	scaled
gal-axy	gal-ax-y
flus-tered	flustered
mega-lith	meg-a-lith
s-lot-ted	slot-ted
deben-ture	de-ben-ture
po-et-ic-s	po-et-ics
sadis-tic	sa-dis-tic
hereto-fore	here-to-fore
foundling	found-ling
feb-ru-ary	feb-ru-ar-y
ves-per-s	ves-pers
bal-moral	bal-mor-al
de-base-men-t	de-base-ment
rheumat-ic	rheu-mat-ic
in-hala-tion	in-ha-la-tion
flanker	flank-er
redac-tion	re-dac-tion
eleventh	e-lev-enth
epis-to-lary	e-pis-to-lar-y
py-rotech-nic-s	py-ro-tech-nics
reac-cep-t	re-ac-cept
de-spon-den-t	de-spond-ent
spir-i-tu-al-is-m	spir-it-u-al-ism
panz-er	pan-zer
bio-met-ric	bi-o-met-ric
den-t	dent
ele-phan-tine	el-e-phan-tine
in-dic-t	in-dict
ex-hibitor	ex-hib-i-tor
paean	pae-an
syco-phancy	syc-o-phan-cy
my-opi-a	my-o-pi-a
hearthrug	hearth-rug
swishy	swish-y
alone	a-lone
sou-venir	sou-ve-nir
pro-tec-t	pro-tect
ban-knote	bank-note
g-lycine	gly-cine
er-gonom-ic	er-go-nom-ic
pachy-der-m	pach-y-derm
yel-lowed	yellowed
colony	col-o-ny
dele-tion	de-le-tion
s-cal-able	scal-a-ble
un-ut-ter-able	un-ut-ter-a-ble
in-sou-ciant	in-sou-ci-ant
visa	vi-sa
rar-efied	rar-e-fied
hearsay	hear-say
de-tainee	de-tain-ee
pig-gery	pig-ger-y
cu-bis-m	cub-ism
dis-cour-age-men-t	dis-cour-age-ment
s-in-u-ous	sin-u-ous
mit-i-gat-ing	mitigating
lin-ear-ly	lin-e-ar-ly
unre-deemed	un-re-deemed
re-tini-tis	ret-i-ni-tis
durable	du-ra-ble
pulpy	pulp-y
s-trange-ly	strange-ly
hail-stor-m	hail-storm
forte	for-te
cool-ing	cooling
para-medic	par-a-med-ic
un-elect-ed	un-e-lect-ed
lan-guorous	lan-guor-ous
va-sec-to-my	vas-ec-to-my
en-chan-t	en-chant
pho-to-copy	pho-to-cop-y
em-bed-dable	em-bed-da-ble
viceroy	vice-roy
s-lice	slice
hostel-ry	hos-tel-ry
pol-i-tic-s	pol-i-tics
dia-lec-tic	di-a-lec-tic
copy-ist	cop-y-ist
lemon-ade	lem-on-ade
mis-man-age-men-t	mis-man-age-ment
mul-ti-pro-ces-sor	mul-ti-proc-es-sor
pre-cau-tion-ary	pre-cau-tion-ar-y
calorime-ter	cal-o-rim-e-ter
busi-ly	bus-i-ly
d-e-duc-tion	de-duc-tion
surf-in-g	surf-ing
vari-able	var-i-a-ble
ty-pog-ra-pher-s	ty-po-gra-phers
vest-men-t	vest-ment
p-salmist	psalm-ist
fig-men-t	fig-ment
dis-mem-bered	dismembered
kedgeree	ked-ger-ee
chili	chil-i
cast-away	cast-a-way
viaduc-t	vi-a-duct
geo-chem-istry	ge-o-chem-is-try
haughty	haugh-ty
sur-f	surf
await	a-wait
para-noid	par-a-noid
de-ter-ren-t	de-ter-rent
s-trait-en	strait-en
na-tion-al-is-m	na-tion-al-ism
re-pen-tan-t	re-pent-ant
chim-p	chimp
blowfly	blow-fly
re-peat-able	re-peat-a-ble
warpath	war-path
re-sis-tan-t	re-sist-ant
tarot	ta-rot
power-boat	pow-er-boat
an-tide-pres-san-t	an-ti-de-pres-sant
at-temp-t	at-tempt
la-ryn-geal	la-ryn-ge-al
duster	dust-er
cloa-ca	clo-a-ca
coxswain	cox-swain
t-int-ed	tinted
as-tro-physi-cist	as-tro-phys-i-cist
ra-dio	ra-di-o
sounder	sound-er
perky	perk-y
cope-d	coped
s-lan-der-ous	slan-der-ous
con-ge-nial	con-gen-ial
seag-ul-l	sea-gull
in-ho-mo-ge-neous	in-ho-mo-ge-ne-ous
fri-vol-ity	fri-vol-i-ty
cater-er	ca-ter-er
surly	sur-ly
ex-tin-guish-men-t	ex-tin-guish-ment
s-cor-er	scor-er
rev-erend	rev-er-end
petrol-o-gy	pe-trol-o-gy
s-louch	slouch
ar-senic	ar-se-nic
soloist	so-lo-ist
scrolling	scroll-ing
mo-lasses	mo-las-ses
ego	e-go
as-cen-t	as-cent
geyser	gey-ser
pan-theon	pan-the-on
s-tore	store
do-lerite	dol-er-ite
mere-tri-cious	mer-e-tri-cious
con-sulate	con-su-late
un-us-able	un-us-a-ble
naive-ly	na-ive-ly
aquat-ic	a-quat-ic
es-cu-d-o	es-cu-do
fore-fron-t	fore-front
u-nim-peach-able	un-im-peach-a-ble
cho-ris-ter	chor-is-ter
pick-ax-e	pick-axe
ar-gu-men-t	ar-gu-ment
aver-sive	a-ver-sive
lusty	lust-y
meta-bol-ic	met-a-bol-ic
op-por-tunist	op-por-tun-ist
holo-caust	hol-o-caust
rein-car-na-tion	re-in-car-na-tion
in-ter-op-er-abil-i-ty	in-ter-op-er-a-bil-i-ty
molec-u-lar	mo-lec-u-lar
hor-mon-al	hor-mo-nal
rear-ma-men-t	re-ar-ma-ment
jour-nalese	jour-nal-ese
un-de-cid-able	un-de-cid-a-ble
vol-un-tary	vol-un-tar-y
di-a-betes	di-a-be-tes
in-den-t	in-dent
s-now-bal-l	snow-ball
april	a-pril
spinet	spin-et
enu-mer-a-tor	e-nu-mer-a-tor
homage	hom-age
s-lash	slash
philol-o-gy	phi-lol-o-gy
biofeed-back	bi-o-feed-back
hedgerow	hedge-row
s-cotch	scotch
moi-ety	moi-e-ty
s-mol-der	smol-der
murky	murk-y
provider	pro-vid-er
y-acht	yacht
pathfind-er	path-find-er
s-core-card	score-card
fo-liage	fo-li-age
macro-scop-ic	mac-ro-scop-ic
un-al-ter-able	un-al-ter-a-ble
con-tes-tant	con-test-ant
body	bod-y
mer-chan-t	mer-chant
electro-mechan-i-cal	e-lec-tro-me-chan-i-cal
crafty	craft-y
Words with errors: 2265
Words with incorrect number of syllables: 2067
Total evluated: 6500
Perfect accuracy: 0.65
Number of syllables accuracy: 0.68
Average Levenshtein Distance(across incorrect words): 1.21
