Attempt	Real
im-mi-nen-t	im-mi-nent
ephemer-a	e-phem-er-a
handy	hand-y
tarot	ta-rot
iso-topic	i-so-top-ic
un-ser-vice-able	un-ser-vice-a-ble
syco-phan-tic	syc-o-phan-tic
needle-work	nee-dle-work
epit-o-me	e-pit-o-me
con-sumer	con-sum-er
aphro-disi-ac	aph-ro-dis-i-ac
relic-t	rel-ict
in-con-sid-er-able	in-con-sid-er-a-ble
brazen-ly	bra-zen-ly
pot-tery	pot-ter-y
bas-ketry	bas-ket-ry
im-paction	im-pac-tion
seizure	sei-zure
var-ie-gat-ed	var-i-e-gat-ed
un-sus-tain-able	un-sus-tain-a-ble
gan-glion	gan-gli-on
lurk-ing	lurking
man-ager-ess	man-ag-er-ess
b-lessed-ness	bless-ed-ness
caviar	cav-i-ar
pen-i-ten-tiary	pen-i-ten-tia-ry
s-lap-stick	slap-stick
mo-men-t	mo-ment
wel-com-ing	wel-co-ming
re-volt-ed	revolted
tes-ta-men-tary	tes-ta-men-ta-ry
e-s-pe-cial-ly	es-pe-cial-ly
clemen-t	clem-ent
s-culp-ture	sculp-ture
unin-spir-ing	un-in-spir-ing
s-e-lectee	se-lect-ee
por-phyry	por-phy-ry
s-lash-ing	slash-ing
in-ter-na-tion-al-is-m	in-ter-na-tion-al-ism
sub-scriber	sub-scrib-er
non-cha-lan-t	non-cha-lant
guardian	guard-i-an
de-fer-men-t	de-fer-ment
s-mol-der	smol-der
o-r-a-to-ry	or-a-to-ry
in-volve-men-t	in-volve-ment
poly-mer	pol-y-mer
cervix	cer-vix
d-if-fer	dif-fer
dial-y-sis	di-al-y-sis
ef-fer-ves-cen-t	ef-fer-ves-cent
un-count-able	un-count-a-ble
capy-bara	cap-y-ba-ra
un-pleas-an-t	un-pleas-ant
diminu-tion	dim-i-nu-tion
p-tarmi-gan	ptar-mi-gan
rhetor-i-cal	rhe-tor-i-cal
un-print-able	un-print-a-ble
fungi-cide	fun-gi-cide
avail-abil-i-ty	a-vail-a-bil-i-ty
s-lick-er	slick-er
sec-u-lar-is-m	sec-u-lar-ism
melt-ed	melted
s-words-man	swords-man
en-joy-ably	en-joy-a-bly
brand-ed	bran-ded
backgam-mon	back-gam-mon
cur-tilage	cur-ti-lage
augite	au-gite
com-paction	com-pac-tion
com-mence-men-t	com-mence-ment
tiger	ti-ger
s-tar-ship	star-ship
predilec-tion	pre-di-lec-tion
retic-u-lum	re-tic-u-lum
sole-cis-m	sol-e-cism
litho-sphere	lith-o-sphere
epis-co-pal	e-pis-co-pal
trans-for-m	trans-form
methy-lene	meth-yl-ene
mil-lenar-i-an	mil-le-nar-i-an
rene-gade	ren-e-gade
there-after	there-af-ter
cov-et-ed	coveted
leaky	leak-y
suit-abil-i-ty	suit-a-bil-i-ty
de-served-ly	de-serv-ed-ly
dis-burse-men-t	dis-burse-ment
daisy	dai-sy
coralline	cor-al-line
spinet	spin-et
u-nim-pressed	un-im-pressed
prebendary	preb-en-dar-y
layper-son	lay-per-son
soli-tude	sol-i-tude
scenery	scen-er-y
in-famy	in-fa-my
samovar	sam-o-var
livid	liv-id
ther-mo-dy-nam-ic-s	ther-mo-dy-nam-ics
we-b	web
sen-sa-tion-al-is-m	sen-sa-tion-al-ism
brawny	brawn-y
gener-ic	ge-ner-ic
chi-nois-erie	chi-noi-se-rie
puffer	puff-er
shopfron-t	shop-front
mil-i-taris-tic	mil-i-ta-ris-tic
mis-s	miss
posit	pos-it
hap-py-goluck-y	hap-py-go-luck-y
re-con-nec-t	re-con-nect
meio-sis	mei-o-sis
trans-ceiver	trans-ceiv-er
s-hears	shears
avarice	av-a-rice
hal-l	hall
ar-rival	ar-ri-val
sonata	so-na-ta
im-per-ma-nen-t	im-per-ma-nent
notepad	note-pad
itchy	itch-y
pro-ges-terone	pro-ges-ter-one
div-ina-tion	div-i-na-tion
ine-bri-ate	in-e-bri-ate
awestruc-k	awe-struck
man-dolin	man-do-lin
pi-rat-ed	pirated
rar-efied	rar-e-fied
vol-un-tary	vol-un-tar-y
s-paniel	span-iel
about	a-bout
in-tu-itive	in-tu-i-tive
meta-physic-s	met-a-phys-ics
pru-den-t	pru-dent
lay-of-f	lay-off
pa-tien-t	pa-tient
re-quiem	req-ui-em
hauler	haul-er
en-able	en-a-ble
sa-van-t	sa-vant
mope-d	mo-ped
ur-gen-t	ur-gent
moun-taineer-ing	moun-tain-eer-ing
s-cold-ing	scold-ing
coro-nal	cor-o-nal
midlife	mid-life
an-te-dilu-vian	an-te-di-lu-vi-an
clien-tele	cli-en-tele
over-sim-pli-fi-ca-tion	o-ver-sim-pli-fi-ca-tion
peace-able	peace-a-ble
cam-panol-o-gy	cam-pa-nol-o-gy
ho-muncu-lus	ho-mun-cu-lus
sep-a-ratism	sep-a-ra-tism
diver-s	di-vers
opaque	o-paque
re-unite	re-u-nite
s-i-nus	si-nus
s-to-icis-m	sto-i-cism
perky	perk-y
rif-f	riff
kayak	kay-ak
phoenix	phoe-nix
tele-scop-ic	tel-e-scop-ic
thumbprint	thumb-print
paraf-fin	par-af-fin
nascen-t	nas-cent
break-away	break-a-way
mac-a-roni	mac-a-ro-ni
te-dious	te-di-ous
topo-log-i-cal	top-o-log-i-cal
coter-mi-nous	co-ter-mi-nous
halo-gen	hal-o-gen
i-conog-ra-phy	i-co-nog-ra-phy
cir-cum-lo-cu-to-ry	cir-cum-loc-u-to-ry
haystack	hay-stack
i-nan-i-mate	in-an-i-mate
s-tut-ter	stut-ter
sar-i	sa-ri
qui-etus	qui-e-tus
sooty	soot-y
oc-tagon	oc-ta-gon
hal-ibut	hal-i-but
con-strict-ed	constricted
in-ter-minable	in-ter-mi-na-ble
spel-l	spell
ca-su-al-ty	cas-u-al-ty
com-peti-tor	com-pet-i-tor
macroe-co-nom-ic	mac-ro-ec-o-nom-ic
pe-cu-niary	pe-cu-ni-ar-y
s-pat	spat
en-slave-men-t	en-slave-ment
iso-la-tion-ist	i-so-la-tion-ist
mea-sure	meas-ure
rep-re-sen-t	rep-re-sent
dreamy	dream-y
largo	lar-go
g-o-nad	go-nad
cen-t	cent
metic-u-lous	me-tic-u-lous
aqua	aq-ua
raisin	rai-sin
windy	wind-y
monar-chist	mon-ar-chist
chara-banc	char-a-banc
painstak-ing	pains-tak-ing
s-tun-ning	stun-ning
testy	tes-ty
footage	foot-age
s-pade-work	spade-work
guilty	guilt-y
re-cessed	recessed
pyri-dine	pyr-i-dine
archangel	arch-an-gel
rigid-ly	rig-id-ly
s-nap-shot	snap-shot
in-fect-ed	in-fec-ted
bedrid-den	bed-rid-den
repack-age	re-pack-age
pres-ti-gious	pres-tig-ious
murky	murk-y
mi-cro-surgery	mi-cro-sur-ger-y
bigamy	big-a-my
s-tu-pen-dous	stu-pen-dous
gril-l	grill
laity	la-i-ty
on-ag-er	on-a-ger
homi-cide	hom-i-cide
en-light-en-men-t	en-light-en-ment
babysit-ting	babysitting
s-limy	slim-y
turfy	turf-y
s-lushy	slush-y
so-bri-ety	so-bri-e-ty
vacu-ity	va-cu-i-ty
flautist	flau-tist
peren-ni-al	per-en-ni-al
par-venu	par-ve-nu
w-hole-heart-ed	whole-heart-ed
breezy	breez-y
erec-tion	e-rec-tion
ini-tia-tive	in-i-ti-a-tive
t-wo	two
u-n-achiev-able	un-a-chiev-a-ble
ju-niper	ju-ni-per
knol-l	knoll
crotch-ety	crotch-et-y
thinker	think-er
cy-clotron	cy-clo-tron
gerund	ger-und
couloir	cou-loir
con-ver-gen-t	con-ver-gent
tilde	til-de
colum-nar	co-lum-nar
forest-ed	forested
mati-nee	mat-i-nee
en-croach-men-t	en-croach-ment
geno-ci-dal	gen-o-cid-al
book-stal-l	book-stall
un-san-i-tary	un-san-i-tar-y
vi-o-l	vi-ol
s-trat-i-fi-ca-tion	strat-i-fi-ca-tion
strug-gling	struggling
ap-plica-tive	ap-pli-ca-tive
framer	fram-er
cloudy	cloud-y
xeno-pho-bic	xen-o-pho-bic
an-tipodes	an-tip-o-des
s-traight-for-ward-ly	straight-for-ward-ly
pa-troness	pa-tron-ess
s-tur-dy	stur-dy
ex-trac-t	ex-tract
linoleum	li-no-le-um
com-pli-men-t	com-pli-ment
dan-de-lion	dan-de-li-on
s-parse	sparse
stag-nan-t	stag-nant
land-fil-l	land-fill
lega-tion	le-ga-tion
lyri-cis-m	lyr-i-cism
mil-lisec-ond	mil-li-sec-ond
avert	a-vert
mio-sis	mi-o-sis
ap-praisal	ap-prais-al
s-mile	smile
run-t	runt
s-tiff-en-ing	stiff-en-ing
impi	im-pi
postage	post-age
manikin	man-i-kin
opine	o-pine
usurp-er	u-surp-er
e-s-o-ter-ic	es-o-ter-ic
co-terie	co-te-rie
brandy	bran-dy
ho-mo-ge-neous	ho-mo-ge-ne-ous
fragili-ty	fra-gil-i-ty
deuteron	deu-ter-on
choral	cho-ral
s-lith-er	slith-er
gui-tarist	gui-tar-ist
s-tar-tling-ly	star-tling-ly
in-fini-tude	in-fin-i-tude
courtier	cour-ti-er
apron	a-pron
in-duc-t	in-duct
pun-gen-t	pun-gent
as-tro-physi-cist	as-tro-phys-i-cist
claret	clar-et
non-con-formist	non-con-form-ist
sickbed	sick-bed
sum-mery	sum-mer-y
s-nooze	snooze
gneis-s	gneiss
frat-ri-ci-dal	frat-ri-cid-al
s-lid-er	slid-er
syco-phan-t	syc-o-phant
g-lut-tonous	glut-ton-ous
pout-ing	pouting
grandeur	gran-deur
kamikaze	ka-mi-ka-ze
apoplexy	ap-o-plex-y
rhetor-i-cal-ly	rhe-tor-i-cal-ly
reclu-sive	re-clu-sive
antonym	an-to-nym
in-ef-fi-cien-t	in-ef-fi-cient
busi-nesslike	busi-ness-like
flesh-ing	fleshing
his-togram	his-to-gram
copy-ist	cop-y-ist
oldie	old-ie
trusty	trust-y
n-im-ble	nim-ble
en-durance	en-dur-ance
lath-e	lathe
con-ser-va-tive	con-serv-a-tive
cam-p	camp
pro-trac-t	pro-tract
co-pra	cop-ra
dis-con-ti-nu-ity	dis-con-ti-nu-i-ty
de-monolo-gy	de-mon-ol-o-gy
sinewy	sin-ew-y
un-re-li-able	un-re-li-a-ble
apish	ap-ish
pro-pa-gan-da	prop-a-gan-da
pedantry	ped-ant-ry
nun-nery	nun-ner-y
brio	bri-o
mega-lo-ma-ni-a	meg-a-lo-ma-ni-a
u-nan-swer-able	un-an-swer-a-ble
whaler	whal-er
elec-trophore-sis	e-lec-tro-pho-re-sis
temer-i-ty	te-mer-i-ty
epi-gram	ep-i-gram
serol-o-gy	se-rol-o-gy
s-lalom	sla-lom
in-san-i-tary	in-san-i-tar-y
gal-vanome-ter	gal-va-nom-e-ter
playable	play-a-ble
re-cy-cling	recycling
fid-get	fidg-et
epis-co-pa-cy	e-pis-co-pa-cy
raven	ra-ven
pizzi-ca-to	piz-zi-ca-to
nightwear	night-wear
dis-traugh-t	dis-traught
xenon	xe-non
re-new-able	re-new-a-ble
smoky	smok-y
supreme	su-preme
erot-i-ca	e-rot-i-ca
stylist	styl-ist
barony	bar-o-ny
in-stal-l	in-stall
seg-men-t	seg-ment
faucet	fau-cet
dis-union	dis-un-ion
meso-sphere	mes-o-sphere
pekan	pek-an
at-tach-men-t	at-tach-ment
cor-duroy	cor-du-roy
ap-proach-able	ap-proach-a-ble
para-m-ag-net-ic	par-a-mag-net-ic
suf-frag-ist	suf-fra-gist
drafty	draft-y
pig-gery	pig-ger-y
im-per-ti-nen-t	im-per-ti-nent
promon-to-ry	prom-on-to-ry
s-laugh-ter-house	slaugh-ter-house
ori-en-t	o-ri-ent
de-crepi-tude	de-crep-i-tude
heraldic	he-ral-dic
cli-toris	clit-o-ris
s-cant-i-ness	scant-i-ness
re-dis-cov-ery	re-dis-cov-er-y
avowed	a-vowed
beady	bead-y
hearti-ly	heart-i-ly
as-p	asp
con-queror	con-quer-or
os-teopa-thy	os-te-op-a-thy
siren	si-ren
s-lip-page	slip-page
d-educ-t	de-duct
prof-itably	prof-it-a-bly
avoid	a-void
over-rate	o-ver-rate
s-tair-well	stair-well
con-sumerist	con-sum-er-ist
cafe	ca-fe
clumpy	clump-y
com-pelling	com-pel-ling
pharao-h	phar-aoh
pen-sion-able	pen-sion-a-ble
cara-cal	car-a-cal
macaw	ma-caw
do-lerite	dol-er-ite
c-it-i-zen	cit-i-zen
aplom-b	a-plomb
melo-dra-mat-ic	mel-o-dra-mat-ic
paci-fist	pac-i-fist
e-bul-lien-t	e-bul-lient
con-ge-nial	con-gen-ial
hotspot	hot-spot
mal-adroit	mal-a-droit
payable	pay-a-ble
me-te-o-ro-log-i-cal	me-te-or-o-log-i-cal
fleshy	flesh-y
arach-noid	a-rach-noid
i-n-ad-ver-ten-t	in-ad-vert-ent
hero-is-m	her-o-ism
p-res-ence	pres-ence
no-body	no-bod-y
swasti-ka	swas-ti-ka
avowed-ly	a-vow-ed-ly
s-tok-er	stok-er
u-n-am-bi-tious	un-am-bi-tious
lim-b	limb
ar-guable	ar-gu-a-ble
in-ter-dis-ci-pli-nary	in-ter-dis-ci-pli-nar-y
crevasse	cre-vasse
herbal-is-m	her-bal-ism
glitzy	glitz-y
elec-tri-cal	e-lec-tri-cal
er-r	err
api-ary	a-pi-ar-y
satir-i-cal	sa-tir-i-cal
tol-l	toll
as-s	ass
junkie	jun-kie
un-no-tice-able	un-no-tice-a-ble
mis-chievous	mis-chie-vous
enu-mer-a-tion	e-nu-mer-a-tion
my-opic	my-op-ic
mono-rail	mon-o-rail
joyride	joy-ride
telepa-thy	te-lep-a-thy
elec-tro-stat-ic-s	e-lec-tro-stat-ics
con-nivance	con-niv-ance
em-i-nen-t	em-i-nent
gen-i-tali-a	gen-i-ta-li-a
whirligig	whirl-i-gig
ion-ic	i-on-ic
di-etet-ic	di-e-tet-ic
g-lid-ing	glid-ing
nico-tine	nic-o-tine
telekine-sis	tel-e-ki-ne-sis
chantry	chan-try
lano-lin	lan-o-lin
petard	pe-tard
gallery	gal-ler-y
u-nashamed-ly	un-a-sham-ed-ly
cal-l	call
menswear	mens-wear
frizzy	friz-zy
za-g	zag
pro-ce-du-ral-ly	pro-ce-dur-al-ly
haughty	haugh-ty
poly-phon-ic	pol-y-phon-ic
ran-corous	ran-cor-ous
im-pass-able	im-pass-a-ble
vari-ance	var-i-ance
quel-l	quell
lachry-mose	lach-ry-mose
iso-la-tion	i-so-la-tion
en-hance-men-t	en-hance-ment
idyl-l	i-dyll
claiman-t	claim-ant
foible	foi-ble
in-elas-tic	in-e-las-tic
painful-ly	pain-ful-ly
di-a-betes	di-a-be-tes
predica-men-t	pre-dic-a-ment
un-der-achieve-men-t	un-der-a-chieve-ment
cari-bou	car-i-bou
weightlift-ing	weight-lift-ing
un-kep-t	un-kept
n-ode	node
dis-rep-utable	dis-rep-u-ta-ble
tiara	ti-ar-a
shindig	shin-dig
pati-na-tion	pat-i-na-tion
crinkly	crin-kly
hia-tus	hi-a-tus
s-trat-e-gy	strat-e-gy
metronome	met-ro-nome
ir-refutable	ir-ref-u-ta-ble
dry-s-tone	dry-stone
rein-vest-men-t	re-in-vest-ment
bio-chemist	bi-o-chem-ist
si-lencer	si-lenc-er
io-dine	i-o-dine
struc-tural-ly	struc-tur-al-ly
flow-ery	flow-er-y
habit	hab-it
breathy	breath-y
pur-suer	pur-su-er
ga-mete	gam-ete
au-topi-lot	au-to-pi-lot
propul-sion	pro-pul-sion
elec-tro-stat-ic	e-lec-tro-stat-ic
s-targaz-er	star-gaz-er
nar-cis-sis-m	nar-cis-sism
i-n-ap-pli-ca-ble	in-ap-pli-ca-ble
cat-alyt-ic	cat-a-lyt-ic
pe-cu-liar-i-ty	pe-cu-li-ar-i-ty
growler	growl-er
s-care	scare
tithing	tith-ing
roofer	roof-er
s-tock-ade	stock-ade
testable	test-a-ble
top-i-ary	to-pi-ar-y
here-inafter	here-in-af-ter
bio-met-ric-s	bi-o-met-rics
in-hibito-ry	in-hib-i-to-ry
un-usu-al-ly	un-u-su-al-ly
scream-ing	screaming
res-onate	res-o-nate
set-tle-men-t	set-tle-ment
di-aphanous	di-aph-a-nous
het-ero-sex-u-al	het-er-o-sex-u-al
ju-ridi-cal	ju-rid-i-cal
arthro-pod	ar-thro-pod
in-struc-t	in-struct
freighter	freight-er
camper	camp-er
wiper	wip-er
vari-ate	var-i-ate
to-tal-i-tar-i-an-is-m	to-tal-i-tar-i-an-ism
fermion	fer-mi-on
un-de-vel-ope-d	un-de-vel-oped
work-able	work-a-ble
oa-sis	o-a-sis
dis-sent-ing	dissenting
sharp-en-er	shar-pen-er
sprayer	spray-er
la-ryn-geal	la-ryn-ge-al
un-charis-mat-ic	un-char-is-mat-ic
un-de-tectable	un-de-tect-a-ble
com-po-nen-t	com-po-nent
en-cryp-t	en-crypt
tablet	tab-let
copy-right	cop-y-right
de-struc-t	de-struct
p-ri-mor-dial	pri-mor-di-al
fraud-u-len-t	fraud-u-lent
peanut	pea-nut
wa-ter-fal-l	wa-ter-fall
sacro-sanc-t	sac-ro-sanct
scrawny	scrawn-y
mil-i-tary	mil-i-tar-y
y-ours	yours
plu-ral-is-m	plu-ral-ism
sawyer	saw-yer
pat-terned	patterned
k-lax-on	klax-on
as-so-cia-tive	as-so-ci-a-tive
awash	a-wash
gravi-ton	grav-i-ton
pri-mar-i-ly	pri-ma-ri-ly
s-tone-ma-son	stone-ma-son
ser-van-t	serv-ant
charis-ma	cha-ris-ma
epic	ep-ic
medal-lion	me-dal-lion
mit-t	mitt
haver-ing	ha-ve-ring
s-tarve	starve
re-for-esta-tion	re-for-est-a-tion
con-sid-er-ably	con-sid-er-a-bly
ex-trater-res-tri-al	ex-tra-ter-res-tri-al
renown	re-nown
mendele-vi-um	men-de-le-vi-um
s-lip-per	slip-per
dele-tion	de-le-tion
tramway	tram-way
gal-axy	gal-ax-y
sub-unit	sub-u-nit
elec-tro-cu-tion	e-lec-tro-cu-tion
un-der-state-men-t	un-der-state-ment
sus-pend-ed	sus-pen-ded
a-balone	ab-a-lo-ne
horny	horn-y
ex-pi-ra-to-ry	ex-pir-a-to-ry
s-cur-ry	scur-ry
voca-tive	voc-a-tive
corny	corn-y
fever	fe-ver
s-phyg-mo-manome-ter	sphyg-mo-ma-nom-e-ter
squirearchy	squire-ar-chy
undis-tort-ed	un-dis-tort-ed
gourmet	gour-met
l-it-mus	lit-mus
s-tole	stole
ori-en-ta-tion	o-ri-en-ta-tion
madri-gal	mad-ri-gal
tele-scope	tel-e-scope
fury	fu-ry
an-nal-s	an-nals
fontanel	fon-ta-nel
hi-ero-glyph	hi-er-o-glyph
rein-sur-ance	re-in-sur-ance
con-comi-tan-t	con-com-i-tant
key-boardis-t	key-board-ist
s-ketch-book	sketch-book
catal-y-sis	ca-tal-y-sis
par-enter-al	par-en-ter-al
s-cot	scot
to-bac-conist	to-bac-co-nist
un-pro-nounce-able	un-pro-nounce-a-ble
lusti-ly	lust-i-ly
frilli-er	fril-li-er
roller	roll-er
holis-ti-cal-ly	ho-lis-ti-cal-ly
arc-ing	arcing
javelin	jave-lin
easy	eas-y
any-ways	an-y-ways
dairy-ing	dair-y-ing
s-trap	strap
in-cor-rec-t	in-cor-rect
colonist	col-o-nist
mar-ketable	mar-ket-a-ble
eter-nal	e-ter-nal
s-tock-bro-ker	stock-brok-er
n-ear-sight-ed	near-sight-ed
e-u-pho-ni-um	eu-pho-ni-um
over-staffed	overstaffed
queasy	quea-sy
s-lim-mer	slim-mer
poly-the-is-m	pol-y-the-ism
f-reak-ish	freak-ish
pep-pery	pep-per-y
ethol-o-gy	e-thol-o-gy
iron-i-cal-ly	i-ron-i-cal-ly
over-dose	o-ver-dose
s-lack-er	slack-er
fire-bom-b	fire-bomb
ni-hilis-m	ni-hil-ism
kerosene	ker-o-sene
s-tand	stand
table-cloth	ta-ble-cloth
liquor	liq-uor
gan-g-ly	gan-gly
pan-golin	pan-go-lin
d-weller	dwell-er
triplet	tri-plet
telling-ly	tell-ing-ly
blush-ing	blushing
s-cape	scape
iron-stone	i-ron-stone
u-topi-an	u-to-pi-an
trans-fer-able	trans-fer-a-ble
brasserie	bras-se-rie
video-phone	vid-e-o-phone
reroute	re-route
un-ob-serv-able	un-ob-serv-a-ble
chore-o-graph-ic	cho-re-o-graph-ic
hashish	hash-ish
propin-quity	pro-pin-qui-ty
open-ing	o-pen-ing
over-growth	o-ver-growth
over-load-ed	overloaded
ureter	u-re-ter
wealthy	wealth-y
pu-ri-tanis-m	pu-ri-tan-ism
metic-u-lous-ly	me-tic-u-lous-ly
petu-lan-t	pet-u-lant
genus	ge-nus
lam-ben-t	lam-bent
unswerv-ing	un-swerv-ing
un-trace-able	un-trace-a-ble
jaun-t	jaunt
b-land-ly	bland-ly
con-gru-en-t	con-gru-ent
g-lut-ton	glut-ton
u-n-avail-able	un-a-vail-a-ble
im-per-son-ator	im-per-son-a-tor
er-gonomic-s	er-go-nom-ics
dis-hon-esty	dis-hon-es-ty
gen-uine	gen-u-ine
ob-serv-able	ob-serv-a-ble
necro-mancer	nec-ro-man-cer
over-play	o-ver-play
c-itadel	cit-a-del
over-es-ti-ma-tion	o-ver-es-ti-ma-tion
basal	ba-sal
rivulet	riv-u-let
s-wot	swot
babes	babes
comet	com-et
b-lench	blench
ogle	o-gle
halon	hal-on
roadmap	road-map
au-gury	au-gu-ry
taunt-ing	taunting
d-win-dling	dwindling
ta-pes-try	tap-es-try
harpist	har-pist
a-tone-men-t	a-tone-ment
ver-i-fi-able	ver-i-fi-a-ble
s-lip-way	slip-way
undis-ci-plined	un-dis-ci-plined
carpal	car-pal
beanie	bean-ie
en-thu-si-as-m	en-thu-si-asm
ap-par-en-t	ap-par-ent
in-sipid	in-sip-id
s-pace	space
s-tain-less	stain-less
cuirass	cui-rass
drowsi-ness	drow-si-ness
ax-e	axe
dis-obe-di-en-t	dis-o-be-di-ent
ethanol	eth-a-nol
reti-na	ret-i-na
co-vari-ance	co-var-i-ance
silli-ness	sil-li-ness
oily	oil-y
spi-dery	spi-der-y
k-ilt	kilt
in-quisi-to-ri-al	in-quis-i-to-ri-al
ide-al-is-m	i-de-al-ism
feath-erlight	feath-er-light
in-cor-rupt-ible	in-cor-rupt-i-ble
so-cial-is-m	so-cial-ism
tear-away	tear-a-way
con-ser-va-to-ry	con-serv-a-to-ry
s-worn	sworn
bulky	bulk-y
ni-troge-nous	ni-trog-e-nous
lam-p	lamp
liveli-hood	live-li-hood
con-vic-t	con-vict
learned	learn-ed
dioce-san	di-oc-e-san
video-tape	vid-e-o-tape
de-mo	dem-o
s-tar-ling	star-ling
land-fal-l	land-fall
manda-to-ry	man-da-to-ry
sleepi-ness	sleep-i-ness
com-pen-dium	com-pen-di-um
badtem-pered	bad-tem-pered
as-tronomer	as-tron-o-mer
trans-mo-gri-fy	trans-mog-ri-fy
iso-la-tion-is-m	i-so-la-tion-ism
out-cal-l	out-call
medi-ocrity	me-di-oc-ri-ty
pre-his-toric	pre-his-tor-ic
in-for-m	in-form
e-quer-ry	eq-uer-ry
brazen	bra-zen
shifty	shift-y
cretinous	cre-tin-ous
sym-bio-sis	sym-bi-o-sis
quo-tien-t	quo-tient
primeval	pri-me-val
tri-bunal	tri-bu-nal
beery	beer-y
g-nom-ic	gno-mic
ex-cite-men-t	ex-cite-ment
nurs-ery	nurs-er-y
in-tra-venous-ly	in-tra-ve-nous-ly
ashen	ash-en
speechi-fy-ing	speechifying
galling	gall-ing
lu-natic	lu-na-tic
liar	li-ar
cordiller-a	cor-dil-le-ra
s-mooch	smooch
gun-nery	gun-ner-y
s-liv-er	sliv-er
athe-ist	a-the-ist
for-mal-is-m	for-mal-ism
d-if-fi-den-t	dif-fi-dent
whoso-ev-er	who-so-ev-er
mer-ce-nary	mer-ce-nar-y
solemn-ly	sol-emn-ly
om-nipres-ence	om-ni-pres-ence
repa-tri-ate	re-pa-tri-ate
subto-tal	sub-to-tal
li-bidi-nous	li-bid-i-nous
firear-m	fire-arm
erased	e-rased
porno	por-no
im-po-ten-t	im-po-tent
p-reser-va-tion	pres-er-va-tion
whar-f	wharf
hab-it-able	hab-it-a-ble
chili	chil-i
trac-t	tract
reti-nal	ret-i-nal
trans-portable	trans-port-a-ble
cade-t	ca-det
non-vi-o-len-t	non-vi-o-lent
crony	cro-ny
defama-tion	def-a-ma-tion
fron-t	front
rescale	re-scale
an-tic-s	an-tics
re-align-men-t	re-a-lign-ment
en-fran-chise-men-t	en-fran-chise-ment
cy-tochrome	cy-to-chrome
downy	down-y
s-tand-ing	stand-ing
igua-na	i-gua-na
physi-cist	phys-i-cist
vizier	vi-zier
tiling	til-ing
in-n	inn
s-tokes	stokes
polit-buro	po-lit-bu-ro
quirky	quirk-y
s-cat-ter-ing	scat-ter-ing
de-ni-able	de-ni-a-ble
boxy	box-y
mo-tocross	mo-to-cross
felo-nious	fe-lo-ni-ous
ap-proval	ap-prov-al
temptress	tempt-ress
twister	twist-er
hy-drome-chan-ic-s	hy-dro-me-chan-ics
moth-er-stobe	mo-ther-stobe
dance-able	dance-a-ble
s-tac-ca-to	stac-ca-to
diplo-mat	dip-lo-mat
un-healthy	un-health-y
rosary	ro-sa-ry
tetrox-ide	te-trox-ide
can-taloupe	can-ta-loupe
k-er-chief	ker-chief
doorstop	door-stop
mar-riage-able	mar-riage-a-ble
madam	mad-am
length-en-ing	lengthening
sup-plan-t	sup-plant
cour-tesy	cour-te-sy
pupil	pu-pil
clever	clev-er
ob-struc-tion-is-m	ob-struc-tion-ism
sur-moun-t	sur-mount
rein-sert	re-in-sert
over-whelm-ing	o-ver-whelm-ing
exe-un-t	ex-e-unt
stin-t	stint
in-con-testable	in-con-test-a-ble
s-lur-ry	slur-ry
de-canter	de-cant-er
pedi-gree	ped-i-gree
taxi-dermy	tax-i-der-my
t-elecom-mu-ni-ca-tion	tel-e-com-mu-ni-ca-tion
en-dear-men-t	en-dear-ment
im-pinge-men-t	im-pinge-ment
nice-ty	ni-ce-ty
copy-cat	cop-y-cat
over-pay	o-ver-pay
i-n-ad-e-quate-ly	in-ad-e-quate-ly
san-i-tary	san-i-tar-y
karakul	kar-a-kul
cre-ation	cre-a-tion
laud-ed	lauded
hoary	hoar-y
meaty	meat-y
penum-bra	pe-num-bra
an-t	ant
tarsal	tar-sal
apol-o-gize	a-pol-o-gize
enig-mat-ic	en-ig-mat-ic
re-al-ness	real-ness
makeover	make-o-ver
s-played	splayed
omi-nous-ly	om-i-nous-ly
lacrosse	la-crosse
dodgy	dodg-y
cope-d	coped
gloat-ing	gloating
odome-ter	o-dom-e-ter
con-ven-t	con-vent
bio-di-ver-si-ty	bi-o-di-ver-si-ty
cater	ca-ter
mea-sur-able	meas-ur-a-ble
repli-cate	rep-li-cate
friendlily	friend-li-ly
un-set-tling	unsettling
in-tractable	in-trac-ta-ble
record-ed	re-cor-ded
leg-isla-tive	leg-is-la-tive
over-re-ac-tion	o-ver-re-ac-tion
ur-ticari-a	ur-ti-car-i-a
asyn-chro-nous	a-syn-chro-nous
mayflow-er	may-flow-er
ex-plana-to-ry	ex-plan-a-to-ry
quater-nion	qua-ter-ni-on
b-lis-ter	blis-ter
anoin-t	a-noint
s-po-rad-i-cal-ly	spo-rad-i-cal-ly
elec-tron-ic-s	e-lec-tron-ics
dal-liance	dal-li-ance
ruler	rul-er
s-tate-ly	state-ly
even-tu-al-i-ty	e-ven-tu-al-i-ty
for-man-t	for-mant
waxy	wax-y
quan-tifi-ca-tion	quan-ti-fi-ca-tion
in-fec-t	in-fect
lin-i-men-t	lin-i-ment
pho-to-volta-ic	pho-to-vol-ta-ic
ha-cien-da	ha-ci-en-da
s-plat-ter	splat-ter
ro-man-ti-cis-m	ro-man-ti-cism
s-tu-dious	stu-di-ous
taboo	ta-boo
s-nowy	snow-y
screwy	screw-y
s-lan-der	slan-der
mul-ti-plica-tive	mul-ti-pli-ca-tive
click-ing	clicking
deathbed	death-bed
phrasal	phras-al
politic	pol-i-tic
aback	a-back
evo-lute	ev-o-lute
overeat	o-ver-eat
repar-tee	rep-ar-tee
as-sis-tan-t	as-sis-tant
vestal	ves-tal
in-deli-bly	in-del-i-bly
i-n-escapably	in-es-cap-a-bly
mer-cury	mer-cu-ry
min-uet	min-u-et
u-nim-pres-sive	un-im-pres-sive
calder-a	cal-de-ra
in-deli-ble	in-del-i-ble
di-ar-rhea	di-ar-rhe-a
over-come	o-ver-come
risky	risk-y
e-t-y-mo-log-i-cal	et-y-mo-log-i-cal
s-cary	scar-y
causal	caus-al
s-can	scan
binoc-u-lar	bin-oc-u-lar
wiry	wir-y
pi-tu-itary	pi-tu-i-tar-y
moi-ety	moi-e-ty
pyra-mid	pyr-a-mid
breast-feed	breastfeed
s-tranger	stran-ger
syl-labary	syl-la-bar-y
y-oung	young
dia-lec-tic	di-a-lec-tic
holis-tic	ho-lis-tic
anoma-lous	a-nom-a-lous
teenaged	teen-aged
up-fron-t	up-front
pastis	pas-tis
facile	fac-ile
un-en-durable	un-en-dur-a-ble
vine-gar	vin-e-gar
erode	e-rode
pes-simist	pes-si-mist
e-u-pho-ri-a	eu-pho-ri-a
sec-ondary	sec-ond-ar-y
con-struc-t	con-struct
dis-re-spec-t	dis-re-spect
d-if-fu-siv-i-ty	dif-fu-siv-i-ty
sibyl	sib-yl
lech-ery	lech-er-y
rel-e-van-t	rel-e-vant
un-linked	unlinked
ra-dio	ra-di-o
sibi-lan-t	sib-i-lant
s-cup-per	scup-per
b-lessed	bless-ed
sur-fac-tan-t	sur-fac-tant
plan-e-tary	plan-e-tar-y
op-tic-s	op-tics
briefer	brief-er
babysit	ba-by-sit
rachis	ra-chis
in-sol-ven-t	in-sol-vent
im-peri-um	im-pe-ri-um
un-playable	un-play-a-ble
mono-plane	mon-o-plane
lot-tery	lot-ter-y
s-teel-work-s	steel-works
ivory	i-vo-ry
scruffy	scruff-y
eat-able	eat-a-ble
copla-nar	co-pla-nar
laud-able	laud-a-ble
re-volver	re-volv-er
rapid	rap-id
s-woop	swoop
cus-tom-ary	cus-tom-ar-y
elec-tron-i-cal-ly	e-lec-tron-i-cal-ly
hosepipe	hose-pipe
marcher	march-er
elec-tri-fy	e-lec-tri-fy
mono-graph-ic	mon-o-graph-ic
mis-treat-men-t	mis-treat-ment
cretin	cre-tin
k-in-folk	kin-folk
data-base	da-ta-base
shrim-p	shrimp
pres-bytery	pres-by-ter-y
un-easy	un-eas-y
in-de-fin-able	in-de-fin-a-ble
en-fee-bled	enfeebled
poly-thene	pol-y-thene
bac-te-rio-phage	bac-te-ri-o-phage
en-tan-gle-men-t	en-tan-gle-ment
em-piri-cist	em-pir-i-cist
showy	show-y
loathing	loath-ing
hy-gien-e	hy-giene
capri-ole	cap-ri-ole
philo-soph-i-cal	phil-o-soph-i-cal
polyurethane	pol-y-u-re-thane
plover	plov-er
busy	bus-y
clien-t	cli-ent
guille-mot	guil-le-mot
zigza-g	zig-zag
quiet-ness	qui-et-ness
omen	o-men
vi-o-len-t	vi-o-lent
con-stan-t	con-stant
sulky	sulk-y
clam-p	clamp
limou-sine	lim-ou-sine
u-nas-so-ci-at-ed	un-as-so-ci-at-ed
stealthy	stealth-y
drowsy	drow-sy
out-stretched	outstretched
rap-proche-men-t	rap-proche-ment
lithi-um	lith-i-um
em-bolis-m	em-bo-lism
tri-bune	trib-une
teapot	tea-pot
pass-able	pass-a-ble
ma-jorette	ma-jor-ette
gillie	gil-lie
con-struc-tivis-m	con-struc-tiv-ism
pre-cau-tion-ary	pre-cau-tion-ar-y
tan-nery	tan-ner-y
re-doubtable	re-doubt-a-ble
un-premed-i-tat-ed	un-pre-med-i-tat-ed
s-tar-dom	star-dom
sub-con-trac-t	sub-con-tract
s-trait	strait
thral-l	thrall
re-newed	renewed
heron-ry	her-on-ry
s-tench	stench
mul-ti-cul-tur-al-is-m	mul-ti-cul-tur-al-ism
in-vesti-ture	in-ves-ti-ture
prod-uc-t	prod-uct
elec-tro-mag-net-ic	e-lec-tro-mag-net-ic
om-nipo-ten-t	om-nip-o-tent
archdea-con	arch-dea-con
astride	a-stride
s-tar-lit	star-lit
aver-sion	a-ver-sion
in-ter-change-ably	in-ter-change-a-bly
artistry	art-ist-ry
naval	na-val
baldy	bald-y
koala	ko-a-la
iso-ton-ic	i-so-ton-ic
s-tain	stain
holo-graph-ic	hol-o-graph-ic
un-gentle-man-ly	un-gen-tle-man-ly
e-c-u-menis-m	ec-u-me-nism
duck-bil-l	duck-bill
aright	a-right
quasar	qua-sar
mal-leable	mal-le-a-ble
per-sis-tent-ly	per-sist-ent-ly
undis-cov-ered	un-dis-cov-ered
bearskin	bear-skin
per-fumery	per-fum-er-y
habi-ta-tion	hab-i-ta-tion
spec-tropho-tome-ter	spec-tro-pho-tom-e-ter
s-car-i-ly	scar-i-ly
nomen-cla-ture	no-men-cla-ture
e-u-phoric	eu-phor-ic
i-n-un-date	in-un-date
per-for-m	per-form
mi-cro-cos-m	mi-cro-cosm
hye-na	hy-e-na
chancy	chanc-y
s-tate-men-t	state-ment
bowsprit	bow-sprit
cam-panile	cam-pa-ni-le
plat-inum	plat-i-num
ri-ot-ing	ri-o-ting
wind-mil-l	wind-mill
im-pro-vi-sa-tion	im-prov-i-sa-tion
grainy	grain-y
aquat-ic	a-quat-ic
rel-a-tivis-tic	rel-a-tiv-is-tic
re-liv-e	re-live
undis-cern-ing	un-dis-cern-ing
s-teer-age	steer-age
pig-ment-ed	pig-men-ted
weedy	weed-y
tyran-t	ty-rant
tran-scrip-t	tran-script
banker	bank-er
over-sam-pling	o-ver-sam-pling
im-pris-on-men-t	im-pris-on-ment
as-tro-physic-s	as-tro-phys-ics
om-nipresen-t	om-ni-pres-ent
chromite	chro-mite
bul-letin	bul-le-tin
rack-e-teer-ing	rack-et-eer-ing
un-learned	un-learn-ed
wrap-around	wrap-a-round
erup-t	e-rupt
con-cor-dance	con-cord-ance
emet-ic	e-met-ic
re-ac-tionary	re-ac-tion-ar-y
s-ta-tionery	sta-tion-er-y
makeweight	make-weight
di-uret-ic	di-u-ret-ic
laser	la-ser
regress	re-gress
sand-piper	sand-pi-per
tam-bourine	tam-bou-rine
over-turn	o-ver-turn
yippee	yip-pee
dil-l	dill
impi-ety	im-pi-e-ty
arabesque	ar-a-besque
over-fil-l	o-ver-fill
hero-in	her-o-in
pun-ish-men-t	pun-ish-ment
anony-mous	a-non-y-mous
in-com-bustible	in-com-bus-ti-ble
in-ter-plan-e-tary	in-ter-plan-e-tar-y
ir-rev-er-en-t	ir-rev-er-ent
s-tol-id	stol-id
over-weight	o-ver-weight
nephri-tis	ne-phri-tis
ver-dan-t	ver-dant
elec-trol-y-sis	e-lec-trol-y-sis
rigid-i-fy	ri-gid-i-fy
toupee	tou-pee
schema	sche-ma
s-teeple-chase	stee-ple-chase
schemat-ic	sche-mat-ic
dila-tor	di-la-tor
ac-t	act
u-nim-por-tance	un-im-por-tance
whiskey	whis-key
dum-b	dumb
vol-ley-bal-l	vol-ley-ball
de-for-mi-ty	de-form-i-ty
d-is-fig-ure	dis-fig-ure
dark-ened	dar-kened
her-s	hers
tur-bu-len-t	tur-bu-lent
cobalt	co-balt
dis-moun-t	dis-mount
my-ocar-dial	my-o-car-di-al
ef-flu-en-t	ef-flu-ent
burn-t	burnt
weed-s	weeds
in-abil-i-ty	in-a-bil-i-ty
neu-ro-surgery	neu-ro-sur-ger-y
se-questered	se-ques-tered
s-nob-bish	snob-bish
covert-ly	cov-ert-ly
delete	de-lete
con-tigu-ous	con-tig-u-ous
cheer-ing	cheering
valiant-ly	val-iant-ly
s-lush	slush
re-strain-ing	restraining
zephyr	zeph-yr
dopey	dope-y
staphy-lo-coc-cus	staph-y-lo-coc-cus
pal-lia-tive	pal-li-a-tive
n-in-com-poop	nin-com-poop
re-li-ably	re-li-a-bly
residu-um	re-sid-u-um
recharge-able	re-charge-a-ble
rev-e-la-to-ry	re-vel-a-to-ry
residue	res-i-due
de-cryp-t	de-crypt
con-cep-t	con-cept
pro-pri-etary	pro-pri-e-tar-y
base-men-t	base-ment
valu-able	val-u-a-ble
un-em-ploy-men-t	un-em-ploy-ment
tuxe-do	tux-e-do
trol-l	troll
volatile	vol-a-tile
un-quench-able	un-quench-a-ble
peas-antry	peas-ant-ry
share-able	share-a-ble
bar-bar-ian	bar-bar-i-an
ar-ran-t	ar-rant
ex-porter	ex-port-er
pover-ty	pov-er-ty
flota-tion	flo-ta-tion
s-trato-spher-ic	strat-o-spher-ic
con-tretemp-s	con-tre-temps
wan-t	want
fuz-z	fuzz
even-song	e-ven-song
clair-voy-an-t	clair-voy-ant
par-tici-ple	par-ti-ci-ple
in-equity	in-eq-ui-ty
temp-t	tempt
bond-ing	bonding
para-mount	par-a-mount
ridicu-lous-ness	ri-dic-u-lous-ness
cabaret	cab-a-ret
s-cud	scud
c-ity	cit-y
vir-u-len-t	vir-u-lent
per-mafrost	per-ma-frost
s-ti-fle	sti-fle
s-pam	spam
s-lot	slot
bet-ter-men-t	bet-ter-ment
out-landish	out-land-ish
fil-a-men-t	fil-a-ment
d-ab-ble	dab-ble
de-co	dec-o
thau-maturge	thau-ma-turge
mar-quetry	mar-que-try
trans-porter	trans-port-er
un-fash-ion-able	un-fash-ion-a-ble
salmon	salm-on
tho-raci-c	tho-rac-ic
post-mod-ernism	post-mod-ern-ism
irony	i-ro-ny
spunky	spunk-y
s-tan-za	stan-za
de-scen-den-t	de-scend-ent
io-ta	i-o-ta
canon-ic	ca-non-ic
d-u-al-is-m	du-al-ism
in-ter-locu-to-ry	in-ter-loc-u-to-ry
ec-topic	ec-top-ic
tat-ter-s	tat-ters
s-nig-ger	snig-ger
vol-canic	vol-can-ic
dol-drum-s	dol-drums
blitzkrieg	blitz-krieg
li-bido	li-bi-do
linen	lin-en
fal-ter-ing	fal-te-ring
civic-s	civ-ics
as-pirin	as-pi-rin
scrupu-lous	scru-pu-lous
as-besto-sis	as-bes-to-sis
com-bat-an-t	com-bat-ant
u-nashamed	un-a-shamed
para-nor-mal	par-a-nor-mal
g-naw-ing	gnaw-ing
groat-s	groats
gov-er-nance	gov-ern-ance
debonair	deb-o-nair
imag-i-na-tive	im-ag-i-na-tive
ide-o-log-i-cal	i-de-o-log-i-cal
nympho-ma-ni-ac	nym-pho-ma-ni-ac
demo-crat-i-cal-ly	dem-o-crat-i-cal-ly
ge-nom-ic	ge-no-mic
s-pace-man	space-man
propul-sive	pro-pul-sive
de-odor-an-t	de-o-dor-ant
hu-mankind	hu-man-kind
chrysalis	chrys-a-lis
undi-min-ished	un-di-min-ished
redac-tion	re-dac-tion
sounder	sound-er
unin-spired	un-in-spired
glam-orous	glam-or-ous
im-preg-nable	im-preg-na-ble
rap-t	rapt
mid-dleweight	mid-dle-weight
mini-cab	min-i-cab
sinew	sin-ew
s-cuf-f	scuff
s-tim-u-la-tion	stim-u-la-tion
transna-tion-al	trans-na-tion-al
medal	med-al
renter	rent-er
or-ga-nized	or-gan-ized
syrup	syr-up
dereg-u-late	de-reg-u-late
ready	read-y
crypt-anal-y-sis	crypt-a-nal-y-sis
de-po-si-tion	dep-o-si-tion
layabout	lay-a-bout
s-ing	sing
duress	du-ress
mag-ne-sium	mag-ne-si-um
tardy	tar-dy
api-an	a-pi-an
re-ac-tan-t	re-ac-tant
undis-tribut-ed	un-dis-trib-ut-ed
pon-tif-f	pon-tiff
stilet-to	sti-let-to
s-nide	snide
tidy	ti-dy
un-electable	un-e-lect-a-ble
an-throp-ic	an-thro-pic
ex-citable	ex-cit-a-ble
tetra-he-dron	tet-ra-he-dron
visa	vi-sa
evince	e-vince
b-e-fit	be-fit
loutish	lout-ish
grand-par-en-t	grand-par-ent
ar-c	arc
grotesque-ly	gro-tesque-ly
s-lim	slim
lisp-ing	lis-ping
feal-ty	fe-al-ty
swingy	swing-y
velum	ve-lum
dis-pen-sary	dis-pen-sa-ry
over-ca-pac-i-ty	o-ver-ca-pac-i-ty
husky	hus-ky
dis-senter	dis-sent-er
un-emo-tion-al	un-e-mo-tion-al
tu-mul-tuous	tu-mul-tu-ous
s-tran-gle-hold	stran-gle-hold
butch-ery	butch-er-y
lethar-gy	leth-ar-gy
mono-chrome	mon-o-chrome
naked-ness	na-ked-ness
n-ear	near
lamen-t	la-ment
cur-tained	curtained
con-certi-na	con-cer-ti-na
mu-tan-t	mu-tant
lin-eage	lin-e-age
elec-t	e-lect
away	a-way
u-n-ap-pre-ci-at-ed	un-ap-pre-ci-at-ed
over-ly-ing	o-ver-ly-ing
paramour	par-a-mour
over-in-flat-ed	o-ver-in-flat-ed
haver-sack	hav-er-sack
di-gestible	di-gest-i-ble
recordis-t	re-cord-ist
lazuli	laz-u-li
u-nion-i-sa-tion	un-ion-i-sa-tion
pim-p	pimp
hy-dropho-bic	hy-dro-pho-bic
pec-toral	pec-to-ral
test-ing	testing
re-frac-t	re-fract
in-sulin	in-su-lin
ex-pend-able	ex-pend-a-ble
ex-ten-t	ex-tent
ca-cao	ca-ca-o
labi-al	la-bi-al
oven	ov-en
aro-ma	a-ro-ma
s-lide	slide
s-parse-ly	sparse-ly
par-don-able	par-don-a-ble
toi-letries	toi-let-ries
rheo-stat	rhe-o-stat
s-tu-dio	stu-di-o
out-fal-l	out-fall
ther-mo-elec-tric	ther-mo-e-lec-tric
phys-io-ther-a-py	phys-i-o-ther-a-py
para-mil-i-tary	par-a-mil-i-tar-y
re-freshed	refreshed
cos-set-ed	cosseted
se-quoia	se-quoi-a
n-ear-by	near-by
cloa-ca	clo-a-ca
spon-sored	sponsored
pointy	point-y
body-work	bod-y-work
cov-etous	cov-et-ous
ap-point-men-t	ap-point-ment
tem-per-a-men-t	tem-per-a-ment
har-m	harm
wit-ti-cis-m	wit-ti-cism
trapeze	tra-peze
holdal-l	hold-all
sec-re-tar-iat	sec-re-tar-i-at
s-pleen	spleen
copy	cop-y
dis-in-fec-tan-t	dis-in-fect-ant
war-rior	war-ri-or
grid-ded	gridded
ob-scu-ran-tist	ob-scu-rant-ist
warpaint	war-paint
gramo-phone	gram-o-phone
precipice	prec-i-pice
nut-shel-l	nut-shell
s-nob	snob
ure-thra	u-re-thra
lan-der	land-er
scratchy	scratch-y
kine-mat-ic-s	kin-e-mat-ics
peep-s	peeps
k-ing	king
ca-ress-ing	ca-res-sing
e-s-pousal	es-pous-al
ide-al-ly	i-de-al-ly
s-nip-pet	snip-pet
em-ploy-able	em-ploy-a-ble
sed-i-men-t	sed-i-ment
menar-che	men-ar-che
soupy	soup-y
biorhyth-m	bi-o-rhythm
resti-tu-tion	res-ti-tu-tion
squalor	squal-or
s-cour	scour
flus-tered	flustered
chewy	chew-y
his-tamine	his-ta-mine
scholas-ti-cis-m	scho-las-ti-cism
de-po-nen-t	de-po-nent
over-state-men-t	o-ver-state-ment
re-ori-en-ta-tion	re-o-ri-en-ta-tion
fre-quent-ed	frequented
valid-ly	val-id-ly
de-featist	de-feat-ist
duo	du-o
cologne	co-logne
book-wor-m	book-worm
sadis-tic	sa-dis-tic
grapevine	grape-vine
u-n-ad-ven-tur-ous	un-ad-ven-tur-ous
salu-ta-tion	sal-u-ta-tion
caliper	cal-i-per
y-achts-man	yachts-man
hered-i-ty	he-red-i-ty
seedbed	seed-bed
s-plut-ter	splut-ter
cordite	cord-ite
l-itur-gi-cal	li-tur-gi-cal
re-com-bi-nan-t	re-com-bi-nant
backpedal	back-ped-al
polo-ni-um	po-lo-ni-um
s-lip	slip
bindweed	bind-weed
an-swer-able	an-swer-a-ble
bene-fac-tress	ben-e-fac-tress
poly-crys-talline	pol-y-crys-tal-line
s-park	spark
bil-l	bill
un-vary-ing	un-var-y-ing
draught-s	draughts
un-nec-es-sary	un-nec-es-sar-y
mus-cle-d	mus-cled
un-equiv-o-cal	un-e-quiv-o-cal
s-now-drop	snow-drop
chem-istry	chem-is-try
manor	man-or
geron-toc-ra-cy	ger-on-toc-ra-cy
par-a-bola	pa-rab-o-la
vol-can-is-m	vol-can-ism
pick-pock-et-ing	pickpocketing
reper-toire	rep-er-toire
crispy	crisp-y
e-mery	em-er-y
ethos	e-thos
dis-cred-itable	dis-cred-it-a-ble
in-el-e-gan-t	in-el-e-gant
ex-cel-sior	ex-cel-si-or
s-pan	span
ex-huma-tion	ex-hu-ma-tion
nurs-ery-men	nurs-er-y-men
arid	ar-id
li-censee	li-cen-see
de-bat-able	de-bat-a-ble
retro	ret-ro
spooky	spook-y
foxy	fox-y
s-link	slink
wicked	wick-ed
con-sti-tu-tion-al-is-m	con-sti-tu-tion-al-ism
s-tar-board	star-board
o-culist	oc-u-list
stipend	sti-pend
jester	jest-er
zenith	ze-nith
ep-ithe-lial	ep-i-the-li-al
qua-drat-ic	quad-rat-ic
podgy	podg-y
ap-t	apt
trans-paren-cy	trans-par-en-cy
re-len-t	re-lent
fi-brob-last	fi-bro-blast
phi-lan-thropist	phi-lan-thro-pist
mimet-ic	mi-met-ic
k-ilo-ton	kil-o-ton
stinger	sting-er
gable	ga-ble
gob-bledy-gook	gob-ble-dy-gook
cheesy	chees-y
ir-rel-e-van-t	ir-rel-e-vant
s-tami-na	stam-i-na
ron-dav-el	ron-da-vel
elo-quen-t	el-o-quent
drol-l	droll
taxi-cab	tax-i-cab
tele-gram	tel-e-gram
domi-cile	dom-i-cile
mi-cro-elec-tron-ic-s	mi-cro-e-lec-tron-ics
s-cope	scope
s-plin-ter	splin-ter
propen-si-ty	pro-pen-si-ty
over-print	o-ver-print
armpit	arm-pit
opi-um	o-pi-um
tremen-dous	tre-men-dous
potash	pot-ash
serendip-i-ty	ser-en-dip-i-ty
bi-l-abi-al	bi-la-bi-al
darter	dart-er
ap-pendage	ap-pend-age
reprisal	re-pris-al
short-fal-l	short-fall
rea-son-able	rea-son-a-ble
cameo	cam-e-o
over-flow-ing	o-ver-flo-wing
pushy	push-y
s-e-lec-t	se-lect
canyon	can-yon
saucy	sau-cy
cap-i-tal-is-m	cap-i-tal-ism
serendip-i-tous	ser-en-dip-i-tous
con-sul-tan-t	con-sult-ant
con-sumeris-m	con-sum-er-ism
s-caf-fold-ing	scaf-fold-ing
s-ab-bath	sab-bath
welly	wel-ly
tomboy	tom-boy
s-low-poke	slow-poke
e-u-phemis-m	eu-phe-mism
para-keet	par-a-keet
e-s-prit	es-prit
com-men-tary	com-men-tar-y
man-i-cured	ma-ni-cured
forgery	for-ger-y
di-ary	di-a-ry
im-pu-den-t	im-pu-dent
stuff-in-g	stuff-ing
ra-tio-nal	ra-tion-al
trouper	troup-er
sus-tain-able	sus-tain-a-ble
de-fines	def-ines
per-tur-b	per-turb
blun-der-ing	blundering
pletho-ra	pleth-o-ra
conifer	co-ni-fer
rain-fal-l	rain-fall
ra-dia-tive	ra-di-a-tive
here-about-s	here-a-bouts
im-porter	im-port-er
tapi-o-ca	tap-i-o-ca
mar-ke-teer	mar-ket-eer
re-peat-able	re-peat-a-ble
para-noia	par-a-noi-a
inkling	ink-ling
so-lace	sol-ace
pro-le-tari-at	pro-le-tar-i-at
emul-sion	e-mul-sion
seda-tive	sed-a-tive
s-not-ty	snot-ty
re-cruiter	re-cruit-er
ju-di-cia-ry	ju-di-ci-ar-y
s-cout-ing	scout-ing
s-ten-tor	sten-tor
elec-troneg-a-tive	e-lec-tro-neg-a-tive
tain-t	taint
burn-ings	bur-nings
freck-led	freckled
celiba-cy	cel-i-ba-cy
dis-con-nec-t	dis-con-nect
prankster	prank-ster
re-portage	re-port-age
per-hap-s	per-haps
iron-work	i-ron-work
com-fort-ably	com-fort-a-bly
forcible	for-ci-ble
teenag-er	teen-ag-er
beryl	ber-yl
abaft	a-baft
ovum	o-vum
mo-lester	mo-lest-er
s-cant-y	scant-y
e-m-a-na-tion	em-a-na-tion
gun-metal	gun-met-al
ef-fer-en-t	ef-fer-ent
inkwell	ink-well
whim-per-ing	whimpering
p-salter	psal-ter
un-al-ter-able	un-al-ter-a-ble
sado-masochis-tic	sa-do-mas-o-chis-tic
s-tock-y	stock-y
cochlea	coch-le-a
over-crowd	o-ver-crowd
per-pe-tu-ity	per-pe-tu-i-ty
in-fras-truc-tural	in-fra-struc-tur-al
apery	ap-er-y
in-cip-i-en-t	in-cip-i-ent
mon-e-taris-m	mon-e-ta-rism
para-pet	par-a-pet
din-t	dint
ephemeris	e-phem-er-is
bather	bath-er
morsel	mor-sel
thievish	thiev-ish
rata-touille	ra-ta-touille
musty	mus-ty
marathon	mar-a-thon
un-suit-able	un-suit-a-ble
over-ful-l	o-ver-full
rover	rov-er
stag-ger-s	stag-gers
cham-p	champ
platelet	plate-let
de-mo-li-tion	dem-o-li-tion
newsagen-t	news-a-gent
prodi-gious	pro-di-gious
col-lec-tivi-sa-tion	col-lec-ti-vi-sa-tion
hideous-ly	hid-e-ous-ly
re-f	ref
un-lac-ing	un-lacing
pen-nan-t	pen-nant
owlish	owl-ish
clank-ing	clan-king
com-fort-able	com-fort-a-ble
un-der-study	un-der-stud-y
y-our	your
con-flu-en-t	con-flu-ent
fussy	fuss-y
tran-scen-dence	tran-scend-ence
harshen	harsh-en
leak-ing	leaking
condi-men-t	con-di-ment
above	a-bove
toughie	tough-ie
s-tand-point	stand-point
out-lawed	outlawed
dusky	dusk-y
hy-dro-stat-ic-s	hy-dro-stat-ics
pre-cep-t	pre-cept
rein-car-nate	re-in-car-nate
voyeuris-tic	voy-eur-is-tic
s-low-down	slow-down
cognoscen-ti	co-gno-scen-ti
sali-vary	sal-i-var-y
res-i-den-t	res-i-dent
machis-mo	ma-chis-mo
skintight	skin-tight
s-nif-fle	snif-fle
s-culp-tor	sculp-tor
pe-riphrastic	per-i-phras-tic
loess	lo-ess
s-tork	stork
ec-to-plas-m	ec-to-plasm
mono-syl-lab-ic	mon-o-syl-lab-ic
rigid-i-ty	ri-gid-i-ty
skul-l	skull
devo-tee	dev-o-tee
trans-for-ma-tive	trans-form-a-tive
con-gealed	congealed
brief-s	briefs
read-mis-sion	re-ad-mis-sion
cy-to-plas-m	cy-to-plasm
el-l	ell
brack-et-ed	bracketed
re-in-force-men-t	re-in-force-ment
ledger	ledg-er
con-stituen-t	con-stit-u-ent
trireme	tri-reme
palmist	palm-ist
pe-ri-as-tron	per-i-as-tron
in-ter-molec-u-lar	in-ter-mo-lec-u-lar
foghorn	fog-horn
forester	for-est-er
trea-sure	treas-ure
respite	res-pite
re-sen-t	re-sent
im-munol-o-gy	im-mu-nol-o-gy
plu-per-fec-t	plu-per-fect
e-spres-so	es-pres-so
daun-t	daunt
au-thor-i-tar-i-an-is-m	au-thor-i-tar-i-an-ism
bur-nished	burnished
dilem-ma	di-lem-ma
whirlpool	whirl-pool
domi-cil-iary	dom-i-cil-i-ar-y
washy	wash-y
tanker	tank-er
empti-ness	emp-ti-ness
or-tho-doxy	or-tho-dox-y
s-teed	steed
o-r-a-cle	or-a-cle
con-fronta-tion-al	con-fron-ta-tion-al
silen-t	si-lent
scrip-t	script
chore-a	cho-re-a
pullover	pull-o-ver
im-petu-ous	im-pet-u-ous
hul-la-baloo	hul-la-ba-loo
grouchy	grouch-y
autarchy	au-tar-chy
qui-es-cen-t	qui-es-cent
episode	ep-i-sode
dishy	dish-y
oafish	oaf-ish
playfel-low	play-fel-low
in-ge-nious-ly	in-gen-ious-ly
para-sol	par-a-sol
chevron	chev-ron
dis-penser	dis-pens-er
around	a-round
hypocrisy	hy-poc-ri-sy
the-atri-cal-s	the-at-ri-cals
re-formist	re-form-ist
awak-en-ing	a-wak-en-ing
lam-plit	lamp-lit
w-hole	whole
blotchy	blotch-y
car-cino-gen	car-cin-o-gen
cul-l	cull
ge-net-ic-s	ge-net-ics
u-nas-sist-ed	un-as-sist-ed
de-signed-ly	de-sign-ed-ly
more-over	more-o-ver
per-mit-ting	permitting
coitus	co-i-tus
pasty	past-y
archer	arch-er
even-tu-al	e-ven-tu-al
op-ti-mis-m	op-ti-mism
un-palat-able	un-pal-at-a-ble
un-break-able	un-break-a-ble
fron-tispiece	fron-tis-piece
foot-bal-l	foot-ball
mul-l	mull
dis-uni-ty	dis-u-ni-ty
e-lo-cu-tion	el-o-cu-tion
flam-boy-an-t	flam-boy-ant
recom-mence	re-com-mence
crum-by	crumb-y
prospec-tive-ly	prospectively
hy-dro-elec-tric	hy-dro-e-lec-tric
recre-ation-al	rec-re-a-tion-al
un-jus-ti-fi-able	un-jus-ti-fi-a-ble
e-q-ui-table	eq-ui-ta-ble
chaffinch	chaf-finch
s-tand-stil-l	stand-still
liv-ery	liv-er-y
s-neer-ing	sneering
hyp-nother-a-py	hyp-no-ther-a-py
un-re-peat-able	un-re-peat-a-ble
naughty	naugh-ty
un-invit-ing	un-in-vit-ing
even-tu-al-ly	e-ven-tu-al-ly
pedan-tic	pe-dan-tic
beaker	beak-er
tableau	tab-leau
u-n-at-tached	un-at-tached
con-tour-ing	con-touring
grit-s	grits
lava-to-ry	lav-a-to-ry
aubergine	au-ber-gine
s-trand-ed	strand-ed
s-toep	stoep
mono-ma-ni-a	mon-o-ma-ni-a
sahib	sa-hib
pecan	pe-can
p-saltery	psal-ter-y
hon-orary	hon-or-ar-y
an-nounce-men-t	an-nounce-ment
painter	paint-er
pold-er	pol-der
pos-i-tivist	pos-i-tiv-ist
hand-picked	handpicked
sub-mersible	sub-mers-i-ble
do-lor-ous	dol-or-ous
b-land-ness	bland-ness
repos-i-to-ry	re-pos-i-to-ry
un-bear-able	un-bear-a-ble
chirpy	chirp-y
dispir-it-ed	dis-pir-it-ed
oblo-quy	ob-lo-quy
op-er-a-tional-ly	op-er-a-tion-al-ly
bluish	blu-ish
teleprint-er	tel-e-print-er
ge-nial-i-ty	ge-ni-al-i-ty
fire-bal-l	fire-ball
felon	fel-on
a-tol-l	at-oll
paci-fis-m	pac-i-fism
u-n-ac-cus-tomed	un-ac-cus-tomed
ex-plo-ration	ex-plo-ra-tion
ini-ti-ate	in-i-ti-ate
cathe-dral	ca-the-dral
mon-o-clon-al	mon-o-clo-nal
dishar-mo-ny	dis-har-mo-ny
canon-i-cal	ca-non-i-cal
over-al-l	o-ver-all
newsprint	news-print
rudi-men-ta-ry	ru-di-men-ta-ry
in-dif-fer-en-t	in-dif-fer-ent
alarm-ing	a-larm-ing
in-de-cen-t	in-de-cent
con-join-t	con-joint
rhyth-m	rhythm
pas-toral	pas-to-ral
quadru-ply	quad-ru-ply
miser	mi-ser
lauda-to-ry	laud-a-to-ry
rusty	rust-y
adop-t	a-dopt
s-pas-mod-ic	spas-mod-ic
as-segai	as-se-gai
showjumper-s	show-jum-pers
reim-ple-ment-ed	reimplemented
bio-med-i-cal	bi-o-med-i-cal
metro	met-ro
im-por-tan-t	im-por-tant
cre-ativ-i-ty	cre-a-tiv-i-ty
respire	re-spire
saucer	sau-cer
callable	call-a-ble
an-niver-sary	an-ni-ver-sa-ry
bereft	be-reft
domi-no	dom-i-no
debone	de-bone
in-di-can-t	in-di-cant
en-dother-mic	en-do-ther-mic
s-tom-a	sto-ma
isother-mal	i-so-ther-mal
in-vol-un-tary	in-vol-un-tar-y
minia-ture	min-i-a-ture
out-sel-l	out-sell
shiny	shin-y
con-stric-t	con-strict
im-memo-ri-al	im-me-mo-ri-al
in-dus-tri-al-is-m	in-dus-tri-al-ism
id-io-cy	id-i-o-cy
mono	mon-o
high-lander	high-lan-der
op-por-tunis-tic	op-por-tun-is-tic
prebend	preb-end
chrysan-the-mum	chry-san-the-mum
un-handy	un-hand-y
distaff	dis-taff
teacup	tea-cup
pro-tec-torate	pro-tec-tor-ate
hostler	hos-tler
con-tam-i-nan-t	con-tam-i-nant
video-con-fer-enc-ing	vid-e-o-con-fer-enc-ing
lega-tee	leg-a-tee
ap-pari-tion	ap-pa-ri-tion
s-tool	stool
schnapp-s	schnapps
growl-ing	growling
dis-cov-ery	dis-cov-er-y
un-solv-able	un-solv-a-ble
vivi-sec-tion	viv-i-sec-tion
diox-in	di-ox-in
s-lit	slit
mastodon	mas-to-don
d-if-fer-en-tiable	dif-fer-en-ti-a-ble
dis-abling	disabling
ax-iom	ax-i-om
ra-j	raj
p-light	plight
mut-t	mutt
s-tratig-ra-phy	stra-tig-ra-phy
de-gauss-ing	degaussing
p-re-sen-ter	pre-sent-er
par-lia-men-t	par-lia-ment
frag-men-tary	frag-men-tar-y
tele-vi-su-al	tel-e-vis-u-al
colon-nade	col-on-nade
s-tonework	stone-work
s-take	stake
memo-ri-al	me-mo-ri-al
at-mo-spher-ic-s	at-mos-pher-ics
buck-min-ster-fullerene	buck-min-ster-ful-ler-ene
bug-gery	bug-ger-y
pathol-o-gy	pa-thol-o-gy
soror-i-ty	so-ror-i-ty
i-nat-ten-tion	in-at-ten-tion
bio-met-ric	bi-o-met-ric
retroac-tive	ret-ro-ac-tive
ex-tra-galac-tic	ex-tra-ga-lac-tic
s-now-man	snow-man
tillage	till-age
tourni-quet	tour-ni-quet
d-if-fract	dif-fract
aun-t	aunt
raider	raid-er
geo-ther-mal	ge-o-ther-mal
over-lie	o-ver-lie
c-it-ron	cit-ron
sober-ly	so-ber-ly
jokey	jok-ey
d-if-fer-en-t	dif-fer-ent
s-in-cere-ly	sin-cere-ly
u-topi-a	u-to-pi-a
prom-is-sory	prom-is-so-ry
ivy	i-vy
wave-fron-t	wave-front
dearie	dear-ie
phonol-o-gy	pho-nol-o-gy
s-tim-u-late	stim-u-late
pre-dic-t	pre-dict
i-nar-tic-u-late	in-ar-tic-u-late
ra-tio-nal-ist	ra-tion-al-ist
the-is-m	the-ism
pe-rusal	pe-rus-al
marginal-ly	mar-gin-al-ly
zaire	za-ire
lo-bot-omy	lo-bot-o-my
judg-men-t	judg-ment
over-state	o-ver-state
l-iti-gious	li-ti-gious
wun-derkind	wun-der-kind
peachy	peach-y
u-p-lift	up-lift
disin-gen-u-ous	dis-in-gen-u-ous
viceroy	vice-roy
tal-en-t	tal-ent
petro-chem-i-cal	pet-ro-chem-i-cal
bene-fac-tion	ben-e-fac-tion
searcher	search-er
de-scend-ing	descending
dairy-man	dair-y-man
s-cythe	scythe
in-co-her-en-t	in-co-her-ent
out-place-men-t	out-place-ment
ge-neti-cist	ge-net-i-cist
aqualung	aq-ua-lung
un-change-able	un-change-a-ble
so-porif-ic	sop-o-rif-ic
un-en-force-able	un-en-force-a-ble
g-naw	gnaw
den-tistry	den-tis-try
de-jec-t	de-ject
dunghill	dung-hill
knel-l	knell
ox-i-dan-t	ox-i-dant
un-war-rantable	un-war-rant-a-ble
out-sider	out-sid-er
habi-tat	hab-i-tat
in-com-men-su-rable	in-com-men-su-ra-ble
quad-ran-t	quad-rant
ty-pog-ra-pher-s	ty-po-gra-phers
pro-tea	pro-te-a
can-nery	can-ner-y
bacil-lus	ba-cil-lus
undy-ing	un-dy-ing
s-tore-keep-er	store-keep-er
hus-bandry	hus-band-ry
undis-crim-i-nat-ing	un-dis-crim-i-nat-ing
dis-mem-bered	dismembered
re-tire-men-t	re-tire-ment
in-flat-able	in-flat-a-ble
millpond	mill-pond
cer-ti-fi-able	cer-ti-fi-a-ble
func-tion-al-is-m	func-tion-al-ism
over-pass	o-ver-pass
moldy	mold-y
sur-d	surd
gullible	gul-li-ble
s-hear	shear
dol-l	doll
u-n-ac-quaint-ed	un-ac-quaint-ed
rhea	rhe-a
torus	to-rus
avid	av-id
obli-ga-tion	ob-li-ga-tion
com-forter	com-fort-er
dis-claimer	dis-claim-er
s-plashy	splash-y
in-vestor	in-ves-tor
e-s-planade	es-pla-nade
in-de-pen-den-t	in-de-pend-ent
meri-no	me-ri-no
s-car-let	scar-let
dyad	dy-ad
motet	mo-tet
sa-k-i	sa-ki
con-ducive	con-du-cive
ex-hi-bi-tion-is-m	ex-hi-bi-tion-ism
idea	i-de-a
mer-chan-dis-e	mer-chan-dise
melody	mel-o-dy
un-re-served-ly	un-re-serv-ed-ly
light-s	lights
d-if-fer-ing	differing
ru-ined	ruined
bur-glary	bur-gla-ry
megas-tar	meg-a-star
omis-sion	o-mis-sion
un-wrap-s	un-wraps
topol-o-gy	to-pol-o-gy
skul-dug-gery	skul-dug-ger-y
i-den-ti-fi-able	i-den-ti-fi-a-ble
luke-war-m	luke-warm
galleon	gal-le-on
pho-to-copi-er	pho-to-cop-i-er
ge-neal-o-gy	ge-ne-al-o-gy
en-trail-s	en-trails
di-arist	di-a-rist
lov-able	lov-a-ble
in-fir-mary	in-fir-ma-ry
re-vo-ca-ble	rev-o-ca-ble
trel-lised	trellised
over-shot	o-ver-shot
e-vanes-cen-t	ev-a-nes-cent
un-for-giv-able	un-for-giv-a-ble
op-eretta	op-er-et-ta
warmer	warm-er
an-tibi-ot-ic	an-ti-bi-ot-ic
periscope	per-i-scope
s-tone	stone
cen-trifu-gal	cen-trif-u-gal
net-work-ing	networking
de-ter-gen-t	de-ter-gent
ex-pan-sion-ary	ex-pan-sion-ar-y
war-ran-t	war-rant
seg-ment-ed	seg-men-ted
over-ly	o-ver-ly
psy-chopathol-o-gy	psy-cho-pa-thol-o-gy
in-sec-t	in-sect
literati	lit-e-ra-ti
hy-per-boloid	hy-per-bo-loid
dis-cred-it-ed	discredited
k-er-atin	ker-a-tin
jugu-lar	jug-u-lar
oakum	oa-kum
fiz-z	fizz
nir-vana	nir-va-na
vari-abil-i-ty	var-i-a-bil-i-ty
over-heat	o-ver-heat
propy-lene	pro-pyl-ene
rugged	rug-ged
navvy	nav-vy
colos-sal	co-los-sal
retest	re-test
z-inc	zinc
readap-t	re-a-dapt
any-body	an-y-bod-y
s-calp	scalp
n-er-vous	nerv-ous
serai	se-ra-i
tempter	tempt-er
cos-mopoli-tan	cos-mo-pol-i-tan
s-peak	speak
ini-ti-a-tion	in-i-ti-a-tion
en-camp-men-t	en-camp-ment
quiv-er-ing	quivering
re-mov-able	re-mov-a-ble
unin-sured	un-in-sured
un-mis-tak-ably	un-mis-tak-a-bly
ri-boflavin	ri-bo-fla-vin
u-nan-nounced	un-an-nounced
pesky	pes-ky
chan-cellery	chan-cel-ler-y
de-flec-t	de-flect
genoa	gen-o-a
poly-eth-yl-ene	pol-y-eth-yl-ene
lodger	lodg-er
mal-adap-tive	mal-a-dap-tive
sym-bol-is-m	sym-bol-ism
pre-de-ter-mined	predetermined
jerky	jerk-y
taffe-ta	taf-fe-ta
s-ta-tion	sta-tion
chameleon	cha-me-le-on
vam-p	vamp
preva-len-t	prev-a-lent
tax-able	tax-a-ble
prodi-gy	prod-i-gy
elec-torate	e-lec-tor-ate
ar-den-t	ar-dent
trap-s	traps
plushy	plush-y
piti-ful-ly	pit-i-ful-ly
un-der-cur-ren-t	un-der-cur-rent
k-er-nel	ker-nel
un-stop-pable	un-stop-pa-ble
u-n-adapt-ed	un-a-dapt-ed
im-muno-log-i-cal	im-mu-no-log-i-cal
cud-gel	cudg-el
ger-m	germ
gig-gling	giggling
urol-o-gist	u-rol-o-gist
soapy	soap-y
e-d-u-ca-tor	ed-u-ca-tor
stroller	stroll-er
which-ever	which-ev-er
cardi-gan	car-di-gan
d-e-duc-tive	de-duc-tive
of-fend-ing	of-fen-ding
mu-cosa	mu-co-sa
geo-chem-istry	ge-o-chem-is-try
hasti-ly	hast-i-ly
s-tra-tum	stra-tum
or-gan-is-m	or-gan-ism
basil-i-ca	ba-sil-i-ca
ool-o-gy	o-ol-o-gy
ki-mono	ki-mo-no
e-s-o-ter-i-ca	es-o-ter-i-ca
in-ves-tiga-tive	in-ves-ti-ga-tive
u-nar-guable	un-ar-gu-a-ble
any	an-y
over-look	o-ver-look
hide-away	hide-a-way
chico-ry	chic-o-ry
dis-cour-age-men-t	dis-cour-age-ment
em-bed-dable	em-bed-da-ble
gin-sen-g	gin-seng
fortress	for-tress
s-tatu-to-ry	stat-u-to-ry
oblique	o-blique
top-sy-turvy	top-sy-tur-vy
milliner	mil-li-ner
para-psy-chol-o-gy	par-a-psy-chol-o-gy
elec-tro-car-dio-gram	e-lec-tro-car-di-o-gram
stymie	sty-mie
ileum	il-e-um
retsi-na	ret-si-na
dero-gate	der-o-gate
es-timable	es-ti-ma-ble
ret-inue	ret-i-nue
ring-leader	ring-lead-er
cu-rios-i-ty	cu-ri-os-i-ty
quadruped	quad-ru-ped
apol-o-gist	a-pol-o-gist
hu-man-is-m	hu-man-ism
hu-man-i-tar-i-an-is-m	hu-man-i-tar-i-an-ism
gala	ga-la
but-tery	but-ter-y
scruf-f	scruff
weaver	weav-er
t-wofold	two-fold
b-o-rax	bo-rax
ther-mome-ter	ther-mom-e-ter
tenet	ten-et
woofer	woof-er
e-t-y-mol-o-gy	et-y-mol-o-gy
lega-tor	le-ga-tor
boohoo	boo-hoo
method-ol-o-gy	meth-od-ol-o-gy
giro	gi-ro
celebri-ty	ce-leb-ri-ty
hy-drochlo-ride	hy-dro-chlo-ride
mushy	mush-y
gravy	gra-vy
lik-able	lik-a-ble
su-per-posed	superposed
con-troller	con-trol-ler
un-tidy	un-ti-dy
piercer	pierc-er
uten-sil	u-ten-sil
cuboid	cu-boid
som-no-len-t	som-no-lent
par-tic-i-pan-t	par-tic-i-pant
ir-ri-tan-t	ir-ri-tant
con-sul-tan-cy	con-sult-an-cy
black-ened	blackened
ure-thane	u-re-thane
mono-graph	mon-o-graph
rosy	ros-y
Words with errors: 2202
Words with incorrect number of syllables: 2002
Total evluated: 6500
Perfect accuracy: 0.66
Number of syllables accuracy: 0.69
Average Levenshtein Distance(across incorrect words): 1.22
