Attempt	Real
ex-cerp-t	ex-cerpt
tele-graph	tel-e-graph
decile	dec-ile
un-even	un-e-ven
grit-s	grits
dis-senter	dis-sent-er
colonic	co-lon-ic
prefer-men-t	pre-fer-ment
nascen-t	nas-cent
de-moun-t	de-mount
la-ten-t	la-tent
ele-phan-t	el-e-phant
epis-to-lary	e-pis-to-lar-y
ex-pec-t	ex-pect
cryp-t	crypt
prod-uc-t	prod-uct
hy-pother-mi-a	hy-po-ther-mi-a
de-mo-li-tion	dem-o-li-tion
brunette	bru-nette
teenage	teen-age
ax-olotl	ax-o-lotl
rein-vest	re-in-vest
apol-o-gy	a-pol-o-gy
sushi	su-shi
con-denser	con-dens-er
quadru-ply	quad-ru-ply
eras-er	e-ras-er
con-tour-ing	con-touring
k-itchen-ware	kitch-en-ware
heinous	hei-nous
awestruc-k	awe-struck
su-per-posed	superposed
en-hance-men-t	en-hance-ment
hedgerow	hedge-row
im-muno-com-pro-mised	im-mu-no-com-pro-mised
t-wain	twain
chee-ri-o	cheer-i-o
opi-ate	o-pi-ate
workspace	work-space
u-n-ad-just-ed	un-ad-just-ed
de-fines	def-ines
post-mistress	post-mis-tress
hireling	hire-ling
con-fec-tionery	con-fec-tion-er-y
bank-able	bank-a-ble
s-e-lec-t	se-lect
de-lim-it-ed	delimited
op-por-tunis-m	op-por-tun-ism
is-lander	is-land-er
mu-nif-i-cen-t	mu-nif-i-cent
re-moun-t	re-mount
co-pra	cop-ra
heat-wave	heatwave
stal-l	stall
ra-dioac-tiv-i-ty	ra-di-o-ac-tiv-i-ty
astray	a-stray
to-po-graph-ic	top-o-graph-ic
busy	bus-y
peri-na-tal	per-i-na-tal
in-dis-tinc-t	in-dis-tinct
luke-war-m	luke-warm
v-enue	ven-ue
surgery	sur-ger-y
throaty	throat-y
wind-mil-l	wind-mill
menu	men-u
di-alec-t	di-a-lect
pogrom	po-grom
in-dus-tri-al-is-m	in-dus-tri-al-ism
re-place-able	re-place-a-ble
cel-e-bran-t	cel-e-brant
di-rec-t	di-rect
stringy	string-y
thun-der-stor-m	thun-der-storm
li-bido	li-bi-do
trendy	trend-y
portage	por-tage
hypocrisy	hy-poc-ri-sy
skimpy	skimp-y
dio-cese	di-o-cese
stat-ic-s	stat-ics
auger	au-ger
de-cen-t	de-cent
de-caf-feinate	de-caf-fein-ate
p-res-ence	pres-ence
wicked-ness	wick-ed-ness
ori-fice	or-i-fice
mega-ton	meg-a-ton
in-ex-orably	in-ex-o-ra-bly
reper-toire	rep-er-toire
doc-tor-ing	doctoring
moray	mo-ray
scream-ing	screaming
syn-onymy	syn-on-y-my
dis-union	dis-un-ion
propy-lene	pro-pyl-ene
con-va-les-cen-t	con-va-les-cent
hookah	hook-ah
iso-lat-ed	i-so-lat-ed
showy	show-y
hoard-ed	hoarded
net-work-ing	networking
flutist	flut-ist
lit-er-ary	lit-er-ar-y
s-port-ing	sport-ing
re-s-e-lec-t	re-se-lect
dis-turbing-ly	dis-turb-ing-ly
para-pet	par-a-pet
ephemer-a	e-phem-er-a
mal-odor-ous	mal-o-dor-ous
po-litesse	pol-i-tesse
tusker	tusk-er
cy-to-tox-i-c	cy-to-tox-ic
ben-e-fi-cia-ry	ben-e-fi-ci-ar-y
temp-t	tempt
dis-cotheque	dis-co-theque
saga	sa-ga
hosepipe	hose-pipe
fetishist	fet-ish-ist
sycamore	syc-a-more
mis-judg-men-t	mis-judg-ment
ge-nial-i-ty	ge-ni-al-i-ty
obey	o-bey
bud-getary	budg-et-ar-y
over-draw	o-ver-draw
turnip	tur-nip
vagabond	vag-a-bond
avul-sion	a-vul-sion
hy-drome-chan-ic-s	hy-dro-me-chan-ics
mis-treat-men-t	mis-treat-ment
frat-ri-ci-dal	frat-ri-cid-al
atom-ic-i-ty	at-o-mic-i-ty
gas-troin-testi-nal	gas-tro-in-tes-ti-nal
m-nemon-ic	mne-mon-ic
tithing	tith-ing
mono-gram	mon-o-gram
re-mark-ably	re-mark-a-bly
re-spon-der	re-spond-er
oblate	ob-late
s-mash-er	smash-er
eardrum	ear-drum
un-hy-gien-ic	un-hy-gi-en-ic
cater-er	ca-ter-er
tru-is-m	tru-ism
san-i-tary	san-i-tar-y
ul-tra-son-ic-s	ul-tra-son-ics
fire-bal-l	fire-ball
movie	mov-ie
med-dling	meddling
prov-ably	prov-a-bly
s-tun-ning-ly	stun-ning-ly
an-nounce-men-t	an-nounce-ment
bleat-ing	bleating
mo-lester	mo-lest-er
tele-path-ic	tel-e-path-ic
nowhere	no-where
os-tracis-m	os-tra-cism
frangi-pani	fran-gi-pan-i
vet-eri-nary	vet-er-i-nar-y
crum-b	crumb
reaf-fir-ma-tion	re-af-fir-ma-tion
pot-tery	pot-ter-y
syl-labary	syl-la-bar-y
mid-wifer-y	mid-wife-ry
daisy	dai-sy
re-pairable	re-pair-a-ble
puz-zle-men-t	puz-zle-ment
pre-pared-ness	pre-par-ed-ness
bulky	bulk-y
reti-nal	ret-i-nal
overeat	o-ver-eat
s-lice	slice
re-can-t	re-cant
s-can-ner	scan-ner
s-neak-ing	sneak-ing
s-cal-a-bil-i-ty	scal-a-bil-i-ty
land-fal-l	land-fall
con-strict-ed	constricted
epi-ge-net-ic	ep-i-ge-net-ic
s-coop	scoop
elec-troen-cephalo-gram	e-lec-tro-en-ceph-a-lo-gram
ide-al-ly	i-de-al-ly
soft-bal-l	soft-ball
dele-te-ri-ous	del-e-te-ri-ous
hazel-nut	ha-zel-nut
ril-l	rill
in-signi-a	in-sig-ni-a
s-lop-py	slop-py
brassiere	bras-siere
down-fal-l	down-fall
durable	du-ra-ble
turquoise	tur-quoise
baloney	ba-lo-ney
as-cen-der	as-cend-er
ini-tia-tor	in-i-ti-a-tor
stylis-tic	sty-lis-tic
wa-ter-work-s	wa-ter-works
ap-por-tion-men-t	ap-por-tion-ment
co-va-len-t	co-va-lent
lawyer	law-yer
suit-ably	suit-a-bly
brain-stor-m	brain-storm
big-otry	big-ot-ry
fisticuff-s	fist-i-cuffs
heady	head-y
wildlife	wild-life
elec-torate	e-lec-tor-ate
s-lick-er	slick-er
ini-ti-a-tion	in-i-ti-a-tion
s-loth	sloth
re-ac-t	re-act
unre-deemed	un-re-deemed
s-cu-ba	scu-ba
crenel-la-tion-s	cren-el-la-tions
dishar-mo-ny	dis-har-mo-ny
un-kep-t	un-kept
roofer	roof-er
reshow	re-show
masochist	mas-och-ist
sar-cas-m	sar-casm
tri-umphal-is-m	tri-um-phal-ism
as-sertive	as-ser-tive
triplex	tri-plex
rogu-ish	ro-guish
cherub	cher-ub
bio-med-i-cal	bi-o-med-i-cal
dan-de-lion	dan-de-li-on
bac-teri-um	bac-te-ri-um
spon-tane-ity	spon-ta-ne-i-ty
s-tore	store
sali-vate	sal-i-vate
pi-caresque	pic-a-resque
link-able	link-a-ble
dopey	dope-y
hero-is-m	her-o-ism
windy	wind-y
ex-pe-di-en-t	ex-pe-di-ent
em-bez-zle-men-t	em-bez-zle-ment
an-tag-o-nis-m	an-tag-o-nism
filet	fi-let
leav-ened	leavened
con-struc-tivist	con-struc-tiv-ist
l-itur-gi-cal	li-tur-gi-cal
over-feed	o-ver-feed
s-nob-bish	snob-bish
teach-able	teach-a-ble
paragon	par-a-gon
pauci-ty	pau-ci-ty
ephor	eph-or
ir-re-deemable	ir-re-deem-a-ble
dev-il-men-t	dev-il-ment
un-ortho-doxy	un-or-tho-dox-y
tetchy	tetch-y
col-lec-tivis-m	col-lec-tiv-ism
tele-vised	televised
tapir	ta-pir
rein-vig-o-rate	re-in-vig-or-ate
un-proven	un-prov-en
giblet-s	gib-lets
mag-ne-to-hy-dro-dy-nam-ic-s	mag-ne-to-hy-dro-dy-nam-ics
reaf-fir-m	re-af-firm
colos-sal	co-los-sal
ure-thra	u-re-thra
telethon	tel-e-thon
duck-bil-l	duck-bill
bar-bi-e	bar-bie
hobo	ho-bo
molten	mol-ten
cat-a-com-b	cat-a-comb
silage	si-lage
up-hol-stery	up-hol-ster-y
measly	mea-sly
s-lop-ing	slop-ing
decagon	dec-a-gon
privy	priv-y
atop	a-top
ar-chi-tec-t	ar-chi-tect
nest-ing	nesting
over-ly-ing	o-ver-ly-ing
vari-a-tion	var-i-a-tion
plebiscite	pleb-i-scite
re-ceiver-ship	re-ceiv-er-ship
buzzer	buzz-er
syl-labus	syl-la-bus
urine	u-rine
t-ingly	tin-gly
camel	cam-el
in-equitable	in-eq-ui-ta-ble
arach-nid	a-rach-nid
s-tac-ca-to	stac-ca-to
out-fal-l	out-fall
squea-mish	squeam-ish
e-voca-tive	e-voc-a-tive
basil	bas-il
residu-um	re-sid-u-um
li-censee	li-cen-see
pro-gram-mable	pro-gram-ma-ble
nud-is-t	nud-ist
pre-pon-der-an-t	pre-pon-der-ant
re-de-vel-op-men-t	re-de-vel-op-ment
syco-phan-tic	syc-o-phan-tic
dis-am-biguate	dis-am-big-u-ate
hermeneu-tic-s	her-me-neu-tics
in-testi-nal	in-tes-ti-nal
laser	la-ser
s-mooch	smooch
mus-ke-teer	mus-ket-eer
valise	va-lise
as-tro-nau-tic-s	as-tro-nau-tics
ne-ma-tode	nem-a-tode
ir-re-solv-able	ir-re-solv-a-ble
flu-vial	flu-vi-al
even-t	e-vent
nadir	na-dir
s-ing	sing
den-t	dent
mut-ter-ing	muttering
chi-ropody	chi-rop-o-dy
over-spill	o-ver-spill
cerise	ce-rise
over-lap	o-ver-lap
s-tate	state
meta-mor-phose	met-a-mor-phose
spir-i-tu-al-ist	spir-it-u-al-ist
mildew	mil-dew
chore-og-ra-phy	cho-re-og-ra-phy
post-mortem	post-mor-tem
spel-l	spell
serol-o-gy	se-rol-o-gy
dis-cre-tionary	dis-cre-tion-ar-y
hy-draulic	hy-drau-lic
stinky	stink-y
there-about-s	there-a-bouts
showjumper-s	show-jum-pers
tetrox-ide	te-trox-ide
u-nashamed	un-a-shamed
flammable	flam-ma-ble
even	e-ven
em-bar-rass-men-t	em-bar-rass-ment
dimin-u-en-do	di-min-u-en-do
fraugh-t	fraught
money-len-der	mon-ey-lend-er
per-ineum	per-i-ne-um
para-met-ric	par-a-met-ric
c-it-rate	cit-rate
earshot	ear-shot
fruition	fru-i-tion
mem-o-rable	mem-o-ra-ble
sauna	sau-na
re-state-men-t	re-state-ment
thinker	think-er
joyrid-ing	joy-rid-ing
schemat-ic	sche-mat-ic
dredger	dredg-er
lay-of-f	lay-off
gassy	gas-sy
foxy	fox-y
het-ero-sex-u-al-i-ty	het-er-o-sex-u-al-i-ty
op-ti-mistic	op-ti-mis-tic
retel-l	re-tell
me-te-orite	me-te-or-ite
coun-t	count
par-enter-al	par-en-ter-al
clash-ing	clashing
sinewy	sin-ew-y
translu-cen-cy	trans-lu-cen-cy
s-mall-hold-ing	small-hold-ing
ion	i-on
dul-l	dull
para-dox-i-cal-ly	par-a-dox-i-cal-ly
mega-lo-ma-ni-a	meg-a-lo-ma-ni-a
ir-re-proach-able	ir-re-proach-a-ble
coven	cov-en
cougar	cou-gar
sandy	sand-y
thum-b	thumb
suc-cu-len-t	suc-cu-lent
cafe	ca-fe
avoid-able	a-void-a-ble
chival-ry	chiv-al-ry
grasshop-per	grass-hop-per
playable	play-a-ble
en-riched	enriched
re-liance	re-li-ance
s-take	stake
recharge	re-charge
con-tigu-ous	con-tig-u-ous
preda-to-ry	pred-a-to-ry
im-moral	im-mor-al
lamen-t	la-ment
illiq-uid	il-liq-uid
s-cat	scat
pun-y	pu-ny
morsel	mor-sel
tom-fool-ery	tom-fool-er-y
polyg-a-mous	po-lyg-a-mous
tuner	tun-er
ex-pan-sion-ary	ex-pan-sion-ar-y
bub-blegum	bub-ble-gum
gig-gling	giggling
be-atif-ic	be-a-tif-ic
cylin-dri-cal	cy-lin-dri-cal
s-pace-suit	space-suit
gaga	ga-ga
black-ened	blackened
s-tu-dious	stu-di-ous
para-sol	par-a-sol
mis-man-age-men-t	mis-man-age-ment
roundup	round-up
s-trap	strap
ap-palling-ly	ap-pall-ing-ly
chock-ablock	chock-a-block
irony	i-ro-ny
mousy	mous-y
l-o-gof-f	log-off
serendip-i-ty	ser-en-dip-i-ty
ar-chaeopteryx	ar-chae-op-ter-yx
wastrel	wast-rel
sharp-en-er	shar-pen-er
shaver	shav-er
kil-n	kiln
com-pelling-ly	com-pel-ling-ly
refugee	ref-u-gee
flesh-ing	fleshing
i-con-o-clas-m	i-con-o-clasm
re-align	re-a-lign
erot-i-ca	e-rot-i-ca
s-tupid	stu-pid
dormer	dor-mer
carouse	ca-rouse
gener-ic	ge-ner-ic
con-sis-ten-cy	con-sist-en-cy
tra-cheoto-my	tra-che-ot-o-my
im-pair-men-t	im-pair-ment
mas-sacre	mas-sa-cre
foible	foi-ble
hal-l	hall
fir-ma-men-t	fir-ma-ment
car-cino-gen	car-cin-o-gen
s-paniel	span-iel
lin-t	lint
crater	cra-ter
hail-stor-m	hail-storm
lol-l	loll
glacier	gla-cier
huf-f	huff
retroac-tive-ly	ret-ro-ac-tive-ly
margina-li-a	mar-gi-na-li-a
grad-u-al-is-m	grad-u-al-ism
s-cope	scope
hy-gien-e	hy-giene
tiara	ti-ar-a
pi-laster	pi-las-ter
mel-liflu-ous	mel-lif-lu-ous
bal-loon-ist	balloonist
me-te-o-ro-log-i-cal	me-te-or-o-log-i-cal
celebri-ty	ce-leb-ri-ty
so-cio-bi-ol-o-gy	so-ci-o-bi-ol-o-gy
land-fil-l	land-fill
tenac-i-ty	te-nac-i-ty
burly	bur-ly
he-do-nist	he-don-ist
t-in-pot	tin-pot
rosin	ros-in
cameo	cam-e-o
tra-chea	tra-che-a
in-vesti-ture	in-ves-ti-ture
fo-lio	fo-li-o
grater	grat-er
dispir-it-ing	dis-pir-it-ing
di-ver-sion-ary	di-ver-sion-ar-y
s-tave	stave
reroutes	re-routes
apex	a-pex
dullard	dull-ard
om-nipo-tence	om-nip-o-tence
u-n-avail-able	un-a-vail-a-ble
ap-pari-tion	ap-pa-ri-tion
dis-agree-able	dis-a-gree-a-ble
s-pleen	spleen
hy-per-bole	hy-per-bo-le
res-onator	res-o-na-tor
im-agery	im-age-ry
frigate	frig-ate
de-canter	de-cant-er
sac-risty	sac-ris-ty
apro-pos	ap-ro-pos
re-cidi-vist	re-cid-i-vist
s-plat	splat
earth-wor-m	earth-worm
ashore	a-shore
lacy	lac-y
ten-antry	ten-ant-ry
crinkly	crin-kly
haystack	hay-stack
car-boxyl	car-box-yl
desul-to-ry	des-ul-to-ry
pay-men-t	pay-ment
mo-nop-oly	mo-nop-o-ly
testy	tes-ty
tele-phone	tel-e-phone
verisimil-i-tude	ver-i-si-mil-i-tude
par-lia-men-t	par-lia-ment
di-a-conal	di-ac-o-nal
notepad	note-pad
d-is-fig-ure-men-t	dis-fig-ure-ment
cor-nu-copi-a	cor-nu-co-pi-a
syl-labub	syl-la-bub
pizze-ri-a	piz-ze-ri-a
reshuf-fle	re-shuf-fle
c-it-i-zen	cit-i-zen
backspace	back-space
g-lut-tonous	glut-ton-ous
tablet	tab-let
over-crowd-ing	o-ver-crow-ding
mag-netron	mag-ne-tron
ibex	i-bex
bal-alai-ka	bal-a-lai-ka
in-vari-ably	in-var-i-a-bly
pedi-gree	ped-i-gree
s-cythe	scythe
bailif-f	bail-iff
iron-work-s	i-ron-works
mag-netism	mag-net-ism
s-to-icis-m	sto-i-cism
soupy	soup-y
ap-t	apt
cyan	cy-an
pre-dictabil-i-ty	pre-dict-a-bil-i-ty
s-nug	snug
un-fash-ion-able	un-fash-ion-a-ble
in-ge-nious-ly	in-gen-ious-ly
re-as-sur-ing	reassuring
as-pi-ran-t	as-pir-ant
mala-chite	mal-a-chite
pass-ably	pass-a-bly
video	vid-e-o
antonym	an-to-nym
mono-syl-la-ble	mon-o-syl-la-ble
tiger-ish	ti-ger-ish
flamin-go	fla-min-go
s-niv-el	sniv-el
k-nack-er	knack-er
epis-te-mo-log-i-cal	e-pis-te-mo-log-i-cal
any-thing	an-y-thing
elec-tro-cute	e-lec-tro-cute
swimwear	swim-wear
soloist	so-lo-ist
k-in-folk	kin-folk
m-is-fit	mis-fit
covenan-t	cov-e-nant
r-e-fit	re-fit
par-don-able	par-don-a-ble
eter-nal-ly	e-ter-nal-ly
mi-crodot	mi-cro-dot
glos-sary	glos-sa-ry
au-topi-lot	au-to-pi-lot
molyb-de-num	mo-lyb-de-num
how-itzer	how-itz-er
pre-lude	prel-ude
mus-cle-d	mus-cled
s-cathe	scathe
lurk-ing	lurking
uten-sil	u-ten-sil
mushy	mush-y
c-on-cil-ia-tor	con-cil-i-a-tor
rudi-men-ta-ry	ru-di-men-ta-ry
pa-troness	pa-tron-ess
aware-ness	a-ware-ness
in-farc-t	in-farct
con-junc-t	con-junct
s-tack	stack
sec-tar-i-an-is-m	sec-tar-i-an-ism
tread-mil-l	tread-mill
mis-spellings	mis-spel-lings
a-vian	a-vi-an
c-i-ta-tion	ci-ta-tion
asyn-chro-nous	a-syn-chro-nous
u-n-aid-ed	un-aid-ed
duik-er	dui-ker
boxy	box-y
prov-i-den-t	prov-i-dent
trea-sury	treas-ur-y
far-m	farm
s-lash	slash
astride	a-stride
deuteron	deu-ter-on
in-ex-tin-guish-able	in-ex-tin-guish-a-ble
wrestler	wres-tler
bonus	bo-nus
in-duce-men-t	in-duce-ment
aloud	a-loud
s-parse	sparse
trea-sonous	trea-son-ous
cheesy	chees-y
per-ma-nen-t	per-ma-nent
midair	mid-air
neg-ligee	neg-li-gee
s-trafe	strafe
her-bi-cide	herb-i-cide
nonex-is-tence	non-ex-ist-ence
cor-dial	cor-di-al
ir-repara-ble	ir-rep-a-ra-ble
de-rail-men-t	de-rail-ment
edgy	edg-y
lemon	lem-on
video-taped	videotaped
aug-men-t	aug-ment
essence	es-sence
both-ered	bothered
s-po-radic	spo-rad-ic
fly-over	fly-o-ver
con-sumeris-m	con-sum-er-ism
racist	rac-ist
un-sellable	un-sell-a-ble
punchy	punch-y
i-nessen-tial	in-es-sen-tial
ju-niper	ju-ni-per
s-norkel	snor-kel
net-bal-l	net-ball
poly-atom-ic	pol-y-a-tom-ic
over-hear	o-ver-hear
holis-ti-cal-ly	ho-lis-ti-cal-ly
per-centile	per-cen-tile
eleventh	e-lev-enth
ig-neous	ig-ne-ous
nico-tine	nic-o-tine
lumpen	lum-pen
retsi-na	ret-si-na
dropout	drop-out
in-tran-si-gen-t	in-tran-si-gent
odor-ous	o-dor-ous
s-lant-ing	slant-ing
marked-ly	mark-ed-ly
shunter	shunt-er
tele-tex-t	tel-e-text
de-cay-ing	decaying
b-i-fo-cal	bi-fo-cal
mod-icum	mod-i-cum
sole-cis-m	sol-e-cism
erase	e-rase
mal-treat-men-t	mal-treat-ment
mar-ke-teer	mar-ket-eer
s-mug-gling	smuggling
sacra-men-t	sac-ra-ment
lano-lin	lan-o-lin
punc-til-ious	punc-til-i-ous
af-fec-t	af-fect
chim-panzee	chim-pan-zee
un-equiv-o-cal-ly	un-e-quiv-o-cal-ly
in-ter-roga-to-ry	in-ter-rog-a-to-ry
purist	pur-ist
ten-an-t	ten-ant
onus	o-nus
urchin	ur-chin
coro-ner	cor-o-ner
un-pleas-an-t	un-pleas-ant
transat-lantic	trans-at-lan-tic
neg-li-gen-t	neg-li-gent
cou-turi-er	cou-tu-ri-er
e-t-y-mol-o-gy	et-y-mol-o-gy
linoleum	li-no-le-um
monomolec-u-lar	mon-o-mo-lec-u-lar
throw-away	throw-a-way
dacha	da-cha
tri-bune	trib-une
flash-bul-b	flash-bulb
renown	re-nown
weaver	weav-er
hul-la-baloo	hul-la-ba-loo
s-car-let	scar-let
v-int-ner	vint-ner
de-mount-able	de-mount-a-ble
birthright	birth-right
frothy	froth-y
church-war-den	church-ward-en
fer-al	fe-ral
lever-age	lev-er-age
pro-cure-men-t	pro-cure-ment
minke	min-ke
welder	weld-er
e-go-is-m	e-go-ism
para-troop-s	par-a-troops
in-choate	in-cho-ate
bilin-gual-is-m	bi-lin-gual-ism
plea-sur-able	pleas-ur-a-ble
b-otan-i-cal	bo-tan-i-cal
deca-dence	dec-a-dence
t-suna-mi	tsu-na-mi
an-tic-s	an-tics
break-away	break-a-way
sharply	sharp-ly
en-chant-ed	enchanted
cuprous	cu-prous
read-just	re-ad-just
su-perla-tive	su-per-la-tive
s-mart-ly	smart-ly
mariner	mar-i-ner
di-ar-rhea	di-ar-rhe-a
madam	mad-am
undis-closed	un-dis-closed
tra-di-tion-al-is-m	tra-di-tion-al-ism
awash	a-wash
mer-ce-nary	mer-ce-nar-y
ir-re-triev-able	ir-re-triev-a-ble
t-inc-ture	tinc-ture
papule	pap-ule
in-trepid	in-trep-id
nether-most	neth-er-most
civil-ian	ci-vil-ian
any-body	an-y-bod-y
colony	col-o-ny
s-melt-ing	smelting
re-al-is-m	re-al-ism
con-nec-t	con-nect
peri-toneum	per-i-to-ne-um
hand-bil-l	hand-bill
moth-er-stobe	mo-ther-stobe
mea-sure-less	meas-ure-less
s-nuff-box	snuff-box
cus-tom-ary	cus-tom-ar-y
foghorn	fog-horn
madri-gal	mad-ri-gal
fig-u-ra-tive	fig-ur-a-tive
s-traw-ber-ry	straw-ber-ry
dis-junc-t	dis-junct
de-r-ate	de-rate
u-nipo-lar	u-ni-po-lar
tor-ren-t	tor-rent
dum-found-ing	dumf-ound-ing
ex-tru-sion-s	ex-tru-sions
springy	spring-y
s-car-i-fy	scar-i-fy
pre-sum-ably	pre-sum-a-bly
litho-graph	lith-o-graph
cream-ery	cream-er-y
b-otanist	bot-a-nist
en-hancer	en-hanc-er
cervix	cer-vix
whizkid-s	whizkids
pyra-mid	pyr-a-mid
s-tock-ing	stock-ing
jokey	jok-ey
s-trap-ping	strap-ping
regress	re-gress
iso-topic	i-so-top-ic
un-de-ni-able	un-de-ni-a-ble
pachy-der-m	pach-y-derm
treaty	trea-ty
cli-toral	clit-o-ral
skua	sku-a
re-trieval	re-triev-al
jazzy	jazz-y
dis-mis-s	dis-miss
in-ge-nious	in-gen-ious
un-ex-plain-able	un-ex-plain-a-ble
dis-so-nan-t	dis-so-nant
turtle-neck	tur-tle-neck
math-e-mat-ic-s	math-e-mat-ics
dogged	dog-ged
damni-fy	dam-ni-fy
grouchy	grouch-y
de-pic-t	de-pict
nymp-holep-sy	nym-pho-lep-sy
hunger	hun-ger
japon-i-ca	ja-pon-i-ca
bi-l-abi-al	bi-la-bi-al
pu-rifi-ca-tion	pu-ri-fi-ca-tion
polo-ni-um	po-lo-ni-um
un-be-liev-able	un-be-liev-a-ble
pen-tame-ter	pen-tam-e-ter
unswerv-ing	un-swerv-ing
limpet	lim-pet
teacup	tea-cup
crispy	crisp-y
com-pan-ion-able	com-pan-ion-a-ble
in-spi-ra-tional	in-spi-ra-tion-al
de-ca-pod	dec-a-pod
s-core-board	score-board
ex-pe-di-tionary	ex-pe-di-tion-ar-y
dis-ap-proval	dis-ap-prov-al
ar-chi-tec-tural	ar-chi-tec-tur-al
de-sir-abil-i-a	de-si-ra-bi-li-a
con-comi-tan-t	con-com-i-tant
grandeur	gran-deur
avalanche	av-a-lanche
tachy-on	tach-y-on
salty	salt-y
pathol-o-gy	pa-thol-o-gy
whaler	whal-er
dessert	des-sert
mush-room-ing	mushrooming
s-par-ing	spar-ing
un-ruly	un-ru-ly
patel-la	pa-tel-la
re-fine-men-t	re-fine-ment
s-corch	scorch
bluish	blu-ish
aback	a-back
op-po-nen-t	op-po-nent
shrim-p	shrimp
cade-t	ca-det
rap-t	rapt
ram-shackle	ram-shack-le
lachry-mal	lach-ry-mal
jour-nalese	jour-nal-ese
her-i-tabil-i-ty	her-it-a-bil-i-ty
im-ma-nen-t	im-ma-nent
clever	clev-er
ashamed	a-shamed
curvy	curv-y
g-lycine	gly-cine
pagean-t	pag-eant
cen-trifu-ga-tion	cen-trif-u-ga-tion
i-a-tro-genic	i-at-ro-gen-ic
ra-dio-g-ra-pher	ra-di-og-ra-pher
tri-umvi-rate	tri-um-vi-rate
over-rule	o-ver-rule
s-tar-tle	star-tle
halo-gen	hal-o-gen
burn-ings	bur-nings
seg-ment-ed	seg-men-ted
corvette	cor-vette
can-ni-bal-is-m	can-ni-bal-ism
gra-tu-itous-ly	gra-tu-i-tous-ly
el-ven	elv-en
s-teed	steed
s-tur-dy	stur-dy
floater	float-er
b-liss-ful-ly	bliss-ful-ly
e-u-pho-nious	eu-pho-ni-ous
u-nadul-ter-at-ed	un-a-dul-ter-at-ed
as-pi-ra-tional	as-pi-ra-tion-al
s-mash	smash
changeling	change-ling
li-able	li-a-ble
twilit	twi-lit
hal-ibut	hal-i-but
over-grown	o-ver-grown
or-di-nary	or-di-nar-y
leisurewear	lei-sure-wear
over-look	o-ver-look
hys-terec-to-my	hys-ter-ec-to-my
provoca-tive-ly	pro-voc-a-tive-ly
feud-is-t	feud-ist
mas-cara	mas-car-a
can-non-bal-l	can-non-ball
catholic	cath-o-lic
chan-cellery	chan-cel-ler-y
pro-lactin	pro-lac-tin
s-cout-ing	scout-ing
con-sor-tium	con-sor-ti-um
di-a-bolis-m	di-ab-o-lism
so-lic-it-ing	soliciting
lega-tee	leg-a-tee
method-olog-i-cal	meth-od-o-log-i-cal
delin-quen-cy	de-lin-quen-cy
brigade	bri-gade
s-lum-ber	slum-ber
busi-ly	bus-i-ly
poly-tech-nic	pol-y-tech-nic
crum-by	crumb-y
febrile	fe-brile
un-der-study	un-der-stud-y
bru-tal-is-m	bru-tal-ism
lemur	le-mur
awry	a-wry
in-stan-ta-neous-ly	in-stan-ta-ne-ous-ly
per-ilous-ly	per-il-ous-ly
cordage	cord-age
s-luice	sluice
changeover	change-o-ver
peremp-to-ry	per-emp-to-ry
causal-ly	caus-al-ly
un-equiv-o-cal	un-e-quiv-o-cal
junkie	jun-kie
open-er	o-pen-er
con-ceiv-able	con-ceiv-a-ble
u-n-ac-quaint-ed	un-ac-quaint-ed
re-pen-tan-t	re-pent-ant
re-place-men-t	re-place-ment
toothy	tooth-y
woofer	woof-er
s-plice	splice
overuse	o-ver-use
trust-ed	trusted
bleary	blear-y
armistice	ar-mi-stice
psy-cholin-guis-tic-s	psy-cho-lin-guis-tics
po-ten-tial-i-ty	po-ten-ti-al-i-ty
briskly	brisk-ly
out-sider	out-sid-er
s-tand	stand
phe-nomeno-log-i-cal	phe-nom-e-no-log-i-cal
nougat	nou-gat
nasal	na-sal
s-tark-ly	stark-ly
con-sid-er-ably	con-sid-er-a-bly
chore-a	cho-re-a
coral	cor-al
de-liv-ery	de-liv-er-y
o-nion	on-ion
nice-ty	ni-ce-ty
rel-a-tivis-tic	rel-a-tiv-is-tic
poly-mor-phous	pol-y-mor-phous
epis-co-pa-cy	e-pis-co-pa-cy
elec-tron	e-lec-tron
mar-keter	mar-ket-er
cyclic	cy-clic
sur-vivor	sur-vi-vor
timid-i-ty	ti-mid-i-ty
lisp-ing	lis-ping
un-easi-ly	un-eas-i-ly
cashier	cash-ier
u-nattain-able	un-at-tain-a-ble
s-tu-dious-ly	stu-di-ous-ly
in-con-gruity	in-con-gru-i-ty
bel-liger-ence	bel-lig-er-ence
seafood	sea-food
poltroon	pol-troon
un-con-ge-nial	un-con-gen-ial
col-lo-qui-al-is-m	col-lo-qui-al-ism
rar-efied	rar-e-fied
quotable	quot-a-ble
parochial-is-m	pa-ro-chi-al-ism
s-ta-tionery	sta-tion-er-y
s-noop	snoop
as-ceti-cis-m	as-cet-i-cism
edi-tion	e-di-tion
groupie	group-ie
in-her-i-ta-ble	in-her-it-a-ble
toil-s	toils
s-trand	strand
ep-ithe-lial	ep-i-the-li-al
tele-phon-ist	te-leph-o-nist
naive	na-ive
vivid	viv-id
beret	be-ret
gaslight	gas-light
undi-min-ished	un-di-min-ished
wa-ter-fron-t	wa-ter-front
s-tim-u-la-tion	stim-u-la-tion
carousel	car-ou-sel
sub-stan-dard	sub-stand-ard
schis-m	schism
poly-crys-talline	pol-y-crys-tal-line
causal	caus-al
nephri-tis	ne-phri-tis
psy-chother-a-py	psy-cho-ther-a-py
reap-point	re-ap-point
framer	fram-er
ghana	ghana
duo-de-num	du-o-de-num
nu-tri-en-t	nu-tri-ent
costar	co-star
mono-pole	mon-o-pole
rook-ery	rook-er-y
stag-ger-s	stag-gers
cologne	co-logne
prostate	pros-tate
alone	a-lone
gable	ga-ble
lethar-gy	leth-ar-gy
poly-syl-la-ble	pol-y-syl-la-ble
boyfriend	boy-friend
s-pac-er	spac-er
knol-l	knoll
s-cur-ry	scur-ry
sawmil-l	saw-mill
vista	vis-ta
clemen-cy	clem-en-cy
tru-cu-len-t	truc-u-lent
y-outh-ful	youth-ful
boater	boat-er
a-ban-don-men-t	a-ban-don-ment
in-sa-tiable	in-sa-tia-ble
com-fort-able	com-fort-a-ble
s-teer	steer
prison	pris-on
put-t	putt
s-tart	start
cloven	clo-ven
desert-s	de-serts
u-nim-proved	un-im-proved
s-ports-wear	sports-wear
en-tice-men-t	en-tice-ment
un-break-able	un-break-a-ble
head-quar-ter-s	head-quar-ters
bio-chem-i-cal	bi-o-chem-i-cal
hy-drazine	hy-dra-zine
flota-tion	flo-ta-tion
hel-l	hell
chameleon	cha-me-le-on
re-strain-ing	restraining
mas-t	mast
labur-num	la-bur-num
her-s	hers
in-de-pen-dent-ly	in-de-pend-ent-ly
peep-s	peeps
lofty	loft-y
mono-phon-ic	mon-o-phon-ic
es-capist	es-cap-ist
rai-men-t	rai-ment
de-posi-tary	de-pos-i-tar-y
dis-pen-sary	dis-pen-sa-ry
im-pa-tien-t	im-pa-tient
e-s-pouse	es-pouse
polit-buro	po-lit-bu-ro
e-s-o-ter-ic	es-o-ter-ic
shipload	ship-load
nat-u-ral-is-m	nat-u-ral-ism
pe-cu-liar-i-ty	pe-cu-li-ar-i-ty
in-sur-gen-t	in-sur-gent
de-fen-dan-t	de-fend-ant
malev-o-len-t	ma-lev-o-lent
unlove-ly	un-love-ly
teapot	tea-pot
blender	blend-er
sonar	so-nar
rolling	roll-ing
frilli-er	fril-li-er
in-tu-itive	in-tu-i-tive
s-tork	stork
rub-bishy	rub-bish-y
s-ta-tion	sta-tion
biomorph	bi-o-morph
ide-o-log-i-cal-ly	i-de-o-log-i-cal-ly
grass-root-s	grass-roots
za-p	zap
n-ear-by	near-by
sub-trac-t	sub-tract
pro-po-nen-t	pro-po-nent
per-sis-tent-ly	per-sist-ent-ly
moral-is-m	mor-al-ism
s-nob	snob
chemist	chem-ist
s-tu-dentship	stu-dent-ship
alarm-ing	a-larm-ing
s-teril-i-ty	ste-ril-i-ty
mar-ketable	mar-ket-a-ble
im-per-fec-t	im-per-fect
telex	tel-ex
om-nibus	om-ni-bus
co-gen-t	co-gent
carat	car-at
palat-able	pal-at-a-ble
s-teel	steel
con-san-guineous	con-san-guin-e-ous
s-cle-ro-sis	scle-ro-sis
elitism	e-lit-ism
in-dica-tive	in-dic-a-tive
p-ri-mo-gen-i-ture	pri-mo-gen-i-ture
flip-pan-t	flip-pant
unso-cia-ble	un-so-cia-ble
heart-en-ing	heartening
en-comi-um	en-co-mi-um
re-vival-is-m	re-viv-al-ism
aris-to-crat	a-ris-to-crat
s-tim-u-lus	stim-u-lus
con-fir-m	con-firm
elec-tor	e-lec-tor
avail-able	a-vail-a-ble
tidi-ness	ti-di-ness
charis-ma	cha-ris-ma
physi-cist	phys-i-cist
kalei-do-scop-ic	ka-lei-do-scop-ic
s-pas-mod-ic	spas-mod-ic
per-ish-able	per-ish-a-ble
chilblain	chil-blain
dereg-u-la-tion	de-reg-u-lation
legalese	le-gal-ese
liken	lik-en
re-phrases	re-phra-ses
a-tol-l	at-oll
pil-l	pill
re-formist	re-form-ist
per-mit-ting	permitting
bistro	bis-tro
pedan-t	ped-ant
penum-bra	pe-num-bra
serene-ly	se-rene-ly
w-hole-wheat	wholewheat
e-vic-t	e-vict
char-cu-terie	char-cu-te-rie
in-san-i-tary	in-san-i-tar-y
k-nave	knave
pleas-antry	pleas-ant-ry
irid-i-um	i-rid-i-um
tenet	ten-et
the-atri-cal-ly	the-at-ri-cal-ly
mae-stro	maes-tro
defam-a-to-ry	de-fam-a-to-ry
quiet-ness	qui-et-ness
re-sent-men-t	re-sent-ment
de-testable	de-test-a-ble
el-e-men-t	el-e-ment
dotage	dot-age
in-clemen-t	in-clem-ent
over-sim-pli-fy	o-ver-sim-pli-fy
un-prov-able	un-prov-a-ble
ship-men-t	ship-ment
s-train-er	strain-er
s-trap-less	strap-less
pho-to-copi-er	pho-to-cop-i-er
cus-tody	cus-to-dy
decla-ma-tion	dec-la-ma-tion
ex-igu-ous	ex-ig-u-ous
hairy	hair-y
gaun-t	gaunt
trackbed	track-bed
domi-cil-iary	dom-i-cil-i-ar-y
car-bonyl	car-bon-yl
com-plainan-t	com-plain-ant
aster	as-ter
com-pla-cen-t	com-pla-cent
floozy	floo-zy
pala-tial	pa-la-tial
case-men-t	case-ment
smithy	smith-y
ju-bi-lan-t	ju-bi-lant
bomb-shel-l	bomb-shell
no-body	no-bod-y
n-er-vous	nerv-ous
atavis-m	at-a-vism
syn-di-cal-is-m	syn-di-cal-ism
quan-tifi-ca-tion	quan-ti-fi-ca-tion
over-al-l	o-ver-all
s-plen-did	splen-did
renter	rent-er
miser-li-ness	mi-ser-li-ness
polypropy-lene	pol-y-pro-pyl-ene
in-tac-t	in-tact
for-m	form
ple-nary	ple-na-ry
s-ince	since
s-caf-fold-ing	scaf-fold-ing
forest-ed	forested
philo-soph-i-cal-ly	phil-o-soph-i-cal-ly
the-atri-cal	the-at-ri-cal
vac-uole	vac-u-ole
squashy	squash-y
gofer	go-fer
quartzite	quartz-ite
e-u-phemisti-cal-ly	eu-phe-mis-ti-cal-ly
be-muse-men-t	be-muse-ment
s-mug	smug
anony-mous-ly	a-non-y-mous-ly
mal-ad-just-men-t	mal-ad-just-ment
pineap-ple	pine-ap-ple
poignan-cy	poign-an-cy
gazelle	ga-zelle
cor-po-ratist	cor-po-rat-ist
erup-tive	e-rup-tive
triv-ial	triv-i-al
un-com-mu-nica-tive	un-com-mu-ni-ca-tive
gas-work-s	gas-works
s-tar-ry	star-ry
s-can-dalous	scan-dal-ous
bazaar	ba-zaar
re-cal-l	re-call
gneis-s	gneiss
u-nashamed-ly	un-a-sham-ed-ly
decre-men-t	dec-re-ment
pearly	pearl-y
s-tay	stay
re-for-esta-tion	re-for-est-a-tion
brouha-ha	brou-ha-ha
loutish	lout-ish
or-thorhom-bic	or-tho-rhom-bic
mono-graph-ic	mon-o-graph-ic
steve-dore	ste-ve-dore
nympho-ma-ni-a	nym-pho-ma-ni-a
bil-iary	bil-i-ar-y
ho-minid	hom-i-nid
sickbed	sick-bed
u-nan-swer-able	un-an-swer-a-ble
u-n-avail-ing	un-a-vail-ing
crus-tacean	crus-ta-cean
ref-er-ee-ing	re-fe-ree-ing
s-trange	strange
caramel	car-a-mel
mor-tu-ary	mor-tu-ar-y
furtive	fur-tive
in-her-en-t	in-her-ent
triage	tri-age
beau-teous	beau-te-ous
un-sea-son-ably	un-sea-son-a-bly
proac-tive	pro-ac-tive
grouper	group-er
frilly	frill-y
in-elas-tic	in-e-las-tic
penury	pen-u-ry
t-hou-sand	thou-sand
searcher	search-er
d-if-fi-den-t	dif-fi-dent
in-dif-fer-en-t	in-dif-fer-ent
labyrinth	lab-y-rinth
eigh-teen	eight-een
pectin	pec-tin
short-ter-m	short-term
im-per-turbable	im-per-turb-a-ble
baron-age	bar-on-age
whirligig	whirl-i-gig
stylis-tic-s	sty-lis-tics
easel	ea-sel
signet	sig-net
lethal	le-thal
s-loshed	sloshed
flesh-pot-s	flesh-pots
gallery	gal-ler-y
cryo-gen-ic-s	cry-o-gen-ics
s-parkle	spar-kle
epis-temic	ep-i-ste-mic
meta-phys-i-cal	met-a-phys-i-cal
i-n-escapable	in-es-cap-a-ble
there-upon	there-up-on
in-de-fati-ga-ble	in-de-fat-i-ga-ble
provoca-tive	pro-voc-a-tive
re-spectabil-i-ty	re-spect-a-bil-i-ty
k-ing-pin	king-pin
ap-proval	ap-prov-al
es-carp-men-t	es-carp-ment
elec-tric-i-ty	e-lec-tric-i-ty
liny	lin-y
codling	cod-ling
sub-sis-tence	sub-sist-ence
ap-plica-tive	ap-pli-ca-tive
reti-na	ret-i-na
en-dometri-um	en-do-me-tri-um
gen-tri-fied	gentrified
bougainvil-lea	bou-gain-vil-le-a
in-fini-tive	in-fin-i-tive
re-duc-tion-is-m	re-duc-tion-ism
floaty	float-y
cheery	cheer-y
hadron	had-ron
ari-a	a-ri-a
in-ter-dis-ci-pli-nary	in-ter-dis-ci-pli-nar-y
i-n-ap-pro-pri-ate-ly	in-ap-pro-pri-ate-ly
cur-ran-t	cur-rant
lodestar	lode-star
s-tor-age	stor-age
cli-toris	clit-o-ris
s-apling	sap-ling
s-teeple-chase	stee-ple-chase
for-get-table	for-get-ta-ble
necrop-o-lis	ne-crop-o-lis
tidy	ti-dy
methanol	meth-a-nol
spen-t	spent
steady	stead-y
in-di-can-t	in-di-cant
cheru-bic	che-ru-bic
s-neak-i-ly	sneak-i-ly
valiant-ly	val-iant-ly
mod-esty	mod-es-ty
ring-leader	ring-lead-er
a-gree-men-t	a-gree-ment
ra-dius	ra-di-us
swarthy	swarth-y
primeval	pri-me-val
down-load-ed	downloaded
asym-me-try	a-sym-me-try
metro	met-ro
s-cor-pi-on	scor-pi-on
fore-stal-l	fore-stall
muster	mus-ter
phrasal	phras-al
dis-pens-able	dis-pen-sa-ble
balder-dash	bal-der-dash
ethos	e-thos
bi-modal	bi-mod-al
paramed-i-cal	par-a-med-i-cal
coro-n-a	co-ro-na
teething	teeth-ing
s-ling-shot	sling-shot
s-cowl	scowl
fugi-tive	fu-gi-tive
skew-ered	skewered
pro-pa-gan-dis-t	prop-a-gan-dist
phle-boto-my	phle-bot-o-my
dis-mal-l-y	dis-mal-ly
foot-bal-l	foot-ball
ten-able	ten-a-ble
re-assess-men-t	re-as-sess-ment
mag-ne-sium	mag-ne-si-um
trea-sur-er	treas-ur-er
repet-i-tive	re-pet-i-tive
gloat-ing	gloating
ca-cao	ca-ca-o
bony	bon-y
s-now-stor-m	snow-storm
ob-struc-t	ob-struct
un-elect-ed	un-e-lect-ed
tremo-lo	trem-o-lo
stringer	string-er
in-her-i-tance	in-her-it-ance
phoenix	phoe-nix
cretin	cre-tin
readi-ness	read-i-ness
tri-adic	tri-ad-ic
s-tun-t	stunt
collinear	col-lin-e-ar
d-if-fi-cult	dif-fi-cult
teleg-ra-phy	te-leg-ra-phy
s-lan-der	slan-der
mono-cul-ture	mon-o-cul-ture
le-gionary	le-gion-ar-y
coxswain	cox-swain
undis-mayed	un-dis-mayed
s-to-ry-teller	sto-ry-tell-er
nex-t	next
s-to-ical	sto-i-cal
athe-is-tic	a-the-is-tic
barony	bar-o-ny
d-warfed	dwarfed
u-til-i-tar-i-an-is-m	u-til-i-tar-i-an-ism
re-spon-den-t	re-spond-ent
con-ti-nu-ity	con-ti-nu-i-ty
ev-ery-thing	eve-ry-thing
fri-ary	fri-ar-y
hang-glid-ed	hang-gli-ded
briefly	brief-ly
soli-taire	sol-i-taire
s-tock	stock
cy-clotron	cy-clo-tron
d-e-lec-ta-ble	de-lec-ta-ble
bar-barous	bar-ba-rous
u-n-ad-dressed	un-ad-dressed
willpow-er	will-pow-er
declam-a-to-ry	de-clam-a-to-ry
s-mog	smog
louis	lou-is
s-tand-point	stand-point
diminu-tive	di-min-u-tive
ob-scu-ran-tist	ob-scu-rant-ist
ileum	il-e-um
u-niden-ti-fied	un-i-den-ti-fied
s-lack	slack
con-fron-t	con-front
cuboid	cu-boid
epic	ep-ic
ditch-ing	ditching
enig-mat-ic	en-ig-mat-ic
over-flow-ing	o-ver-flo-wing
pun-t	punt
i-n-ac-ti-va-tion	in-ac-ti-va-tion
hit-table	hit-ta-ble
gillie	gil-lie
s-pace-ship	space-ship
con-sum-able	con-sum-a-ble
con-duc-tance	con-duct-ance
s-cat-ter	scat-ter
shep-herd-ing	shepherding
chemise	che-mise
i-n-ad-ver-ten-t	in-ad-vert-ent
pover-ty	pov-er-ty
meso-sphere	mes-o-sphere
in-ven-t	in-vent
mis-cre-an-t	mis-cre-ant
chamois	cham-ois
metronome	met-ro-nome
s-tow-away	stow-a-way
pro-ject-ing	projecting
s-care-mon-ger-ing	scare-mon-ger-ing
polyun-sat-u-rat-ed	pol-y-un-sat-u-rat-ed
ab-sen-t	ab-sent
s-lip-ping	slipping
widescreen	wide-screen
com-paction	com-pac-tion
ef-fec-t	ef-fect
over-cast	o-ver-cast
mis-cel-lany	mis-cel-la-ny
em-bed-dable	em-bed-da-ble
poly-mer	pol-y-mer
gullible	gul-li-ble
ex-porta-bil-i-ty	ex-por-ta-bi-li-ty
polygamy	po-lyg-a-my
elo-quent-ly	el-o-quent-ly
hor-mon-al	hor-mo-nal
s-tat-uesque	stat-u-esque
preva-len-t	prev-a-lent
plexus	plex-us
au-thor-i-tar-i-an-is-m	au-thor-i-tar-i-an-ism
u-nim-por-tance	un-im-por-tance
in-sis-tence	in-sist-ence
en-thalpy	en-thal-py
seascape	sea-scape
in-tel-li-gentsi-a	in-tel-li-gent-si-a
con-flict-ual	con-flic-tu-al
s-carab	scar-ab
polypep-tide	pol-y-pep-tide
untest-ed	un-test-ed
ter-ror-is-m	ter-ror-ism
ima-go	i-ma-go
s-ab-bat-i-cal	sab-bat-i-cal
babysit-ter	ba-by-sit-ter
ceilid-h	cei-lidh
waspish	wasp-ish
breath-able	breath-a-ble
hourly	hour-ly
velour	ve-lour
io-dide	i-o-dide
si-lencer	si-lenc-er
bio-di-ver-si-ty	bi-o-di-ver-si-ty
k-ilo-wat-t	kil-o-watt
pitiable	pit-i-a-ble
p-re-sen-ti-men-t	pre-sen-ti-ment
parish	par-ish
key-boardis-t	key-board-ist
con-ceal-men-t	con-ceal-ment
s-lipped	slipped
vacu-ity	va-cu-i-ty
opales-cen-t	o-pal-es-cent
trigonom-e-try	trig-o-nom-e-try
radix	ra-dix
repa-tri-a-tion	re-pa-tri-a-tion
i-n-of-fen-sive	in-of-fen-sive
re-ceip-t	re-ceipt
ev-i-den-t	ev-i-dent
grapevine	grape-vine
s-tom-ach	stom-ach
coax-i-al	co-ax-i-al
footwear	foot-wear
mil-lenar-i-an-is-m	mil-le-nar-i-an-ism
in-no-cen-t	in-no-cent
pom-p	pomp
y-on	yon
ar-bi-trary	ar-bi-trar-y
ethic-s	eth-ics
phono-log-i-cal	pho-no-log-i-cal
undiplo-mat-ic	un-dip-lo-mat-ic
night-fal-l	night-fall
s-to-ical-ly	sto-i-cal-ly
com-pen-dium	com-pen-di-um
vari-able	var-i-a-ble
dipole	di-pole
bal-lis-tic-s	bal-lis-tics
nightwear	night-wear
s-lalom	sla-lom
con-stituen-t	con-stit-u-ent
t-ele-con-fer-ence	tel-e-con-fer-ence
dis-cred-it-ed	discredited
racial-is-m	ra-cial-ism
fluffy	fluff-y
sub-ter-ranean	sub-ter-ra-ne-an
un-con-scionable	un-con-scion-a-ble
over-due	o-ver-due
in-suf-fer-able	in-suf-fer-a-ble
un-steady	un-stead-y
painful	pain-ful
av-enue	av-e-nue
ca-nary	ca-nar-y
over-ex-po-sure	o-ver-ex-po-sure
con-flict-ed	conflicted
poly-syl-lab-ic	pol-y-syl-lab-ic
gut-sy	guts-y
in-valid	in-va-lid
in-deco-rous	in-dec-o-rous
pro-tect-ed	protected
steamship	steam-ship
y-acht	yacht
tho-raci-c	tho-rac-ic
hook-ing	hooking
pedestal	ped-es-tal
sus-tain-abil-i-ty	sus-tain-a-bil-i-ty
bushel	bush-el
s-toat	stoat
speci-fici-ty	spec-i-fic-i-ty
s-ports-man	sports-man
ax-il-lary	ax-il-lar-y
think-able	think-a-ble
s-nowflake	snow-flake
weari-ly	wea-ri-ly
quain-t	quaint
nympho-ma-ni-ac	nym-pho-ma-ni-ac
rhubar-b	rhu-barb
ridicu-lous-ness	ri-dic-u-lous-ness
sinis-tral	sin-is-tral
ir-re-place-able	ir-re-place-a-ble
paci-fist	pac-i-fist
at-temp-t	at-tempt
ar-c	arc
s-melt	smelt
premis-es	prem-is-es
over-take	o-ver-take
telekine-sis	tel-e-ki-ne-sis
clair-voy-an-t	clair-voy-ant
so-ci-etal	so-ci-e-tal
ca-ma-raderie	ca-ma-ra-de-rie
moral-is-tic	mor-al-is-tic
wind-fal-l	wind-fall
berserk	ber-serk
loathing	loath-ing
u-nas-sist-ed	un-as-sist-ed
ev-ery-where	eve-ry-where
origa-mi	o-ri-ga-mi
foam-ing	foaming
war-ran-t	war-rant
delu-sion	de-lu-sion
per-hap-s	per-haps
ini-ti-ate	in-i-ti-ate
s-traight-for-ward	straight-for-ward
spinal	spi-nal
grimy	grim-y
re-pub-li-can-is-m	re-pub-li-can-ism
sign-er-s	sign-ers
tasty	tast-y
tourni-quet	tour-ni-quet
swarm-ing	swarming
dili-gence	dil-i-gence
roof-in-g	roof-ing
milliner	mil-li-ner
hearsay	hear-say
elfin	elf-in
colum-nar	co-lum-nar
mil-i-tary	mil-i-tar-y
de-pen-den-t	de-pend-ent
per-e-stroi-ka	pe-re-stroi-ka
s-tran-gle-hold	stran-gle-hold
quaf-f	quaff
con-cep-t	con-cept
pati-na-tion	pat-i-na-tion
handy	hand-y
over-crowd	o-ver-crowd
treach-ery	treach-er-y
kinder-garten	kin-der-gar-ten
w-hole-saler	whole-sal-er
tonedeaf	tone-deaf
over-ca-pac-i-ty	o-ver-ca-pac-i-ty
can-dlelit	can-dle-lit
en-dother-mic	en-do-ther-mic
s-tupid-ly	stu-pid-ly
ex-ult-ing	exulting
ac-cen-t	ac-cent
dairy-ing	dair-y-ing
lizard	liz-ard
ar-ro-gan-t	ar-ro-gant
se-can-t	se-cant
dance-able	dance-a-ble
fraud-u-len-t	fraud-u-lent
cornea	cor-ne-a
retro-fit	ret-ro-fit
re-stroom	rest-room
beery	beer-y
im-pres-sion-able	im-pres-sion-a-ble
pre-cep-t	pre-cept
en-chanter	en-chant-er
ar-ranger	ar-rang-er
tin-t	tint
kinky	kink-y
causal-i-ty	cau-sal-i-ty
pity	pit-y
mesca-line	mes-ca-line
gun-metal	gun-met-al
ve-nial	ve-ni-al
quadri-par-tite	quad-ri-par-tite
p-salter	psal-ter
prefa-to-ry	pref-a-to-ry
miser	mi-ser
es-capis-m	es-cap-ism
man-i-cured	ma-ni-cured
felon	fel-on
com-mer-cial-is-m	com-mer-cial-ism
em-ploy-able	em-ploy-a-ble
busi-nesslike	busi-ness-like
cowslip	cow-slip
lyri-cist	lyr-i-cist
ide-o-log-i-cal	i-de-o-log-i-cal
over-heat	o-ver-heat
diplo-mat-ic	dip-lo-mat-ic
avenger	a-veng-er
wilder-ness	wil-der-ness
fi-nale	fi-na-le
shogun	sho-gun
tena-cious	te-na-cious
witch-ery	witch-er-y
pre-lim-i-nary	pre-lim-i-nar-y
d-u-al-is-m	du-al-ism
feal-ty	fe-al-ty
un-der-stand-ably	un-der-stand-a-bly
ratepay-er	rate-pay-er
undis-cov-ered	un-dis-cov-ered
bat-tle-men-t	bat-tle-ment
tele-o-log-i-cal	tel-e-o-log-i-cal
discog-ra-phy	dis-cog-ra-phy
s-tand-stil-l	stand-still
aver	a-ver
abroad	a-broad
ide-al-i-ty	i-de-al-i-ty
s-in-cere-ly	sin-cere-ly
plat-inum	plat-i-num
chivvy	chiv-vy
abuse	a-buse
s-nig-ger	snig-ger
for-syth-ia	for-syth-i-a
hy-per-boloid	hy-per-bo-loid
re-liv-e	re-live
chro-mo-so-ma-l	chro-mo-so-mal
ex-is-ten-tial-is-m	ex-is-ten-tial-ism
k-ing-fish-er	king-fish-er
o-r-a-to-ry	or-a-to-ry
cus-p	cusp
stripling	strip-ling
mi-cro-cos-m	mi-cro-cosm
chirpy	chirp-y
poster	post-er
fetid	fet-id
dele-tion	de-le-tion
idea	i-de-a
at-tribute	at-trib-ute
in-di-gestible	in-di-gest-i-ble
frica-tive	fric-a-tive
dis-cour-age-men-t	dis-cour-age-ment
s-ap-per	sap-per
un-able	un-a-ble
fig-u-ra-tive-ly	fig-ur-a-tive-ly
minute-ly	mi-nute-ly
s-nout	snout
pay-rol-l	pay-roll
re-sis-tan-t	re-sist-ant
quo-tien-t	quo-tient
hon-orary	hon-or-ar-y
tabloid	tab-loid
mono-chrome	mon-o-chrome
hideous	hid-e-ous
mod-ernist	mod-ern-ist
cap-i-tal-is-m	cap-i-tal-ism
crawler	crawl-er
div-ina-tion	div-i-na-tion
pun-ish-able	pun-ish-a-ble
choosy	choos-y
lazi-ness	la-zi-ness
gestalt	ge-stalt
dis-tur-b	dis-turb
hov-e	hove
testable	test-a-ble
con-queror	con-quer-or
anom-aly	a-nom-a-ly
om-nipres-ence	om-ni-pres-ence
din-t	dint
re-gion-al-is-m	re-gion-al-ism
hy-dro-dy-nam-ic-s	hy-dro-dy-nam-ics
in-deli-ble	in-del-i-ble
mono-ma-ni-a	mon-o-ma-ni-a
mis-chievous	mis-chie-vous
e-s-py	es-py
over-stretch	o-ver-stretch
u-n-avoid-ably	un-a-void-a-bly
spi-dery	spi-der-y
cen-tipede	cen-ti-pede
knuck-le-duster	knuck-le-dust-er
erot-ic	e-rot-ic
table-ware	ta-ble-ware
streaky	streak-y
puma	pu-ma
gov-ern-men-t	gov-ern-ment
ir-rel-e-van-t	ir-rel-e-vant
sug-gestible	sug-gest-i-ble
springer	spring-er
seclu-sion	se-clu-sion
dauber	daub-er
rheumat-ic	rheu-mat-ic
un-for-get-table	un-for-get-ta-ble
cedil-la	ce-dil-la
lu-mi-nes-cen-t	lu-mi-nes-cent
com-plain-ing	complaining
tit-ter-ing	tittering
beeswax	bees-wax
mo-men-tary	mo-men-tar-y
bear-able	bear-a-ble
gree-nie	green-ie
shoplift	shop-lift
per-i	pe-ri
gigo-lo	gig-o-lo
ven-t	vent
ig-no-ran-t	ig-no-rant
lap-idary	lap-i-dar-y
transcon-ti-nen-tal	trans-con-ti-nen-tal
con-tractible	con-tract-i-ble
imag-in-able	im-ag-i-na-ble
li-bidi-nous	li-bid-i-nous
bat-ter-ing	battering
roadmap	road-map
enor-mous-ly	e-nor-mous-ly
in-tifa-da	in-ti-fa-da
up-silon	up-si-lon
s-tarfish	star-fish
elec-tron-ic	e-lec-tron-ic
s-mug-gler	smug-gler
e-s-pe-cial-ly	es-pe-cial-ly
g-nom-ic	gno-mic
sprawl-ing	sprawling
es-cape-men-t	es-cape-ment
re-cum-ben-t	re-cum-bent
dum-b	dumb
propane	pro-pane
e-d-uca-tive	ed-u-ca-tive
be-wil-dered	bewildered
shoplift-ing	shop-lift-ing
ren-t	rent
recorder	re-cord-er
s-lant-ed	slanted
in-fringe-men-t	in-fringe-ment
lever	lev-er
briefer	brief-er
s-ketch	sketch
pompous	pomp-ous
e-quinoc-tial	e-qui-noc-tial
labi-al	la-bi-al
t-wofold	two-fold
hu-mankind	hu-man-kind
re-former	re-form-er
in-signif-i-can-t	in-sig-nif-i-cant
deeply	deep-ly
tidal	tid-al
pro-gressed	progressed
velo-drome	ve-lo-drome
k-lick	klick
re-duc-ible	re-duc-i-ble
mono-logue	mon-o-logue
gamy	gam-y
dentin	den-tin
gal-lantry	gal-lant-ry
makeweight	make-weight
recharge-able	re-charge-a-ble
g-o-nad	go-nad
reroute	re-route
u-nas-sail-able	un-as-sail-a-ble
cred-it-wor-thy	cred-it-worth-y
viaduc-t	vi-a-duct
sep-a-ratist	sep-a-ra-tist
satiny	sat-in-y
per-pe-tu-ity	per-pe-tu-i-ty
ma-joli-ca	ma-jol-i-ca
s-taunch	staunch
pro-pri-etary	pro-pri-e-tar-y
chateau	cha-teau
nestling	nest-ling
gud-geon	gudg-eon
s-ca-lene	sca-lene
s-tacked	stacked
mendele-vi-um	men-de-le-vi-um
s-carce-ly	scarce-ly
isother-mal	i-so-ther-mal
s-cuf-f	scuff
vana-di-um	va-na-di-um
pa-pyrus	pa-py-rus
s-plut-ter-ing	spluttering
prophet-ess	proph-et-ess
un-rol-l	un-roll
gin-sen-g	gin-seng
cen-trifuge	cen-tri-fuge
felo-nious	fe-lo-ni-ous
d-in-gle	din-gle
se-man-tic-s	se-man-tics
pro-to-zoan	pro-to-zo-an
semi-con-duct-ing	sem-i-con-duct-ing
gamut	gam-ut
acid	ac-id
tele-scop-ic	tel-e-scop-ic
ef-fer-en-t	ef-fer-ent
delta	del-ta
in-ter-locu-to-ry	in-ter-loc-u-to-ry
l-it-i-gate	lit-i-gate
lazi-ly	la-zi-ly
un-remit-ting	un-re-mit-ting
mileage	mile-age
s-lo-gan	slo-gan
ledger	ledg-er
taskmas-ter	task-mas-ter
s-cullery	scul-ler-y
cursed	curs-ed
bio-chemist	bi-o-chem-ist
nitwit	nit-wit
parch-men-t	parch-ment
bes-tiary	bes-ti-ar-y
proph-esy	proph-e-sy
modal	mod-al
morass	mo-rass
oboe	o-boe
ini-tial-ly	in-i-tial-ly
regime	re-gime
hep-tagon	hep-ta-gon
cour-tesy	cour-te-sy
moun-taineer-ing	moun-tain-eer-ing
elec-tro-dy-nam-ic-s	e-lec-tro-dy-nam-ics
restora-tive	re-stor-a-tive
baleen	ba-leen
cabri-o-let	cab-ri-o-let
com-man-dan-t	com-man-dant
hereti-cal	he-ret-i-cal
ir-rec-on-cil-able	ir-rec-on-cil-a-ble
s-woop	swoop
lassie	las-sie
light-s	lights
in-de-ter-minable	in-de-ter-mi-na-ble
obe-di-ence	o-be-di-ence
con-trac-t	con-tract
in-flic-t	in-flict
pedol-o-gy	pe-dol-o-gy
hussy	hus-sy
oc-tan-t	oc-tant
cloa-ca	clo-a-ca
chorale	cho-rale
su-per-cil-ious	su-per-cil-i-ous
atyp-i-cal	a-typ-i-cal
dis-en-fran-chise-men-t	dis-en-fran-chise-ment
sax-ony	sax-o-ny
g-land	gland
s-tonework	stone-work
pros-e	prose
an-ti-quary	an-ti-quar-y
at-trib-ut-able	at-trib-ut-a-ble
gro-cery	gro-cer-y
se-questered	se-ques-tered
un-wrap-s	un-wraps
re-union	re-un-ion
goa-tee	goat-ee
phi-late-ly	phi-lat-e-ly
re-pro-ducibly	re-pro-duc-i-bly
en-tropy	en-tro-py
steadi-ly	stead-i-ly
u-p-end-ed	upended
repro-bate	rep-ro-bate
as-trin-gen-t	as-trin-gent
d-if-fer-en-tiable	dif-fer-en-ti-a-ble
galling	gall-ing
pecan	pe-can
c-it-i-zen-ship	cit-i-zen-ship
kayak	kay-ak
mis-ery	mis-er-y
archangel	arch-an-gel
semi-cir-cle	sem-i-cir-cle
con-struc-t	con-struct
cle-f	clef
in-vari-able	in-var-i-a-ble
rivulet	riv-u-let
ele-giac	el-e-gi-ac
en-durable	en-dur-a-ble
e-quer-ry	eq-uer-ry
video-tape	vid-e-o-tape
ju-bilee	ju-bi-lee
un-gentle-man-ly	un-gen-tle-man-ly
vicin-i-ty	vi-cin-i-ty
ravi-o-li	ra-vi-o-li
milord	mi-lord
un-think-able	un-think-a-ble
in-fi-deli-ty	in-fi-del-i-ty
dy-nam-ic-s	dy-nam-ics
eigen-func-tion	ei-gen-func-tion
de-cayed	decayed
as-sign-men-t	as-sign-ment
crosstalk	cross-talk
pikestaff	pike-staff
opi-um	o-pi-um
mar-malade	mar-ma-lade
moun-tain-sid-e	moun-tain-side
wafer	wa-fer
prompter	prompt-er
cu-rios-i-ty	cu-ri-os-i-ty
psy-cho-me-t-ric	psy-cho-met-ric
sulky	sulk-y
mimet-ic	mi-met-ic
archetype	ar-che-type
copy-ist	cop-y-ist
in-deli-bly	in-del-i-bly
over-crowd-ed	o-ver-crow-ded
chore-og-ra-pher	cho-re-og-ra-pher
politic	pol-i-tic
brandy	bran-dy
warpath	war-path
re-trench-men-t	re-trench-ment
en-cryp-t	en-crypt
re-deemer	re-deem-er
s-later	slat-er
atom	at-om
en-tran-t	en-trant
quixot-ic	quix-ot-ic
weasel	wea-sel
s-tat-uette	stat-u-ette
supreme	su-preme
car-borun-dum	car-bo-run-dum
s-e-lec-tor	se-lec-tor
va-porous	va-por-ous
em-piri-cis-m	em-pir-i-cism
er-bium	er-bi-um
s-to-ry-book	sto-ry-book
ig-no-min-ious	ig-no-min-i-ous
ethnog-ra-phy	eth-nog-ra-phy
prairie	prai-rie
s-lut	slut
com-part-men-t	com-part-ment
droopy	droop-y
swelling	swell-ing
s-trait-en	strait-en
par-a-sitic	par-a-sit-ic
prelate	prel-ate
in-duc-t	in-duct
re-f	ref
sec-ondary	sec-ond-ar-y
d-e-duc-tion	de-duc-tion
hectare	hec-tare
s-tarlight	star-light
timid	tim-id
vig-i-lante	vig-i-lan-te
waster	wast-er
feath-ery	feath-er-y
s-lith-er	slith-er
dis-en-chant-men-t	dis-en-chant-ment
lun-cheon	lunch-eon
wari-ness	war-i-ness
overnight	o-ver-night
ex-tra-galac-tic	ex-tra-ga-lac-tic
ex-cep-t	ex-cept
in-ca-pable	in-ca-pa-ble
un-prof-itable	un-prof-it-a-ble
oldie	old-ie
s-nack	snack
s-ta-tion-mas-ter	sta-tion-mas-ter
lugubri-ous	lu-gu-bri-ous
mar-garine	mar-ga-rine
poly-mor-phic	pol-y-mor-phic
de-ter-minable	de-ter-mi-na-ble
over-anx-ious	o-ver-anx-ious
javelin	jave-lin
volatile	vol-a-tile
un-no-tice-able	un-no-tice-a-ble
chom-p	chomp
s-moth-er	smoth-er
asymp-tote	as-ymp-tote
un-bridge-able	un-bridge-a-ble
un-touch-able	un-touch-a-ble
undy-ing	un-dy-ing
dis-in-fec-tan-t	dis-in-fect-ant
p-re-sen-ta-tion	pres-en-ta-tion
rheuma-tol-o-gy	rheu-ma-tol-o-gy
duf-f	duff
aza-lea	a-zal-ea
ra-dio-graph	ra-di-o-graph
k-i-na	ki-na
coac-tion	co-ac-tion
mirac-u-lous	mi-rac-u-lous
vestibu-lar	ves-tib-u-lar
rep-utable	rep-u-ta-ble
s-toop	stoop
triglyc-eride	tri-glyc-er-ide
rain-fal-l	rain-fall
sleepi-ness	sleep-i-ness
timescale	time-scale
un-watch-able	un-watch-a-ble
mistle-toe	mis-tle-toe
able	a-ble
per-fec-tion-is-m	per-fec-tion-ism
s-limy	slim-y
de-jec-t	de-ject
phooey	phoo-ey
sweaty	sweat-y
prefer-ably	pref-er-a-bly
over-reach	o-ver-reach
sil-vered	silvered
ve-loci-pede	ve-loc-i-pede
ur-gen-t	ur-gent
eon	e-on
im-pro-pri-ety	im-pro-pri-e-ty
poly-chrome	pol-y-chrome
gaseous	gas-e-ous
pathos	pa-thos
ar-guably	ar-gu-a-bly
tele-ol-o-gy	tel-e-ol-o-gy
io-ta	i-o-ta
hon-esty	hon-es-ty
minu-ti-ae	mi-nu-ti-ae
enor-mi-ty	e-nor-mi-ty
re-in-force-men-t	re-in-force-ment
u-nimag-in-ably	un-im-ag-i-na-bly
im-pon-der-able	im-pon-der-a-ble
s-ten-to-ri-an	sten-to-ri-an
pla-cen-tae	pla-cen-tae
un-easy	un-eas-y
drowsi-ness	drow-si-ness
ef-ful-gen-t	ef-ful-gent
book-binder	book-bind-er
de-ter-mi-nan-t	de-ter-mi-nant
an-tipa-thet-ic	an-ti-pa-thet-ic
rever-ie	rev-er-ie
salien-t	sa-li-ent
mayflow-er	may-flow-er
crino-line	crin-o-line
op-er-a-tional	op-er-a-tion-al
s-words-man	swords-man
goulash	gou-lash
flossy	floss-y
im-peach-men-t	im-peach-ment
silent-ly	si-lent-ly
im-porter	im-port-er
endgame	end-game
savvy	sav-vy
s-cot	scot
caseload	case-load
un-man-age-able	un-man-age-a-ble
do-lor-ous	dol-or-ous
supreme-ly	su-preme-ly
crisper	crisp-er
in-ter-minable	in-ter-mi-na-ble
aqualung	aq-ua-lung
duchess	duch-ess
dis-claimer	dis-claim-er
sav-agery	sav-age-ry
pago-da	pa-go-da
mau-soleum	mau-so-le-um
ef-fi-cien-t	ef-fi-cient
lo-quac-ity	lo-quac-i-ty
s-mart-ing	smart-ing
pi-rat-ed	pirated
phe-nomenol-o-gy	phe-nom-e-nol-o-gy
sounder	sound-er
erad-i-cate	e-rad-i-cate
over-weight	o-ver-weight
backpedal	back-ped-al
omen	o-men
ar-chiv-ist	ar-chi-vist
crum-bling	crumbling
dusty	dust-y
tour-na-men-t	tour-na-ment
rec-ol-lec-t	rec-ol-lect
birdie	bird-ie
baron	bar-on
erup-t	e-rupt
legged	leg-ged
revenan-t	rev-e-nant
e-h	eh
ni-troge-nous	ni-trog-e-nous
con-duct-ed	conducted
elec-tion	e-lec-tion
quadrupole	quad-ru-pole
over-spend	o-ver-spend
en-teri-tis	en-ter-i-tis
tam-bourine	tam-bou-rine
i-nane	in-ane
pussy-cat	pussycat
s-worn	sworn
biofeed-back	bi-o-feed-back
bathos	ba-thos
un-quench-able	un-quench-a-ble
weari-ness	wea-ri-ness
run-t	runt
sub-scrip-t	sub-script
here-upon	here-up-on
lusty	lust-y
e-jec-t	e-ject
over-am-bi-tious	o-ver-am-bi-tious
s-tance	stance
com-mis-sioned	commissioned
frown-ing	frowning
b-otany	bot-a-ny
mic-turi-tion	mic-tu-ri-tion
iso-stat-ic	i-so-stat-ic
undis-tin-guished	un-dis-tin-guished
puree	pu-ree
tum-bled	tumbled
de-ten-t	de-tent
mal-adroit	mal-a-droit
pesti-len-t	pes-ti-lent
i-n-ad-e-quate-ly	in-ad-e-quate-ly
layabout	lay-a-bout
an-thro-pogenic	an-thro-po-gen-ic
fleshy	flesh-y
ir-ri-tabil-i-ty	ir-ri-ta-bil-i-ty
whirlpool	whirl-pool
face-tious	fa-ce-tious
bradawl	brad-awl
cool-ing	cooling
daun-t	daunt
deis-m	de-ism
s-cald-ing	scald-ing
pumice	pum-ice
pleat-ed	pleated
bias	bi-as
o-h	oh
mon-e-taris-m	mon-e-ta-rism
cob-we-b	cob-web
con-jec-tural	con-jec-tur-al
ar-rival	ar-ri-val
sawyer	saw-yer
sideshow	side-show
re-bury	re-bur-y
recre-ation	rec-re-a-tion
l-itotes	li-to-tes
ema-ci-at-ed	e-ma-ci-at-ed
plaza	pla-za
tenon	ten-on
sibi-lan-t	sib-i-lant
op-er-a-tional-ly	op-er-a-tion-al-ly
vig-i-lan-t	vig-i-lant
ex-plorato-ry	ex-plor-a-to-ry
moist-en	mois-ten
cat-a-clysmic	cat-a-clys-mic
clumpy	clump-y
deben-ture	de-ben-ture
tyran-ni-cal	ty-ran-ni-cal
re-gen-t	re-gent
beanstalk	bean-stalk
artist	art-ist
in-com-press-ible	in-com-press-i-ble
vestibule	ves-ti-bule
fly-away	fly-a-way
s-marten	smart-en
u-n-avail-abil-i-ty	un-a-vail-a-bil-i-ty
s-pank	spank
babysit	ba-by-sit
cyn-i-cis-m	cyn-i-cism
pro-tec-tion-is-m	pro-tec-tion-ism
panoram-ic	pan-o-ram-ic
cycli-cal	cy-cli-cal
numb-skul-l	numb-skull
poly-math	pol-y-math
gal-axy	gal-ax-y
iron-stone	i-ron-stone
palatal	pal-a-tal
un-der-ar-m	un-der-arm
mea-sured	meas-ured
con-ceiv-ably	con-ceiv-a-bly
sever-i-ty	se-ver-i-ty
over-whelm-ing-ly	o-ver-whelm-ing-ly
scrolling	scroll-ing
panache	pa-nache
em-bo-som	em-bos-om
ex-cep-tion-able	ex-cep-tion-a-ble
s-ingsong	sing-song
de-viance	de-vi-ance
colosto-my	co-los-to-my
su-per-abun-dan-t	su-per-a-bun-dant
killer	kil-ler
el-e-men-tary	el-e-men-ta-ry
idyl-l	i-dyll
in-quisi-to-ri-al	in-quis-i-to-ri-al
fi-brob-last	fi-bro-blast
de-mo	dem-o
fran-chisee	fran-chi-see
re-cen-t	re-cent
s-pas-m	spasm
whif-f	whiff
gleam-ing	gleaming
im-politic	im-pol-i-tic
cre-ative	cre-a-tive
metaphor-i-cal	met-a-phor-i-cal
rec-ti-lin-ear	rec-ti-lin-e-ar
largo	lar-go
fa-tal-is-m	fa-tal-ism
fer-ven-t	fer-vent
ap-proach-able	ap-proach-a-ble
speedome-ter	speed-om-e-ter
prover-bial	pro-ver-bi-al
u-p-land	up-land
golfer	golf-er
itin-er-ary	i-tin-er-ar-y
majesty	maj-es-ty
over-board	o-ver-board
dol-l	doll
s-lip-shod	slip-shod
avowed	a-vowed
over-writ-ing	overwriting
oafish	oaf-ish
an-thracite	an-thra-cite
s-mack-er	smack-er
erased	e-rased
a-balone	ab-a-lo-ne
palimpses-t	pal-imp-sest
mag-ne-tome-ter	mag-ne-tom-e-ter
petro-chem-i-cal	pet-ro-chem-i-cal
e-t-y-mo-log-i-cal	et-y-mo-log-i-cal
arouse	a-rouse
pro-pri-etor-ship	pro-pri-e-tor-ship
tur-bu-len-t	tur-bu-lent
re-main-s	re-mains
ban-tamweight	ban-tam-weight
as-pidis-tra	as-pi-dis-tra
de-ni-able	de-ni-a-ble
an-titrust	an-ti-trust
maisonette	mai-son-ette
lantern	lan-tern
over-throw	o-ver-throw
hero-ine	her-o-ine
sexy	sex-y
un-de-ni-ably	un-de-ni-a-bly
lyrist	lyr-ist
s-mirk-ing	smirking
psy-choso-cial	psy-cho-so-cial
funky	funk-y
i-n-ac-tiv-i-ty	in-ac-tiv-i-ty
g-naw	gnaw
de-crepit	de-crep-it
c-it-ron	cit-ron
dosage	dos-age
ex-or-bi-tan-t	ex-or-bi-tant
theodo-lite	the-od-o-lite
in-ter-locu-tor	in-ter-loc-u-tor
penu-ri-ous	pe-nu-ri-ous
ruf-f	ruff
ex-ac-t	ex-act
s-tul-ti-fy	stul-ti-fy
bil-liard-s	bil-liards
river-ine	riv-er-ine
anoma-lous	a-nom-a-lous
roundel	roun-del
usu-ri-ous	u-su-ri-ous
fin-ery	fin-er-y
dis-in-fec-t	dis-in-fect
synapse	syn-apse
stealth-ily	stealth-i-ly
mag-netite	mag-net-ite
c-on-cil-iar	con-cil-i-ar
loft-ed	lofted
menswear	mens-wear
pilchard	pil-chard
hide-away	hide-a-way
un-ob-ser-van-t	un-ob-serv-ant
an-swer-able	an-swer-a-ble
lava-to-ri-al	lav-a-to-ri-al
open-ness	o-pen-ness
as-siduity	as-si-du-i-ty
Words with errors: 2222
Words with incorrect number of syllables: 2025
Total evluated: 6500
Perfect accuracy: 0.66
Number of syllables accuracy: 0.69
Average Levenshtein Distance(across incorrect words): 1.24
