Attempt	Real
beryl	ber-yl
sonar	so-nar
palatal	pal-a-tal
un-de-sir-able	un-de-sir-a-ble
cli-toral	clit-o-ral
rusty	rust-y
psy-chi-atric	psy-chi-at-ric
recheck	re-check
un-spen-t	un-spent
painful-ly	pain-ful-ly
gov-er-nance	gov-ern-ance
sprayer	spray-er
de-liv-er-able	de-liv-er-a-ble
mil-l	mill
us-able	us-a-ble
nougat	nou-gat
cir-cum-spec-t	cir-cum-spect
gusty	gust-y
eu-gen-ic-s	eu-gen-ics
over-whelm	o-ver-whelm
pen-t	pent
prelate	prel-ate
wigeon	wig-eon
garbage	gar-bage
miser	mi-ser
pas-san-t	pas-sant
reim-pose	re-im-pose
arm-s	arms
dere-lic-tion	der-e-lic-tion
tele-graph-ic	tel-e-graph-ic
d-if-fer-ent-ly	dif-fer-ent-ly
d-u-al-i-ty	du-al-i-ty
barter	bar-ter
k-ing-fish-er	king-fish-er
chemist	chem-ist
pere-grine	per-e-grine
marten	mar-ten
trol-l	troll
me-chan-ic-s	me-chan-ics
dis-join-t	dis-joint
cater	ca-ter
bac-teri-um	bac-te-ri-um
dis-band-men-t	dis-band-ment
nurs-ery	nurs-er-y
duet	du-et
reser-va-tion	res-er-va-tion
seedbed	seed-bed
con-duct-ed	conducted
car-dio-vas-cu-lar	car-di-o-vas-cu-lar
rein-vest-men-t	re-in-vest-ment
geo-sta-tion-ary	ge-o-sta-tion-ar-y
cupo-la	cu-po-la
sum-mon-s	sum-mons
pan-the-is-m	pan-the-ism
iso-ton-ic	i-so-ton-ic
muf-f	muff
dis-com-fort-ing	discomforting
gul-l	gull
lo-bot-omy	lo-bot-o-my
el-l	ell
lech-ery	lech-er-y
s-lat-ted	slat-ted
s-cam-per	scamp-er
translu-cen-cy	trans-lu-cen-cy
iso-la-tion-ist	i-so-la-tion-ist
boyfriend	boy-friend
doc-u-men-t	doc-u-ment
squalor	squal-or
ogle	o-gle
sahib	sa-hib
hy-gien-ic	hy-gi-en-ic
col-lec-t	col-lect
in-ge-nious	in-gen-ious
idea	i-de-a
in-tox-i-can-t	in-tox-i-cant
celiba-cy	cel-i-ba-cy
warthog	wart-hog
fuse-lage	fu-se-lage
proph-esy	proph-e-sy
s-tair-head	stair-head
in-ex-press-ible	in-ex-press-i-ble
metaphor	met-a-phor
rat-tlesnake	rat-tle-snake
chaf-f	chaff
pli-able	pli-a-ble
s-ti-fle	sti-fle
brioche	bri-oche
rep-til-ian	rep-til-i-an
su-per-fluity	su-per-flu-i-ty
s-tarter	start-er
banger	bang-er
ine-bri-a-tion	in-e-bri-a-tion
vari-cose	var-i-cose
in-abil-i-ty	in-a-bil-i-ty
mythol-o-gy	my-thol-o-gy
un-suit-able	un-suit-a-ble
dormer	dor-mer
bradawl	brad-awl
s-tar-lit	star-lit
arthro-pod	ar-thro-pod
con-tention	con-ten-tion
plenum	ple-num
un-men-tion-able	un-men-tion-a-ble
dy-namis-m	dy-na-mism
neonate	ne-o-nate
moc-casin	moc-ca-sin
tusker	tusk-er
in-con-testable	in-con-test-a-ble
vir-u-len-t	vir-u-lent
vol-can-is-m	vol-can-ism
down-load-ed	downloaded
elec-trophore-sis	e-lec-tro-pho-re-sis
chid-ing	chiding
ir-re-solv-able	ir-re-solv-a-ble
rapid-ly	rap-id-ly
monog-a-mous	mo-nog-a-mous
d-if-fer-en-ti-ate	dif-fer-en-ti-ate
raisin	rai-sin
col-lec-tivi-sa-tion	col-lec-ti-vi-sa-tion
mono-plane	mon-o-plane
buoy-an-t	buoy-ant
vig-i-lan-t	vig-i-lant
het-ero-ge-neous	het-er-o-ge-ne-ous
re-bury	re-bur-y
c-leg	cleg
grantee	gran-tee
em-broi-dery	em-broi-der-y
ten-an-t	ten-ant
i-nessen-tial	in-es-sen-tial
spencer	spen-cer
halo-gen	hal-o-gen
pep-pered	peppered
for-mal-is-m	for-mal-ism
dero-ga-tion	der-o-ga-tion
dis-tur-b	dis-turb
sec-tar-i-an-is-m	sec-tar-i-an-ism
bian-nu-al	bi-an-nu-al
skil-l	skill
dis-may-ing	dismaying
e-spres-so	es-pres-so
co-conut	co-co-nut
avarice	av-a-rice
calami-tous	ca-lam-i-tous
geo-met-ric	ge-o-met-ric
in-nard-s	in-nards
u-nion-ist	un-ion-ist
per-fec-tion-is-m	per-fec-tion-ism
sibi-lan-t	sib-i-lant
co-eval	co-e-val
l-itotes	li-to-tes
over-feed	o-ver-feed
alar-m	a-larm
in-fin-ite-ly	in-fi-nite-ly
ret-ro-spec-t	ret-ro-spect
dis-turbing-ly	dis-turb-ing-ly
in-ter-minable	in-ter-mi-na-ble
teenag-er	teen-ag-er
bel-l	bell
bene-fac-tress	ben-e-fac-tress
witch-ery	witch-er-y
hearty	heart-y
a-part-men-t	a-part-ment
pun-y	pu-ny
p-re-sen-ter	pre-sent-er
ful-mi-nan-t	ful-mi-nant
s-culp-t	sculpt
di-aphrag-mat-ic	di-a-phrag-mat-ic
naked	na-ked
unglam-orous	un-glam-or-ous
bistro	bis-tro
over-fil-l	o-ver-fill
meta-mor-phis-m	met-a-mor-phism
uri-nary	u-ri-nar-y
de-tectable	de-tect-a-ble
mag-ne-sium	mag-ne-si-um
gen-t	gent
wafer	wa-fer
atavis-tic	at-a-vis-tic
con-stituen-t	con-stit-u-ent
in-cite-men-t	in-cite-ment
un-de-vel-ope-d	un-de-vel-oped
gale-na	ga-le-na
in-tra-venous-ly	in-tra-ve-nous-ly
cream-ery	cream-er-y
de-signed-ly	de-sign-ed-ly
cabaret	cab-a-ret
tachy-on	tach-y-on
de-port-men-t	de-port-ment
hemi-sphere	hem-i-sphere
method	meth-od
click-ing	clicking
spel-l	spell
in-com-bustible	in-com-bus-ti-ble
catchy	catch-y
idio-syn-cratic	id-i-o-syn-crat-ic
epis-to-lary	e-pis-to-lar-y
apol-o-gist	a-pol-o-gist
lan-guorous	lan-guor-ous
mis-di-rec-t	mis-di-rect
wis-p	wisp
laven-der	lav-en-der
filet	fi-let
san-i-tary	san-i-tar-y
erad-i-ca-tion	e-rad-i-ca-tion
civil-ian	ci-vil-ian
im-preg-nable	im-preg-na-ble
unabridged	un-a-bridged
elec-tion	e-lec-tion
ini-tia-tive	in-i-ti-a-tive
im-pair-men-t	im-pair-ment
legal-ly	le-gal-ly
pe-cu-liar-i-ty	pe-cu-li-ar-i-ty
mag-ne-to-hy-dro-dy-nam-ic-s	mag-ne-to-hy-dro-dy-nam-ics
e-u-phoric	eu-phor-ic
pon-tif-f	pon-tiff
ped-i-men-t	ped-i-ment
sala-cious	sa-la-cious
neo-prene	ne-o-prene
sax-ony	sax-o-ny
irid-i-um	i-rid-i-um
singer	sing-er
graphol-o-gy	graph-ol-o-gy
darter	dart-er
s-tu-pe-fy	stu-pe-fy
scrumhalf	scrum-half
ex-per-i-menter	ex-per-i-ment-er
foible	foi-ble
mil-ligram	mil-li-gram
per-i-he-lion	per-i-he-li-on
megas-tar	meg-a-star
beaver	bea-ver
s-nip	snip
lessen	less-en
earth-wor-m	earth-worm
plain-t	plaint
c-it-i-zen-ry	cit-i-zen-ry
co-pro-ces-sor	co-proc-es-sor
res-onator	res-o-na-tor
defam-a-to-ry	de-fam-a-to-ry
roughage	rough-age
at-tribu-tive	at-trib-u-tive
cordage	cord-age
s-woon	swoon
pe-ri-as-tron	per-i-as-tron
de-ser-ti-fi-ca-tion	de-sert-i-fi-ca-tion
per-jury	per-ju-ry
s-trap-ping	strap-ping
non-even-t	non-e-vent
anorex-i-c	an-o-rex-ic
u-nas-so-ci-at-ed	un-as-so-ci-at-ed
an-thro-pogenic	an-thro-po-gen-ic
re-gret-tably	re-gret-ta-bly
reap-praisal	re-ap-prais-al
bury	bur-y
fer-n	fern
con-sulate	con-su-late
sol-ven-t	sol-vent
prece-dence	prec-e-dence
colo-nial	co-lo-ni-al
un-know-able	un-know-a-ble
mono-gram	mon-o-gram
sur-viv-able	sur-viv-a-ble
im-mov-able	im-mov-a-ble
chas-m	chasm
machi-na-tion	mach-i-na-tion
in-ter-molec-u-lar	in-ter-mo-lec-u-lar
axle	ax-le
damni-fy	dam-ni-fy
cabri-o-let	cab-ri-o-let
con-nec-t	con-nect
em-place-men-t	em-place-ment
pedantry	ped-ant-ry
free-lancer	free-lanc-er
there-upon	there-up-on
plaza	pla-za
ra-tio-nal-ist	ra-tion-al-ist
i-n-ap-pli-ca-ble	in-ap-pli-ca-ble
bacil-lus	ba-cil-lus
ero-sion	e-ro-sion
mi-crocode	mi-cro-code
hubris-tic	hu-bris-tic
or-bital	or-bit-al
un-em-ploy-men-t	un-em-ploy-ment
hater	hat-er
mantrap	man-trap
s-toked	stoked
deuteron	deu-ter-on
tailplane	tail-plane
ax-e	axe
e-bul-lien-t	e-bul-lient
wa-ter-work-s	wa-ter-works
face-tious	fa-ce-tious
wolfhound	wolf-hound
tra-cheoto-my	tra-che-ot-o-my
doubtless-ly	doubt-less-ly
fore-fron-t	fore-front
e-lo-cu-tion	el-o-cu-tion
per-mit-ting	permitting
bru-tal-is-m	bru-tal-ism
tur-bocharg-er	tur-bo-charg-er
copi-er	cop-i-er
gory	gor-y
gigo-lo	gig-o-lo
over-done	o-ver-done
sor-cery	sor-cer-y
sitar	si-tar
s-cythe	scythe
cham-pi-onship	cham-pi-on-ship
s-panker	spank-er
s-cen-t	scent
tear-away	tear-a-way
carotene	car-o-tene
pho-to-chem-istry	pho-to-chem-is-try
mogul	mo-gul
pewter	pew-ter
ole-an-der	o-le-an-der
puer-per-al	pu-er-per-al
dis-cour-age-men-t	dis-cour-age-ment
ref-er-en-t	ref-er-ent
kinder-garten	kin-der-gar-ten
co-gen-t	co-gent
trea-sur-er	treas-ur-er
e-s-pe-cial-ly	es-pe-cial-ly
ex-i-gen-t	ex-i-gent
un-mis-tak-ably	un-mis-tak-a-bly
fibu-la	fib-u-la
dunghill	dung-hill
gra-tu-itous	gra-tu-i-tous
in-vestor	in-ves-tor
com-men-t	com-ment
dipole	di-pole
or-ga-ni-za-tion	or-gan-i-za-tion
jour-nal-is-m	jour-nal-ism
s-cald-ing	scald-ing
dimin-u-en-do	di-min-u-en-do
s-low-ness	slow-ness
ir-ra-tional-i-ty	ir-ra-tion-al-i-ty
omi-nous-ly	om-i-nous-ly
sur-viv-abil-i-ty	sur-viv-a-bil-i-ty
beanie	bean-ie
ex-huma-tion	ex-hu-ma-tion
regime	re-gime
o-r-a-to-ry	or-a-to-ry
hon-esty	hon-es-ty
as-tro-physi-cist	as-tro-phys-i-cist
wind-surfer	wind-surf-er
par-a-bola	pa-rab-o-la
gas-troin-testi-nal	gas-tro-in-tes-ti-nal
lamen-t	la-ment
philol-o-gy	phi-lol-o-gy
milord	mi-lord
monomer	mon-o-mer
carat	car-at
chamomile	cham-o-mile
rosy	ros-y
platy-pus	plat-y-pus
re-liance	re-li-ance
river-ine	riv-er-ine
ar-cana	ar-ca-na
un-cre-ative	un-cre-a-tive
ni-hilis-tic	ni-hil-is-tic
mighty	might-y
sero-tonin	ser-o-to-nin
s-teril-i-ty	ste-ril-i-ty
mu-cosa	mu-co-sa
pick-ax-e	pick-axe
cannabis	can-na-bis
provo-ca-tion	prov-o-ca-tion
spec-tropho-tome-ter	spec-tro-pho-tom-e-ter
hi-jack-ing	hi-jac-king
e-ti-quette	et-i-quette
cat-a-clysmic	cat-a-clys-mic
in-sis-ten-t	in-sist-ent
de-liv-ery	de-liv-er-y
con-comi-tan-t	con-com-i-tant
ex-trav-a-gan-t	ex-trav-a-gant
unglazed	un-glazed
siren	si-ren
de-fend-ing	defending
tor-toise-shel-l	tor-toise-shell
s-norkel	snor-kel
t-wo	two
e-d-u-cate	ed-u-cate
pa-tri-lin-eal	pat-ri-lin-e-al
un-no-tice-able	un-no-tice-a-ble
meta-mor-phose	met-a-mor-phose
e-u-nuch	eu-nuch
s-tone	stone
u-n-ap-peal-ing	un-ap-peal-ing
s-tut-ter	stut-ter
caviar	cav-i-ar
in-erad-i-ca-ble	in-e-rad-i-ca-ble
dat-able	dat-a-ble
stripling	strip-ling
en-fee-bled	enfeebled
per-sis-tent-ly	per-sist-ent-ly
s-tave	stave
dactyl	dac-tyl
mono-lith	mon-o-lith
limpet	lim-pet
my-opi-a	my-o-pi-a
penal-ty	pen-al-ty
heraldic	he-ral-dic
s-tair	stair
labi-a	la-bi-a
pseudony-mous	pseu-don-y-mous
s-tar-tled	star-tled
leath-ery	leath-er-y
bumper	bump-er
killing	kill-ing
car-cino-gen	car-cin-o-gen
i-nat-ten-tive	in-at-ten-tive
pun-ish-able	pun-ish-a-ble
achieve	a-chieve
in-elas-tic	in-e-las-tic
de-con-struc-tive	deconstructive
lin-eage	lin-e-age
vis-coun-t	vis-count
antonym	an-to-nym
ev-ery-one	eve-ry-one
climber	climb-er
dis-si-den-t	dis-si-dent
iron-mon-ger	i-ron-mon-ger
dis-obey	dis-o-bey
ema-ci-at-ed	e-ma-ci-at-ed
s-low-down	slow-down
un-treat-able	un-treat-a-ble
syn-onym	syn-o-nym
patchy	patch-y
re-vam-p	re-vamp
avoid-ance	a-void-ance
in-scrutable	in-scru-ta-ble
prof-itably	prof-it-a-bly
s-tupid-ly	stu-pid-ly
brunette	bru-nette
fever-ish-ly	fe-ver-ish-ly
amoun-t	a-mount
rein-tro-duc-tion	re-in-tro-duc-tion
s-e-lec-tion	se-lec-tion
gravedig-ger	grave-dig-ger
re-pen-tance	re-pent-ance
macrophage	mac-ro-phage
vol-cano	vol-ca-no
hu-morist	hu-mor-ist
craven	cra-ven
en-teri-tis	en-ter-i-tis
pelvic	pel-vic
s-care-mon-ger	scare-mon-ger
timid-ly	tim-id-ly
t-int-ed	tinted
ir-re-press-ible	ir-re-press-i-ble
cor-dial	cor-di-al
cu-rios-i-ty	cu-ri-os-i-ty
yel-l	yell
l-o-gof-f	log-off
ethno-graph-ic	eth-no-graph-ic
mil-lenar-i-an	mil-le-nar-i-an
re-pay-men-t	re-pay-ment
valen-tine	val-en-tine
de-brief-in-g	debriefing
trouser-s	trou-sers
un-sea-son-ably	un-sea-son-a-bly
dis-junc-t	dis-junct
macroe-co-nom-ic	mac-ro-ec-o-nom-ic
ship-men-t	ship-ment
s-ling-shot	sling-shot
y-oungish	young-ish
schoolmistress	school-mis-tress
in-fantry	in-fan-try
lectern	lec-tern
think-able	think-a-ble
spinal	spi-nal
u-nadul-ter-at-ed	un-a-dul-ter-at-ed
k-itsch	kitsch
coun-t	count
spooky	spook-y
hip-popota-mus	hip-po-pot-a-mus
pre-dic-t	pre-dict
comi-ty	com-i-ty
de-viance	de-vi-ance
d-if-fer-ence	dif-fer-ence
e-u-phemisti-cal-ly	eu-phe-mis-ti-cal-ly
wreck-ing	wrecking
in-ef-fi-cien-t	in-ef-fi-cient
salien-t	sa-li-ent
loopy	loop-y
iron	i-ron
turnout	turn-out
over-lord	o-ver-lord
en-dow-men-t	en-dow-ment
aware	a-ware
de-r-ate	de-rate
babysit-ting	babysitting
morale	mo-rale
awak-en	a-wak-en
piety	pi-e-ty
in-hibito-ry	in-hib-i-to-ry
in-ter-dic-t	in-ter-dict
in-dis-tinc-t	in-dis-tinct
dispir-it-ing	dis-pir-it-ing
toasty	toast-y
melody	mel-o-dy
colonel	colo-nel
timescale	time-scale
mal-odor-ous	mal-o-dor-ous
macaw	ma-caw
leg-isla-tive	leg-is-la-tive
b-lis-s	bliss
smithereen-s	smith-er-eens
obli-ga-tion	ob-li-ga-tion
ri-ot-ing	ri-o-ting
facet	fac-et
in-ho-mo-ge-neous	in-ho-mo-ge-ne-ous
rege-late	re-ge-late
grandiose	gran-di-ose
un-bridge-able	un-bridge-a-ble
bullfinch	bull-finch
colum-nar	co-lum-nar
b-otany	bot-a-ny
he-do-nist	he-don-ist
wind-surf-in-g	wind-surf-ing
d-weller	dwell-er
floater	float-er
playfel-low	play-fel-low
le-gal-is-m	le-gal-ism
bowsprit	bow-sprit
bene-fac-tor	ben-e-fac-tor
costar	co-star
tablet	tab-let
per-me-abil-i-ty	per-me-a-bil-i-ty
e-mer-ald	em-er-ald
mel-liflu-ous	mel-lif-lu-ous
wiring	wir-ing
man-i-festo	man-i-fes-to
cen-trifuge	cen-tri-fuge
re-gali-a	re-ga-li-a
blush-ing	blushing
f-reaky	freak-y
de-co	dec-o
un-stop-pable	un-stop-pa-ble
in-stru-men-t	in-stru-ment
glassy	glass-y
decor	de-cor
brava-do	bra-va-do
rodeo	ro-de-o
di-uret-ic	di-u-ret-ic
wari-ness	war-i-ness
pro-ject-ed	projected
maser	ma-ser
arachno-pho-bi-a	a-rach-no-pho-bi-a
pro-ce-du-ral-ly	pro-ce-dur-al-ly
quotable	quot-a-ble
s-trapped	strapped
handrail	hand-rail
hero-ine	her-o-ine
s-nore	snore
imag-i-na-tion	im-ag-i-na-tion
oviduc-t	o-vi-duct
pan-creas	pan-cre-as
garage	ga-rage
medic	med-ic
cradling	cra-dling
dis-in-fec-t	dis-in-fect
telepa-thy	te-lep-a-thy
nascen-t	nas-cent
joyrid-ing	joy-rid-ing
col-lec-tivis-m	col-lec-tiv-ism
wicked-ly	wick-ed-ly
duress	du-ress
cam-panile	cam-pa-ni-le
jester	jest-er
ashore	a-shore
hal-lelu-jah	hal-le-lu-jah
hand-bel-l	hand-bell
revenan-t	rev-e-nant
across	a-cross
s-tam-mer-ing	stammering
repli-ca-ble	rep-li-ca-ble
co-ex-is-ten-t	co-ex-ist-ent
s-neaky	sneak-y
motet	mo-tet
con-tigu-ous	con-tig-u-ous
im-pri-matur	im-pri-ma-tur
tubu-lar	tu-bu-lar
me-te-o-rol-o-gy	me-te-or-ol-o-gy
mar-i-onette	mar-i-on-ette
chau-vin-is-m	chau-vin-ism
s-car-f	scarf
homi-cide	hom-i-cide
sharp-en-er	shar-pen-er
mean-s	means
over-load-ed	overloaded
con-sid-er-ably	con-sid-er-a-bly
con-junc-t	con-junct
moral-i-ty	mo-ral-i-ty
stinger	sting-er
aven-s	av-ens
delin-quen-t	de-lin-quent
read-abil-i-ty	read-a-bil-i-ty
privy	priv-y
epi-ge-net-ic	ep-i-ge-net-ic
nephew	neph-ew
as-besto-sis	as-bes-to-sis
corky	cork-y
surly	sur-ly
elic-it	e-lic-it
fur-rowed	furrowed
fig-u-ra-tive-ly	fig-ur-a-tive-ly
eva-sion	e-va-sion
print-able	print-a-ble
tiger-ish	ti-ger-ish
gamut	gam-ut
para-sol	par-a-sol
deu-teri-um	deu-te-ri-um
quan-tifi-ca-tion	quan-ti-fi-ca-tion
bot-tled	bottled
s-pay	spay
gur-gling	gurgling
ragout	ra-gout
toluene	tol-u-ene
reawak-en	re-a-wak-en
spiny	spin-y
leucine	leu-cine
over-spill	o-ver-spill
ad-d	add
deco-rous	dec-o-rous
surfer	surf-er
in-ex-cus-able	in-ex-cus-a-ble
ketchup	ketch-up
hy-per-boloid	hy-per-bo-loid
emet-ic	e-met-ic
postage	post-age
ba-ro-nial	ba-ro-ni-al
s-tatu-to-ry	stat-u-to-ry
d-ab-bing	dab-bing
blud-geon	bludg-eon
gen-uine	gen-u-ine
gallery	gal-ler-y
hooky	hook-y
restora-tive	re-stor-a-tive
quiet-ness	qui-et-ness
vene-re-al	ve-ne-re-al
leafy	leaf-y
solem-n	sol-emn
ethnog-ra-phy	eth-nog-ra-phy
de-lin-eate	de-lin-e-ate
tanker	tank-er
shaver	shav-er
con-tac-t	con-tact
ma-tri-lin-eal	mat-ri-lin-e-al
in-ex-orable	in-ex-o-ra-ble
timer	tim-er
lyri-cis-m	lyr-i-cism
s-tar-let	star-let
colos-sus	co-los-sus
c-etacean	ce-ta-cean
blood-wor-m	blood-worm
so-h	soh
untest-ed	un-test-ed
breast-feed-ing	breastfeeding
catch-men-t	catch-ment
in-salu-bri-ous	in-sa-lu-bri-ous
mono-phon-ic	mon-o-phon-ic
i-n-ad-mis-si-ble	in-ad-mis-si-ble
squally	squal-ly
sober	so-ber
drama-tist	dram-a-tist
qui-eten	qui-et-en
pro-po-nen-t	pro-po-nent
prof-itable	prof-it-a-ble
chee-ri-o	cheer-i-o
re-strain-ing	restraining
deli	del-i
spiky	spik-y
spicy	spic-y
debu-tante	deb-u-tante
of-f	off
rheuma-tol-o-gy	rheu-ma-tol-o-gy
over-crowd-ed	o-ver-crow-ded
serene-ly	se-rene-ly
lar-ynx-es	la-rynx-es
im-port-ed	imported
unloved	un-loved
bank-able	bank-a-ble
del-i-ques-cen-t	del-i-ques-cent
restive	res-tive
repli-cate	rep-li-cate
un-be-liev-able	un-be-liev-a-ble
do-lerite	dol-er-ite
pirou-ette	pir-ou-ette
un-quan-tifi-able	un-quan-ti-fi-a-ble
join-ery	join-er-y
sun-tanned	suntanned
bio-di-ver-si-ty	bi-o-di-ver-si-ty
ra-tio-nale	ra-tion-ale
beget	be-get
s-pa-cious	spa-cious
car-borun-dum	car-bo-run-dum
por-traitist	por-trait-ist
u-n-awares	un-a-wares
golfer	golf-er
par-lia-men-tary	par-lia-men-ta-ry
pro-gressed	progressed
mer-ri-men-t	mer-ri-ment
seabed	sea-bed
monarch	mon-arch
busi-ly	bus-i-ly
tele-gram	tel-e-gram
e-cono-met-ric-s	e-con-o-met-rics
re-place-men-t	re-place-ment
in-ex-tin-guish-able	in-ex-tin-guish-a-ble
i-ambic	i-am-bic
apoc-a-lypse	a-poc-a-lypse
geron-toc-ra-cy	ger-on-toc-ra-cy
he-li-cal	hel-i-cal
mazy	ma-zy
post-mod-ernist	post-mod-ern-ist
mono-chrome	mon-o-chrome
w-ere-wolf	were-wolf
cos-set-ed	cosseted
methanol	meth-a-nol
suc-cinc-t	suc-cinct
cor-pu-len-t	cor-pu-lent
ide-al-ly	i-de-al-ly
corset	cor-set
ex-cep-tion-able	ex-cep-tion-a-ble
scrip-t	script
s-po-radic	spo-rad-ic
s-tac-ca-to	stac-ca-to
mo-lester	mo-lest-er
con-flu-en-t	con-flu-ent
tirade	ti-rade
mon-u-men-t	mon-u-ment
ravine	ra-vine
valid	val-id
edgy	edg-y
il-l	ill
over-take	o-ver-take
piper	pip-er
in-equal-i-ty	in-e-qual-i-ty
d-well	dwell
con-fi-den-tial-i-ty	con-fi-den-ti-al-i-ty
un-con-tain-able	un-con-tain-a-ble
g-lu-ta-mate	glu-ta-mate
geopo-lit-i-cal	ge-o-po-lit-i-cal
telekine-sis	tel-e-ki-ne-sis
y-on	yon
fu-tur-is-m	fu-tur-ism
in-fini-tude	in-fin-i-tude
tol-er-an-t	tol-er-ant
necro-mancer	nec-ro-man-cer
im-mutable	im-mu-ta-ble
s-tench	stench
s-meg-ma	smeg-ma
rangy	rang-y
coun-ter-ac-t	coun-ter-act
u-n-af-fil-i-at-ed	un-af-fil-i-at-ed
aster	as-ter
spillage	spill-age
em-bel-lish-men-t	em-bel-lish-ment
bereft	be-reft
as-cen-der	as-cend-er
s-api-en-t	sa-pi-ent
s-lough	slough
febrile	fe-brile
chi-ropody	chi-rop-o-dy
dili-gent-ly	dil-i-gent-ly
papil-la	pa-pil-la
fetishist	fet-ish-ist
rata-touille	ra-ta-touille
ap-praisal	ap-prais-al
driv-able	driv-a-ble
ra-tio-nal-ly	ra-tion-al-ly
il-lu-mi-nan-t	il-lu-mi-nant
u-n-ad-just-ed	un-ad-just-ed
aquar-i-um	a-quar-i-um
asymp-tote	as-ymp-tote
adop-t	a-dopt
as-pirin	as-pi-rin
pedan-t	ped-ant
dis-playable	displayable
mis-chievous	mis-chie-vous
over-ween-ing	o-ver-ween-ing
un-in-hab-it-able	un-in-hab-it-a-ble
papule	pap-ule
melan-cho-li-a	mel-an-cho-li-a
dis-en-fran-chise-men-t	dis-en-fran-chise-ment
com-mu-nica-tive	com-mu-ni-ca-tive
s-lim-line	slim-line
meio-sis	mei-o-sis
over-ca-pac-i-ty	o-ver-ca-pac-i-ty
an-cien-t	an-cient
un-easi-ly	un-eas-i-ly
me-galith-ic	meg-a-lith-ic
bunker	bun-ker
temptress	tempt-ress
chrysalis	chrys-a-lis
con-cussed	concussed
couloir	cou-loir
con-fine-men-t	con-fine-ment
minute	mi-nute
copy	cop-y
un-speak-able	un-speak-a-ble
in-fini-tive	in-fin-i-tive
mut-ter-ing	muttering
cross-over	cross-o-ver
in-fir-mary	in-fir-ma-ry
bas-ketry	bas-ket-ry
as-pec-t	as-pect
jus-ti-fi-able	jus-ti-fi-a-ble
turnip	tur-nip
s-cour	scour
s-pawn	spawn
rhap-sody	rhap-so-dy
s-pas-m	spasm
s-cal-able	scal-a-ble
com-mod-e	com-mode
in-tel-lec-tu-al-is-m	in-tel-lec-tu-al-ism
pol-lu-tan-t	pol-lu-tant
squalid	squal-id
s-mut-ty	smut-ty
colonic	co-lon-ic
s-nack	snack
flab-ber-gast-ed	flabbergasted
s-ing	sing
w-hole	whole
cob-we-b	cob-web
car-diopul-monary	car-di-o-pul-mo-nar-y
ter-tiary	ter-ti-ar-y
stingray	sting-ray
ep-ithe-li-um	ep-i-the-li-um
porcine	por-cine
ju-nior	jun-ior
chem-istry	chem-is-try
di-rec-t	di-rect
gi-antism	gi-ant-ism
ca-nary	ca-nar-y
e-s-prit	es-prit
bowlder	bowl-der
s-tar-dom	star-dom
beret	be-ret
read-mit	re-ad-mit
s-nick	snick
handy	hand-y
p-reser-va-tion	pres-er-va-tion
ge-nom-ic	ge-no-mic
swasti-ka	swas-ti-ka
suf-frag-ist	suf-fra-gist
be-muse-men-t	be-muse-ment
elec-tro-stat-ic-s	e-lec-tro-stat-ics
moral-ist	mor-al-ist
un-ruly	un-ru-ly
s-ten-tor	sten-tor
cursed	curs-ed
u-n-ac-knowl-edged	un-ac-knowl-edged
pumice	pum-ice
post-mod-ernism	post-mod-ern-ism
herbal	herb-al
in-con-tro-vert-ible	in-con-tro-vert-i-ble
fi-nale	fi-na-le
in-fla-tion-ary	in-fla-tion-ar-y
sed-i-men-t	sed-i-ment
welder	weld-er
s-trate-gic	stra-te-gic
u-n-aware	un-a-ware
un-en-vi-able	un-en-vi-a-ble
bear-able	bear-a-ble
sewage	sew-age
re-cip-i-en-t	re-cip-i-ent
per-former	per-form-er
vestibule	ves-ti-bule
fly-away	fly-a-way
min-der	mind-er
de-cay-ing	decaying
id-iot	id-i-ot
om-nibus	om-ni-bus
com-mis-sari-at	com-mis-sar-i-at
rea-son-ably	rea-son-a-bly
canon-ry	can-on-ry
d-if-fu-sive	dif-fu-sive
s-to-icis-m	sto-i-cism
avail-abil-i-ty	a-vail-a-bil-i-ty
g-lyph	glyph
d-enizen	den-i-zen
nightwear	night-wear
earnest-ly	ear-nest-ly
pago-da	pa-go-da
s-portive	spor-tive
ap-pa-ra-tus	ap-pa-rat-us
o-r-ange	or-ange
s-tol-id	stol-id
iso-stat-ic	i-so-stat-ic
trans-fer-able	trans-fer-a-ble
speechi-fy-ing	speechifying
helper	help-er
satirist	sat-i-rist
ratepay-er	rate-pay-er
saunter	saun-ter
aslan-t	a-slant
sado-masochis-tic	sa-do-mas-o-chis-tic
valet	val-et
un-count-able	un-count-a-ble
wel-com-ing	wel-co-ming
grit-s	grits
shopfron-t	shop-front
s-lay	slay
im-pe-ri-al-is-m	im-pe-ri-al-ism
diploid	dip-loid
be-fud-dled	befuddled
tuxe-do	tux-e-do
as-cen-dan-cy	as-cend-an-cy
sub-ur-bia	sub-ur-bi-a
ap-palling-ly	ap-pall-ing-ly
un-sur-pass-able	un-sur-pass-a-ble
im-per-son-ator	im-per-son-a-tor
lizard	liz-ard
en-slave-men-t	en-slave-ment
ver-dan-t	ver-dant
lo-quac-ity	lo-quac-i-ty
re-for-esta-tion	re-for-est-a-tion
footwear	foot-wear
com-pan-ion-able	com-pan-ion-a-ble
vis-ual-ly	vis-u-al-ly
s-mooth-ness	smooth-ness
bathrobe	bath-robe
paramount-cy	par-a-mount-cy
fishy	fish-y
dom-i-nan-t	dom-i-nant
com-ple-men-tary	com-ple-men-ta-ry
cour-tesy	cour-te-sy
elec-tive	e-lec-tive
ar-chi-tec-t	ar-chi-tect
mora-to-ri-um	mor-a-to-ri-um
milk-shake	milkshake
un-demo-crat-ic	un-dem-o-crat-ic
melo-dra-ma	mel-o-dra-ma
n-erd	nerd
tele-o-log-i-cal	tel-e-o-log-i-cal
celi-bate	cel-i-bate
en-vi-ron-s	en-vi-rons
s-tun-ner	stun-ner
s-cu-ba	scu-ba
lacteal	lac-te-al
or-b	orb
stron-groom	strong-room
retic-u-lat-ed	re-tic-u-lat-ed
ditch-ing	ditching
elec-tric-i-ty	e-lec-tric-i-ty
e-d-u-cat-ed	ed-u-cat-ed
ig-no-ran-t	ig-no-rant
nu-tri-men-t	nu-tri-ment
mili-tia-man	mi-li-tia-man
drap-ery	dra-per-y
t-hou-sand	thou-sand
wrestler	wres-tler
in-con-sid-er-able	in-con-sid-er-a-ble
dizzy	diz-zy
twilit	twi-lit
mastodon	mas-to-don
com-bustible	com-bus-ti-ble
bour-geoisie	bour-geoi-sie
cut-lery	cut-ler-y
dairy-man	dair-y-man
or-nithol-o-gy	or-ni-thol-o-gy
mari-nade	mar-i-nade
tu-mul-tuous	tu-mul-tu-ous
lassie	las-sie
palimpses-t	pal-imp-sest
un-equal	un-e-qual
vol-canic	vol-can-ic
wom-ankind	wom-an-kind
damnable	dam-na-ble
in-tu-itive-ly	in-tu-i-tive-ly
triv-ial	triv-i-al
bouf-fan-t	bouf-fant
his-tamine	his-ta-mine
cru-ci-for-m	cru-ci-form
where-about-s	where-a-bouts
overeat	o-ver-eat
bak-ery	bak-er-y
s-tom-ach	stom-ach
s-tove	stove
haulage	haul-age
s-lide	slide
plateau	pla-teau
con-stab-u-lary	con-stab-u-lar-y
u-nim-pressed	un-im-pressed
reval-u-a-tion	re-val-u-a-tion
cloven	clo-ven
mis-con-duc-t	mis-con-duct
fontanel	fon-ta-nel
cen-tral-is-m	cen-tral-ism
bish-opric	bish-op-ric
p-ri-mo-gen-i-ture	pri-mo-gen-i-ture
ap-pel-lan-t	ap-pel-lant
ra-dionu-clide	ra-di-o-nu-clide
millinery	mil-li-ner-y
even-tu-al-i-ty	e-ven-tu-al-i-ty
con-nect-ing	con-nec-ting
chancery	chan-cer-y
tasty	tast-y
d-ab-ble	dab-ble
homonym	hom-o-nym
prompter	prompt-er
toothy	tooth-y
in-sid-e	in-side
den-drochronol-o-gy	den-dro-chro-nol-o-gy
prover-bial	pro-ver-bi-al
cus-tomer	cus-tom-er
un-mea-sur-able	un-meas-ur-a-ble
lu-mi-nary	lu-mi-nar-y
es-teemed	e-steemed
macaque	ma-caque
mid-dleweight	mid-dle-weight
hu-man-is-m	hu-man-ism
o-live	ol-ive
brack-et-ed	bracketed
loony	loon-y
ex-pi-ra-to-ry	ex-pir-a-to-ry
t-suna-mi	tsu-na-mi
con-ver-gen-t	con-ver-gent
forego	fore-go
baronet	bar-on-et
lu-mi-nes-cen-t	lu-mi-nes-cent
s-coot	scoot
moral	mor-al
debonair	deb-o-nair
prof-itabil-i-ty	prof-it-a-bil-i-ty
pro-pri-ety	pro-pri-e-ty
pil-l	pill
pen-tame-ter	pen-tam-e-ter
apothe-cary	a-poth-e-car-y
de-jec-t	de-ject
hi-ero-glyph	hi-er-o-glyph
crevice	crev-ice
re-mark-able	re-mark-a-ble
m-is-fire	mis-fire
over-val-ue	o-ver-val-ue
clank-ing	clan-king
k-ilo-hertz	kil-o-hertz
in-sol-ven-t	in-sol-vent
fron-tispiece	fron-tis-piece
glacier	gla-cier
un-re-cov-er-able	un-re-cov-er-a-ble
de-monolo-gy	de-mon-ol-o-gy
tweedy	tweed-y
para-mount	par-a-mount
para-pet	par-a-pet
ef-ful-gen-t	ef-ful-gent
phrasal	phras-al
itin-er-ary	i-tin-er-ar-y
l-itany	lit-a-ny
ear-l	earl
sacral	sa-cral
buf-foon-ery	buf-foon-er-y
peremp-to-ry	per-emp-to-ry
re-pel-len-t	re-pel-lent
ori-en-tal	o-ri-en-tal
partheno-gen-e-sis	par-the-no-gen-e-sis
coali-tion	co-a-li-tion
l-iti-gious	li-ti-gious
over-dose	o-ver-dose
sus-tain-abil-i-ty	sus-tain-a-bil-i-ty
positron	pos-i-tron
gal-l	gall
un-pleas-an-t	un-pleas-ant
k-nap-sack	knap-sack
mar-riage-able	mar-riage-a-ble
dearie	dear-ie
cam-panol-o-gy	cam-pa-nol-o-gy
cameo	cam-e-o
s-tom-achache	stom-ach-ache
un-remit-ting	un-re-mit-ting
mea-sure	meas-ure
con-stan-t	con-stant
multi-na-tion-al	mul-ti-na-tion-al
un-ser-vice-able	un-ser-vice-a-ble
con-vict-ed	convicted
s-pleen	spleen
hy-dro-elec-tric	hy-dro-e-lec-tric
haven	ha-ven
dreamy	dream-y
ethic-s	eth-ics
drafty	draft-y
scrapie	scrap-ie
com-pact-ed	compacted
i-n-ac-tiv-i-ty	in-ac-tiv-i-ty
power-boat	pow-er-boat
fri-able	fri-a-ble
dis-tillery	dis-till-er-y
mutiny	mu-ti-ny
racial	ra-cial
s-tunned	stunned
in-flec-t	in-flect
panz-er	pan-zer
casi-no	ca-si-no
su-per-cil-ious	su-per-cil-i-ous
cater-er	ca-ter-er
lento	len-to
s-tone-ma-son	stone-ma-son
spen-t	spent
c-om-mend-ably	com-mend-a-bly
i-n-ac-ces-si-ble	in-ac-ces-si-ble
s-cur-ry	scur-ry
numb-skul-l	numb-skull
rook-ery	rook-er-y
holler	hol-ler
midair	mid-air
car-avel	car-a-vel
both-ered	bothered
si-lencer	si-lenc-er
phonol-o-gy	pho-nol-o-gy
rheumat-ic-s	rheu-mat-ics
dyad	dy-ad
odor-ous	o-dor-ous
there-about-s	there-a-bouts
k-i-lo	ki-lo
plumy	plum-y
iono-sphere	i-on-o-sphere
mer-chan-t	mer-chant
crier	cri-er
en-ti-tle-men-t	en-ti-tle-ment
tremo-lo	trem-o-lo
rhodo-den-dron	rho-do-den-dron
s-teeple-chase	stee-ple-chase
epi-gram-mat-ic	ep-i-gram-mat-ic
vizier	vi-zier
s-cout-mas-ter	scout-mas-ter
s-cary	scar-y
wealthy	wealth-y
in-tac-t	in-tact
au-gury	au-gu-ry
ar-m	arm
door-bel-l	door-bell
qui-es-cen-t	qui-es-cent
busi-nesslike	busi-ness-like
comet	com-et
xeno-phobe	xen-o-phobe
stealthy	stealth-y
un-usu-al	un-u-su-al
pro-ceed-s	pro-ceeds
car-dioid	car-di-oid
imag-in-able	im-ag-i-na-ble
durable	du-ra-ble
con-jec-tural	con-jec-tur-al
chaot-ic	cha-ot-ic
mag-ne-si-a	mag-ne-sia
meta-lan-guage	met-a-lan-guage
dumpling	dump-ling
thrilling	thrill-ing
seedling	seed-ling
lisp-ing	lis-ping
hubris	hu-bris
en-vi-able	en-vi-a-ble
codex	co-dex
pheas-an-t	pheas-ant
em-bassy	em-bas-sy
promp-t	prompt
u-nimag-in-able	un-im-ag-i-na-ble
dis-traugh-t	dis-traught
s-porty	sport-y
at-tain-able	at-tain-a-ble
io-ta	i-o-ta
avi-ate	a-vi-ate
im-paction	im-pac-tion
resid-uary	re-sid-u-ar-y
ranker	rank-er
re-port-ed	reported
s-can-dalous	scan-dal-ous
eroge-nous	e-rog-e-nous
her-b	herb
baroness	bar-on-ess
cine	cin-e
abaft	a-baft
e-quip-men-t	e-quip-ment
poly-math	pol-y-math
ga-lop	gal-op
p-salmody	psal-mo-dy
un-re-pairable	un-re-pair-a-ble
s-coop	scoop
es-capade	es-ca-pade
s-plen-did-ly	splen-did-ly
karaoke	kar-a-o-ke
s-ketchy	sketch-y
con-troller	con-trol-ler
reroutes	re-routes
hostage	hos-tage
num-b	numb
de-viant	de-vi-ant
dither	dith-er
jeer-ing	jeering
even	e-ven
place-bo	pla-ce-bo
in-ci-den-t	in-ci-dent
su-per-scrip-t	su-per-script
stylis-tic	sty-lis-tic
dis-cor-dance	dis-cord-ance
u-p-lift-ed	uplifted
idyl-l	i-dyll
toughie	tough-ie
t-inc-ture	tinc-ture
episod-ic	ep-i-sod-ic
pedestal	ped-es-tal
aubergine	au-ber-gine
menswear	mens-wear
elec-tro	e-lec-tro
s-tand	stand
im-politic	im-pol-i-tic
arouse	a-rouse
b-land-ness	bland-ness
an-throp-ic	an-thro-pic
pala-tial	pa-la-tial
eatery	eat-er-y
s-neer-ing	sneering
sand-piper	sand-pi-per
i-n-ad-e-quate-ly	in-ad-e-quate-ly
dis-tiller	dis-till-er
limpid	lim-pid
ined-i-ble	in-ed-i-ble
u-nimag-in-ably	un-im-ag-i-na-bly
mul-ti-me-ter	mul-tim-e-ter
b-land	bland
trans-ceiver	trans-ceiv-er
astray	a-stray
nymp-holep-sy	nym-pho-lep-sy
jerkin	jer-kin
over-much	o-ver-much
s-mall-hold-er	small-hold-er
readap-t	re-a-dapt
raillery	rail-ler-y
omit	o-mit
ex-is-ten-t	ex-ist-ent
salu-bri-ous	sa-lu-bri-ous
blos-som-ing	blossoming
testos-terone	tes-tos-ter-one
s-tair-well	stair-well
vi-o-len-t	vi-o-lent
ob-scu-ran-tism	ob-scu-rant-ism
aqualung	aq-ua-lung
ha-cien-da	ha-ci-en-da
saucy	sau-cy
s-car	scar
s-now	snow
pussy	pus-sy
s-pa	spa
sub-sis-tence	sub-sist-ence
bom-bard-men-t	bom-bard-ment
s-niv-el	sniv-el
how-itzer	how-itz-er
vol-un-tary	vol-un-tar-y
pogo	po-go
en-riched	enriched
in-farc-t	in-farct
de-moun-t	de-mount
com-menter	com-ment-er
ca-su-istry	cas-u-ist-ry
medic-i-nal	me-dic-i-nal
mis-sion-ary	mis-sion-ar-y
even-tu-al	e-ven-tu-al
met-ric-s	met-rics
mis-nomer	mis-no-mer
re-pen-tan-t	re-pent-ant
finick-y	fin-ick-y
ge-o-mag-net-i-cal-ly	ge-o-mag-ne-ti-cal-ly
re-searcher	re-search-er
fer-ven-t	fer-vent
s-tacked	stacked
ex-tralin-guis-tic	ex-tra-lin-guis-tic
cy-ber-net-ic-s	cy-ber-net-ics
pin-bal-l	pin-ball
coura-geous	cou-ra-geous
necro-sis	ne-cro-sis
s-port-ing	sport-ing
un-sellable	un-sell-a-ble
ine-bri-ate	in-e-bri-ate
ca-su-al-ty	cas-u-al-ty
com-mence-men-t	com-mence-ment
reg-i-men-t	reg-i-ment
mon-e-taris-m	mon-e-ta-rism
palace	pal-ace
s-car-let	scar-let
s-lug	slug
over-pow-er	o-ver-pow-er
paci-fy	pac-i-fy
s-lam	slam
s-nort	snort
leak-ing	leaking
easy-go-ing	eas-y-go-ing
centi-grade	cen-ti-grade
fruit-ing	fruiting
s-cab-by	scab-by
s-ab-bat-i-cal	sab-bat-i-cal
em-bit-tered	embittered
con-ser-va-tive	con-serv-a-tive
goatskin	goat-skin
toka-mak	to-ka-mak
s-lushy	slush-y
rem-nan-t	rem-nant
basin	ba-sin
pan-golin	pan-go-lin
m-i-lieu	mi-lieu
liquor	liq-uor
telex	tel-ex
re-frig-er-an-t	re-frig-er-ant
lunchtime	lunch-time
undi-rect-ed	un-di-rect-ed
over-load	o-ver-load
ren-t	rent
in-con-solable	in-con-sol-a-ble
pout-ing	pouting
tam-p	tamp
iso-lat-ing	i-so-lat-ing
s-mal-l	small
dowdy	dow-dy
ante	an-te
in-nu-mer-able	in-nu-mer-a-ble
projec-t	proj-ect
s-mat-ter-ing	smat-ter-ing
iso-la-tion	i-so-la-tion
sher-if-f	sher-iff
cu-nei-form	cu-ne-i-form
s-ketch-book	sketch-book
arum	ar-um
mati-nee	mat-i-nee
doyenne	doy-enne
s-tock-ade	stock-ade
crony	cro-ny
un-for-giv-able	un-for-giv-a-ble
ex-tra-galac-tic	ex-tra-ga-lac-tic
vestal	ves-tal
s-ten-cil	sten-cil
event-ing	e-vent-ing
rapid	rap-id
maudlin	maud-lin
s-ta-men	sta-men
fuz-z	fuzz
e-quer-ry	eq-uer-ry
sea-son-able	sea-son-a-ble
qua-dru-pli-cate	quad-ru-pli-cate
type-scrip-t	type-script
an-tag-o-nis-m	an-tag-o-nism
in-ter-lock-ing	in-ter-loc-king
re-deemable	re-deem-a-ble
ki-mono	ki-mo-no
de-po-nen-t	de-po-nent
forty	for-ty
physique	phy-sique
prag-mat-ic-s	prag-mat-ics
layper-son	lay-per-son
hori-zon	ho-ri-zon
laud-able	laud-a-ble
sky-scraper	sky-scrap-er
crus-tacean	crus-ta-cean
who-dunit	who-dun-it
di-a-betes	di-a-be-tes
baron-age	bar-on-age
oblique	o-blique
in-creduli-ty	in-cre-du-li-ty
litho-sphere	lith-o-sphere
pompous	pomp-ous
s-tu-dious	stu-di-ous
en-crust-ed	encrusted
beeswax	bees-wax
cheery	cheer-y
whistler	whis-tler
ex-plorato-ry	ex-plor-a-to-ry
heron-ry	her-on-ry
clever	clev-er
li-censee	li-cen-see
pe-trel	pet-rel
semi-con-duct-ing	sem-i-con-duct-ing
know-able	know-a-ble
mar-garine	mar-ga-rine
epis-te-mo-log-i-cal	e-pis-te-mo-log-i-cal
s-lum-ber	slum-ber
sealan-t	seal-ant
com-mu-nion	com-mun-ion
cuirass	cui-rass
e-n-act-men-t	en-act-ment
in-dige-nous	in-dig-e-nous
crock-ery	crock-er-y
sacra-men-t	sac-ra-ment
fir-m	firm
pris-m	prism
s-now-stor-m	snow-storm
hy-per-tex-t	hy-per-text
duf-f	duff
mater	ma-ter
mis-treat-men-t	mis-treat-ment
con-stituen-cy	con-stit-u-en-cy
s-tiff-en	stiff-en
v-ole	vole
ir-rel-e-van-t	ir-rel-e-vant
shogun	sho-gun
s-mirk-ing	smirking
archangel	arch-an-gel
dozen	doz-en
suprema-cy	su-prem-a-cy
ur-gen-t	ur-gent
un-man-age-able	un-man-age-a-ble
baby-ish	ba-by-ish
liv-ery	liv-er-y
g-lut-tony	glut-ton-y
ma-tri-archy	ma-tri-ar-chy
syn-chronic-i-ty	syn-chro-nic-i-ty
devo-tee	dev-o-tee
s-nug-ly	snug-ly
murky	murk-y
dis-cotheque	dis-co-theque
hereti-cal	he-ret-i-cal
punky	punk-y
panties	pant-ies
propane	pro-pane
gro-cery	gro-cer-y
lusty	lust-y
in-volve-men-t	in-volve-ment
ne-go-tiable	ne-go-ti-a-ble
s-naf-fle	snaf-fle
matin-s	mat-ins
ex-oge-nous	ex-og-e-nous
body	bod-y
s-tar-tling	star-tling
brevi-ty	brev-i-ty
wa-terbed	wa-ter-bed
erad-i-cate	e-rad-i-cate
au-thoress	au-thor-ess
crenel-la-tion-s	cren-el-la-tions
con-vect-ed	convected
s-tock	stock
camshaft	cam-shaft
pun-ish-men-t	pun-ish-ment
semi-con-scious	sem-i-con-scious
bound-ary	bound-a-ry
spec-troscopy	spec-tros-co-py
s-cant	scant
un-der-rat-ed	underrated
peace-able	peace-a-ble
bathos	ba-thos
r-e-fit	re-fit
undis-turbed	un-dis-turbed
deci-bel	dec-i-bel
melo-dra-mat-ic	mel-o-dra-mat-ic
burly	bur-ly
s-tore-keep-er	store-keep-er
beryl-li-um	be-ryl-li-um
re-cal-ci-tran-t	re-cal-ci-trant
liveli-hood	live-li-hood
inim-itable	in-im-i-ta-ble
camper	camp-er
coro-net	cor-o-net
pream-p	pre-amp
skater	skat-er
mag-ne-tome-ter	mag-ne-tom-e-ter
dis-ori-en-tat-ed	disorientated
hardy	har-dy
in-choate	in-cho-ate
chro-matog-ra-phy	chro-ma-tog-ra-phy
sus-pend-ed	sus-pen-ded
ir-re-vo-ca-bly	ir-rev-o-ca-bly
b-land-ly	bland-ly
in-es-timable	in-es-ti-ma-ble
fir-ma-men-t	fir-ma-ment
un-pre-dictably	un-pre-dict-a-bly
en-joy-ably	en-joy-a-bly
sul-tana	sul-tan-a
dredger	dredg-er
mar-l	marl
en-tice-men-t	en-tice-ment
en-abled	e-na-bled
goa-tee	goat-ee
u-n-ac-com-pa-nied	un-ac-com-pa-nied
await	a-wait
im-pa-tien-t	im-pa-tient
tri-den-t	tri-dent
ranch-ing	ranching
respite	res-pite
timid	tim-id
s-in-ter	sin-ter
e-t-y-mol-o-gy	et-y-mol-o-gy
servi-ette	ser-vi-ette
with-ered	withered
em-bossed	embossed
panache	pa-nache
mis-aligned	mis-a-ligned
pur-suance	pur-su-ance
habi-ta-tion	hab-i-ta-tion
par-si-mo-nious	par-si-mo-ni-ous
duik-er	dui-ker
re-tiree	re-tir-ee
clam-orous	clam-or-ous
dic-tio-nary	dic-tion-ar-y
ron-dav-el	ron-da-vel
in-duce-men-t	in-duce-ment
faucet	fau-cet
n-im-ble-ness	nim-ble-ness
un-ob-ser-van-t	un-ob-serv-ant
loess	lo-ess
domi-cile	dom-i-cile
s-toat	stoat
apoplec-tic	ap-o-plec-tic
sav-agery	sav-age-ry
un-re-served-ly	un-re-serv-ed-ly
pom-padour	pom-pa-dour
hide-away	hide-a-way
f-reak-ish	freak-ish
cladding	clad-ding
re-flec-t	re-flect
cos-mopoli-tan	cos-mo-pol-i-tan
hosan-na	ho-san-na
racial-is-m	ra-cial-ism
grunter	grunt-er
g-naw	gnaw
retic-u-lum	re-tic-u-lum
hero	he-ro
steplad-der	step-lad-der
gud-geon	gudg-eon
s-tratig-ra-phy	stra-tig-ra-phy
brazen	bra-zen
mi-cro-surgery	mi-cro-sur-ger-y
k-in-folk	kin-folk
thievish	thiev-ish
tox-i-c-i-ty	tox-ic-i-ty
s-par-tan	spar-tan
aro-matic-i-ty	ar-o-ma-tic-i-ty
reclu-sive	re-clu-sive
s-louch	slouch
im-mea-sur-ably	im-meas-ur-a-bly
di-nosaur	di-no-saur
donor	do-nor
s-ta-tion	sta-tion
pizze-ri-a	piz-ze-ri-a
in-spi-ra-tional	in-spi-ra-tion-al
l-it-i-gan-t	lit-i-gant
bonobo	bo-no-bo
napoleon	na-po-le-on
treach-ery	treach-er-y
un-for-get-table	un-for-get-ta-ble
kamikaze	ka-mi-ka-ze
foot-baller	foot-ball-er
rein-ter-pret	re-in-ter-pret
video-taped	videotaped
aorist	a-o-rist
per-for-m	per-form
s-cur-rilous	scur-ril-ous
s-tormer	storm-er
lauda-to-ry	laud-a-to-ry
pro-tect-ed	protected
yeti	yet-i
s-care	scare
lam-ben-t	lam-bent
ileum	il-e-um
g-nos-tic	gnos-tic
hor-mon-al	hor-mo-nal
avun-cu-lar	a-vun-cu-lar
beachy	beach-y
para-phrase	par-a-phrase
hang-over	hang-o-ver
s-narl	snarl
celebri-ty	ce-leb-ri-ty
pre-dictable	pre-dict-a-ble
epi-demi-o-log-i-cal	ep-i-de-mi-o-log-i-cal
dis-place-men-t	dis-place-ment
apery	ap-er-y
epi-logue	ep-i-logue
castof-f	cast-off
s-nip-pet	snip-pet
c-on-cil-iar	con-cil-i-ar
slaver	slav-er
un-pro-cessed	un-proc-essed
busk-ing	busking
tiger	ti-ger
wartime	war-time
theos-o-phy	the-os-o-phy
pin-t	pint
moray	mo-ray
distaff	dis-taff
erec-tile	e-rec-tile
melan-cholic	mel-an-chol-ic
u-n-adorned	un-a-dorned
in-vest-men-t	in-vest-ment
cham-p	champ
sedi-tious	se-di-tious
damask	dam-ask
meri-no	me-ri-no
con-sign-men-t	con-sign-ment
any-how	an-y-how
se-nior	sen-ior
p-salter	psal-ter
rapi-er	ra-pi-er
s-to-chas-tic	sto-chas-tic
choline	cho-line
ex-pan-sion-is-m	ex-pan-sion-ism
b-o-rate	bo-rate
un-tidy	un-ti-dy
em-bank-men-t	em-bank-ment
can-nery	can-ner-y
rel-a-tivis-m	rel-a-tiv-ism
brief-s	briefs
k-itchen-ware	kitch-en-ware
kinswom-an	kins-wom-an
so-cio-cul-tur-al	so-ci-o-cul-tur-al
per-ineum	per-i-ne-um
tute-lage	tu-te-lage
flighty	flight-y
s-lan-der-ous	slan-der-ous
the-atri-cal-ly	the-at-ri-cal-ly
un-mis-tak-able	un-mis-tak-a-ble
earnest-ness	ear-nest-ness
gateau	ga-teau
glitzy	glitz-y
l-o-gis-ti-cal	lo-gis-ti-cal
remix	re-mix
in-sis-tence	in-sist-ence
un-trans-lat-able	un-trans-lat-a-ble
co-pro-lite	cop-ro-lite
ax-iom	ax-i-om
bar-baris-m	bar-ba-rism
preterite	pret-er-ite
un-us-able	un-us-a-ble
delir-i-um	de-lir-i-um
per-fidy	per-fi-dy
vagabond	vag-a-bond
for-giv-able	for-giv-a-ble
polon-aise	pol-o-naise
rein-vig-o-rate	re-in-vig-or-ate
crazi-ly	cra-zi-ly
moral-is-m	mor-al-ism
c-ityscape	cit-y-scape
ox-alate	ox-a-late
raver	rav-er
de-cathlon	de-cath-lon
satchel	satch-el
net-work-ing	networking
gener-i-cal-ly	ge-ner-i-cal-ly
retroac-tive-ly	ret-ro-ac-tive-ly
pyra-mi-dal	py-ram-i-dal
plat-inum	plat-i-num
char-i-o-teer	char-i-ot-eer
dis-mem-bered	dismembered
leapfrog	leap-frog
s-log	slog
no-tice-ably	no-tice-a-bly
firkin	fir-kin
me-dieval	me-di-e-val
s-ta-tor	sta-tor
s-lum	slum
de-pri-va-tion	dep-ri-va-tion
over-pay-men-t	o-ver-pay-ment
galleon	gal-le-on
poly-tech-nic	pol-y-tech-nic
s-cat	scat
crys-talline	crys-tal-line
rai-men-t	rai-ment
any-body	an-y-bod-y
ac-cep-t	ac-cept
dy-nasty	dy-nas-ty
wormy	worm-y
shaven	shav-en
pur-suan-t	pur-su-ant
groundswell	ground-swell
risot-to	ri-sot-to
s-mirk	smirk
chromi-um	chro-mi-um
g-naw-ing	gnaw-ing
grouchy	grouch-y
de-sir-able	de-sir-a-ble
over-pass	o-ver-pass
spoilage	spoil-age
re-vi-sion-is-m	re-vi-sion-ism
s-lash-er	slash-er
la-ten-t	la-tent
trac-t	tract
s-ta-tis-ti-cal	sta-tis-ti-cal
wordy	word-y
feu-dal-is-m	feu-dal-ism
psy-chother-a-pist	psy-cho-ther-a-pist
un-de-cid-able	un-de-cid-a-ble
be-wil-dered	bewildered
lot-tery	lot-ter-y
join-t	joint
au-thor-i-tar-i-an-is-m	au-thor-i-tar-i-an-ism
con-queror	con-quer-or
kriegspiel	krieg-spiel
aun-tie	aunt-ie
laden	lad-en
oblige	o-blige
sailor	sail-or
o-belisk	ob-e-lisk
over-pow-er-ing	o-ver-pow-er-ing
coax-i-al	co-ax-i-al
propul-sive	pro-pul-sive
s-wot	swot
kestrel	kes-trel
fi-deli-ty	fi-del-i-ty
premis-es	prem-is-es
car-bona-ceous	car-bo-na-ceous
clair-voy-an-t	clair-voy-ant
flick-er-ing	flickering
dis-able	dis-a-ble
de-vel-op-men-t	de-vel-op-ment
in-sou-ciance	in-sou-ci-ance
su-per-nu-mer-ary	su-per-nu-mer-ar-y
s-tiff	stiff
s-nig-ger-ing	sniggering
para-mil-i-tary	par-a-mil-i-tar-y
grapevine	grape-vine
pit-fal-l	pit-fall
ra-dio-graph-ic	ra-di-o-graph-ic
re-sent-men-t	re-sent-ment
h-es-i-ta-tion	hes-i-ta-tion
avowed	a-vowed
im-pres-sion-able	im-pres-sion-a-ble
un-touch-able	un-touch-a-ble
julep	ju-lep
a-pos-tolic	ap-os-tol-ic
cau-tion-ary	cau-tion-ar-y
dauphin	dau-phin
aphid	a-phid
verdi-gris	ver-di-gris
covenan-t	cov-e-nant
zealotry	zeal-ot-ry
syn-di-cal-is-m	syn-di-cal-ism
re-mis-s	re-miss
s-pas-tic	spas-tic
count-able	count-a-ble
steamship	steam-ship
mul-ti-plica-tive	mul-ti-pli-ca-tive
artistry	art-ist-ry
sub-jec-tivis-m	sub-jec-tiv-ism
poly-gon	pol-y-gon
ir-ra-tional	ir-ra-tion-al
turnover	turn-o-ver
any-more	an-y-more
spec-s	specs
medicine	med-i-cine
poly-syl-la-ble	pol-y-syl-la-ble
shady	shad-y
any-where	an-y-where
coloured	co-loured
ho-muncu-lus	ho-mun-cu-lus
re-frac-t	re-fract
unlove-ly	un-love-ly
over-draft	o-ver-draft
over-anx-ious	o-ver-anx-ious
enor-mous-ly	e-nor-mous-ly
ex-ul-tan-t	ex-ult-ant
verisimil-i-tude	ver-i-si-mil-i-tude
nun-nery	nun-ner-y
coro-ner	cor-o-ner
seg-men-t	seg-ment
pastis	pas-tis
re-stroom	rest-room
p-ri-mor-dial	pri-mor-di-al
bar-racu-d-a	bar-ra-cu-da
crisply	crisp-ly
pizzi-ca-to	piz-zi-ca-to
mi-ni	min-i
theodo-lite	the-od-o-lite
menar-che	men-ar-che
s-natch	snatch
duo	du-o
ex-pand-able	ex-pand-a-ble
bindery	bind-er-y
scrib-bling	scribbling
clover	clo-ver
meta-mor-phic	met-a-mor-phic
droplet	drop-let
thorny	thorn-y
f-rigid	frig-id
ten-antry	ten-ant-ry
mit-t	mitt
incog-ni-to	in-cog-ni-to
hy-dropho-bic	hy-dro-pho-bic
un-hope-d	un-hoped
trac-ery	trac-er-y
phe-nomenol-o-gy	phe-nom-e-nol-o-gy
tele-vi-sion	tel-e-vi-sion
fairy	fair-y
wrinkly	wrin-kly
mis-in-for-m	mis-in-form
stinky	stink-y
porce-lain	por-ce-lain
cologne	co-logne
teeter	tee-ter
oblig-ing-ly	o-blig-ing-ly
basil	bas-il
s-tur-dy	stur-dy
undis-put-ed	un-dis-put-ed
geni-i	ge-ni-i
gaucherie	gau-che-rie
un-com-fort-able	un-com-fort-a-ble
causal	caus-al
mo-lesta-tion	mo-les-ta-tion
front-ed	fronted
lit-toral	lit-to-ral
s-tatis-ti-cian	stat-is-ti-cian
s-mooth-ly	smooth-ly
in-ward-s	in-wards
ne-ma-tode	nem-a-tode
squea-mish	squeam-ish
un-clas-si-fi-able	un-clas-si-fi-a-ble
may-oral-ty	may-or-al-ty
par-ent-ing	parenting
swinger	swing-er
may-oral	may-or-al
necrop-sy	nec-rop-sy
curie	cu-rie
pathol-o-gist	pa-thol-o-gist
en-tran-t	en-trant
polyurethane	pol-y-u-re-thane
antrum	an-trum
voyeuris-tic	voy-eur-is-tic
catalep-sy	cat-a-lep-sy
ptero-dactyl	pter-o-dac-tyl
chewy	chew-y
urchin	ur-chin
penum-bra	pe-num-bra
op-por-tunis-m	op-por-tun-ism
heater	heat-er
fetishis-tic	fet-ish-is-tic
jeal-ousy	jeal-ous-y
de-trac-t	de-tract
over-com-pen-sate	o-ver-com-pen-sate
s-nap-shot	snap-shot
c-i-ta-tion	ci-ta-tion
un-abashed	un-a-bashed
tractable	trac-ta-ble
body-guard	bod-y-guard
mega-lo-ma-ni-a	meg-a-lo-ma-ni-a
weed-s	weeds
re-splen-den-t	re-splend-ent
beery	beer-y
im-ple-men-t	im-ple-ment
pity	pit-y
yardage	yard-age
stylist	styl-ist
d-if-fer-en-ti-a-tion	dif-fer-en-ti-a-tion
re-ver-ber-an-t	re-ver-ber-ant
ex-pec-tant-ly	ex-pect-ant-ly
in-tran-si-gen-t	in-tran-si-gent
theoc-ra-cy	the-oc-ra-cy
record-ed	re-cor-ded
ide-o-log-i-cal	i-de-o-log-i-cal
s-parse	sparse
s-melly	smell-y
comber	comb-er
in-nocu-ous	in-noc-u-ous
voca-tive	voc-a-tive
be-trothal	be-troth-al
flutist	flut-ist
de-ten-t	de-tent
are-na	a-re-na
rap-proche-men-t	rap-proche-ment
provider	pro-vid-er
erot-ic	e-rot-ic
iron-ic	i-ron-ic
fore-ar-m	fore-arm
doyen	doy-en
gen-eros-i-ty	gen-er-os-i-ty
moun-t	mount
metatarsal	met-a-tar-sal
can-dlelit	can-dle-lit
ox-i-dan-t	ox-i-dant
at-trib-ut-able	at-trib-ut-a-ble
dauber	daub-er
plebiscite	pleb-i-scite
draugh-t	draught
ban-ter-ing	bantering
gaze-bo	ga-ze-bo
e-m-a-na-tion	em-a-na-tion
s-tim-u-lus	stim-u-lus
dis-re-spec-t	dis-re-spect
com-man-der	com-mand-er
un-frozen	un-fro-zen
elec-trolyte	e-lec-tro-lyte
hair-spray	hairspray
backgam-mon	back-gam-mon
s-tay	stay
res-onate	res-o-nate
rea-son-able-ness	rea-son-a-ble-ness
un-buried	un-bur-ied
im-ped-i-men-t	im-ped-i-ment
car-rion	car-ri-on
beefeater	beef-eat-er
de-caf-feinate	de-caf-fein-ate
im-prison	im-pris-on
japan	ja-pan
open-ly	o-pen-ly
s-not-ty	snot-ty
so-bri-ety	so-bri-e-ty
over-pop-u-la-tion	o-ver-pop-u-la-tion
flinty	flint-y
lega-tor	le-ga-tor
dodger	dodg-er
binoc-u-lars	bin-oc-u-lars
sub-mersible	sub-mers-i-ble
in-n	inn
aqua-naut	aq-ua-naut
rhetoric	rhet-o-ric
kosher	ko-sher
tapir	ta-pir
vengeance	venge-ance
piercer	pierc-er
mus-cu-loskele-tal	mus-cu-lo-skel-e-tal
grandeur	gran-deur
mi-crowave	mi-cro-wave
elec-t	e-lect
flammable	flam-ma-ble
bracelet	brace-let
e-bony	eb-on-y
as-para-gus	as-par-a-gus
for-get-table	for-get-ta-ble
dul-cimer	dul-ci-mer
dis-ori-en-ta-tion	dis-o-ri-en-ta-tion
antacid	ant-ac-id
re-mark-ably	re-mark-a-bly
warpath	war-path
over-ride	o-ver-ride
usurp-er	u-surp-er
sooty	soot-y
s-ta-tion-mas-ter	sta-tion-mas-ter
overem-pha-sis	o-ver-em-pha-sis
dis-gust-ed	disgusted
ce-men-t	ce-ment
ide-al-is-tic	i-de-al-is-tic
re-cruiter	re-cruit-er
timetable	time-ta-ble
im-per-me-able	im-per-me-a-ble
s-teeple-jack	stee-ple-jack
decile	dec-ile
body-build-ing	bod-y-build-ing
prostaglandin	pros-ta-glan-din
ini-ti-a-tion	in-i-ti-a-tion
vil-lager	vil-lag-er
pres-i-den-t	pres-i-dent
dis-in-vest-men-t	dis-in-vest-ment
thread-ed	threaded
over-rate	o-ver-rate
at-temp-t	at-tempt
ir-rev-er-en-t	ir-rev-er-ent
prefer-able	pref-er-a-ble
lay-of-f	lay-off
liq-uida-tor	liq-ui-da-tor
in-fil-l	in-fill
sub-jec-t	sub-ject
opaque	o-paque
bio-med-i-cal	bi-o-med-i-cal
pouter	pout-er
s-park	spark
poly-glot	pol-y-glot
d-in-gle	din-gle
pes-simist	pes-si-mist
con-tentious	con-ten-tious
s-cis-sor	scis-sor
ho-mo-mor-phis-m	ho-mo-mor-phism
greensward	green-sward
onus	o-nus
footrest	foot-rest
budgie	budg-ie
over-sleep	o-ver-sleep
potable	po-ta-ble
diathermy	di-a-ther-my
crim-p	crimp
pur-suer	pur-su-er
de-men-t	de-ment
hypochon-dri-a-cal	hy-po-chon-dri-a-cal
short-ter-m	short-term
barefaced	bare-faced
di-alec-ti-cal	di-a-lec-ti-cal
promis-ing	prom-is-ing
fore-stal-l	fore-stall
sepi-a	se-pi-a
p-re-sen-ta-tion	pres-en-ta-tion
gospel	gos-pel
sies-ta	si-es-ta
trans-ac-t	trans-act
en-chanter	en-chant-er
grenade	gre-nade
poly-cyclic	pol-y-cy-clic
preg-nan-t	preg-nant
dan-de-lion	dan-de-li-on
en-v-i-ron	en-vi-ron
im-per-ti-nen-t	im-per-ti-nent
di-vorcee	di-vor-cee
debu-tan-t	deb-u-tant
on-slaugh-t	on-slaught
sug-ary	sug-ar-y
e-u-pho-nious	eu-pho-ni-ous
s-mudge	smudge
reap-pear-ance	re-ap-pear-ance
nour-ish-men-t	nour-ish-ment
or-thonor-mal	or-tho-nor-mal
cesspool	cess-pool
un-palat-able	un-pal-at-a-ble
s-luice	sluice
feb-ru-ary	feb-ru-ar-y
s-melt-ing	smelting
s-toep	stoep
pointy	point-y
in-co-her-en-t	in-co-her-ent
warhorse	war-horse
tenac-i-ty	te-nac-i-ty
pu-ri-tanis-m	pu-ri-tan-ism
over-pay	o-ver-pay
groovy	groov-y
method-olog-i-cal	meth-od-o-log-i-cal
over-cast	o-ver-cast
ro-botic	ro-bot-ic
opin-ion-at-ed	o-pin-ion-at-ed
ven-omous	ven-om-ous
we-b	web
i-n-ac-cu-rate-ly	in-ac-cu-rate-ly
ovum	o-vum
de-file-men-t	de-file-ment
feath-erlight	feath-er-light
var-ie-gat-ed	var-i-e-gat-ed
mon-o-clon-al	mon-o-clo-nal
ves-ti-gial	ves-tig-i-al
canon-ic	ca-non-ic
t-ingly	tin-gly
view-able	view-a-ble
posse	pos-se
lighter	light-er
phe-nomeno-log-i-cal	phe-nom-e-no-log-i-cal
briefer	brief-er
un-con-scionable	un-con-scion-a-ble
syco-phan-tic	syc-o-phan-tic
un-kep-t	un-kept
velum	ve-lum
out-lawed	outlawed
ex-ten-der	ex-tend-er
con-temp-t	con-tempt
arc-ing	arcing
proac-tive	pro-ac-tive
hia-tus	hi-a-tus
patho-log-i-cal	path-o-log-i-cal
os-tracis-m	os-tra-cism
manda-to-ry	man-da-to-ry
monies	mon-ies
bio-chemist	bi-o-chem-ist
han-dover	hand-o-ver
war-m	warm
s-mite	smite
so-cio-bi-ol-o-gy	so-ci-o-bi-ol-o-gy
in-tractable	in-trac-ta-ble
pul-l	pull
un-der-cur-ren-t	un-der-cur-rent
tri-umphal	tri-um-phal
pro-le-tari-at	pro-le-tar-i-at
ve-nial	ve-ni-al
elu-sive	e-lu-sive
swar-m	swarm
en-tourage	en-tou-rage
touris-tic	tour-is-tic
froward	fro-ward
f-reak	freak
tableau	tab-leau
cen-tipede	cen-ti-pede
ion	i-on
epi-taph	ep-i-taph
i-con-o-clas-m	i-con-o-clasm
un-solv-able	un-solv-a-ble
styling	styl-ing
e-quinox	e-qui-nox
iso-trop-ic	i-so-trop-ic
ul-tra-son-ic-s	ul-tra-son-ics
ju-bi-lan-t	ju-bi-lant
k-ilo-byte	kil-o-byte
s-port-ing-ly	sport-ing-ly
en-vi-ron-men-t	en-vi-ron-ment
roundel	roun-del
ni-troge-nous	ni-trog-e-nous
reload	re-load
gamy	gam-y
mea-sure-men-t	meas-ure-ment
u-nau-dit-ed	un-au-dit-ed
mis-spel-l	mis-spell
rosary	ro-sa-ry
glossy	gloss-y
s-tim-u-lat-ing	stim-u-lat-ing
in-con-ti-nen-t	in-con-ti-nent
semide-tached	sem-i-de-tached
azure	az-ure
ril-l	rill
doubter	doubt-er
mas-tery	mas-ter-y
s-tokes	stokes
courage	cour-age
furtive	fur-tive
gib-ber-ing	gibbering
laser	la-ser
in-gre-di-en-t	in-gre-di-ent
soli-taire	sol-i-taire
di-aphrag-m	di-a-phragm
hy-acinth	hy-a-cinth
largo	lar-go
is-suance	is-su-ance
d-if-fer-en-t	dif-fer-ent
e-d-u-ca-tion-al	ed-u-ca-tion-al
poly-mer	pol-y-mer
ex-pect-ed	expected
fil-i-buster	fil-i-bus-ter
coax-ing	coaxing
buri-al	bur-i-al
aviary	a-vi-ar-y
prove-nance	prov-e-nance
bur-gundy	bur-gun-dy
melo-di-ous	me-lo-di-ous
k-loof	kloof
crooked	crook-ed
catheter	cath-e-ter
fragili-ty	fra-gil-i-ty
s-esame	ses-a-me
vial	vi-al
celandine	cel-an-dine
rhyth-m	rhythm
lodestar	lode-star
s-tran-gle-hold	stran-gle-hold
parental	pa-ren-tal
s-mall-ish	small-ish
moun-tain-sid-e	moun-tain-side
apron	a-pron
bedrid-den	bed-rid-den
s-in-u-ous	sin-u-ous
stymie	sty-mie
s-tud	stud
un-equiv-o-cal-ly	un-e-quiv-o-cal-ly
apoc-a-lyp-tic	a-poc-a-lyp-tic
vine-gar	vin-e-gar
i-nani-ty	in-an-i-ty
fe-lic-i-ta-tion-s	fe-lic-i-ta-tions
mytho-log-i-cal	myth-o-log-i-cal
quater-nion	qua-ter-ni-on
over-dra-mat-ic	o-ver-dra-mat-ic
con-for-mance	con-form-ance
tri-maran	tri-ma-ran
ret-inue	ret-i-nue
un-rol-l	un-roll
s-core-less	score-less
ex-cerp-t	ex-cerpt
laager	laa-ger
ep-ithe-lial	ep-i-the-li-al
tav-er-na	ta-ver-na
gril-l	grill
good-s	goods
ex-ocrine	ex-o-crine
temer-i-ty	te-mer-i-ty
elite	e-lite
para-noia	par-a-noi-a
en-cycli-cal	en-cyc-li-cal
mar-ketable	mar-ket-a-ble
u-n-ac-count-ed	un-ac-count-ed
virus	vi-rus
rheumat-ic	rheu-mat-ic
brandy	bran-dy
s-teep	steep
briefly	brief-ly
un-watch-able	un-watch-a-ble
aza-lea	a-zal-ea
puerile	pu-er-ile
fon-dan-t	fon-dant
s-cent-ed	scent-ed
lazuli	laz-u-li
prepa-ra-tion	prep-a-ra-tion
coinage	coin-age
in-stan-t	in-stant
an-tic-s	an-tics
put-t	putt
polyun-sat-u-rat-ed	pol-y-un-sat-u-rat-ed
y-o-del	yo-del
brun-t	brunt
demon-stra-bly	de-mon-stra-bly
t-in-gle	tin-gle
vari-ate	var-i-ate
over-drive	o-ver-drive
fundrais-ing	fund-rais-ing
dis-qui-etude	dis-qui-e-tude
y-achts-man	yachts-man
s-targaz-er	star-gaz-er
s-melt	smelt
s-ta-tion-ary	sta-tion-ar-y
in-haler	in-hal-er
re-in-state-men-t	re-in-state-ment
sisal	si-sal
salary	sal-a-ry
guilty	guilt-y
t-wofaced	two-faced
im-pru-den-t	im-pru-dent
physic	phys-ic
cobalt	co-balt
teenage	teen-age
hookah	hook-ah
overkil-l	o-ver-kill
move-men-t	move-ment
bubon-ic	bu-bon-ic
choral	cho-ral
s-tar-ship	star-ship
for-syth-ia	for-syth-i-a
over-whelm-ing	o-ver-whelm-ing
labi-um	la-bi-um
unchris-tian	un-chris-tian
re-word-ings	re-word-ings
soli-tude	sol-i-tude
awry	a-wry
in-can-des-cen-t	in-can-des-cent
strol-l	stroll
bur-nished	burnished
cathar-tic	ca-thar-tic
lender	lend-er
pornog-ra-pher	por-nog-ra-pher
con-demned	condemned
gaiter	gait-er
im-moral-i-ty	im-mo-ral-i-ty
ex-pec-t	ex-pect
pester	pes-ter
any	an-y
s-tate-ly	state-ly
mega-hertz	meg-a-hertz
hep-tagon	hep-ta-gon
green-ery	green-er-y
rein-ter-pre-ta-tion	re-in-ter-pre-ta-tion
lousy	lous-y
giblet-s	gib-lets
lithog-ra-phy	li-thog-ra-phy
fun-da-men-tal-is-m	fun-da-men-tal-ism
d-u-al	du-al
lounger	loung-er
meta-physic-s	met-a-phys-ics
mar-tinet	mar-ti-net
docile	doc-ile
fluffy	fluff-y
fault-ing	faulting
odi-um	o-di-um
dis-ori-en-t	dis-o-ri-ent
carouse	ca-rouse
in-suf-fi-cien-t	in-suf-fi-cient
cer-ti-fi-able	cer-ti-fi-a-ble
tri-adic	tri-ad-ic
s-capu-la	scap-u-la
as-cetic	as-cet-ic
pagean-t	pag-eant
peanut	pea-nut
co-ef-fi-cien-t	co-ef-fi-cient
ar-bi-trari-ness	ar-bi-trar-i-ness
ha-track	hat-rack
s-lap	slap
por-phyrit-ic	por-phy-rit-ic
er-ro-neous-ly	er-ro-ne-ous-ly
lanky	lank-y
soft-bal-l	soft-ball
sil-vered	silvered
in-trauter-ine	in-tra-u-ter-ine
taboo	ta-boo
break-able	break-a-ble
k-nack	knack
mili-ti-a	mi-li-tia
e-vac-uee	e-vac-u-ee
racon-teur	rac-on-teur
i-n-or-di-nate	in-or-di-nate
joey	jo-ey
margina-li-a	mar-gi-na-li-a
swelling	swell-ing
trainee	train-ee
treaty	trea-ty
k-lick	klick
Words with errors: 2265
Words with incorrect number of syllables: 2068
Total evluated: 6500
Perfect accuracy: 0.65
Number of syllables accuracy: 0.68
Average Levenshtein Distance(across incorrect words): 1.22
