Attempt	Real
mil-i-tarist	mil-i-ta-rist
doorstep	door-step
prepo-si-tion	prep-o-si-tion
nomen-cla-ture	no-men-cla-ture
tabloid	tab-loid
s-cum	scum
unin-sur-able	un-in-sur-a-ble
re-pro-cess	re-proc-ess
s-can-sion	scan-sion
s-carci-ty	scar-ci-ty
bal-loon-ist	balloonist
y-acht-ing	yacht-ing
i-nan-i-mate	in-an-i-mate
re-al-is-m	re-al-ism
awake	a-wake
hearti-ly	heart-i-ly
semi-fi-nal-ist	sem-i-fi-nal-ist
la-ten-t	la-tent
melan-cho-li-a	mel-an-cho-li-a
s-lip-per-i-ness	slip-per-i-ness
lusti-ly	lust-i-ly
ob-scu-ran-tism	ob-scu-rant-ism
d-if-frac-tion	dif-frac-tion
epis-co-pal	e-pis-co-pal
im-mi-nen-t	im-mi-nent
rip-pling	rippling
in-tol-er-an-t	in-tol-er-ant
podi-um	po-di-um
elec-tro-mag-net	e-lec-tro-mag-net
enor-mous	e-nor-mous
b-liss-ful-ly	bliss-ful-ly
no-tice-able	no-tice-a-ble
over-lie	o-ver-lie
racon-teur	rac-on-teur
con-ducive	con-du-cive
di-rec-t	di-rect
crazy	cra-zy
residue	res-i-due
en-er-get-ic-s	en-er-get-ics
basal	ba-sal
trib-al-is-m	trib-al-ism
aorist	a-o-rist
founder	found-er
tomboy	tom-boy
marcher	march-er
s-port-ing-ly	sport-ing-ly
poly-the-is-tic	pol-y-the-is-tic
cav-ernous	cav-ern-ous
plat-inum	plat-i-num
s-nap-shot	snap-shot
triplex	tri-plex
spel-l	spell
dis-abled	dis-a-bled
poly-tech-nic	pol-y-tech-nic
here-inafter	here-in-af-ter
sleazy	slea-zy
cere-bel-lum	cer-e-bel-lum
im-pinge-men-t	im-pinge-ment
elec-tri-cal	e-lec-tri-cal
tri-umvi-rate	tri-um-vi-rate
breather	breath-er
droopy	droop-y
pedan-tic	pe-dan-tic
corvette	cor-vette
anoin-t	a-noint
sax-ony	sax-o-ny
molyb-de-num	mo-lyb-de-num
un-invit-ing	un-in-vit-ing
pirou-ette	pir-ou-ette
unlov-ing	un-lov-ing
su-per-cil-ious	su-per-cil-i-ous
in-con-ti-nen-t	in-con-ti-nent
con-ceal-men-t	con-ceal-ment
op-ti-misti-cal-ly	op-ti-mis-ti-cal-ly
ma-hogany	ma-hog-a-ny
en-fran-chise-men-t	en-fran-chise-ment
lassie	las-sie
in-dige-nous	in-dig-e-nous
fri-vol-ity	fri-vol-i-ty
ven-t	vent
na-iad	nai-ad
gal-l	gall
tri-umphal-is-m	tri-um-phal-ism
ev-ery-one	eve-ry-one
sor-cery	sor-cer-y
en-slave-men-t	en-slave-ment
iso-trop-ic	i-so-trop-ic
kosher	ko-sher
s-mug-ness	smug-ness
oblige	o-blige
dis-avow-al	dis-a-vow-al
l-ynx	lynx
tonal-i-ty	to-nal-i-ty
ver-i-fi-able	ver-i-fi-a-ble
trencher	trench-er
con-coc-t	con-coct
en-chant-men-t	en-chant-ment
pom-p	pomp
cen-tripetal	cen-trip-e-tal
s-now-stor-m	snow-storm
inkling	ink-ling
gad-get	gadg-et
vam-p	vamp
gril-l	grill
loafer	loaf-er
e-ti-quette	et-i-quette
i-n-or-di-nate-ly	in-or-di-nate-ly
it-s	its
cos-set-ed	cosseted
deis-m	de-ism
chan-t	chant
chancery	chan-cer-y
kinder-garten	kin-der-gar-ten
in-fan-t	in-fant
en-hancer	en-hanc-er
lancer	lanc-er
no-tice-ably	no-tice-a-bly
pun-ish-able	pun-ish-a-ble
baili-wick	bail-i-wick
cir-cum-spec-t	cir-cum-spect
prostaglandin	pros-ta-glan-din
un-know-able	un-know-a-ble
menis-cus	me-nis-cus
con-tin-gen-t	con-tin-gent
u-n-af-ford-able	un-af-ford-a-ble
colo-nial-ist	co-lo-ni-al-ist
elic-it	e-lic-it
tor-men-t	tor-ment
con-junc-t	con-junct
ex-ult-ing	exulting
im-pro-vi-sa-tion-al	im-prov-i-sa-tion-al
tick-et-ed	ticketed
ji-u-jit-su	jiu-jit-su
drainage	drain-age
re-pug-nan-t	re-pug-nant
tyran-ny	tyr-an-ny
get-away	get-a-way
t-in-foil	tin-foil
fruity	fruit-y
dis-penser	dis-pens-er
pekan	pek-an
vir-ginal	vir-gin-al
frilli-er	fril-li-er
e-dic-t	e-dict
pur-suan-t	pur-su-ant
a-gen-t	a-gent
apish	ap-ish
b-e-fit	be-fit
in-former	in-form-er
k-ilo-wat-t	kil-o-watt
de-posi-tary	de-pos-i-tar-y
leak-ing	leaking
capy-bara	cap-y-ba-ra
bel-liger-en-t	bel-lig-er-ent
ef-flu-en-t	ef-flu-ent
feu-dal-is-m	feu-dal-ism
retic-u-lum	re-tic-u-lum
gen-eros-i-ty	gen-er-os-i-ty
con-tain-men-t	con-tain-ment
babysit-ting	babysitting
meta-mor-phosed	metamorphosed
noisy	nois-y
s-lip-way	slip-way
calami-ty	ca-lam-i-ty
co-her-en-t	co-her-ent
ho-minid	hom-i-nid
s-cout-mas-ter	scout-mas-ter
in-cip-i-en-t	in-cip-i-ent
leg-isla-tive	leg-is-la-tive
short-s	shorts
s-cor-pi-on	scor-pi-on
un-com-fort-able	un-com-fort-a-ble
pri-apic	pri-ap-ic
foothill	foot-hill
avowed	a-vowed
bassist	bass-ist
ple-beian	ple-be-ian
cleaver	cleav-er
ran-corous	ran-cor-ous
a-ban-don-men-t	a-ban-don-ment
throw-away	throw-a-way
oboe	o-boe
fig-u-ra-tive	fig-ur-a-tive
pronom-i-nal	pro-nom-i-nal
t-suna-mi	tsu-na-mi
wear-able	wear-a-ble
in-haler	in-hal-er
aver-sion	a-ver-sion
cow-ardice	cow-ard-ice
monies	mon-ies
med-dling	meddling
re-ceiv-able	re-ceiv-a-ble
enor-mi-ty	e-nor-mi-ty
over-dra-mat-ic	o-ver-dra-mat-ic
s-lant-ing	slant-ing
blankly	blank-ly
uri-nary	u-ri-nar-y
dis-ori-en-t	dis-o-ri-ent
mid--	mid-
s-cuf-fle	scuf-fle
sarong	sa-rong
in-sou-ciance	in-sou-ci-ance
dis-trac-t	dis-tract
as-sailan-t	as-sail-ant
out-fal-l	out-fall
dis-parag-ing	dis-par-ag-ing
vir-u-len-t	vir-u-lent
dy-namo	dy-na-mo
sonor-i-ty	so-nor-i-ty
o-cean-ic	o-ce-an-ic
im-pass-able	im-pass-a-ble
tra-di-tion-al-is-m	tra-di-tion-al-ism
de-port-men-t	de-port-ment
reawak-en	re-a-wak-en
anti-gen	an-ti-gen
ra-bid	rab-id
con-strict-ed	constricted
su-per-fi-cial-i-ty	su-per-fi-ci-al-i-ty
ur-ticari-a	ur-ti-car-i-a
screwy	screw-y
jerky	jerk-y
reap-point	re-ap-point
tachy-on	tach-y-on
con-tem-po-rary	con-tem-po-rar-y
mal-l	mall
her-m	herm
miser-ly	mi-ser-ly
som-no-len-t	som-no-lent
be-wil-dered	bewildered
in-es-timable	in-es-ti-ma-ble
can-dlelit	can-dle-lit
un-ortho-doxy	un-or-tho-dox-y
bol-stered	bolstered
un-ten-able	un-ten-a-ble
rhetoric	rhet-o-ric
rent-ed	rented
g-lyph	glyph
s-can-dalous	scan-dal-ous
docile	doc-ile
struc-tural	struc-tur-al
omi-nous-ly	om-i-nous-ly
s-ly-ly	sly-ly
s-pline	spline
bristling	bris-tling
awry	a-wry
an-teceden-t	an-te-ced-ent
lazuli	laz-u-li
tele-scop-ic	tel-e-scop-ic
s-tum-bling	stum-bling
cigar	ci-gar
cater-er	ca-ter-er
fever	fe-ver
u-p-land	up-land
s-mall-hold-er	small-hold-er
kil-n	kiln
morsel	mor-sel
s-tart	start
s-mart-ly	smart-ly
ex-pan-sion-ary	ex-pan-sion-ar-y
pre-fab-ri-cat-ed	prefabricated
s-lob-ber	slob-ber
tex-t	text
pup-peteer	pup-pet-eer
episod-ic	ep-i-sod-ic
temptress	tempt-ress
in-signif-i-cance	in-sig-nif-i-cance
paschal	pas-chal
cheater	cheat-er
backchat	back-chat
surly	sur-ly
undiplo-mat-ic	un-dip-lo-mat-ic
par-si-mo-nious	par-si-mo-ni-ous
dis-join-t	dis-joint
es-carp-men-t	es-carp-ment
phle-boto-my	phle-bot-o-my
re-alpoli-tik	re-al-po-li-tik
dis-per-san-t	dis-per-sant
apro-pos	ap-ro-pos
poly-eth-yl-ene	pol-y-eth-yl-ene
trireme	tri-reme
navel	na-vel
laud-ed	lauded
panache	pa-nache
as-cen-der	as-cend-er
cru-ci-for-m	cru-ci-form
pes-simis-m	pes-si-mism
man-dolin	man-do-lin
busi-nesslike	busi-ness-like
springy	spring-y
tapi-o-ca	tap-i-o-ca
volup-tuous	vo-lup-tu-ous
nymp-holep-sy	nym-pho-lep-sy
un-pre-dictabil-i-ty	un-pre-dict-a-bil-i-ty
ra-dionu-clide	ra-di-o-nu-clide
g-lut	glut
record-ing	re-cord-ing
s-pay	spay
hand-bel-l	hand-bell
tread-mil-l	tread-mill
leisured	lei-sured
umpteenth	ump-teenth
chili	chil-i
dis-ap-proval	dis-ap-prov-al
pro-pel-lan-t	pro-pel-lant
u-n-apolo-get-ic	un-a-pol-o-get-ic
ge-neal-o-gy	ge-ne-al-o-gy
s-lan-t	slant
scriptwrit-er	script-writ-er
cham-p	champ
le-nien-t	le-ni-ent
hotspot	hot-spot
po-ten-t	po-tent
u-n-aware	un-a-ware
in-deli-ble	in-del-i-ble
per-for-m	per-form
in-salu-bri-ous	in-sa-lu-bri-ous
liquor-ish	liq-uor-ish
desul-to-ry	des-ul-to-ry
chan-cellery	chan-cel-ler-y
skele-tal	skel-e-tal
ar-madil-lo	ar-ma-dil-lo
g-nos-tic	gnos-tic
bet-ter-men-t	bet-ter-ment
fer-al	fe-ral
un-hy-gien-ic	un-hy-gi-en-ic
preschool	pre-school
catalep-sy	cat-a-lep-sy
re-vival	re-viv-al
ease-men-t	ease-ment
mega-lith	meg-a-lith
s-trate-gic	stra-te-gic
over-crowd-ed	o-ver-crow-ded
non-pay-men-t	non-pay-ment
in-tra-venous	in-tra-ve-nous
chop-s	chops
gateau	ga-teau
ephemeris	e-phem-er-is
palm-istry	palm-is-try
in-de-pen-dence	in-de-pend-ence
bian-nu-al	bi-an-nu-al
satin	sat-in
in-vari-ably	in-var-i-a-bly
d-enizen	den-i-zen
won-t	wont
lacteal	lac-te-al
footwear	foot-wear
bas-ket-bal-l	bas-ket-ball
over-sup-ply	o-ver-sup-ply
forestry	for-est-ry
n-im-bly	nim-bly
cel-ery	cel-er-y
moral-ly	mor-al-ly
graver	grav-er
lauda-to-ry	laud-a-to-ry
n-im-ble-ness	nim-ble-ness
un-opened	un-o-pened
eerie	ee-rie
hostler	hos-tler
leisure-ly	lei-sure-ly
share-able	share-a-ble
pre-cau-tion-ary	pre-cau-tion-ar-y
coast-ing	coasting
es-timable	es-ti-ma-ble
con-nect-ing	con-nec-ting
pygmy	pyg-my
quencher	quench-er
ar-range-men-t	ar-range-ment
blun-der-ing	blundering
over-pass	o-ver-pass
polypropy-lene	pol-y-pro-pyl-ene
isother-mal	i-so-ther-mal
y-outh-ful	youth-ful
pael-la	pa-el-la
chrono-log-i-cal-ly	chron-o-log-i-cal-ly
painful	pain-ful
awning	awn-ing
aware-ness	a-ware-ness
para-troop-er	par-a-troop-er
s-lag	slag
more-over	more-o-ver
rege-late	re-ge-late
dusky	dusk-y
s-ingsong	sing-song
spiky	spik-y
panz-er	pan-zer
ivory	i-vo-ry
un-der-study	un-der-stud-y
chi-ropodis-t	chi-rop-o-dist
homage	hom-age
schis-m	schism
dy-nam-ic-s	dy-nam-ics
puni-tive	pu-ni-tive
ar-cana	ar-ca-na
mantrap	man-trap
pa-gan-is-m	pa-gan-ism
ir-re-place-able	ir-re-place-a-ble
cy-clotron	cy-clo-tron
s-ta-tion-er	sta-tion-er
tri-bune	trib-une
de-mo-graph-ic-s	dem-o-graph-ics
ef-fron-tery	ef-fron-ter-y
vari-cose	var-i-cose
eigen-state	ei-gen-state
poly-syl-la-ble	pol-y-syl-la-ble
ranter	rant-er
sur-fac-tan-t	sur-fac-tant
earshot	ear-shot
es-sen-tial-is-m	es-sen-tial-ism
s-lob-ber-ing	slobbering
dinky	dink-y
bire-frin-gen-t	bi-re-frin-gent
con-nec-t	con-nect
veg-etable	veg-e-ta-ble
bony	bon-y
alar-m	a-larm
cliffhang-er	cliff-hang-er
fa-nati-cis-m	fa-nat-i-cism
laden	lad-en
promi-nent-ly	prom-i-nent-ly
s-lop-py	slop-py
p-tarmi-gan	ptar-mi-gan
pro-tec-tion-is-m	pro-tec-tion-ism
con-tex-t	con-text
s-e-lec-tiv-i-ty	se-lec-tiv-i-ty
u-nim-peach-able	un-im-peach-a-ble
cashier	cash-ier
sever-i-ty	se-ver-i-ty
garter	gar-ter
ex-clu-sion-ary	ex-clu-sion-ar-y
he-li-copter	hel-i-cop-ter
free-lancer	free-lanc-er
epit-o-me	e-pit-o-me
un-fore-see-able	un-fore-see-a-ble
in-di-rec-t	in-di-rect
c-ityscape	cit-y-scape
goody	good-y
feath-ery	feath-er-y
rasper	rasp-er
mis-spellings	mis-spel-lings
ge-net-ic-s	ge-net-ics
un-fa-mil-iar-i-ty	un-fa-mil-i-ar-i-ty
retsi-na	ret-si-na
palin-drome	pal-in-drome
tal-c	talc
re-cur-ren-t	re-cur-rent
s-ten-cil	sten-cil
paramed-i-cal	par-a-med-i-cal
froward	fro-ward
swindler	swin-dler
epis-tle	e-pis-tle
racist	rac-ist
s-tate-less	state-less
translit-er-ate	trans-lit-er-ate
quartzite	quartz-ite
feal-ty	fe-al-ty
me-nial	me-ni-al
episode	ep-i-sode
s-nug-gle	snug-gle
un-al-ter-able	un-al-ter-a-ble
over-cast	o-ver-cast
satel-lite	sat-el-lite
elu-ci-date	e-lu-ci-date
minaret	min-a-ret
de-ter-ren-t	de-ter-rent
de-ter-mi-nan-t	de-ter-mi-nant
kalei-do-scope	ka-lei-do-scope
s-nort	snort
s-plodge	splodge
in-ter-jec-t	in-ter-ject
or-thonor-mal	or-tho-nor-mal
oblig-ing	o-blig-ing
charge-able	charge-a-ble
es-teemed	e-steemed
tac-t	tact
o-belisk	ob-e-lisk
elit-ist	e-lit-ist
s-pear-head	spear-head
he-do-nis-m	he-don-ism
ra-dio-met-ric	ra-di-o-met-ric
pre-dictably	pre-dict-a-bly
in-ex-press-ible	in-ex-press-i-ble
synapse	syn-apse
ir-re-duc-ible	ir-re-duc-i-ble
able	a-ble
os-teopa-thy	os-te-op-a-thy
turnip	tur-nip
over-sleep	o-ver-sleep
s-tormy	storm-y
mid-wifer-y	mid-wife-ry
g-narled	gnarled
fidu-cia-ry	fi-du-ci-ar-y
s-pate	spate
scruf-f	scruff
minke	min-ke
de-fen-dan-t	de-fend-ant
ple-nary	ple-na-ry
pol-lard-ed	pollarded
pre-dom-i-nan-t	pre-dom-i-nant
beachy	beach-y
techno-pho-bi-a	tech-no-pho-bia
over-whelm-ing-ly	o-ver-whelm-ing-ly
physic	phys-ic
meringue	me-ringue
k-ilo-byte	kil-o-byte
nar-cis-sis-m	nar-cis-sism
obli-ga-tion	ob-li-ga-tion
rapid-ly	rap-id-ly
redac-tion	re-dac-tion
tal-en-t	tal-ent
in-dictable	in-dict-a-ble
tiara	ti-ar-a
s-todgy	stodg-y
dereg-u-late	de-reg-u-late
manikin	man-i-kin
d-if-fer-en-t	dif-fer-ent
bib-lio-phile	bib-li-o-phile
y-outh-ful-ness	youth-ful-ness
ep-silon	ep-si-lon
dial-y-sis	di-al-y-sis
hia-tus	hi-a-tus
p-resent-ly	pres-ent-ly
ques-tion-able	ques-tion-a-ble
sooty	soot-y
dig-ni-tary	dig-ni-tar-y
su-perla-tive	su-per-la-tive
p-re-set	pre-set
restau-ran-t	res-tau-rant
antler	ant-ler
flamin-go	fla-min-go
per-e-stroi-ka	pe-re-stroi-ka
con-toured	contoured
nonessen-tial	non-es-sen-tial
u-n-af-fil-i-at-ed	un-af-fil-i-at-ed
paragon	par-a-gon
in-sol-ven-t	in-sol-vent
ap-par-en-t	ap-par-ent
n-in-com-poop	nin-com-poop
dis-re-spec-t	dis-re-spect
but-tery	but-ter-y
un-record-ed	un-re-cord-ed
bur-bling	burbling
anoma-lous	a-nom-a-lous
lumpy	lump-y
viceroy	vice-roy
lo-quac-ity	lo-quac-i-ty
in-equitable	in-eq-ui-ta-ble
s-pace-man	space-man
ram-p	ramp
s-courge	scourge
s-ta-tus	sta-tus
bo-hemi-an	bo-he-mi-an
pom-padour	pom-pa-dour
in-ces-san-t	in-ces-sant
s-nag	snag
trans-for-m	trans-form
breezy	breez-y
dis-obe-di-ence	dis-o-be-di-ence
t-wang	twang
head-scar-f	head-scarf
thorny	thorn-y
cat-a-clysmic	cat-a-clys-mic
s-ludge	sludge
s-plice	splice
in-dig-nan-t	in-dig-nant
odd-s	odds
com-men-tary	com-men-tar-y
steamship	steam-ship
per-me-abil-i-ty	per-me-a-bil-i-ty
over-land	o-ver-land
shoring	shor-ing
s-lim-line	slim-line
bion-ic-s	bi-on-ics
flus-tered	flustered
sinewy	sin-ew-y
s-calp	scalp
de-cay-ing	decaying
s-parkler	spar-kler
velo-drome	ve-lo-drome
dowa-ger	dow-a-ger
mirac-u-lous	mi-rac-u-lous
autarchy	au-tar-chy
s-tu-por	stu-por
con-tigu-ous	con-tig-u-ous
odi-um	o-di-um
in-stan-t	in-stant
piv-otal	piv-ot-al
coro-na-tion	cor-o-na-tion
geosyn-chronous	ge-o-syn-chro-nous
domi-cile	dom-i-cile
de-cayed	decayed
prepara-to-ry	pre-par-a-to-ry
d-if-fi-cul-ty	dif-fi-cul-ty
overkil-l	o-ver-kill
tirade	ti-rade
com-mod-e	com-mode
thread-ed	threaded
s-mudgy	smudg-y
specif-i-cal-ly	spe-cif-i-cal-ly
peanut	pea-nut
hack-able	hack-a-ble
i-n-un-da-tion	in-un-da-tion
ele-phan-t	el-e-phant
taran-tu-la	ta-ran-tu-la
beget	be-get
s-lip-stream	slip-stream
o-h	oh
e-quip-men-t	e-quip-ment
elec-tri-fi-ca-tion	e-lec-tri-fi-ca-tion
dyad	dy-ad
body	bod-y
liny	lin-y
elec-torate	e-lec-tor-ate
fisticuff-s	fist-i-cuffs
spher-oid	sphe-roid
minu-ti-ae	mi-nu-ti-ae
elec-tron-i-cal-ly	e-lec-tron-i-cal-ly
s-tu-pen-dous	stu-pen-dous
dum-b	dumb
s-trait-en	strait-en
guille-mot	guil-le-mot
hooky	hook-y
biop-sy	bi-op-sy
howler	howl-er
heater	heat-er
geo-cen-tric	ge-o-cen-tric
un-san-i-tary	un-san-i-tar-y
cu-nei-form	cu-ne-i-form
el-e-gan-t	el-e-gant
in-sis-tence	in-sist-ence
bevy	bev-y
s-cone	scone
re-plen-ish-men-t	re-plen-ish-ment
ten-t	tent
con-fec-tionery	con-fec-tion-er-y
supreme	su-preme
plushy	plush-y
ingress	in-gress
poly-chro-mat-ic	pol-y-chro-mat-ic
li-censee	li-cen-see
trans-for-ma-tive	trans-form-a-tive
s-trag-gler	strag-gler
k-loof	kloof
s-cal-able	scal-a-ble
hy-drochlo-ride	hy-dro-chlo-ride
un-work-able	un-work-a-ble
chrono-log-i-cal	chron-o-log-i-cal
nec-es-sary	nec-es-sar-y
s-later	slat-er
s-not-ty	snot-ty
mut-t	mutt
liveli-hood	live-li-hood
flu-en-t	flu-ent
japon-i-ca	ja-pon-i-ca
han-dover	hand-o-ver
iso-late	i-so-late
punch-line	punchline
pro-fi-cien-t	pro-fi-cient
mis-spel-l	mis-spell
shrim-p	shrimp
s-nub	snub
sub-ur-bia	sub-ur-bi-a
re-stric-t	re-strict
gro-cery	gro-cer-y
s-ce-nari-o	sce-nar-i-o
cur-tained	curtained
even-tide	e-ven-tide
tenac-i-ty	te-nac-i-ty
so-lace	sol-ace
co-ex-is-ten-t	co-ex-ist-ent
ju-bilee	ju-bi-lee
book-stal-l	book-stall
gener-ic	ge-ner-ic
e-d-uca-tive	ed-u-ca-tive
salaried	sal-a-ried
debonair	deb-o-nair
fore-stal-l	fore-stall
dis-com-fort-ing	discomforting
ex-porta-bil-i-ty	ex-por-ta-bi-li-ty
gratic-ule	grat-i-cule
killer	kil-ler
maisonette	mai-son-ette
gelati-nous	ge-lat-i-nous
li-bido	li-bi-do
no-to-ri-ety	no-to-ri-e-ty
u-n-avail-abil-i-ty	un-a-vail-a-bil-i-ty
buf-foon-ery	buf-foon-er-y
liftof-f	lift-off
downy	down-y
turnover	turn-o-ver
macron	ma-cron
s-louch-ing	slouching
ini-tial	in-i-tial
ter-m	term
api-ary	a-pi-ar-y
im-pro-visato-ry	im-pro-vi-sa-to-ry
diplo-mat	dip-lo-mat
s-tiff-en-ing	stiff-en-ing
cal-care-ous	cal-car-e-ous
fifti-eth	fif-ti-eth
dactyl	dac-tyl
ge-o-mag-net-i-cal-ly	ge-o-mag-ne-ti-cal-ly
hon-our	ho-nour
down-sid-e	down-side
chancy	chanc-y
omega	o-me-ga
en-tan-gle-men-t	en-tan-gle-ment
finick-y	fin-ick-y
s-lope	slope
pro-ce-du-ral-ly	pro-ce-dur-al-ly
or-di-nary	or-di-nar-y
lager	la-ger
mar-ketable	mar-ket-a-ble
mis-ery	mis-er-y
pro-cre-ation	pro-cre-a-tion
pes-simist	pes-si-mist
yeti	yet-i
s-teeply	steep-ly
for-warder	for-ward-er
un-sea-son-ably	un-sea-son-a-bly
as-pec-t	as-pect
philo-soph-i-cal-ly	phil-o-soph-i-cal-ly
cy-tochrome	cy-to-chrome
undis-turbed	un-dis-turbed
volt-meter	volt-me-ter
retro-fit	ret-ro-fit
muslin	mus-lin
adult	a-dult
trea-sury	treas-ur-y
un-even-ly	un-e-ven-ly
rant-ing	ranting
s-tar-tling-ly	star-tling-ly
en-ter-tain-men-t	en-ter-tain-ment
u-niden-ti-fied	un-i-den-ti-fied
sub-con-ti-nen-t	sub-con-ti-nent
duchess	duch-ess
hare-bel-l	hare-bell
por-ten-t	por-tent
chaot-ic	cha-ot-ic
pave-men-t	pave-ment
buoy-an-t	buoy-ant
le-gionary	le-gion-ar-y
restau-ra-teur	res-tau-ra-teur
emet-ic	e-met-ic
om-nipo-tence	om-nip-o-tence
chamomile	cham-o-mile
d-well	dwell
s-trag-gle	strag-gle
im-pres-sion-is-m	im-pres-sion-ism
napoleon	na-po-le-on
s-plin-ter	splin-ter
un-treat-able	un-treat-a-ble
un-re-pen-tan-t	un-re-pent-ant
in-her-i-ta-ble	in-her-it-a-ble
cater	ca-ter
breast-feed-ing	breastfeeding
en-durable	en-dur-a-ble
platelet	plate-let
rhetor-i-cal	rhe-tor-i-cal
over-done	o-ver-done
count-able	count-a-ble
over-re-act-s	o-ver-re-acts
reshow	re-show
s-par	spar
un-nec-es-sary	un-nec-es-sar-y
cre-ator	cre-a-tor
in-di-can-t	in-di-cant
di-nosaur	di-no-saur
s-calar	sca-lar
mar-chioness	mar-chion-ess
de-ni-able	de-ni-a-ble
s-care	scare
re-vival-is-m	re-viv-al-ism
salu-tary	sal-u-tar-y
i-nane	in-ane
lam-ben-t	lam-bent
s-worn	sworn
defam-a-to-ry	de-fam-a-to-ry
mine-strone	min-e-stro-ne
ri-ot-ing	ri-o-ting
vet-eri-nary	vet-er-i-nar-y
flam-boy-an-t	flam-boy-ant
saver	sav-er
un-car-ed	un-cared
tremo-lo	trem-o-lo
ex-tra-galac-tic	ex-tra-ga-lac-tic
flash-bul-b	flash-bulb
col-lec-tivi-sa-tion	col-lec-ti-vi-sa-tion
sul-tana	sul-tan-a
wicked	wick-ed
itchy	itch-y
au-tomat	au-to-mat
af-fec-t	af-fect
s-teer	steer
ringer	ring-er
ni-hilis-tic	ni-hil-is-tic
s-woop	swoop
un-e-d-u-cat-ed	un-ed-u-cat-ed
po-litesse	pol-i-tesse
drol-l	droll
un-re-peat-able	un-re-peat-a-ble
cobalt	co-balt
ver-b	verb
phil-an-thropic	phil-an-throp-ic
e-ques-tri-an-is-m	e-ques-tri-an-ism
in-ter-men-t	in-ter-ment
trib-u-tary	trib-u-tar-y
defini-tive-ly	de-fin-i-tive-ly
lieu-tenan-t	lieu-ten-ant
i-n-alien-able	in-al-ien-a-ble
hal-lelu-jah	hal-le-lu-jah
pig-ment-ed	pig-men-ted
lul-la-by	lull-a-by
condi-men-t	con-di-ment
mi-crochip	mi-cro-chip
diplo-ma	di-plo-ma
back-bencher	back-bench-er
platy-pus	plat-y-pus
u-n-ac-quaint-ed	un-ac-quaint-ed
de-nial	de-ni-al
apolo-gia	ap-o-lo-gi-a
eatery	eat-er-y
s-nowy	snow-y
spooky	spook-y
vis-coun-t	vis-count
velour	ve-lour
pantry	pan-try
hexag-o-nal	hex-ag-o-nal
s-ter-ile	ster-ile
micro-organ-ism	mi-cro-or-gan-ism
as-pirin	as-pi-rin
perdi-tion	per-di-tion
archery	ar-cher-y
courtship	court-ship
leviathan	le-vi-a-than
con-trivance	con-triv-ance
declar-a-tive	de-clar-a-tive
s-lop-pi-ness	slop-pi-ness
s-now-drop	snow-drop
ar-ran-t	ar-rant
sala-mi	sa-la-mi
mid-dleweight	mid-dle-weight
un-for-get-table	un-for-get-ta-ble
avail-abil-i-ty	a-vail-a-bil-i-ty
k-i-na	ki-na
bac-teri-um	bac-te-ri-um
con-sis-ten-t	con-sist-ent
taber-na-cle	tab-er-nac-le
op-ti-mistic	op-ti-mis-tic
tachy-car-dia	tach-y-car-di-a
crazi-ly	cra-zi-ly
metaphor-i-cal-ly	met-a-phor-i-cal-ly
pul-monary	pul-mo-nar-y
sub-tex-t	sub-text
asi-nine	as-i-nine
willpow-er	will-pow-er
dairy-ing	dair-y-ing
hy-dro-dy-nam-ic-s	hy-dro-dy-nam-ics
s-lip-page	slip-page
en-vi-able	en-vi-a-ble
frontage	front-age
monotony	mo-not-o-ny
viaduc-t	vi-a-duct
mutiny	mu-ti-ny
asymp-tote	as-ymp-tote
friendlily	friend-li-ly
s-liv-er	sliv-er
baroque	ba-roque
un-ready	un-read-y
gaudy	gaud-y
dosage	dos-age
trol-l	troll
prove-nance	prov-e-nance
con-fronta-tion	con-fron-ta-tion
omit	o-mit
un-print-able	un-print-a-ble
psy-chother-a-py	psy-cho-ther-a-py
nestling	nest-ling
pub-lished	published
barter	bar-ter
ketchup	ketch-up
coro-nary	cor-o-nar-y
s-niff-in-g	sniffing
stat-ic-s	stat-ics
lino	li-no
dud-geon	dudg-eon
genoa	gen-o-a
prov-i-den-t	prov-i-dent
malty	malt-y
aqua	aq-ua
book-wor-m	book-worm
eva-sive	e-va-sive
hermeneu-tic-s	her-me-neu-tics
un-usu-al-ly	un-u-su-al-ly
body-build-ing	bod-y-build-ing
in-con-testable	in-con-test-a-ble
wis-p	wisp
benefice	ben-e-fice
in-ces-t	in-cest
un-abashed-ly	un-a-bash-ed-ly
in-sou-ciant	in-sou-ci-ant
papil-la	pa-pil-la
mul-ti-pro-cess-ing	mul-ti-proc-ess-ing
tara-masala-ta	ta-ra-ma-sa-la-ta
se-quencer	se-quenc-er
ap-proach-ing	approaching
drama-tist	dram-a-tist
elixir	e-lix-ir
u-n-ap-pre-ci-at-ed	un-ap-pre-ci-at-ed
col-le-gial	col-le-gi-al
break-away	break-a-way
speci-fici-ty	spec-i-fic-i-ty
dili-gent-ly	dil-i-gent-ly
bom-bardier	bom-bar-dier
ex-porter	ex-port-er
church-war-den	church-ward-en
in-ward-s	in-wards
crino-line	crin-o-line
en-force-able	en-force-a-ble
suf-fragette	suf-fra-gette
w-ere-wolf	were-wolf
tropopause	trop-o-pause
sepi-a	se-pi-a
sub-ur-b	sub-urb
chiefly	chief-ly
chival-ry	chiv-al-ry
sycamore	syc-a-more
pedi-gree	ped-i-gree
psy-choso-cial	psy-cho-so-cial
joyrid-ing	joy-rid-ing
creamy	cream-y
be-muse-men-t	be-muse-ment
overnight	o-ver-night
par-a-sitism	par-a-sit-ism
in-ter-locu-tor	in-ter-loc-u-tor
com-mu-nica-tive-ness	com-mu-ni-ca-tive-ness
tantrum	tan-trum
felon	fel-on
ge-neti-cist	ge-net-i-cist
dirty	dirt-y
sub-scrip-t	sub-script
green-ery	green-er-y
inim-itable	in-im-i-ta-ble
e-u-pho-ri-a	eu-pho-ri-a
k-ilo-ton	kil-o-ton
at-trac-t	at-tract
taxi-dermy	tax-i-der-my
crick-eter	crick-et-er
con-stituen-cy	con-stit-u-en-cy
anorex-i-c	an-o-rex-ic
c-i-ta-tion	ci-ta-tion
manes	ma-nes
her-mitage	her-mit-age
in-jury	in-ju-ry
giro	gi-ro
swingy	swing-y
easy-go-ing	eas-y-go-ing
calami-tous	ca-lam-i-tous
heart-en-ing	heartening
casi-no	ca-si-no
delux-e	de-luxe
di-alec-t	di-a-lect
aun-t	aunt
elide	e-lide
coolan-t	cool-ant
re-jec-t	re-ject
howdy	how-dy
proac-tive	pro-ac-tive
filthy	filth-y
re-unite	re-u-nite
wave-for-m	wave-form
de-pen-den-cy	de-pend-en-cy
s-lay-ing	slay-ing
ex-i-gen-t	ex-i-gent
lover	lov-er
ab-sen-t	ab-sent
s-tan-za	stan-za
ves-ti-gial	ves-tig-i-al
squally	squal-ly
s-tarlight	star-light
frip-pery	frip-per-y
harshen	harsh-en
di-gestible	di-gest-i-ble
tox-i-c	tox-ic
height-ened	heightened
em-bed-dable	em-bed-da-ble
defuse	de-fuse
joust-ing	jousting
there-after	there-af-ter
ex-igu-ous	ex-ig-u-ous
cre-ation-is-m	cre-a-tion-ism
draftee	draft-ee
cut-lery	cut-ler-y
parox-ys-m	par-ox-ysm
re-spec-t	re-spect
un-equiv-o-cal	un-e-quiv-o-cal
ball-s	balls
um-bili-cus	um-bil-i-cus
un-re-cov-er-able	un-re-cov-er-a-ble
lemur	le-mur
knol-l	knoll
samu-rai	sam-u-rai
cur-able	cur-a-ble
tarsal	tar-sal
in-ex-haustible	in-ex-haust-i-ble
spir-i-tu-al-ist	spir-it-u-al-ist
can-non-bal-l	can-non-ball
s-late	slate
as-p	asp
mon-e-tary	mon-e-tar-y
calorif-ic	cal-o-rif-ic
as-sess-men-t	as-sess-ment
elec-tro-mo-tive	e-lec-tro-mo-tive
awak-en-ing	a-wak-en-ing
artis-tic	ar-tis-tic
un-ser-vice-able	un-ser-vice-a-ble
re-ceiver-ship	re-ceiv-er-ship
ex-pen-di-ture	ex-pend-i-ture
plateau	pla-teau
s-tates-man	states-man
comber	comb-er
lin-ear	lin-e-ar
ves-per-s	ves-pers
s-trato-spher-i-cal-ly	stratospherically
teleg-ra-phy	te-leg-ra-phy
id-i-olec-t	id-i-o-lect
c-om-mend	com-mend
valid-ly	val-id-ly
tute-lage	tu-te-lage
out-per-for-m	out-per-form
re-mark-able	re-mark-a-ble
n-erd	nerd
s-mash-ing	smash-ing
fon-dan-t	fon-dant
monog-a-mous-ly	mo-nog-a-mous-ly
un-en-vi-able	un-en-vi-a-ble
cam-corder	cam-cord-er
k-itchen-ware	kitch-en-ware
dul-cimer	dul-ci-mer
ap-t	apt
en-tourage	en-tou-rage
col-um-n	co-lumn
pup-petry	pup-pet-ry
her-i-tabil-i-ty	her-it-a-bil-i-ty
pinkie	pink-ie
pop-ulis-m	pop-u-lism
garbage	gar-bage
tri-atom-ic	tri-a-tom-ic
droplet	drop-let
verisimil-i-tude	ver-i-si-mil-i-tude
mata-dor	mat-a-dor
jokey	jok-ey
saucy	sau-cy
hy-gien-ic	hy-gi-en-ic
modal-i-ty	mo-dal-i-ty
in-fil-l	in-fill
clien-tele	cli-en-tele
archdea-con	arch-dea-con
debtor	debt-or
c-holes-terol	cho-les-ter-ol
con-ven-t	con-vent
spi-dery	spi-der-y
s-tun	stun
ma-jorette	ma-jor-ette
id-iom	id-i-om
good-night	goodnight
haiku	hai-ku
rap-proche-men-t	rap-proche-ment
cy-to-plas-m	cy-to-plasm
regi-cide	reg-i-cide
per-mafrost	per-ma-frost
mer-cury	mer-cu-ry
clema-tis	clem-a-tis
baldy	bald-y
cat-tery	cat-te-ry
fer-men-t	fer-ment
shifter	shift-er
di-lata-tion	dil-a-ta-tion
spon-tane-ity	spon-ta-ne-i-ty
n-od-dy	nod-dy
ra-dio-ther-a-py	ra-di-o-ther-a-py
an-tipa-thet-ic	an-ti-pa-thet-ic
raga-muf-fin	rag-a-muf-fin
facet	fac-et
an-tithe-sis	an-tith-e-sis
touristy	tour-ist-y
s-tarve	starve
as-cetic	as-cet-ic
painful-ly	pain-ful-ly
met-ric-s	met-rics
in-di-vid-u-al-is-m	in-di-vid-u-al-ism
askance	a-skance
poly-cyclic	pol-y-cy-clic
kestrel	kes-trel
bur-geon-ing	burgeoning
s-cape-goat	scape-goat
s-tock-bro-ker	stock-brok-er
cologne	co-logne
calum-ny	cal-um-ny
ima-go	i-ma-go
p-salm	psalm
copy-writ-er	cop-y-writ-er
loosen	loos-en
c-leg	cleg
u-nattain-able	un-at-tain-a-ble
un-con-scionable	un-con-scion-a-ble
for-m	form
reval-ue	re-val-ue
cor-dial	cor-di-al
l-o-gis-ti-cal-ly	lo-gis-ti-cal-ly
carpal	car-pal
dis-ap-point-men-t	dis-ap-point-ment
data-base	da-ta-base
breath-able	breath-a-ble
hazel	ha-zel
glan-s	glans
ra-dio-gram	ra-di-o-gram
ghana	ghana
dauber	daub-er
sala-man-der	sal-a-man-der
gun-metal	gun-met-al
in-tu-itive	in-tu-i-tive
un-palat-able	un-pal-at-a-ble
s-mack	smack
tele-path-ic	tel-e-path-ic
un-ob-ser-van-t	un-ob-serv-ant
pruri-en-t	pru-ri-ent
i-ambus	i-am-bus
balustrade	bal-us-trade
l-o-go	lo-go
com-fort-able	com-fort-a-ble
ni-hilis-m	ni-hil-ism
fid-get	fidg-et
warthog	wart-hog
de-tectably	de-tect-a-bly
repro-bate	rep-ro-bate
at-mo-spher-ic	at-mos-pher-ic
livid	liv-id
takeover	take-o-ver
s-in-ter	sin-ter
forepaw	fore-paw
bi-modal	bi-mod-al
geno-ci-dal	gen-o-cid-al
hul-l	hull
aper-i-tif	a-pe-ri-tif
ex-citable	ex-cit-a-ble
cuf-f	cuff
catgut	cat-gut
avion-ic-s	a-vi-on-ics
sa-van-t	sa-vant
maple	ma-ple
florin	flor-in
clam-p	clamp
s-pawn	spawn
colo-nial-is-m	co-lo-ni-al-ism
suc-cinc-t	suc-cinct
cordage	cord-age
dis-pen-sary	dis-pen-sa-ry
peri-patet-ic	per-i-pa-tet-ic
sawmil-l	saw-mill
culi-nary	cu-li-nar-y
any-where	an-y-where
wom-b	womb
con-san-guineous	con-san-guin-e-ous
at-mo-spher-ic-s	at-mos-pher-ics
melo-dra-ma	mel-o-dra-ma
catheter	cath-e-ter
foot-baller	foot-ball-er
classy	class-y
moral-i-ty	mo-ral-i-ty
over-ground	o-ver-ground
di-atom-ic	di-a-tom-ic
sur-viv-abil-i-ty	sur-viv-a-bil-i-ty
ridicu-lous-ly	ri-dic-u-lous-ly
s-paniel	span-iel
s-tate-ly	state-ly
hec-tor-ing	hectoring
bur-nished	burnished
far-m	farm
un-learned	un-learn-ed
suit-ably	suit-a-bly
squin-t	squint
switchgear	switch-gear
metic-u-lous	me-tic-u-lous
en-cour-age-men-t	en-cour-age-ment
jerkin	jer-kin
ge-nial	ge-ni-al
hab-it-able	hab-it-a-ble
in-ex-orable	in-ex-o-ra-ble
leisurewear	lei-sure-wear
rear-ma-men-t	re-ar-ma-ment
fool-ery	fool-er-y
s-to-ic	sto-ic
maya	ma-ya
mod-ernism	mod-ern-ism
rodeo	ro-de-o
min-i-mal-is-m	min-i-mal-ism
edi-tion	e-di-tion
salver	sal-ver
toluene	tol-u-ene
w-hole-some	whole-some
give-away	give-a-way
ra-tio-nale	ra-tion-ale
stipen-di-ary	sti-pen-di-ar-y
ac-coun-t	ac-count
tes-ta-men-tary	tes-ta-men-ta-ry
gusty	gust-y
de-flec-t	de-flect
crack-er-s	crack-ers
flaun-t	flaunt
k-ismet	kis-met
s-cuf-f	scuff
no-tary	no-ta-ry
metal-lic	me-tal-lic
in-ter-dis-ci-pli-nary	in-ter-dis-ci-pli-nar-y
jar-l	jarl
manor	man-or
loca-tive	loc-a-tive
busi-ly	bus-i-ly
in-stal-l	in-stall
iso-la-tion	i-so-la-tion
di-ure-sis	di-u-re-sis
polyg-a-mous	po-lyg-a-mous
celi-bate	cel-i-bate
s-lot-ted	slot-ted
sun-burned	sunburned
s-tun-ner	stun-ner
tardy	tar-dy
biomorph	bi-o-morph
javelin	jave-lin
ex-oti-cis-m	ex-ot-i-cism
carouse	ca-rouse
dolomite	do-lo-mite
bul-b	bulb
murky	murk-y
polypep-tide	pol-y-pep-tide
tithing	tith-ing
re-assess-men-t	re-as-sess-ment
ir-recov-er-able	ir-re-cov-er-a-ble
necrophil-i-a	nec-ro-phil-i-a
epi-ge-net-ic	ep-i-ge-net-ic
bour-geoisie	bour-geoi-sie
melan-choly	mel-an-chol-y
con-flict-ed	conflicted
s-car-i-ly	scar-i-ly
recharge-able	re-charge-a-ble
im-peach-men-t	im-peach-ment
parochial	pa-ro-chi-al
milord	mi-lord
malev-o-lence	ma-lev-o-lence
s-tom-a	sto-ma
e-clec-ti-cis-m	ec-lec-ti-cism
seclu-sion	se-clu-sion
view-able	view-a-ble
phys-iog-no-my	phys-i-og-no-my
oviduc-t	o-vi-duct
mono-plane	mon-o-plane
pharao-h	phar-aoh
tangy	tang-y
mod-icum	mod-i-cum
con-sum-able	con-sum-a-ble
thaw-ing	thawing
vivi-sec-tion	viv-i-sec-tion
d-e-duce	de-duce
dopey	dope-y
pic-turesque	pic-tur-esque
menar-che	men-ar-che
high-lighter	high-ligh-ter
cryp-t	crypt
elec-trophore-sis	e-lec-tro-pho-re-sis
april	a-pril
p-re-sen-ta-tion	pres-en-ta-tion
de-con-struc-t	de-con-struct
car-bona-ceous	car-bo-na-ceous
ashy	ash-y
math-e-mat-ic-s	math-e-mat-ics
prepa-ra-tion	prep-a-ra-tion
fugi-tive	fu-gi-tive
s-niper	snip-er
jean-s	jeans
y-on	yon
palate	pal-ate
dis-ar-ma-men-t	dis-ar-ma-ment
leucine	leu-cine
bubon-ic	bu-bon-ic
arable	ar-a-ble
reim-ple-ment-ed	reimplemented
k-nap-sack	knap-sack
fleecy	fleec-y
about	a-bout
facile	fac-ile
fire-bom-b	fire-bomb
bel-l	bell
aviary	a-vi-ar-y
in-fi-deli-ty	in-fi-del-i-ty
je-junum	je-ju-num
pasty	past-y
prodi-gal	prod-i-gal
re-liv-e	re-live
mis-shapen	mis-shap-en
an-ti-body	an-ti-bod-y
visa	vi-sa
d-u-al-is-m	du-al-ism
s-lush	slush
land-fal-l	land-fall
hoary	hoar-y
feb-ru-ary	feb-ru-ar-y
hys-terec-to-my	hys-ter-ec-to-my
mil-i-taris-m	mil-i-ta-rism
ar-chaeopteryx	ar-chae-op-ter-yx
reroutes	re-routes
the-atri-cal-ly	the-at-ri-cal-ly
ceme-tery	cem-e-ter-y
s-lick-er	slick-er
man-i-cured	ma-ni-cured
naked	na-ked
soupy	soup-y
periscope	per-i-scope
in-tegri-ty	in-teg-ri-ty
s-tiff-ness	stiff-ness
floury	flour-y
crotch-ety	crotch-et-y
con-fine-men-t	con-fine-ment
remix	re-mix
pre-ventable	pre-vent-a-ble
fein-t	feint
ho-mo-mor-phis-m	ho-mo-mor-phism
predilec-tion	pre-di-lec-tion
pi-quan-t	pi-quant
pavil-ion	pa-vil-ion
hus-bandry	hus-band-ry
ca-su-al-ty	cas-u-al-ty
artist	art-ist
hi-ero-glyph-ic	hi-er-o-glyph-ic
pol-lu-tan-t	pol-lu-tant
s-capu-la	scap-u-la
vinyl	vi-nyl
civil-ian	ci-vil-ian
spongy	spon-gy
merid-ion-al	me-rid-i-o-nal
pep-pery	pep-per-y
poly-mor-phis-m	pol-y-mor-phism
over-fly	o-ver-fly
over-write	o-ver-write
cursed	curs-ed
ex-pan-sion-is-m	ex-pan-sion-ism
catch-men-t	catch-ment
dis-agree-able	dis-a-gree-a-ble
cel-l	cell
bur-sary	bur-sa-ry
in-de-fin-able	in-de-fin-a-ble
ob-struc-t	ob-struct
voyeuris-m	vo-yeur-ism
sinew	sin-ew
cool-ing	cooling
marked-ly	mark-ed-ly
re-im-burse-men-t	re-im-burse-ment
cameo	cam-e-o
unerring	un-err-ing
archetype	ar-che-type
re-can-t	re-cant
nowa-days	now-a-days
lachry-mose	lach-ry-mose
vig-i-lan-t	vig-i-lant
damper	damp-er
a-p-a-thy	ap-a-thy
crater	cra-ter
de-po-nen-t	de-po-nent
legate	leg-ate
male-fac-tor	mal-e-fac-tor
pro-pa-gan-da	prop-a-gan-da
cer-ti-fi-able	cer-ti-fi-a-ble
opine	o-pine
s-trap	strap
rein-vest-men-t	re-in-vest-ment
per-pe-tu-ity	per-pe-tu-i-ty
aper-ture	ap-er-ture
kiosk	ki-osk
redo-len-t	red-o-lent
leer-ing	leering
detox-i-fi-ca-tion	de-tox-i-fi-ca-tion
fuz-z	fuzz
hu-man-is-m	hu-man-ism
d-if-fer	dif-fer
iso-la-tion-is-m	i-so-la-tion-ism
ap-plica-tive	ap-pli-ca-tive
w-hole-sale	whole-sale
hel-l	hell
tele-ol-o-gy	tel-e-ol-o-gy
grimy	grim-y
quotable	quot-a-ble
id-io-cy	id-i-o-cy
atyp-i-cal	a-typ-i-cal
hangar	hang-ar
po-ten-tiome-ter	po-ten-ti-om-e-ter
glasshouse	glass-house
an-tide-pres-san-t	an-ti-de-pres-sant
stinky	stink-y
a-t-ro-phy	at-ro-phy
case-men-t	case-ment
gener-i-cal-ly	ge-ner-i-cal-ly
in-elas-tic	in-e-las-tic
ob-se-quious	ob-se-qui-ous
mi-ni	min-i
re-tain-ing	retaining
s-lob	slob
boa	bo-a
megawat-t	meg-a-watt
crofter	croft-er
in-quisi-to-ri-al	in-quis-i-to-ri-al
bi-car-bon-ate	bi-car-bo-nate
ur-gen-t	ur-gent
syco-phan-tic	syc-o-phan-tic
over-am-bi-tious	o-ver-am-bi-tious
rosary	ro-sa-ry
s-core	score
of-fend-ing	of-fen-ding
buri-al	bur-i-al
forego	fore-go
ethic-s	eth-ics
whaler	whal-er
un-ut-ter-able	un-ut-ter-a-ble
semi-cir-cle	sem-i-cir-cle
de-cryp-t	de-crypt
u-n-achiev-able	un-a-chiev-a-ble
ele-phan-tine	el-e-phan-tine
con-ti-nu-ity	con-ti-nu-i-ty
petro-chem-i-cal	pet-ro-chem-i-cal
any-thing	an-y-thing
he-li-pad	hel-i-pad
fifty	fif-ty
jam-boree	jam-bo-ree
bawdy	bawd-y
bunker	bun-ker
charis-mat-ic	char-is-mat-ic
mandible	man-di-ble
aquifer	aq-ui-fer
s-park	spark
s-tatis-tic	sta-tis-tic
syn-chrony	syn-chro-ny
lumpen	lum-pen
here-about-s	here-a-bouts
pre-sum-ably	pre-sum-a-bly
cho-ris-ter	chor-is-ter
con-join-t	con-joint
thum-b	thumb
se-can-t	se-cant
s-tair-way	stair-way
askew	a-skew
pre-dict-ed	predicted
rapi-er	ra-pi-er
over-heat	o-ver-heat
e-u-phemistic	eu-phe-mis-tic
but-tered	buttered
h-es-i-tan-cy	hes-i-tan-cy
declam-a-to-ry	de-clam-a-to-ry
ma-lig-nan-t	ma-lig-nant
metic-u-lous-ly	me-tic-u-lous-ly
gooey	goo-ey
prowler	prowl-er
s-nap	snap
deeply	deep-ly
psy-cho-anal-y-sis	psy-cho-a-nal-y-sis
busker	busk-er
calder-a	cal-de-ra
corset	cor-set
re-lax-an-t	re-lax-ant
rep-til-ian	rep-til-i-an
dimer	di-mer
dim-pled	dimpled
sur-d	surd
bidi-rec-tion-al	bi-di-rec-tion-al
gofer	go-fer
beach-comber	beach-comb-er
quit-s	quits
pro-ceed-s	pro-ceeds
en-cam-p	en-camp
in-nocu-ous	in-noc-u-ous
cheva-lier	chev-a-lier
en-doge-nous	en-dog-e-nous
fre-quent-ed	frequented
polic-ing	policing
hon-esty	hon-es-ty
t-wo	two
even-tu-al-ly	e-ven-tu-al-ly
iso-bar	i-so-bar
necro-mancer	nec-ro-man-cer
tan-ta-moun-t	tan-ta-mount
eye-d	eyed
meta-lan-guage	met-a-lan-guage
over-in-flat-ed	o-ver-in-flat-ed
un-der-stand-ably	un-der-stand-a-bly
over-grown	o-ver-grown
s-in-cere-ly	sin-cere-ly
or-tho-doxy	or-tho-dox-y
penance	pen-ance
nifty	nif-ty
dis-tinc-t	dis-tinct
au-tonomous-ly	au-ton-o-mous-ly
k-nave	knave
repli-ca-tion	rep-li-ca-tion
ex-pres-sion-is-m	ex-pres-sion-ism
derelic-t	der-e-lict
ob-streper-ous	ob-strep-er-ous
salmon	salm-on
sleepi-ness	sleep-i-ness
s-lack-en	slack-en
over-spend	o-ver-spend
pro-tec-t	pro-tect
teenaged	teen-aged
re-bury	re-bur-y
over-growth	o-ver-growth
com-man-dan-t	com-man-dant
geo-sta-tion-ary	ge-o-sta-tion-ar-y
reclu-sive	re-clu-sive
e-lastin	e-las-tin
s-cat-tered	scattered
com-mer-cial-is-m	com-mer-cial-ism
aro-matic-i-ty	ar-o-ma-tic-i-ty
touris-tic	tour-is-tic
sibyl	sib-yl
cyan	cy-an
spec-tropho-tome-ter	spec-tro-pho-tom-e-ter
ephemer-al	e-phem-er-al
deuteron	deu-ter-on
s-tor-age	stor-age
gazelle	ga-zelle
bad-minton	bad-min-ton
in-cum-ben-t	in-cum-bent
re-for-esta-tion	re-for-est-a-tion
fusible	fu-si-ble
con-tention	con-ten-tion
trac-t	tract
over-dose	o-ver-dose
pass-able	pass-a-ble
in-testi-nal	in-tes-ti-nal
in-no-cen-t	in-no-cent
col-liery	col-lier-y
u-n-ap-proved	un-ap-proved
pity	pit-y
as-pidis-tra	as-pi-dis-tra
dick-en-s	dick-ens
scrip-tural	scrip-tur-al
welder	weld-er
coinage	coin-age
obei-sance	o-bei-sance
meta-physic-s	met-a-phys-ics
roguery	ro-guer-y
anonymi-ty	an-o-nym-i-ty
s-tranger	stran-ger
elu-ci-da-tion	e-lu-ci-da-tion
colonic	co-lon-ic
penin-su-la	pen-in-su-la
s-lim-mer	slim-mer
y-our-self	your-self
propul-sion	pro-pul-sion
bene-fac-tion	ben-e-fac-tion
ra-tio-nal-is-m	ra-tion-al-ism
s-apling	sap-ling
s-tock-ade	stock-ade
stager	stag-er
pathos	pa-thos
kwacha	kwa-cha
daun-t	daunt
astride	a-stride
cyn-i-cis-m	cyn-i-cism
toi-letries	toi-let-ries
wildlife	wild-life
s-toop	stoop
in-vert-ed	inverted
s-pade-work	spade-work
brassy	brass-y
para-dox-i-cal	par-a-dox-i-cal
se-man-tic-s	se-man-tics
quiet-ness	qui-et-ness
s-mash-er	smash-er
naive-ly	na-ive-ly
wor-m	worm
c-om-mend-ably	com-mend-a-bly
cur-ricu-lum	cur-ric-u-lum
morass	mo-rass
sec-toral	sec-tor-al
di-uret-ic	di-u-ret-ic
in-con-sid-er-able	in-con-sid-er-a-ble
lit-er-ary	lit-er-ar-y
her-bi-cide	herb-i-cide
unloved	un-loved
herbal-is-m	her-bal-ism
flota-tion	flo-ta-tion
corky	cork-y
rosy	ros-y
s-pan	span
salu-ta-tion	sal-u-ta-tion
ir-re-triev-able	ir-re-triev-a-ble
caseload	case-load
teeter	tee-ter
un-sa-vory	un-sa-vor-y
payable	pay-a-ble
solem-n	sol-emn
think-able	think-a-ble
skua	sku-a
in-fantry	in-fan-try
lano-lin	lan-o-lin
di-vorcee	di-vor-cee
u-n-am-bigu-ous-ly	un-am-big-u-ous-ly
causative	caus-a-tive
halite	hal-ite
salin-i-ty	sa-lin-i-ty
elec-tric-i-ty	e-lec-tric-i-ty
aver	a-ver
raider	raid-er
lacy	lac-y
fetish	fet-ish
sub-jec-t	sub-ject
at-tach-men-t	at-tach-ment
mas-culin-i-ty	mas-cu-lin-i-ty
ori-en-tal	o-ri-en-tal
en-docrine	en-do-crine
dis-ci-plinary	dis-ci-pli-nar-y
necro-man-tic	nec-ro-man-tic
so-ciopo-lit-i-cal	so-ci-o-po-lit-i-cal
hubris	hu-bris
place-men-t	place-ment
up-hol-stery	up-hol-ster-y
t-hou-sand	thou-sand
plu-per-fec-t	plu-per-fect
peas-an-t	peas-ant
s-lur	slur
im-porter	im-port-er
steady	stead-y
causal-i-ty	cau-sal-i-ty
cen-trifu-ga-tion	cen-trif-u-ga-tion
rum-pled	rumpled
pogrom	po-grom
rooftop	roof-top
touchy	touch-y
u-n-ac-com-mo-dat-ing	un-ac-com-mo-dat-ing
caiman	cai-man
asym-met-ri-cal	a-sym-met-ri-cal
naughty	naugh-ty
con-certi-na	con-cer-ti-na
s-noek	snoek
for-syth-ia	for-syth-i-a
mankind	man-kind
covert-ly	cov-ert-ly
macroe-co-nom-ic	mac-ro-ec-o-nom-ic
de-signed-ly	de-sign-ed-ly
za-g	zag
s-now-man	snow-man
s-tan-chion	stan-chion
s-culp-tural	sculp-tur-al
portage	por-tage
spiny	spin-y
makeshift	make-shift
lib-er-al-is-m	lib-er-al-ism
rock-fal-l	rock-fall
ex-trater-ri-to-ri-al	ex-tra-ter-ri-to-ri-al
prop-s	props
s-low-ly	slow-ly
i-n-ap-pli-ca-ble	in-ap-pli-ca-ble
land-for-m	land-form
over-shad-ow	o-ver-shad-ow
foothold	foot-hold
t-int-ed	tinted
video-tape	vid-e-o-tape
in-tel-li-gen-t	in-tel-li-gent
me-chan-ic-s	me-chan-ics
vicarage	vic-ar-age
un-man-age-able	un-man-age-a-ble
grotesque	gro-tesque
c-og-nizance	cog-ni-zance
sadis-tic	sa-dis-tic
tableau	tab-leau
dis-heart-ened	dis-hear-tened
schooner	schoon-er
doughty	dough-ty
re-ceip-t	re-ceipt
en-treaty	en-treat-y
rem-nan-t	rem-nant
t-in-ware	tin-ware
sen-t	sent
in-can-t	in-cant
sewage	sew-age
panoply	pan-o-ply
okapi	o-ka-pi
de-pen-dence	de-pend-ence
up-fron-t	up-front
trans-par-en-t	trans-par-ent
re-f	ref
blus-ter-ing	blustering
con-vivial	con-viv-i-al
un-lac-ing	un-lacing
re-gali-a	re-ga-li-a
in-erad-i-ca-ble	in-e-rad-i-ca-ble
cladding	clad-ding
eroge-nous	e-rog-e-nous
er-ro-neous-ly	er-ro-ne-ous-ly
fer-n	fern
s-tu-pe-fy	stu-pe-fy
en-gi-neered	engineered
flagon	flag-on
racy	rac-y
disin-gen-u-ous	dis-in-gen-u-ous
baronet	bar-on-et
rein-car-nate	re-in-car-nate
brawler	brawl-er
con-juror	con-ju-ror
foamy	foam-y
em-pow-er-men-t	em-pow-er-ment
piercer	pierc-er
quest-ing	questing
any-more	an-y-more
gra-tu-itous-ly	gra-tu-i-tous-ly
s-towage	stow-age
positron	pos-i-tron
be-twix-t	be-twixt
quintessen-tial-ly	quin-tes-sen-tial-ly
flat-tery	flat-ter-y
s-mil-ing	smil-ing
su-per-hero	su-per-he-ro
wrinkly	wrin-kly
en-dow-men-t	en-dow-ment
ragged	rag-ged
s-in-cer-i-ty	sin-cer-i-ty
coun-terof-fen-sive	coun-ter-of-fen-sive
readi-ness	read-i-ness
idly	i-dly
in-con-sis-ten-t	in-con-sist-ent
wat-t	watt
com-muter	com-mut-er
s-tat-ue	stat-ue
u-n-adorned	un-a-dorned
stric-t	strict
repar-tee	rep-ar-tee
s-core-less	score-less
padre	pa-dre
vestal	ves-tal
in-el-e-gan-t	in-el-e-gant
flan-nelette	flan-nel-ette
linger	lin-ger
con-struc-tivist	con-struc-tiv-ist
rarebit	rare-bit
courage	cour-age
enu-mer-ate	e-nu-mer-ate
basalt	ba-salt
monoc-u-lar	mo-noc-u-lar
phooey	phoo-ey
reti-na	ret-i-na
delin-quen-cy	de-lin-quen-cy
s-lip	slip
u-nion	un-ion
cata-ma-ran	cat-a-ma-ran
cor-po-ratism	cor-po-rat-ism
promis-cu-ity	prom-is-cu-i-ty
e-q-ui-ty	eq-ui-ty
em-bod-i-men-t	em-bod-i-ment
navvy	nav-vy
g-naw	gnaw
omi-nous	om-i-nous
freighter	freight-er
tur-bocharg-er	tur-bo-charg-er
method-olog-i-cal	meth-od-o-log-i-cal
prophet	proph-et
amoun-t	a-mount
pal-isade	pal-i-sade
paraglid-ing	par-a-glid-ing
silage	si-lage
u-n-a-mused	un-a-mused
mono-phon-ic	mon-o-phon-ic
tele-phone	tel-e-phone
ren-dezvous	ren-dez-vous
reg-istry	reg-is-try
fil-i-buster	fil-i-bus-ter
coupon	cou-pon
en-ti-tle-men-t	en-ti-tle-ment
s-train-er	strain-er
s-tub-ble	stub-ble
over-reach	o-ver-reach
ripen	rip-en
golfer	golf-er
needle-work	nee-dle-work
s-coop	scoop
over-sim-pli-fy	o-ver-sim-pli-fy
rhetor-i-cal-ly	rhe-tor-i-cal-ly
un-de-ni-able	un-de-ni-a-ble
weari-ness	wea-ri-ness
dis-en-gage-men-t	dis-en-gage-ment
di-ver-sion-ary	di-ver-sion-ar-y
projec-t	proj-ect
mer-chan-dis-e	mer-chan-dise
pre-tex-t	pre-text
har-m	harm
ap-pease-men-t	ap-pease-ment
hon-orary	hon-or-ar-y
u-nashamed	un-a-shamed
with-ered	withered
medul-la	me-dul-la
plaza	pla-za
lapel	la-pel
copy-right	cop-y-right
diskette	disk-ette
pros-e	prose
sub-species	sub-spe-cies
waspish	wasp-ish
limpid	lim-pid
e-q-ui-table	eq-ui-ta-ble
s-ta-tion-ary	sta-tion-ar-y
ex-e-cutable	ex-e-cut-a-ble
un-taugh-t	un-taught
u-nat-tend-ed	un-at-tend-ed
balder-dash	bal-der-dash
pornog-ra-pher	por-nog-ra-pher
s-lab	slab
blowup	blow-up
im-puni-ty	im-pu-ni-ty
dumpling	dump-ling
which-ever	which-ev-er
ethanol	eth-a-nol
spicy	spic-y
arith-metic	a-rith-me-tic
shady	shad-y
resin	res-in
cy-ber-net-ic-s	cy-ber-net-ics
in-dis-pens-able	in-dis-pen-sa-ble
melo-di-ous	me-lo-di-ous
ex-cite-men-t	ex-cite-ment
cor-rup-t	cor-rupt
op-por-tunis-m	op-por-tun-ism
de-base-men-t	de-base-ment
mori-bund	mor-i-bund
petrol-o-gy	pe-trol-o-gy
in-ca-pable	in-ca-pa-ble
ex-is-tence	ex-ist-ence
in-cen-di-ary	in-cen-di-ar-y
lu-bri-can-t	lu-bri-cant
in-ci-den-t	in-ci-dent
genre	gen-re
s-tock-room	stock-room
g-naw-ing	gnaw-ing
s-cythe	scythe
con-flic-t	con-flict
re-fur-bish-men-t	re-fur-bish-ment
ax-iomat-ic	ax-i-o-mat-ic
i-nessen-tial	in-es-sen-tial
farmer	farm-er
mo-nop-oly	mo-nop-o-ly
me-te-o-rol-o-gy	me-te-or-ol-o-gy
chid-ing	chiding
ru-ined	ruined
trouser-s	trou-sers
prosce-ni-um	pro-sce-ni-um
no-madic	no-mad-ic
postlude	post-lude
avi-ate	a-vi-ate
lugubri-ous	lu-gu-bri-ous
dodgy	dodg-y
itin-er-ary	i-tin-er-ar-y
delu-sion	de-lu-sion
anom-aly	a-nom-a-ly
ma-chete	ma-chet-e
ten-antry	ten-ant-ry
duchy	duch-y
a-vian	a-vi-an
astray	a-stray
cryo-genic	cry-o-gen-ic
chi-ropody	chi-rop-o-dy
por-traitist	por-trait-ist
bushy	bush-y
in-ex-tin-guish-able	in-ex-tin-guish-a-ble
k-ing-pin	king-pin
colonist	col-o-nist
physi-cian	phy-si-cian
dotage	dot-age
de-liv-er-able	de-liv-er-a-ble
clien-t	cli-ent
com-plain-t	com-plaint
manome-ter	ma-nom-e-ter
dither	dith-er
s-niv-el	sniv-el
s-lang	slang
k-i-nase	ki-nase
coun-ter-in-tu-itive	coun-ter-in-tu-i-tive
copy-ist	cop-y-ist
cin-e-matog-ra-pher	cin-e-ma-tog-ra-pher
s-pace-craft	space-craft
ini-tial-ly	in-i-tial-ly
ar-chiv-ist	ar-chi-vist
s-tur-dy	stur-dy
s-teeple	stee-ple
pen-i-ten-tiary	pen-i-ten-tia-ry
de-po-si-tion	dep-o-si-tion
scenic	sce-nic
e-t-y-mol-o-gy	et-y-mol-o-gy
ob-stet-ric-s	ob-stet-rics
s-targaze	star-gaze
rep-re-sen-t	rep-re-sent
bailif-f	bail-iff
marigold	mar-i-gold
chore-a	cho-re-a
cordite	cord-ite
quater-nion	qua-ter-ni-on
di-choto-mous	di-chot-o-mous
lender	lend-er
sil-vered	silvered
unin-spir-ing	un-in-spir-ing
s-pear	spear
im-prison	im-pris-on
pun-t	punt
para-dox	par-a-dox
coloured	co-loured
nest-ing	nesting
s-tork	stork
atom	at-om
vestry	ves-try
delir-i-um	de-lir-i-um
duik-er	dui-ker
chore-o-graph-ic	cho-re-o-graph-ic
he-lio-sphere	he-li-o-sphere
tetra-he-dron	tet-ra-he-dron
re-uni-fy	re-u-ni-fy
heron	her-on
emir	e-mir
in-dict-men-t	in-dict-ment
sacral	sa-cral
markup	mark-up
ho-mo-gene-ity	ho-mo-ge-ne-i-ty
s-moother	smooth-er
de-press-ing	de-pres-sing
el-e-men-tary	el-e-men-ta-ry
e-u-pho-nious	eu-pho-ni-ous
s-e-lectee	se-lect-ee
con-vert-ible	con-vert-i-ble
wa-terbed	wa-ter-bed
re-phrases	re-phra-ses
fanci-er	fan-ci-er
stony	ston-y
avenger	a-veng-er
s-tock-ist	stock-ist
az-imuth	az-i-muth
un-con-ge-nial	un-con-gen-ial
porcine	por-cine
her-i-ta-ble	her-it-a-ble
s-pan-gle	span-gle
biotech-nol-o-gy	bi-o-tech-nol-o-gy
cred-itable	cred-it-a-ble
so-cio-bi-ol-o-gy	so-ci-o-bi-ol-o-gy
wealthy	wealth-y
dis-con-ti-nu-ity	dis-con-ti-nu-i-ty
hashish	hash-ish
metaphor-i-cal	met-a-phor-i-cal
click-ing	clicking
medal	med-al
lament-ed	la-ment-ed
makeweight	make-weight
dogs-body	dogs-bod-y
zealot	zeal-ot
ex-pi-ra-to-ry	ex-pir-a-to-ry
fur-rowed	furrowed
isosce-les	i-sos-ce-les
grandios-i-ty	gran-di-os-i-ty
eroti-cis-m	e-rot-i-cism
vi-sion-ary	vi-sion-ar-y
charis-ma	cha-ris-ma
cli-toris	clit-o-ris
pu-rifi-ca-tion	pu-ri-fi-ca-tion
deco-rum	de-co-rum
servi-ette	ser-vi-ette
pauci-ty	pau-ci-ty
dumper	dump-er
fi-nis	fin-is
sym-po-sium	sym-po-si-um
idyl-l	i-dyll
in-ter-sec-t	in-ter-sect
chlo-ro-for-m	chlo-ro-form
chom-p	chomp
dis-cernible	dis-cern-i-ble
ju-nior	jun-ior
de-jec-t	de-ject
soli-tary	sol-i-tar-y
para-m-ag-net-ic	par-a-mag-net-ic
jaz-z	jazz
a-pogee	ap-o-gee
an-nal-s	an-nals
s-mut-ty	smut-ty
his-togram	his-to-gram
ha-rass-ing	harassing
loutish	lout-ish
e-m-a-na-tion	em-a-na-tion
en-cryp-t	en-crypt
black-bal-l	black-ball
flut-ter-ing	fluttering
lig-and	li-gand
bromine	bro-mine
labyrinth	lab-y-rinth
necro-man-cy	nec-ro-man-cy
i-a-tro-genic	i-at-ro-gen-ic
lan-der	land-er
hit-table	hit-ta-ble
s-moth-er	smoth-er
over-weight	o-ver-weight
s-narl	snarl
reat-temp-t	re-at-tempt
guano	gua-no
over-shot	o-ver-shot
ex-plana-to-ry	ex-plan-a-to-ry
prodi-gy	prod-i-gy
damask	dam-ask
os-tracis-m	os-tra-cism
tri-umphant-ly	tri-um-phant-ly
an-tipa-thy	an-tip-a-thy
s-lack	slack
tam-p	tamp
blender	blend-er
muti-nous	mu-ti-nous
hy-per-boloid	hy-per-bo-loid
nugget	nug-get
protest	pro-test
recipe	rec-i-pe
layabout	lay-a-bout
jiffy	jif-fy
s-can-ner	scan-ner
d-if-fi-cult	dif-fi-cult
apery	ap-er-y
geezer	gee-zer
dipole	di-pole
in-fir-m	in-firm
c-on-cil-iar	con-cil-i-ar
s-traight-away	straight-a-way
dis-il-lu-sion-men-t	dis-il-lu-sion-ment
cradling	cra-dling
no-ti-fi-able	no-ti-fi-a-ble
pre-cooked	precooked
s-tu-dious	stu-di-ous
wil-lowy	wil-low-y
telex	tel-ex
inkwell	ink-well
dis-tin-guish-able	dis-tin-guish-a-ble
dodgem	dodg-em
tyran-t	ty-rant
u-nim-pres-sive	un-im-pres-sive
un-easi-ness	un-eas-i-ness
gen-t	gent
gua-camole	gua-ca-mo-le
lunchtime	lunch-time
man-darin	man-da-rin
pru-den-t	pru-dent
de-bat-able	de-bat-a-ble
s-lice	slice
fri-ary	fri-ar-y
rar-efac-tion	rar-e-fac-tion
phi-lan-thropist	phi-lan-thro-pist
re-assert	re-as-sert
un-abat-ed	un-a-bat-ed
broadleaved	broad-leaved
se-nior-i-ty	sen-ior-i-ty
k-ing	king
baoba-b	ba-o-bab
re-plan-t	re-plant
auger	au-ger
s-tam-pede	stam-pede
relic-t	rel-ict
k-ing-dom	king-dom
re-tini-tis	ret-i-ni-tis
s-ketchy	sketch-y
s-mall-ness	small-ness
vol-un-tary	vol-un-tar-y
ide-al	i-de-al
devo-tee	dev-o-tee
boxy	box-y
dairy	dair-y
d-e-lec-ta-ble	de-lec-ta-ble
s-culp-t	sculpt
elu-sive	e-lu-sive
i-nat-ten-tive	in-at-ten-tive
there-about-s	there-a-bouts
rachis	ra-chis
mal-adroit	mal-a-droit
zenith	ze-nith
holis-ti-cal-ly	ho-lis-ti-cal-ly
sub-mersible	sub-mers-i-ble
ox-i-dan-t	ox-i-dant
polypho-ny	po-lyph-o-ny
d-ab-bing	dab-bing
wormy	worm-y
wardrobe	ward-robe
il-l	ill
tena-cious	te-na-cious
an-ti-quary	an-ti-quar-y
u-p-load	up-load
aris-to-crat-ic	a-ris-to-crat-ic
dark-ened	dar-kened
s-care-mon-ger-ing	scare-mon-ger-ing
reprise	re-prise
b-less	bless
pa-troness	pa-tron-ess
re-ac-tan-t	re-ac-tant
radix	ra-dix
koala	ko-a-la
pilchard	pil-chard
va-pid	vap-id
ef-fer-ves-cen-t	ef-fer-ves-cent
mela-tonin	mel-a-to-nin
es-t	est
zither	zith-er
misog-y-nist	mi-sog-y-nist
lantern	lan-tern
s-toked	stoked
key-boardis-t	key-board-ist
unin-sured	un-in-sured
clemen-t	clem-ent
weapon	weap-on
con-trast-ing	contrasting
in-for-mat-ic-s	in-for-mat-ics
lisp-ing	lis-ping
fever-ish	fe-ver-ish
eigen-func-tion	ei-gen-func-tion
di-atom	di-a-tom
c-og-nizan-t	cog-ni-zant
rub-bery	rub-ber-y
re-gion-al-is-m	re-gion-al-ism
d-is-fig-ure	dis-fig-ure
enor-mous-ly	e-nor-mous-ly
s-nug	snug
skir-l	skirl
piezo-elec-tric	pi-e-zo-e-lec-tric
u-nan-swered	un-an-swered
u-nattrac-tive	un-at-trac-tive
ruler	rul-er
s-teer-ing	steer-ing
demon-stra-ble	de-mon-stra-ble
canal	ca-nal
mo-torist	mo-tor-ist
hostel-ry	hos-tel-ry
k-lax-on	klax-on
stilet-to	sti-let-to
tyran-ni-cide	ty-ran-ni-cide
lectern	lec-tern
un-mis-tak-ably	un-mis-tak-a-bly
parish	par-ish
woodsmoke	wood-smoke
sponger	spong-er
blaster	blast-er
syn-onymy	syn-on-y-my
tav-er-na	ta-ver-na
ther-mome-ter	ther-mom-e-ter
re-pen-t	re-pent
ne-ol-o-gis-m	ne-ol-o-gism
monas-tic	mo-nas-tic
k-ilo-volt	kil-o-volt
quadru-ply	quad-ru-ply
pout-ing	pouting
un-remit-ting	un-re-mit-ting
dis-junc-t	dis-junct
vary	var-y
s-pare	spare
s-tain-less	stain-less
yippee	yip-pee
un-wrap-s	un-wraps
man-ner-is-m	man-ner-ism
pre-tender	pre-tend-er
barefaced	bare-faced
s-tat-uette	stat-u-ette
pow-dery	pow-der-y
rheumat-ic	rheu-mat-ic
foxy	fox-y
ar-ranger	ar-rang-er
cir-cum-ven-t	cir-cum-vent
sa-tanis-m	sa-tan-ism
in-farc-t	in-farct
repos-i-to-ry	re-pos-i-to-ry
mar-i-onette	mar-i-on-ette
seascape	sea-scape
en-durance	en-dur-ance
tidi-ness	ti-di-ness
ir-re-solv-able	ir-re-solv-a-ble
mas-sacre	mas-sa-cre
yardage	yard-age
de-trac-t	de-tract
im-muno-sup-pres-sive	im-mu-no-sup-pres-sive
im-mea-sur-ably	im-meas-ur-a-bly
sus-pec-t	sus-pect
s-lide	slide
mag-ne-si-a	mag-ne-sia
in-di-gestible	in-di-gest-i-ble
ca-nary	ca-nar-y
elec-toral	e-lec-tor-al
un-premed-i-tat-ed	un-pre-med-i-tat-ed
re-as-sign-men-t	re-as-sign-ment
ide-o-log-i-cal	i-de-o-log-i-cal
dis-in-fec-t	dis-in-fect
moral	mor-al
dowdy	dow-dy
tweedy	tweed-y
Words with errors: 2192
Words with incorrect number of syllables: 2006
Total evluated: 6500
Perfect accuracy: 0.66
Number of syllables accuracy: 0.69
Average Levenshtein Distance(across incorrect words): 1.22
