Attempt	Real
fri-vol-ity	fri-vol-i-ty
virtue	vir-tue
s-corn	scorn
yel-lowed	yellowed
coro-nary	cor-o-nar-y
k-ilo-hertz	kil-o-hertz
sober-ly	so-ber-ly
gasi-fy	gas-i-fy
tachy-on	tach-y-on
per-pe-tu-ity	per-pe-tu-i-ty
ar-bi-trari-ness	ar-bi-trar-i-ness
so-cioe-co-nom-ic	so-ci-o-ec-o-nom-ic
s-tar-dust	star-dust
dandy	dan-dy
un-work-able	un-work-a-ble
pubescen-t	pu-bes-cent
dis-cernible	dis-cern-i-ble
mal-adroit	mal-a-droit
stilet-to	sti-let-to
e-u-phemisti-cal-ly	eu-phe-mis-ti-cal-ly
k-nap-sack	knap-sack
test-ing	testing
in-ter-ci-ty	in-ter-cit-y
s-toked	stoked
dum-found-ing	dumf-ound-ing
ashore	a-shore
struc-tural-is-m	struc-tur-al-ism
un-steady	un-stead-y
un-ob-ser-van-t	un-ob-serv-ant
valid-ly	val-id-ly
repro-bate	rep-ro-bate
ob-so-les-cen-t	ob-so-les-cent
com-modor-e	com-mo-dore
a-p-a-thy	ap-a-thy
lassie	las-sie
pout-ing	pouting
grenade	gre-nade
flan-nelette	flan-nel-ette
mil-i-tary	mil-i-tar-y
at-tach-men-t	at-tach-ment
un-emo-tion-al	un-e-mo-tion-al
odd-s	odds
hero	he-ro
deben-ture	de-ben-ture
pageantry	pag-eant-ry
s-cat-ter-ing	scat-ter-ing
fil-i-buster	fil-i-bus-ter
tri-umphal-is-m	tri-um-phal-ism
s-nipe	snipe
s-tub-born-ness	stub-born-ness
midrif-f	mid-riff
hawthorn	haw-thorn
rock-et-ing	rocketing
hosepipe	hose-pipe
n-erd	nerd
in-ter-po-lat-able	in-ter-po-la-ta-ble
s-tarlight	star-light
chid-ing	chiding
necrophil-i-a	nec-ro-phil-i-a
copi-er	cop-i-er
com-man-dan-t	com-man-dant
py-rotech-nic-s	py-ro-tech-nics
raisin	rai-sin
copy-right	cop-y-right
camshaft	cam-shaft
un-ques-tion-able	un-ques-tion-a-ble
karakul	kar-a-kul
facile	fac-ile
un-beat-able	un-beat-a-ble
ma-tri-archy	ma-tri-ar-chy
bevy	bev-y
deathbed	death-bed
ne-glec-t	ne-glect
con-sen-t	con-sent
beryl-li-um	be-ryl-li-um
ob-scu-ran-tist	ob-scu-rant-ist
ethno-graph-ic	eth-no-graph-ic
pli-er-s	pli-ers
ir-re-duc-ible	ir-re-duc-i-ble
s-light-ing	slight-ing
ethol-o-gy	e-thol-o-gy
cram-p	cramp
tena-cious	te-na-cious
tem-po-rary	tem-po-rar-y
cre-ation-ist	cre-a-tion-ist
cas-sowary	cas-so-war-y
turn-about	turn-a-bout
sloven-ly	slov-en-ly
buzzer	buzz-er
c-om-mend	com-mend
in-quiry	in-quir-y
holis-ti-cal-ly	ho-lis-ti-cal-ly
ten-t	tent
multi-na-tion-al	mul-ti-na-tion-al
n-ear-sight-ed	near-sight-ed
demon-stra-bly	de-mon-stra-bly
bil-l	bill
catarac-t	cat-a-ract
s-to-ic	sto-ic
di-ure-sis	di-u-re-sis
sor-cery	sor-cer-y
p-neu-mat-ic-s	pneu-mat-ics
prostaglandin	pros-ta-glan-din
in-cip-i-en-t	in-cip-i-ent
colonist	col-o-nist
s-coop	scoop
racy	rac-y
in-fir-m	in-firm
dropout	drop-out
mimet-ic	mi-met-ic
neona-tal	ne-o-na-tal
ev-ery-one	eve-ry-one
con-strain-t	con-straint
reper-cus-sion	re-per-cus-sion
hu-man-is-m	hu-man-ism
spir-i-tu-al	spir-it-u-al
lan-der	land-er
impi	im-pi
footrest	foot-rest
s-mug	smug
tremen-dous-ly	tre-men-dous-ly
phy-loge-ny	phy-log-e-ny
chunky	chunk-y
ir-rec-on-cil-able	ir-rec-on-cil-a-ble
so-lace	sol-ace
sinecure	si-ne-cure
mea-sure	meas-ure
topol-o-gy	to-pol-o-gy
tenet	ten-et
en-cryp-t	en-crypt
over-pay-men-t	o-ver-pay-ment
calder-a	cal-de-ra
s-core-card	score-card
dioce-san	di-oc-e-san
fanci-er	fan-ci-er
s-mudgy	smudg-y
dio-cese	di-o-cese
wom-ankind	wom-an-kind
rescale	re-scale
habit	hab-it
wood-wor-m	wood-worm
a-ban-don-men-t	a-ban-don-ment
s-nag	snag
un-hy-gien-ic	un-hy-gi-en-ic
in-tractable	in-trac-ta-ble
veni-son	ven-i-son
iso-lat-ed	i-so-lat-ed
ro-tary	ro-ta-ry
cou-turi-er	cou-tu-ri-er
re-freshed	refreshed
s-pade-work	spade-work
rein-car-nate	re-in-car-nate
par-adis-e	par-a-dise
k-lax-on	klax-on
de-fines	def-ines
u-nim-ped-ed	un-im-ped-ed
aloud	a-loud
worsted	wor-sted
mo-tocross	mo-to-cross
hindquar-ter-s	hind-quar-ters
seamy	seam-y
tour-na-men-t	tour-na-ment
dis-ori-en-ta-tion	dis-o-ri-en-ta-tion
dimin-u-en-do	di-min-u-en-do
in-former	in-form-er
cope-d	coped
vet-eri-nary	vet-er-i-nar-y
vir-ginal	vir-gin-al
salu-tary	sal-u-tar-y
a-pogee	ap-o-gee
rosy	ros-y
emit	e-mit
elec-toral	e-lec-tor-al
en-rich-men-t	en-rich-ment
arise	a-rise
knuck-le-duster	knuck-le-dust-er
mega-lo-ma-ni-ac	meg-a-lo-ma-ni-ac
win-ery	win-er-y
dread-lock-s	dread-locks
notepad	note-pad
forgery	for-ger-y
prodi-gious	pro-di-gious
breast-feed-ing	breastfeeding
diox-ide	di-ox-ide
dairy	dair-y
un-quench-able	un-quench-a-ble
ac-coun-t	ac-count
in-ex-press-ible	in-ex-press-i-ble
de-co	dec-o
sex-tan-t	sex-tant
baleen	ba-leen
refugee	ref-u-gee
cin-e-matog-ra-pher	cin-e-ma-tog-ra-pher
in-ven-t	in-vent
taffe-ta	taf-fe-ta
re-as-sur-ing	reassuring
hearti-ly	heart-i-ly
dimer	di-mer
y-o-del	yo-del
b-otanist	bot-a-nist
eras-er	e-ras-er
skul-l	skull
s-cullery	scul-ler-y
over-sup-ply	o-ver-sup-ply
dis-agree	dis-a-gree
overqual-i-fied	o-ver-qual-i-fied
w-hole-heart-ed	whole-heart-ed
lighter	light-er
around	a-round
sinewy	sin-ew-y
sub-si-dence	sub-sid-ence
trans-for-m	trans-form
ex-ten-t	ex-tent
e-quidis-tan-t	e-qui-dis-tant
in-ter-jec-t	in-ter-ject
thrifty	thrift-y
idea	i-de-a
meta-physic-s	met-a-phys-ics
re-assem-bly	re-as-sem-bly
over-pro-duc-tion	o-ver-pro-duc-tion
im-moral-i-ty	im-mo-ral-i-ty
sever-i-ty	se-ver-i-ty
buck-min-ster-fullerene	buck-min-ster-ful-ler-ene
dodgy	dodg-y
poly-eth-yl-ene	pol-y-eth-yl-ene
pygmy	pyg-my
lichen	li-chen
vis-i-ta-tion	vis-it-a-tion
solid-ly	sol-id-ly
un-prece-dent-ed	un-prec-e-dent-ed
l-itur-gi-cal	li-tur-gi-cal
s-nug-gle	snug-gle
in-tran-si-gen-t	in-tran-si-gent
spon-sored	sponsored
for-get-table	for-get-ta-ble
pro-ba-tion-ary	pro-ba-tion-ar-y
ap-pre-cia-bly	ap-pre-ci-a-bly
as-pi-ra-tional	as-pi-ra-tion-al
poky	pok-y
glacier	gla-cier
reprise	re-prise
mil-i-taris-tic	mil-i-ta-ris-tic
a-ca-dem-ic	ac-a-dem-ic
ex-is-tence	ex-ist-ence
triple	tri-ple
kalei-do-scop-ic	ka-lei-do-scop-ic
her-mitage	her-mit-age
geo-chem-istry	ge-o-chem-is-try
dal-liance	dal-li-ance
crum-b	crumb
cred-it-wor-thy	cred-it-worth-y
over-long	o-ver-long
widen	wid-en
pro-mul-gate	prom-ul-gate
e-bul-lien-t	e-bul-lient
mela-tonin	mel-a-to-nin
ta-pes-try	tap-es-try
d-warfed	dwarfed
waspish	wasp-ish
in-trauter-ine	in-tra-u-ter-ine
legume	leg-ume
ex-cerp-t	ex-cerpt
gen-i-tali-a	gen-i-ta-li-a
petu-lan-t	pet-u-lant
k-er-chief	ker-chief
tele-scope	tel-e-scope
felo-nious	fe-lo-ni-ous
metempsy-chosis	me-tem-psy-cho-sis
irony	i-ro-ny
palatal	pal-a-tal
livid	liv-id
sali-vary	sal-i-var-y
nan-otech-nol-o-gy	nan-o-tech-nol-o-gy
e-vic-t	e-vict
en-camp-men-t	en-camp-ment
un-fa-mil-iar-i-ty	un-fa-mil-i-ar-i-ty
de-cider	de-cid-er
crunchy	crunch-y
necro-man-tic	nec-ro-man-tic
ar-range-men-t	ar-range-ment
steam-roller	steam-roll-er
t-in-ware	tin-ware
bish-opric	bish-op-ric
darter	dart-er
cow-ardice	cow-ard-ice
sel-l	sell
in-dul-gen-t	in-dul-gent
bru-tal-is-m	bru-tal-ism
lin-ear-ly	lin-e-ar-ly
sabra	sa-bra
hy-per-bole	hy-per-bo-le
top-i-ary	to-pi-ar-y
frown-ing	frowning
rheumat-ic	rheu-mat-ic
print-able	print-a-ble
blotchy	blotch-y
pro-ject-ed	projected
libero	li-be-ro
flat-tery	flat-ter-y
bomb-shel-l	bomb-shell
an-nal-s	an-nals
con-tent-men-t	con-tent-ment
per-for-m	per-form
lul-la-by	lull-a-by
pre-fec-t	pre-fect
ni-hilis-tic	ni-hil-is-tic
stat-ic-s	stat-ics
pathfind-er	path-find-er
e-mery	em-er-y
gin-sen-g	gin-seng
vanil-la	va-nil-la
s-tom-a	sto-ma
c-it-rate	cit-rate
cade-t	ca-det
el-ven	elv-en
en-large-men-t	en-large-ment
rounder	round-er
e-u-phemis-m	eu-phe-mism
testis	tes-tis
in-den-t	in-dent
mantling	man-tling
in-flic-t	in-flict
iso-topic	i-so-top-ic
largo	lar-go
s-tock-ist	stock-ist
s-lob-ber-ing	slobbering
i-n-ad-ver-tent-ly	in-ad-vert-ent-ly
mileage	mile-age
geri-atric	ger-i-at-ric
s-cald-ing	scald-ing
chemist	chem-ist
free-lancer	free-lanc-er
de-mount-able	de-mount-a-ble
dero-gate	der-o-gate
s-api-en-t	sa-pi-ent
es-carp-men-t	es-carp-ment
avoid	a-void
weari-ness	wea-ri-ness
mytho-log-i-cal	myth-o-log-i-cal
con-trol-lable	con-trol-la-ble
hy-per-tex-t	hy-per-text
over-es-ti-ma-tion	o-ver-es-ti-ma-tion
d-if-fuse	dif-fuse
blaster	blast-er
con-sulate	con-su-late
dither	dith-er
hand-bal-l	hand-ball
tom-fool-ery	tom-fool-er-y
jerkin	jer-kin
le-nien-t	le-ni-ent
s-courge	scourge
liqueur	li-queur
anoin-t	a-noint
swinger	swing-er
se-nior-i-ty	sen-ior-i-ty
c-og-nizan-t	cog-ni-zant
cur-ren-t	cur-rent
nether-most	neth-er-most
pres-bytery	pres-by-ter-y
dishar-mo-ny	dis-har-mo-ny
con-sumeris-m	con-sum-er-ism
fore-stal-l	fore-stall
over-ca-pac-i-ty	o-ver-ca-pac-i-ty
pharao-h	phar-aoh
mis-spellings	mis-spel-lings
neo-phyte	ne-o-phyte
s-coot-er	scoot-er
apothe-cary	a-poth-e-car-y
pesti-len-tial	pes-ti-len-tial
li-brary	li-brar-y
joyrid-ing	joy-rid-ing
sub-lu-nary	sub-lu-nar-y
cen-tipede	cen-ti-pede
pro-bity	pro-bi-ty
s-lap	slap
plebiscite	pleb-i-scite
growler	growl-er
neme-sis	nem-e-sis
paraf-fin	par-af-fin
sponger	spong-er
julep	ju-lep
resin	res-in
e-h	eh
voodoo	voo-doo
heresy	her-e-sy
bur-bling	burbling
prospec-tive	pro-spec-tive
s-mall-ish	small-ish
s-cut-tle	scut-tle
for-man-t	for-mant
boot-s	boots
over-spill	o-ver-spill
beaker	beak-er
s-nap-py	snap-py
brand-ed	bran-ded
s-trapped	strapped
tan-ger-ine	tan-ge-rine
s-now	snow
or-na-men-t	or-na-ment
con-tentious	con-ten-tious
epis-co-pate	e-pis-co-pate
dis-band-men-t	dis-band-ment
elvish	elv-ish
mon-o-clon-al	mon-o-clo-nal
many	man-y
re-set-tle-men-t	re-set-tle-ment
sav-agery	sav-age-ry
pos-i-tivist	pos-i-tiv-ist
budgeri-gar	budg-er-i-gar
un-frozen	un-fro-zen
d-e-ductible	de-duct-i-ble
s-mooth	smooth
u-nimag-i-na-tive	un-im-ag-i-na-tive
nougat	nou-gat
s-wot	swot
papule	pap-ule
saucepan	sauce-pan
elec-tro-car-dio-gram	e-lec-tro-car-di-o-gram
maisonette	mai-son-ette
bla-tan-t	bla-tant
chalet	cha-let
ra-dia-tive	ra-di-a-tive
pa-pri-ka	pap-ri-ka
is-suer	is-su-er
va-porous	va-por-ous
u-niden-ti-fi-able	un-i-den-ti-fi-a-ble
s-tow	stow
salien-t	sa-li-ent
turntable	turn-ta-ble
bedrag-gled	be-drag-gled
con-va-les-cen-t	con-va-les-cent
able	a-ble
over-lord	o-ver-lord
open-er	o-pen-er
tantrum	tan-trum
or-tho-doxy	or-tho-dox-y
as-pidis-tra	as-pi-dis-tra
s-ab-bath	sab-bath
grouper	group-er
s-port-ing	sport-ing
chromite	chro-mite
cu-nei-form	cu-ne-i-form
y-achts-man	yachts-man
glis-ten-ing	gli-ste-ning
shandy	shan-dy
bony	bon-y
frag-men-tary	frag-men-tar-y
lethal-i-ty	le-thal-i-ty
heavy	heav-y
garage	ga-rage
in-ward-s	in-wards
scenery	scen-er-y
basal	ba-sal
thruster	thrust-er
s-ta-tionery	sta-tion-er-y
over-re-ac-t	o-ver-re-act
burn-t	burnt
beefeater	beef-eat-er
pol-i-tic-s	pol-i-tics
per-m	perm
pago-da	pa-go-da
archer	arch-er
clumpy	clump-y
flesh-pot-s	flesh-pots
pro-cure-men-t	pro-cure-ment
ser-pen-t	ser-pent
omen	o-men
g-lid-ing	glid-ing
civic	civ-ic
cur-b	curb
ravine	ra-vine
warpath	war-path
lancet	lan-cet
can-nery	can-ner-y
bad-minton	bad-min-ton
ra-dius	ra-di-us
bologna	bo-lo-gna
s-cotch	scotch
bom-bardier	bom-bar-dier
idyl-l	i-dyll
carat	car-at
swasti-ka	swas-ti-ka
het-ero-sex-u-al	het-er-o-sex-u-al
in-salu-bri-ous	in-sa-lu-bri-ous
s-luice	sluice
cra-nial	cra-ni-al
rene-go-ti-ate	re-ne-go-ti-ate
gril-l	grill
patho-gen-e-sis	path-o-gen-e-sis
beanie	bean-ie
rein-ter-pret	re-in-ter-pret
s-nip	snip
thau-maturge	thau-ma-turge
chromi-um	chro-mi-um
seascape	sea-scape
fil-a-men-t	fil-a-ment
impi-ety	im-pi-e-ty
con-ge-nial	con-gen-ial
s-cold-ing	scold-ing
con-certi-na	con-cer-ti-na
mar-quetry	mar-que-try
s-tok-er	stok-er
re-porter	re-port-er
pyrite	py-rite
je-junum	je-ju-num
cathar-sis	ca-thar-sis
moorhen	moor-hen
stylist	styl-ist
over-writ-ing	overwriting
syn-ovial	syn-o-vi-al
lo-bot-omy	lo-bot-o-my
anx-i-ety	anx-i-e-ty
e-mer-ald	em-er-ald
mi-cro-elec-tron-ic-s	mi-cro-e-lec-tron-ics
ex-pan-sion-ary	ex-pan-sion-ar-y
cheva-lier	chev-a-lier
de-bat-able	de-bat-a-ble
bul-letin	bul-le-tin
archangel	arch-an-gel
urchin	ur-chin
de-ity	de-i-ty
u-nim-por-tance	un-im-por-tance
sur-moun-t	sur-mount
cryo-gen-ic-s	cry-o-gen-ics
ex-pend-able	ex-pend-a-ble
s-lipped	slipped
pe-riph-ery	pe-riph-er-y
de-liv-ery	de-liv-er-y
droopy	droop-y
ex-pand-able	ex-pand-a-ble
un-usu-al-ly	un-u-su-al-ly
legate	leg-ate
makeweight	make-weight
solem-n	sol-emn
rhetor-i-cal-ly	rhe-tor-i-cal-ly
penin-su-lar	pen-in-su-lar
video-taped	videotaped
cloudy	cloud-y
flam-boy-an-t	flam-boy-ant
promis-cu-ity	prom-is-cu-i-ty
t-elecom-mut-ing	te-le-com-mu-ting
p-salter	psal-ter
rafter	raft-er
ves-per-s	ves-pers
con-trivance	con-triv-ance
erad-i-ca-tion	e-rad-i-ca-tion
ether	e-ther
s-teep-en	steep-en
sundry	sun-dry
flash-bul-b	flash-bulb
undi-min-ished	un-di-min-ished
s-pas-mod-ic	spas-mod-ic
trouser-s	trou-sers
grad-u-al-is-m	grad-u-al-ism
lawyer	law-yer
re-quiem	req-ui-em
declam-a-to-ry	de-clam-a-to-ry
trouper	troup-er
lot-tery	lot-ter-y
lumpen	lum-pen
s-log	slog
reap-ply	re-ap-ply
frica-tive	fric-a-tive
wolfhound	wolf-hound
lino	li-no
pesti-len-t	pes-ti-lent
an-niver-sary	an-ni-ver-sa-ry
raspy	rasp-y
de-featist	de-feat-ist
un-sea-son-able	un-sea-son-a-ble
mistype	mis-type
cack-ling	cackling
de-po-si-tion	dep-o-si-tion
s-calar	sca-lar
o-nion	on-ion
vir-u-len-t	vir-u-lent
di-rec-torate	di-rec-to-rate
sus-pender-s	sus-pend-ers
teenaged	teen-aged
mono-lay-er	mon-o-lay-er
plu-ral-is-m	plu-ral-ism
hearthrug	hearth-rug
s-tand-ing	stand-ing
cata-ton-ic	cat-a-ton-ic
biom-e-try	bi-om-e-try
elec-tro-mag-net	e-lec-tro-mag-net
over-write	o-ver-write
re-fresh-men-t	re-fresh-ment
u-n-ap-proach-able	un-ap-proach-a-ble
in-dige-nous	in-dig-e-nous
s-tat-ue	stat-ue
pyri-dine	pyr-i-dine
mis-spel-l	mis-spell
naked	na-ked
de-mo-graph-ic-s	dem-o-graph-ics
di-alec-t	di-a-lect
flinch-ing	flin-ching
bar-tender	bar-tend-er
s-lip-per-i-ness	slip-per-i-ness
may-oral-ty	may-or-al-ty
be-liev-abil-i-ty	be-liev-a-bil-i-ty
reli-quary	rel-i-quar-y
shep-herdess	shep-herd-ess
marathon	mar-a-thon
posthu-mous-ly	post-hu-mous-ly
foot-light-s	foot-lights
pro-tea	pro-te-a
plat-inum	plat-i-num
i-n-ap-pro-pri-ate	in-ap-pro-pri-ate
nonex-is-tence	non-ex-ist-ence
condi-men-t	con-di-ment
elec-trophore-sis	e-lec-tro-pho-re-sis
em-bo-som	em-bos-om
ve-nial	ve-ni-al
dis-cern-men-t	dis-cern-ment
peas-antry	peas-ant-ry
ap-pel-lan-t	ap-pel-lant
steve-dore	ste-ve-dore
de-for-m	de-form
propo-si-tion-al	prop-o-si-tion-al
hov-e	hove
k-itchen-ware	kitch-en-ware
sonorous	so-no-rous
celiba-cy	cel-i-ba-cy
laun-dered	laundered
foxy	fox-y
de-bauch-ery	de-bauch-er-y
re-hearsal	re-hears-al
holis-tic	ho-lis-tic
s-pace-ship	space-ship
su-per-b	su-perb
trel-lised	trellised
c-og-nizance	cog-ni-zance
per-fectibil-i-ty	per-fect-i-bil-i-ty
ac-ci-den-t	ac-ci-dent
tele-o-log-i-cal	tel-e-o-log-i-cal
s-tum-ble	stum-ble
sus-pec-t	sus-pect
salty	salt-y
s-trand	strand
salmon	salm-on
id-iot	id-i-ot
pulpy	pulp-y
rivulet	riv-u-let
de-tainee	de-tain-ee
in-di-vid-u-al-is-m	in-di-vid-u-al-ism
be-fud-dling	befuddling
u-ni-ver-sal-is-m	u-ni-ver-sal-ism
s-coff-in-g	scoffing
over-growth	o-ver-growth
mori-bund	mor-i-bund
floaty	float-y
prepo-si-tion	prep-o-si-tion
sales-woman	sales-wom-an
elec-tro	e-lec-tro
drudgery	drudg-er-y
ush-erette	ush-er-ette
ex-oti-cis-m	ex-ot-i-cism
k-ilo-ton	kil-o-ton
lyri-cis-m	lyr-i-cism
ex-cel-sior	ex-cel-si-or
elixir	e-lix-ir
di-a-betes	di-a-be-tes
pan-theon	pan-the-on
puree	pu-ree
para-pet	par-a-pet
dunghill	dung-hill
mushy	mush-y
gan-g-ly	gan-gly
s-tand	stand
pur-po-sive	pur-pos-ive
porta-bil-i-ty	port-a-bil-i-ty
await	a-wait
starchy	starch-y
dizzi-ness	diz-zi-ness
hereti-cal	he-ret-i-cal
dis-hon-esty	dis-hon-es-ty
de-spi-ca-ble	des-pi-ca-ble
bias	bi-as
di-ana	di-an-a
eighty	eight-y
mal-treat-men-t	mal-treat-ment
stric-t	strict
in-nu-mer-able	in-nu-mer-a-ble
re-pairable	re-pair-a-ble
er-r	err
in-fantry-man	in-fan-try-man
species	spe-cies
co-eval	co-e-val
gener-i-cal-ly	ge-ner-i-cal-ly
i-n-ap-pli-ca-ble	in-ap-pli-ca-ble
mi-croscopy	mi-cros-co-py
s-pear	spear
catgut	cat-gut
breakup	break-up
meat-bal-l	meat-ball
surgery	sur-ger-y
pre-ven-t	pre-vent
bang-ing	banging
melan-choly	mel-an-chol-y
ashen	ash-en
re-ceiv-able	re-ceiv-a-ble
paci-fi-er	pac-i-fi-er
s-laugh-ter-house	slaugh-ter-house
mayflow-er	may-flow-er
topaz	to-paz
opin-ion	o-pin-ion
re-pen-t	re-pent
os-tracis-m	os-tra-cism
methanol	meth-a-nol
im-mi-nen-t	im-mi-nent
bio-met-ric-s	bi-o-met-rics
sacra-men-t	sac-ra-ment
pedan-tic	pe-dan-tic
s-trag-gler	strag-gler
awry	a-wry
vista	vis-ta
del-i-catessen	del-i-ca-tes-sen
re-pen-tance	re-pent-ance
in-dex-ing	indexing
s-tun-ning-ly	stun-ning-ly
con-sum-able	con-sum-a-ble
h-m-m	hmm
basil-i-ca	ba-sil-i-ca
p-re-set	pre-set
m-nemon-ic	mne-mon-ic
tonal-i-ty	to-nal-i-ty
non-even-t	non-e-vent
re-moun-t	re-mount
ra-dio-graph	ra-di-o-graph
bar-rack-s	bar-racks
dia-lec-tic	di-a-lec-tic
in-signi-a	in-sig-ni-a
per-cep-t	per-cept
over-look	o-ver-look
cine	cin-e
s-not-ty	snot-ty
gun-nery	gun-ner-y
l-iti-gious	li-ti-gious
carousel	car-ou-sel
over-sleep	o-ver-sleep
ex-pect-ed	expected
em-i-nen-t	em-i-nent
pol-l	poll
baronet	bar-on-et
con-sid-er-able	con-sid-er-a-ble
s-paced	spaced
un-set-tling	unsettling
de-riso-ry	de-ri-so-ry
ban-tamweight	ban-tam-weight
hor-mon-al	hor-mo-nal
legu-mi-nous	le-gu-mi-nous
saline	sa-line
ex-hi-bi-tion-is-m	ex-hi-bi-tion-ism
ir-ri-tan-t	ir-ri-tant
obe-di-en-t	o-be-di-ent
run-t	runt
de-part-men-t	de-part-ment
s-nuf-f	snuff
het-ero-dox	het-er-o-dox
ir-repara-ble	ir-rep-a-ra-ble
iso-ton-ic	i-so-ton-ic
rigid-i-fy	ri-gid-i-fy
lethar-gy	leth-ar-gy
s-tonework	stone-work
para-noia	par-a-noi-a
over-hand	o-ver-hand
au-thoress	au-thor-ess
cir-cling	circling
tithing	tith-ing
s-tul-ti-fy	stul-ti-fy
s-nip-ing	snip-ing
s-care	scare
con-ser-va-to-ry	con-serv-a-to-ry
car-avel	car-a-vel
cut-lery	cut-ler-y
prop-s	props
shaven	shav-en
anorex-i-c	an-o-rex-ic
husky	hus-ky
milk-shake	milkshake
in-ter-change-ably	in-ter-change-a-bly
in-evitabil-i-ty	in-ev-i-ta-bil-i-ty
rubric	ru-bric
ivy	i-vy
catchy	catch-y
tute-lage	tu-te-lage
in-tel-li-gen-t	in-tel-li-gent
ar-guable	ar-gu-a-ble
ser-van-t	serv-ant
ven-omous	ven-om-ous
s-trap-ping	strap-ping
va-grancy	va-gran-cy
piv-otal	piv-ot-al
al-l	all
iso-lat-ing	i-so-lat-ing
fool-hardy	fool-har-dy
apoc-a-lyp-tic	a-poc-a-lyp-tic
s-tarve	starve
at-temp-t	at-tempt
pot-tery	pot-ter-y
dumpy	dump-y
chore-og-ra-pher	cho-re-og-ra-pher
cochlea	coch-le-a
ganger	gang-er
habi-ta-tion	hab-i-ta-tion
doyen	doy-en
te-dious	te-di-ous
dogged-ly	dog-ged-ly
a-tone-men-t	a-tone-ment
g-narled	gnarled
widescreen	wide-screen
quan-tifi-ca-tion	quan-ti-fi-ca-tion
s-teeple-chase	stee-ple-chase
ephemer-a	e-phem-er-a
an-ti-quary	an-ti-quar-y
voyeuris-tic	voy-eur-is-tic
dereg-u-late	de-reg-u-late
s-tark-ly	stark-ly
func-tion-al-is-m	func-tion-al-ism
epis-to-lary	e-pis-to-lar-y
voyeuris-m	vo-yeur-ism
propin-quity	pro-pin-qui-ty
in-ter-cep-t	in-ter-cept
b-lench	blench
dan-de-lion	dan-de-li-on
motet	mo-tet
tem-po-rar-ily	tem-po-rar-i-ly
c-leg	cleg
minute-ly	mi-nute-ly
dis-in-vest-men-t	dis-in-vest-ment
servi-tude	ser-vi-tude
any-place	an-y-place
navy	na-vy
drowsi-ness	drow-si-ness
kiosk	ki-osk
colos-sal	co-los-sal
brawny	brawn-y
foothold	foot-hold
spiny	spin-y
over-crowd	o-ver-crowd
shady	shad-y
over-shad-ow	o-ver-shad-ow
quif-f	quiff
car-cino-gen-e-sis	car-cin-o-gen-e-sis
abuse	a-buse
apron	a-pron
grouchy	grouch-y
as-tro-physic-s	as-tro-phys-ics
dogs-body	dogs-bod-y
tri-maran	tri-ma-ran
pe-cu-niary	pe-cu-ni-ar-y
sim-u-lacrum	sim-u-la-crum
jan-u-ary	jan-u-ar-y
dusty	dust-y
s-po-rad-i-cal-ly	spo-rad-i-cal-ly
rhodo-den-dron	rho-do-den-dron
any-body	an-y-bod-y
pri-mar-i-ly	pri-ma-ri-ly
s-narl	snarl
s-par	spar
re-tal-ia-to-ry	re-tal-i-a-to-ry
axle	ax-le
boxy	box-y
baoba-b	ba-o-bab
s-lant-wise	slant-wise
stinger	sting-er
ac-cep-t	ac-cept
electable	e-lect-a-ble
carotid	ca-rot-id
mod-icum	mod-i-cum
s-ta-tis-ti-cal-ly	sta-tis-ti-cal-ly
pota-to	po-ta-to
swar-m	swarm
n-ear-by	near-by
an-cien-t	an-cient
o-r-a-tor	or-a-tor
tramway	tram-way
in-su-lan-t	in-su-lant
amoun-t	a-mount
cur-ran-t	cur-rant
un-usu-al	un-u-su-al
spencer	spen-cer
spec-s	specs
linkup	link-up
hy-per-boloid	hy-per-bo-loid
grapevine	grape-vine
eroge-nous	e-rog-e-nous
e-ques-tri-an-is-m	e-ques-tri-an-ism
u-n-adapt-ed	un-a-dapt-ed
crispy	crisp-y
halo-gen	hal-o-gen
syrup	syr-up
in-ter-dis-ci-pli-nary	in-ter-dis-ci-pli-nar-y
mea-sure-men-t	meas-ure-ment
ac-cen-t	ac-cent
re-trieval	re-triev-al
u-n-ac-com-pa-nied	un-ac-com-pa-nied
s-tate-men-t	state-ment
ju-nior	jun-ior
bawl-ing	baw-ling
ge-neti-cist	ge-net-i-cist
in-vi-o-lable	in-vi-o-la-ble
man-i-festo	man-i-fes-to
v-ole	vole
tarsal	tar-sal
re-cal-l	re-call
ra-dio-ther-a-py	ra-di-o-ther-a-py
iso-la-tion-is-m	i-so-la-tion-ism
eigen-state	ei-gen-state
s-taunch	staunch
sup-ple-men-t	sup-ple-ment
bilin-gual-is-m	bi-lin-gual-ism
per-cu-ta-neous	per-cu-ta-ne-ous
bumper	bump-er
pro-nounce-men-t	pro-nounce-ment
piebald	pie-bald
au-gury	au-gu-ry
ge-nial	ge-ni-al
as-sis-tan-t	as-sis-tant
diskette	disk-ette
hookah	hook-ah
s-ti-fling	sti-fling
look-ing	looking
cheesy	chees-y
hep-tagon	hep-ta-gon
u-nas-sum-ing	un-as-sum-ing
s-lit	slit
chapel	chap-el
bonus	bo-nus
apo-lit-i-cal	a-po-lit-i-cal
coun-ter-in-tu-itive	coun-ter-in-tu-i-tive
atom-ic	a-tom-ic
fruity	fruit-y
ini-ti-a-tion	in-i-ti-a-tion
sol-diery	sol-dier-y
tractable	trac-ta-ble
busty	bust-y
har-mo-nious-ly	har-mo-ni-ous-ly
ledger	ledg-er
ar-chais-m	ar-cha-ism
non-con-for-mi-ty	non-con-form-i-ty
over-bear-ing	o-ver-bear-ing
s-tran-gles	stran-gles
s-teel-work-s	steel-works
sum-mon-s	sum-mons
di-gestible	di-gest-i-ble
cannabis	can-na-bis
melo-dra-ma	mel-o-dra-ma
gooey	goo-ey
antwer-p	antwerp
s-ten-tor	sten-tor
en-force-able	en-force-a-ble
physic-s	phys-ics
sub-jec-tivis-m	sub-jec-tiv-ism
beach-comber	beach-comb-er
cen-trifu-gal	cen-trif-u-gal
unloved	un-loved
s-now-man	snow-man
sorghum	sor-ghum
volatil-i-ty	vol-a-til-i-ty
s-melt-ing	smelting
stereo-typ-i-cal	ster-e-o-typ-i-cal
moral-ly	mor-al-ly
catheter	cath-e-ter
stopover	stop-o-ver
para-sol	par-a-sol
un-der-achieve-men-t	un-der-a-chieve-ment
con-jec-tural	con-jec-tur-al
tox-i-c-i-ty	tox-ic-i-ty
s-traight-for-ward-ly	straight-for-ward-ly
s-louch-ing	slouching
imag-i-na-tive	im-ag-i-na-tive
cat-a-com-b	cat-a-comb
con-fus-able	con-fus-a-ble
baron	bar-on
heron	her-on
pam-phle-teer	pam-phlet-eer
over-hear	o-ver-hear
para-dox	par-a-dox
spir-i-tu-al-ist	spir-it-u-al-ist
lachry-mal	lach-ry-mal
de-men-t	de-ment
ex-po-nen-t	ex-po-nent
about	a-bout
un-speak-able	un-speak-a-ble
unchecked	un-checked
sacro-sanc-t	sac-ro-sanct
s-tiffly	stiff-ly
gal-vanome-ter	gal-va-nom-e-ter
skil-l	skill
foot-baller	foot-ball-er
rooi-bos	roo-i-bos
marzi-pan	mar-zi-pan
renum-ber	re-num-ber
sumo	su-mo
el-dest	eld-est
hearty	heart-y
sanc-ti-mo-nious	sanc-ti-mo-ni-ous
s-cab-bard	scab-bard
mer-cury	mer-cu-ry
s-ta-sis	sta-sis
prodi-gal	prod-i-gal
gal-axy	gal-ax-y
it-s	its
count-able	count-a-ble
cyclic	cy-clic
breathy	breath-y
s-nap-shot	snap-shot
s-tates-man	states-man
tapir	ta-pir
backpedal	back-ped-al
leisure	lei-sure
tele-path-ic	tel-e-path-ic
ver-dic-t	ver-dict
bur-gundy	bur-gun-dy
e-tu-i	e-tui
mishap	mis-hap
labyrinthine	lab-y-rin-thine
un-de-sir-able	un-de-sir-a-ble
protest-ing	protesting
poly-car-bon-ate	pol-y-car-bon-ate
suit-able	suit-a-ble
daun-t	daunt
copi-lot	co-pi-lot
green-ery	green-er-y
clever	clev-er
enig-mat-ic	en-ig-mat-ic
be-whiskered	be-whisk-ered
un-en-vi-able	un-en-vi-a-ble
twitchy	twitch-y
gloomy	gloom-y
op-er-cu-lum	o-per-cu-lum
sonata	so-na-ta
i-den-ti-fi-able	i-den-ti-fi-a-ble
un-sup-port-able	un-sup-port-a-ble
nephew	neph-ew
can-non-bal-l	can-non-ball
away	a-way
rapid-ly	rap-id-ly
fermion	fer-mi-on
mono-phon-ic	mon-o-phon-ic
pin-t	pint
fiendish	fiend-ish
elec-tri-cal-ly	e-lec-tri-cal-ly
as-tro-nau-tic-s	as-tro-nau-tics
draftee	draft-ee
seg-ment-ed	seg-men-ted
squea-mish	squeam-ish
throaty	throat-y
plain-t	plaint
penu-ri-ous	pe-nu-ri-ous
l-la-ma	lla-ma
to-tal-i-tar-i-an-is-m	to-tal-i-tar-i-an-ism
mazur-ka	ma-zur-ka
en-trail-s	en-trails
speedy	speed-y
s-lan-t	slant
vinyl	vi-nyl
over-heat	o-ver-heat
switchgear	switch-gear
s-lash	slash
courtier	cour-ti-er
per-ish-able	per-ish-a-ble
s-nook-er	snook-er
cor-rec-t	cor-rect
doughty	dough-ty
un-premed-i-tat-ed	un-pre-med-i-tat-ed
hawser	haw-ser
domi-cil-iary	dom-i-cil-i-ar-y
teatime	tea-time
w-hole-sale	whole-sale
man-ager-ess	man-ag-er-ess
arith-metic	a-rith-me-tic
un-event-ful	un-e-vent-ful
repack	re-pack
menagerie	me-nag-er-ie
sawmil-l	saw-mill
gua-camole	gua-ca-mo-le
prepa-ra-tion	prep-a-ra-tion
con-sti-tu-tion-al-is-m	con-sti-tu-tion-al-ism
s-carce	scarce
hero-is-m	her-o-ism
marten	mar-ten
s-cathing	scath-ing
un-du-lat-ing	un-du-la-ting
in-tegri-ty	in-teg-ri-ty
s-cor-pi-on	scor-pi-on
as-pirin	as-pi-rin
boast-ing	boas-ting
en-dow-men-t	en-dow-ment
swishy	swish-y
neg-li-gen-t	neg-li-gent
stri-den-t	stri-dent
overem-pha-sis	o-ver-em-pha-sis
palati-nate	pa-lat-i-nate
re-cov-ery	re-cov-er-y
warhorse	war-horse
tenor	ten-or
i-n-alien-able	in-al-ien-a-ble
in-tra-venous-ly	in-tra-ve-nous-ly
ra-tio-nal-ist	ra-tion-al-ist
funky	funk-y
mas-culin-i-ty	mas-cu-lin-i-ty
prosody	pros-o-dy
hero-ical-ly	he-ro-i-cal-ly
blowfly	blow-fly
re-state-men-t	re-state-ment
e-quip-men-t	e-quip-ment
d-if-fer-ing	differing
mildew	mil-dew
im-pres-sion-is-m	im-pres-sion-ism
crescen-do	cre-scen-do
to-kenis-m	to-ken-ism
swarm-ing	swarming
dis-tan-t	dis-tant
crevasse	cre-vasse
s-nig-ger-ing	sniggering
s-woon	swoon
arachno-pho-bi-a	a-rach-no-pho-bi-a
post-mistress	post-mis-tress
sala-man-der	sal-a-man-der
in-ten-t	in-tent
ne-go-tia-tor	ne-go-ti-a-tor
roadmap	road-map
undis-turbed	un-dis-turbed
un-healthy	un-health-y
mar-keter	mar-ket-er
bet-ter-men-t	bet-ter-ment
sinew	sin-ew
cir-cuitous	cir-cu-i-tous
fusty	fus-ty
rodeo	ro-de-o
l-o-gis-ti-cal-ly	lo-gis-ti-cal-ly
rep-re-sen-t	rep-re-sent
h-es-i-ta-tion	hes-i-ta-tion
ben-e-fi-cia-ry	ben-e-fi-ci-ar-y
hostler	hos-tler
presto	pres-to
eroti-cis-m	e-rot-i-cism
blus-ter-ing	blustering
be-fal-l	be-fall
dat-able	dat-a-ble
chiefly	chief-ly
duo	du-o
par-tic-i-pan-t	par-tic-i-pant
body-guard	bod-y-guard
missal	mis-sal
dis-cour-age-men-t	dis-cour-age-ment
chi-canery	chi-can-er-y
palu-dal	pa-lu-dal
ca-su-al-ty	cas-u-al-ty
cere-bel-lum	cer-e-bel-lum
koala	ko-a-la
re-de-ploy-men-t	re-de-ploy-ment
hazy	ha-zy
at-trac-t	at-tract
s-ketch	sketch
h-es-i-tate	hes-i-tate
busi-nesslike	busi-ness-like
en-dometri-um	en-do-me-tri-um
s-tor-m	storm
jam-boree	jam-bo-ree
cyn-i-cis-m	cyn-i-cism
chasti-ty	chas-ti-ty
inkwell	ink-well
con-fronta-tion-al	con-fron-ta-tion-al
pinafore	pin-a-fore
pizzi-ca-to	piz-zi-ca-to
forcible	for-ci-ble
thievish	thiev-ish
re-new-able	re-new-a-ble
sewage	sew-age
dis-parate	dis-pa-rate
unin-sur-able	un-in-sur-a-ble
banger	bang-er
kwacha	kwa-cha
origa-mi	o-ri-ga-mi
s-tair-way	stair-way
s-tun-t	stunt
up-heaval	up-heav-al
n-ear-ly	near-ly
place-men-t	place-ment
painstak-ing-ly	pains-tak-ing-ly
chanter	chant-er
ax-e-man	axe-man
dopey	dope-y
dullard	dull-ard
mi-crochip	mi-cro-chip
sec-t	sect
les-bian-is-m	les-bi-an-ism
grassy	grass-y
ath-let-ic-s	ath-let-ics
moi-ety	moi-e-ty
promp-t	prompt
s-nore	snore
skua	sku-a
mili-ti-a	mi-li-tia
tena-cious-ly	te-na-cious-ly
lover	lov-er
lever-age	lev-er-age
la-ten-t	la-tent
calum-ny	cal-um-ny
nowa-days	now-a-days
capy-bara	cap-y-ba-ra
per-cip-i-en-t	per-cip-i-ent
syco-phan-tic	syc-o-phan-tic
y-oung	young
vel-veteen	vel-vet-een
islet	is-let
cabri-o-let	cab-ri-o-let
athe-is-tic	a-the-is-tic
mal-odor-ous	mal-o-dor-ous
downy	down-y
poli-ty	pol-i-ty
achieve	a-chieve
dis-qui-etude	dis-qui-e-tude
in-stan-t	in-stant
move-men-t	move-ment
swindler	swin-dler
salience	sa-li-ence
in-signif-i-can-t	in-sig-nif-i-cant
car-dio-vas-cu-lar	car-di-o-vas-cu-lar
owlish	owl-ish
bal-l	ball
hypochon-dri-a-cal	hy-po-chon-dri-a-cal
gherkin	gher-kin
bleary	blear-y
e-u-pho-nious	eu-pho-ni-ous
gud-geon	gudg-eon
undig-ni-fied	un-dig-ni-fied
puer-per-al	pu-er-per-al
s-late	slate
in-fini-tude	in-fin-i-tude
n-ear-ness	near-ness
no-ti-fi-able	no-ti-fi-a-ble
s-cle-ro-sis	scle-ro-sis
un-equiv-o-cal	un-e-quiv-o-cal
boule-vard	boul-e-vard
u-n-al-loyed	un-al-loyed
lessor	les-sor
augite	au-gite
s-tock-room	stock-room
mar-chioness	mar-chion-ess
schis-m	schism
s-nub	snub
gala	ga-la
i-n-or-gan-ic	in-or-gan-ic
ine-bri-ate	in-e-bri-ate
stew-ardess	stew-ard-ess
episode	ep-i-sode
changeling	change-ling
col-lec-tivist	col-lec-tiv-ist
alive	a-live
re-trac-t	re-tract
un-mis-tak-ably	un-mis-tak-a-bly
monar-chist	mon-ar-chist
re-spectable	re-spect-a-ble
s-core	score
bathos	ba-thos
seda-tive	sed-a-tive
ex-clu-sion-ary	ex-clu-sion-ar-y
e-n-act-men-t	en-act-ment
creamy	cream-y
re-for-esta-tion	re-for-est-a-tion
in-vert-ed	inverted
ap-pli-can-t	ap-pli-cant
crenel-la-tion-s	cren-el-la-tions
phle-boto-my	phle-bot-o-my
nitwit	nit-wit
maser	ma-ser
ves-ti-gial	ves-tig-i-al
teeter	tee-ter
hered-i-ty	he-red-i-ty
im-pre-sari-o	im-pre-sa-ri-o
de-lin-eate	de-lin-e-ate
oviduc-t	o-vi-duct
tol-er-an-t	tol-er-ant
gun-metal	gun-met-al
schooner	schoon-er
wind-surfer	wind-surf-er
elu-ci-da-tion	e-lu-ci-da-tion
gospel	gos-pel
es-sen-tial-is-m	es-sen-tial-ism
dy-namis-m	dy-na-mism
un-kep-t	un-kept
pol-lu-tan-t	pol-lu-tant
retic-u-lar	re-tic-u-lar
mi-cro-surgery	mi-cro-sur-ger-y
com-men-t	com-ment
m-nemon-ic-s	mne-mon-ics
calami-ty	ca-lam-i-ty
decade	dec-ade
brassy	brass-y
quel-l	quell
vagabond	vag-a-bond
river-side	riv-er-side
s-lur	slur
retro-fit	ret-ro-fit
essence	es-sence
em-pow-er-men-t	em-pow-er-ment
pre-dic-t	pre-dict
philoso-pher	phi-los-o-pher
catch-men-t	catch-ment
defe-cate	def-e-cate
bas-ketry	bas-ket-ry
puma	pu-ma
s-moth-ered	smothered
n-im-ble-ness	nim-ble-ness
maul-ing	mauling
fundrais-er	fund-rais-er
gale-na	ga-le-na
s-nack	snack
gra-nary	gra-na-ry
spi-ran-t	spi-rant
in-tol-er-an-t	in-tol-er-ant
sec-re-tar-iat	sec-re-tar-i-at
in-sou-ciant	in-sou-ci-ant
za-p	zap
s-to-ry	sto-ry
clank-ing	clan-king
reaper	reap-er
mea-sur-able	meas-ur-a-ble
faucet	fau-cet
touris-m	tour-ism
mili-tia-man	mi-li-tia-man
link-able	link-a-ble
im-pres-sion-able	im-pres-sion-a-ble
s-lob	slob
n-erve-less	nerve-less
devo-tee	dev-o-tee
tiny	ti-ny
lech-ery	lech-er-y
forego	fore-go
pro-gressed	progressed
sinis-tral	sin-is-tral
chorale	cho-rale
p-ith	pith
avenger	a-veng-er
d-e-duce	de-duce
scream-ing	screaming
profli-ga-cy	prof-li-ga-cy
gener-ic	ge-ner-ic
roundup	round-up
mas-cara	mas-car-a
holdup	hold-up
rani	ra-ni
sax-ony	sax-o-ny
quadru-ple	quad-ru-ple
patho-log-i-cal-ly	path-o-log-i-cal-ly
s-lag	slag
i-n-ac-cu-ra-cy	in-ac-cu-ra-cy
in-cre-men-t	in-cre-ment
s-lum	slum
vi-bran-t	vi-brant
s-now-drift	snow-drift
ir-rel-e-van-t	ir-rel-e-vant
s-care-mon-ger-ing	scare-mon-ger-ing
scrolling	scroll-ing
dactylic	dac-tyl-ic
s-nifter	snif-ter
in-sa-tiable	in-sa-tia-ble
gen-u-flec-t	gen-u-flect
es-trange-men-t	es-trange-ment
con-sis-ten-cy	con-sist-en-cy
y-on	yon
mor-dan-t	mor-dant
coy-ote	coy-o-te
con-temptible	con-tempt-i-ble
phil-an-thropic	phil-an-throp-ic
lul-l	lull
cranky	crank-y
en-chanter	en-chant-er
forester	for-est-er
chro-mo-so-ma-l	chro-mo-so-mal
coralline	cor-al-line
p-re-s-e-lec-t	pre-se-lect
con-fronta-tion	con-fron-ta-tion
rever-ie	rev-er-ie
ivory	i-vo-ry
n-im-bly	nim-bly
the-atri-cal-s	the-at-ri-cals
pur-suan-t	pur-su-ant
mid-dleweight	mid-dle-weight
bire-frin-gen-t	bi-re-frin-gent
del-l	dell
s-neer-ing	sneering
pipette	pi-pette
bedrock	bed-rock
gulli-bil-i-ty	gul-li-bil-i-ty
s-lith-er	slith-er
ro-man-ti-cis-m	ro-man-ti-cism
ru-ina-tion	ru-in-a-tion
pick-ax-e	pick-axe
opi-um	o-pi-um
con-stab-u-lary	con-stab-u-lar-y
ridicu-lous	ri-dic-u-lous
teapot	tea-pot
hy-dro-elec-tric	hy-dro-e-lec-tric
sisal	si-sal
turn-around	turn-a-round
erode	e-rode
foot-bal-l	foot-ball
u-n-af-fil-i-at-ed	un-af-fil-i-at-ed
vari-abil-i-ty	var-i-a-bil-i-ty
demon-strate	dem-on-strate
wrinkly	wrin-kly
im-muno-sup-pres-sive	im-mu-no-sup-pres-sive
vestal	ves-tal
avalanche	av-a-lanche
en-joy-men-t	en-joy-ment
valu-able	val-u-a-ble
l-it-i-ga-tion	lit-i-ga-tion
iron-work-s	i-ron-works
moody	mood-y
blud-geon	bludg-eon
ghana	ghana
umpteenth	ump-teenth
restora-tive	re-stor-a-tive
athe-is-m	a-the-ism
epi-gram-mat-ic	ep-i-gram-mat-ic
even	e-ven
avow	a-vow
church-war-den	church-ward-en
bases	ba-ses
d-is-fig-ure	dis-fig-ure
op-tic-s	op-tics
re-searcher	re-search-er
in-con-testable	in-con-test-a-ble
tra-verse	trav-erse
dairy-man	dair-y-man
s-tair-case	stair-case
prefer-able	pref-er-a-ble
rein-ven-tion	re-in-ven-tion
s-tan-za	stan-za
seedbed	seed-bed
laugh-ably	laugh-a-bly
cloven	clo-ven
ten-antry	ten-ant-ry
mis-an-thropy	mis-an-thro-py
in-de-struc-tible	in-de-struct-i-ble
flighty	flight-y
s-lan-der-ous	slan-der-ous
stony	ston-y
ex-i-gen-t	ex-i-gent
som-brero	som-bre-ro
dis-tur-b	dis-turb
e-cho	ech-o
rein-car-nat-ed	reincarnated
mil-l	mill
s-ten-cil	sten-cil
rege-late	re-ge-late
pho-to-copy	pho-to-cop-y
s-nob	snob
gable	ga-ble
crino-line	crin-o-line
celebri-ty	ce-leb-ri-ty
vest-men-t	vest-ment
leg-isla-tive	leg-is-la-tive
touristy	tour-ist-y
de-fen-dan-t	de-fend-ant
trainee	train-ee
in-signif-i-cance	in-sig-nif-i-cance
cre-ator	cre-a-tor
com-mis-sioned	commissioned
bullish	bull-ish
turnover	turn-o-ver
g-lan-du-lar	glan-du-lar
s-teeply	steep-ly
per-fec-tion-is-m	per-fec-tion-ism
valen-tine	val-en-tine
cam-panile	cam-pa-ni-le
synap-tic	syn-ap-tic
en-ter-tain-men-t	en-ter-tain-ment
mut-t	mutt
il-lu-mi-nan-t	il-lu-mi-nant
op-er-a-tional-ly	op-er-a-tion-al-ly
so-cio-bi-ol-o-gy	so-ci-o-bi-ol-o-gy
floozy	floo-zy
cara-pace	car-a-pace
trea-son-able	trea-son-a-ble
con-flict-ual	con-flic-tu-al
valise	va-lise
promis-ing	prom-is-ing
u-nar-tic-u-lat-ed	un-ar-tic-u-lat-ed
teenag-er	teen-ag-er
usu-al-ly	u-su-al-ly
u-nas-so-ci-at-ed	un-as-so-ci-at-ed
s-lick-er	slick-er
de-press-ing	de-pres-sing
ho-mo-mor-phis-m	ho-mo-mor-phism
cen-trifuge	cen-tri-fuge
s-lang	slang
rein-vest	re-in-vest
provo-ca-tion	prov-o-ca-tion
manome-ter	ma-nom-e-ter
pi-anola	pi-a-no-la
gamy	gam-y
thun-der-stor-m	thun-der-storm
loutish	lout-ish
aware-ness	a-ware-ness
rhea	rhe-a
query	que-ry
strug-gling	struggling
binoc-u-lar	bin-oc-u-lar
sali-vate	sal-i-vate
hoary	hoar-y
ju-niper	ju-ni-per
con-cor-dan-t	con-cord-ant
d-enizen	den-i-zen
in-ep-t	in-ept
calami-tous	ca-lam-i-tous
chill-ing	chilling
bene-fac-tress	ben-e-fac-tress
t-ingly	tin-gly
u-n-a-mused	un-a-mused
semi-colon	sem-i-co-lon
byprod-uc-t	by-prod-uct
brav-ery	brav-er-y
ep-silon	ep-si-lon
s-pace-man	space-man
sideshow	side-show
s-mudge	smudge
cladding	clad-ding
s-plin-t	splint
mon-u-men-t	mon-u-ment
pa-pyrus	pa-py-rus
s-toop	stoop
sycamore	syc-a-more
no-tice-able	no-tice-a-ble
b-light	blight
min-uet	min-u-et
oxy-moron	ox-y-mo-ron
asym-me-try	a-sym-me-try
s-tand-by	stand-by
at-tack-ing	attacking
tor-men-t	tor-ment
ex-plorato-ry	ex-plor-a-to-ry
geno-type	gen-o-type
squadron	squad-ron
di-atom-ic	di-a-tom-ic
pro-boscis	pro-bos-cis
piton	pi-ton
reprisal	re-pris-al
pineal	pin-e-al
rogu-ish	ro-guish
ram-p	ramp
vol-cano	vol-ca-no
dis-con-nec-t	dis-con-nect
frankly	frank-ly
con-veyanc-ing	con-vey-anc-ing
nifty	nif-ty
gantry	gan-try
poplar	pop-lar
rent-ed	rented
brunette	bru-nette
ar-rival	ar-ri-val
delu-sive	de-lu-sive
i-conog-ra-phy	i-co-nog-ra-phy
manes	ma-nes
galleon	gal-le-on
auburn	au-burn
tele-scop-ic	tel-e-scop-ic
gateau	ga-teau
s-light-ly	slight-ly
awake	a-wake
geo-phys-i-cal	ge-o-phys-i-cal
geo-sta-tion-ary	ge-o-sta-tion-ar-y
ge-nial-i-ty	ge-ni-al-i-ty
de-ni-able	de-ni-a-ble
doc-u-men-t	doc-u-ment
s-hear	shear
who-dunit	who-dun-it
newsprint	news-print
wat-t	watt
s-lant-ed	slanted
re-minder	re-mind-er
tur-bocharged	turbocharged
em-bossed	embossed
va-pid	vap-id
u-nasked	un-asked
fein-t	feint
ashamed	a-shamed
con-sign-men-t	con-sign-ment
naugh-t	naught
pho-to-chem-istry	pho-to-chem-is-try
ir-re-mov-able	ir-re-mov-a-ble
in-abil-i-ty	in-a-bil-i-ty
un-fet-tered	unfettered
nyala	nya-la
un-prof-itable	un-prof-it-a-ble
hide-away	hide-a-way
pre-dictably	pre-dict-a-bly
apol-o-gize	a-pol-o-gize
cabaret	cab-a-ret
penul-ti-mate	pe-nul-ti-mate
in-choate	in-cho-ate
resur-gen-t	re-sur-gent
in-con-gruity	in-con-gru-i-ty
arc-ing	arcing
s-tore-keep-er	store-keep-er
un-rea-son-ably	un-rea-son-a-bly
un-san-i-tary	un-san-i-tar-y
dauber	daub-er
s-lat	slat
s-played	splayed
dentin	den-tin
s-tork	stork
s-lur-p	slurp
sub-ur-ban-i-sa-tion	su-bur-ba-ni-sa-tion
epi-graph	ep-i-graph
poly-he-dron	pol-y-he-dron
pas-toral	pas-to-ral
par-enter-al	par-en-ter-al
un-re-pen-tan-t	un-re-pent-ant
d-if-fi-cult	dif-fi-cult
pollen	pol-len
lu-bri-can-t	lu-bri-cant
metonymy	me-ton-y-my
s-low-down	slow-down
tonal	ton-al
n-ev-er	nev-er
s-plen-did	splen-did
voca-tive	voc-a-tive
lol-lipop	lol-li-pop
tulip	tu-lip
id-iomat-ic	id-i-o-mat-ic
pauci-ty	pau-ci-ty
con-ceiv-able	con-ceiv-a-ble
vendet-ta	ven-det-ta
over-draw	o-ver-draw
wormy	worm-y
ple-nary	ple-na-ry
diplo-ma	di-plo-ma
iso-stat-ic	i-so-stat-ic
su-per-abun-dan-t	su-per-a-bun-dant
creaky	creak-y
trade-marked	trademarked
telex	tel-ex
s-laugh-ter	slaugh-ter
taxi-dermy	tax-i-der-my
damna-tion	dam-na-tion
e-s-py	es-py
in-valid	in-va-lid
scrip-t	script
op-eretta	op-er-et-ta
crazy	cra-zy
r-eread	re-read
layper-son	lay-per-son
necrop-o-lis	ne-crop-o-lis
s-niv-el	sniv-el
de-pres-san-t	de-pres-sant
ema-ci-at-ed	e-ma-ci-at-ed
s-tiff	stiff
col-le-gial	col-le-gi-al
gneis-s	gneiss
ru-ined	ruined
midair	mid-air
su-per-posed	superposed
basil	bas-il
re-cessed	recessed
jazzy	jazz-y
imag-in-ings	im-ag-in-ings
mis-judg-men-t	mis-judg-ment
p-tarmi-gan	ptar-mi-gan
sub-terfuge	sub-ter-fuge
m-is-fit	mis-fit
o-cean-ic	o-ce-an-ic
en-tomb-men-t	en-tomb-ment
ease-men-t	ease-ment
aplom-b	a-plomb
im-ple-menter	im-ple-ment-er
con-sor-tium	con-sor-ti-um
asymp-to-matic	a-symp-to-mat-ic
phonon	pho-non
arthro-pod	ar-thro-pod
pro-le-tari-at	pro-le-tar-i-at
stymie	sty-mie
ev-ery-where	eve-ry-where
ig-nominy	ig-no-min-y
un-wrap-s	un-wraps
sec-toral	sec-tor-al
ge-neal-o-gy	ge-ne-al-o-gy
coro-ner	cor-o-ner
sur-viv-abil-i-ty	sur-viv-a-bil-i-ty
ra-dionu-clide	ra-di-o-nu-clide
in-fect-ed	in-fec-ted
pim-p	pimp
castel-lat-ed	cas-tel-lat-ed
ide-o-log-i-cal-ly	i-de-o-log-i-cal-ly
in-fan-t	in-fant
s-trat-e-gy	strat-e-gy
physic	phys-ic
pream-pli-fi-er	pre-am-pli-fi-er
s-mog	smog
busy	bus-y
em-ployed	employed
lurid	lu-rid
monas-tic	mo-nas-tic
s-port-ing-ly	sport-ing-ly
over-turn	o-ver-turn
u-n-ad-dressed	un-ad-dressed
tun-able	tun-a-ble
re-s-e-lec-t	re-se-lect
base-bal-l	base-ball
telekine-sis	tel-e-ki-ne-sis
colan-der	col-an-der
un-fath-ome-d	un-fath-omed
con-denser	con-dens-er
washout	wash-out
pesti-lence	pes-ti-lence
com-mand-men-t	com-mand-ment
s-caly	scal-y
worka-day	work-a-day
anony-mous-ly	a-non-y-mous-ly
ear-l	earl
con-tention	con-ten-tion
hero-ine	her-o-ine
book-binder	book-bind-er
di-a-bolis-m	di-ab-o-lism
coitus	co-i-tus
reti-na	ret-i-na
dis-cor-dance	dis-cord-ance
artistry	art-ist-ry
tourni-quet	tour-ni-quet
fron-tispiece	fron-tis-piece
bil-iary	bil-i-ar-y
ap-pendage	ap-pend-age
d-if-fer-en-tial-ly	dif-fer-en-tial-ly
overkil-l	o-ver-kill
hotspot	hot-spot
cretin	cre-tin
cough-ing	coughing
por-ten-t	por-tent
porcine	por-cine
jean-s	jeans
s-cald	scald
moun-t	mount
com-bat-an-t	com-bat-ant
pitiable	pit-i-a-ble
chem-istry	chem-is-try
dick-en-s	dick-ens
af-ter-ward-s	af-ter-wards
cool-ing	cooling
hye-na	hy-e-na
sleepi-ness	sleep-i-ness
the-atri-cal	the-at-ri-cal
b-less	bless
ir-refutable	ir-ref-u-ta-ble
tran-scrip-t	tran-script
lessen	less-en
s-ta-di-um	sta-di-um
in-ter-roga-tor	in-ter-ro-ga-tor
archival	ar-chi-val
o-vary	o-va-ry
exother-mic	ex-o-ther-mic
meta-mor-phis-m	met-a-mor-phism
un-be-liev-able	un-be-liev-a-ble
un-der-stand-able	un-der-stand-a-ble
plen-teous	plen-te-ous
carmine	car-mine
minibus	min-i-bus
in-cisor	in-ci-sor
duo-logue	du-o-logue
sedi-tion	se-di-tion
over-do	o-ver-do
eeri-ly	ee-ri-ly
man-darin	man-da-rin
e-clec-tic	ec-lec-tic
un-sol-d	un-sold
s-pas-m	spasm
s-cabbed	scabbed
desider-a-tum	de-sid-er-a-tum
piti-less	pit-i-less
an-tic-s	an-tics
s-cant-y	scant-y
u-n-aligned	un-a-ligned
tripoli	trip-o-li
in-duce-men-t	in-duce-ment
biorhyth-m	bi-o-rhythm
gassy	gas-sy
rec-ol-lec-t	rec-ol-lect
for-warder	for-ward-er
us-abil-i-ty	us-a-bil-i-ty
geno-ci-dal	gen-o-cid-al
lin-t	lint
cur-tained	curtained
ig-no-ran-t	ig-no-rant
corp-s	corps
in-suf-fer-able	in-suf-fer-a-ble
lep-rechaun	lep-re-chaun
chaot-ic	cha-ot-ic
dis-tric-t	dis-trict
cater-pil-lar	cat-er-pil-lar
sul-tana	sul-tan-a
ra-dioac-tiv-i-ty	ra-di-o-ac-tiv-i-ty
duck-bil-l	duck-bill
cus-tom-ary	cus-tom-ar-y
restora-tion	res-to-ra-tion
ele-phan-tine	el-e-phan-tine
relic-t	rel-ict
wag-gery	wag-ger-y
lack-adaisi-cal	lack-a-dai-si-cal
wafer	wa-fer
e-u-pho-ni-um	eu-pho-ni-um
archdea-con	arch-dea-con
de-lim-it-ed	delimited
chimera	chi-me-ra
s-tove	stove
mandible	man-di-ble
feu-dal-is-m	feu-dal-ism
wash-able	wash-a-ble
in-sou-ciance	in-sou-ci-ance
s-mart	smart
glassy	glass-y
rem-nan-t	rem-nant
run-away	run-a-way
fa-ther-ing	fathering
tain-t	taint
e-quable	eq-ua-ble
valiant-ly	val-iant-ly
z-inc	zinc
benev-o-lence	be-nev-o-lence
predilec-tion	pre-di-lec-tion
b-land-ness	bland-ness
boatswain	boat-swain
sub-servience	sub-ser-vi-ence
en-tourage	en-tou-rage
san-i-tary	san-i-tar-y
elec-tri-fy	e-lec-tri-fy
hit-table	hit-ta-ble
cor-ti-cos-teroid	cor-ti-co-ster-oid
syco-phancy	syc-o-phan-cy
skintight	skin-tight
rack-e-teer-ing	rack-et-eer-ing
s-pan-ner	span-ner
undi-gest-ed	un-di-gest-ed
retic-u-lat-ed	re-tic-u-lat-ed
re-fin-ery	re-fin-er-y
s-lot	slot
s-tam-mer	stam-mer
pen-sion-able	pen-sion-a-ble
re-luc-tan-t	re-luc-tant
trib-al-is-m	trib-al-ism
con-tender	con-tend-er
causal	caus-al
in-flat-able	in-flat-a-ble
jour-nalese	jour-nal-ese
com-pelling-ly	com-pel-ling-ly
s-porran	spor-ran
necrop-sy	nec-rop-sy
gen-er-a-tional	gen-er-a-tion-al
as-sess-men-t	as-sess-ment
hideous-ly	hid-e-ous-ly
wreck-ing	wrecking
over-dose	o-ver-dose
partheno-gen-e-sis	par-the-no-gen-e-sis
legal-ly	le-gal-ly
col-lapsi-ble	col-laps-i-ble
com-pli-men-t	com-pli-ment
ra-dio	ra-di-o
omis-sion	o-mis-sion
an-titrust	an-ti-trust
dy-namo	dy-na-mo
s-nug-ly	snug-ly
raillery	rail-ler-y
un-pre-dictable	un-pre-dict-a-ble
prophet	proph-et
furtive-ly	fur-tive-ly
tapi-o-ca	tap-i-o-ca
linoleum	li-no-le-um
pro-ges-terone	pro-ges-ter-one
re-buf-f	re-buff
high-lighter	high-ligh-ter
rem-i-nis-cen-t	rem-i-nis-cent
re-place-men-t	re-place-ment
ath-leti-cis-m	ath-let-i-cism
barter	bar-ter
over-al-l	o-ver-all
some-body	some-bod-y
man-nequin	man-ne-quin
quest-ing	questing
vol-canic	vol-can-ic
vil-lainy	vil-lain-y
evil	e-vil
trea-sonous	trea-son-ous
biodegrad-able	bi-o-de-grad-a-ble
zaire	za-ire
surfer	surf-er
mar-ke-teer	mar-ket-eer
s-loth	sloth
c-etacean	ce-ta-cean
s-e-lec-tiv-i-ty	se-lec-tiv-i-ty
de-flec-t	de-flect
capri-ole	cap-ri-ole
un-al-ter-able	un-al-ter-a-ble
windy	wind-y
bazaar	ba-zaar
epi-der-mis	ep-i-der-mis
wolfish	wolf-ish
un-prov-able	un-prov-a-ble
t-wofaced	two-faced
drainage	drain-age
leisured	lei-sured
stenog-ra-pher	ste-nog-ra-pher
table-land	ta-ble-land
un-bear-able	un-bear-a-ble
mac-a-roni	mac-a-ro-ni
trace-abil-i-ty	trace-a-bil-i-ty
the-is-m	the-ism
harem	har-em
hon-orif-ic	hon-or-if-ic
di-ary	di-a-ry
rein-te-gra-tion	re-in-te-gra-tion
achieve-men-t	a-chieve-ment
s-cam-p	scamp
sewing	sew-ing
tremu-lous	trem-u-lous
cousin	cous-in
dis-con-ti-nu-ity	dis-con-ti-nu-i-ty
pe-riphrastic	per-i-phras-tic
mis-cel-lany	mis-cel-la-ny
mul-l	mull
sher-if-f	sher-iff
dim-pled	dimpled
base-men-t	base-ment
claiman-t	claim-ant
weary-ing	wea-ry-ing
o-r-a-tor-i-cal	or-a-tor-i-cal
un-drink-able	un-drink-a-ble
prebend	preb-end
quaf-f	quaff
masochist	mas-och-ist
over-lay	o-ver-lay
askew	a-skew
c-on-cil-iar	con-cil-i-ar
s-pan-gled	spangled
anger	an-ger
s-tooge	stooge
caliph	ca-liph
de-pen-den-cy	de-pend-en-cy
sen-ti-men-t	sen-ti-ment
talon	tal-on
nega-tion	ne-ga-tion
geo-cen-tric	ge-o-cen-tric
pover-ty	pov-er-ty
read-mis-sion	re-ad-mis-sion
testy	tes-ty
morsel	mor-sel
tribu-la-tion	trib-u-la-tion
medal-lion	me-dal-lion
cross-road-s	cross-roads
bloomer	bloom-er
un-break-able	un-break-a-ble
un-cre-ative	un-cre-a-tive
dele-te-ri-ous	del-e-te-ri-ous
won-t	wont
reap-pear-ance	re-ap-pear-ance
d-if-fus-er	dif-fus-er
eye-d	eyed
mankind	man-kind
mat-te	matte
wiper	wip-er
debu-tan-t	deb-u-tant
physi-cian	phy-si-cian
valid	val-id
edgy	edg-y
litho-graph-ic	lith-o-graph-ic
bac-carat	bac-ca-rat
trol-l	troll
over-in-flat-ed	o-ver-in-flat-ed
s-to-ical	sto-i-cal
den-tistry	den-tis-try
l-it-i-gan-t	lit-i-gant
suit-ably	suit-a-bly
seashore	sea-shore
as-cen-dan-cy	as-cend-an-cy
ji-u-jit-su	jiu-jit-su
hyp-nother-a-py	hyp-no-ther-a-py
pupil	pu-pil
hul-la-baloo	hul-la-ba-loo
radix	ra-dix
reser-voir	res-er-voir
drinker	drink-er
ca-cao	ca-ca-o
u-nattrac-tive	un-at-trac-tive
di-aphanous	di-aph-a-nous
redo-len-t	red-o-lent
sym-po-sium	sym-po-si-um
en-forcer	en-forc-er
s-teel-work-er	steel-work-er
stager	stag-er
s-to-ry-telling	sto-ry-tell-ing
mon-e-taris-m	mon-e-ta-rism
silt-ing	silting
or-ga-ni-za-tion	or-gan-i-za-tion
rigid-i-ty	ri-gid-i-ty
dredger	dredg-er
hooli-gan	hoo-li-gan
en-hance-men-t	en-hance-ment
ac-t	act
hy-dran-t	hy-drant
duo-de-num	du-o-de-num
re-assem-ble	re-as-sem-ble
earshot	ear-shot
ide-al-ist	i-de-al-ist
bluish	blu-ish
gul-l	gull
dic-tio-nary	dic-tion-ar-y
ban-ter-ing	bantering
fire-bal-l	fire-ball
pantry	pan-try
shim-mer-ing	shimmering
s-tratig-ra-phy	stra-tig-ra-phy
sedan	se-dan
tril-l	trill
ure-a	u-re-a
plan-e-tary	plan-e-tar-y
s-train	strain
tick-et-ed	ticketed
monastery	mon-as-ter-y
u-p-land	up-land
wether	weth-er
macro	mac-ro
gaiter	gait-er
panache	pa-nache
bio-chemist	bi-o-chem-ist
herbal-ist	herb-al-ist
unabridged	un-a-bridged
bunkum	bun-kum
s-plit-ter	split-ter
geni-i	ge-ni-i
unre-deemed	un-re-deemed
dis-agree-able	dis-a-gree-a-ble
in-ter-de-pen-den-t	in-ter-de-pend-ent
nasty	nas-ty
haulage	haul-age
lodger	lodg-er
iso-la-tion-ist	i-so-la-tion-ist
s-cal-lop	scal-lop
zoo-plank-ton	zo-o-plank-ton
epit-o-me	e-pit-o-me
quadrupole	quad-ru-pole
sub-species	sub-spe-cies
silky	silk-y
degra-da-tion	deg-ra-da-tion
at-mo-spher-ic-s	at-mos-pher-ics
unchris-tian	un-chris-tian
reval-ue	re-val-ue
het-ero-sex-u-al-i-ty	het-er-o-sex-u-al-i-ty
mover	mov-er
mag-nif-i-cen-t	mag-nif-i-cent
steadi-ness	stead-i-ness
re-fur-bish-men-t	re-fur-bish-ment
des-tiny	des-ti-ny
oblige	o-blige
mod-e	mode
crin-kled	crinkled
copy-writ-er	cop-y-writ-er
guinea	guin-ea
poly-cyclic	pol-y-cy-clic
corkscrew	cork-screw
chancy	chanc-y
epi-ge-net-ic	ep-i-ge-net-ic
retic-u-lum	re-tic-u-lum
u-n-aware	un-a-ware
un-miss-able	un-miss-a-ble
cor-re-spon-dence	cor-re-spond-ence
em-bez-zle-men-t	em-bez-zle-ment
vis-ual	vis-u-al
s-lay-er	slay-er
cir-cum-ven-t	cir-cum-vent
punc-til-ious	punc-til-i-ous
sacral	sa-cral
aright	a-right
y-ou	you
in-com-bustible	in-com-bus-ti-ble
scholas-ti-cis-m	scho-las-ti-cism
re-align	re-a-lign
char-i-o-teer	char-i-ot-eer
stron-groom	strong-room
s-cam	scam
in-di-can-t	in-di-cant
in-quisi-tor	in-quis-i-tor
poi-sonous	poi-son-ous
en-v-i-ron	en-vi-ron
fusil-lade	fu-sil-lade
short-s	shorts
vex-ing	vexing
mo-men-tary	mo-men-tar-y
re-de-vel-op-men-t	re-de-vel-op-ment
tiler	til-er
lacteal	lac-te-al
barom-e-ter	ba-rom-e-ter
lin-guis-tic-s	lin-guis-tics
li-bidi-nous	li-bid-i-nous
s-lash-er	slash-er
rea-son-able	rea-son-a-ble
s-tar-ling	star-ling
peren-ni-al-ly	per-en-ni-al-ly
dosage	dos-age
es-capis-m	es-cap-ism
s-tormy	storm-y
res-cuer	res-cu-er
fil-ial	fil-i-al
genoa	gen-o-a
pushy	push-y
s-tim-u-lat-ing	stim-u-lat-ing
frailty	frail-ty
over-pro-duced	overproduced
ban-dage	band-age
fleecy	fleec-y
gad-getry	gadg-et-ry
satire	sat-ire
nir-vana	nir-va-na
kalei-do-scope	ka-lei-do-scope
nineti-eth	nine-ti-eth
willpow-er	will-pow-er
privy	priv-y
gavial	ga-vi-al
re-cidi-vist	re-cid-i-vist
mossy	mos-sy
ema-ci-a-tion	e-ma-ci-a-tion
rob-bery	rob-ber-y
stripling	strip-ling
unedit-ed	un-ed-it-ed
climber	climb-er
rein-sur-ance	re-in-sur-ance
u-n-am-bigu-ous	un-am-big-u-ous
cursed	curs-ed
teach-able	teach-a-ble
whizkid-s	whizkids
brigade	bri-gade
poly-mor-phis-m	pol-y-mor-phism
velum	ve-lum
backgam-mon	back-gam-mon
pi-anis-si-mo	pi-a-nis-si-mo
t-wo	two
s-nowflake	snow-flake
bowl-s	bowls
cor-re-spon-den-t	cor-re-spond-ent
reroutes	re-routes
recog-ni-tion	rec-og-ni-tion
s-capu-la	scap-u-la
thirsty	thirst-y
brevi-ty	brev-i-ty
nud-is-t	nud-ist
horo-scope	hor-o-scope
u-nat-tend-ed	un-at-tend-ed
gofer	go-fer
thrilling	thrill-ing
seedy	seed-y
un-sellable	un-sell-a-ble
co-pro-ces-sor	co-proc-es-sor
sym-bio-sis	sym-bi-o-sis
semi-con-duct-ing	sem-i-con-duct-ing
pro-tec-torate	pro-tec-tor-ate
d-if-fer-ent-ly	dif-fer-ent-ly
ori-en-tal	o-ri-en-tal
encage	en-cage
di-a-conal	di-ac-o-nal
un-nerv-ing	unnerving
bat-s	bats
prefer-ably	pref-er-a-bly
precinc-t	pre-cinct
litho-graph	lith-o-graph
liquor-ish	liq-uor-ish
con-ic-s	con-ics
over-am-bi-tious	o-ver-am-bi-tious
mendele-vi-um	men-de-le-vi-um
un-der-gar-men-t	un-der-gar-ment
share-able	share-a-ble
potash	pot-ash
wimpy	wimp-y
un-par-don-able	un-par-don-a-ble
dor-man-t	dor-mant
op-ti-mistic	op-ti-mis-tic
eye-bal-l	eye-ball
body	bod-y
elec-tro-cu-tion	e-lec-tro-cu-tion
s-in-u-ous	sin-u-ous
ap-pa-ra-tus	ap-pa-rat-us
sado-masochis-tic	sa-do-mas-o-chis-tic
tele-tex-t	tel-e-text
re-tain-ing	retaining
s-lap-dash	slap-dash
u-nimag-in-able	un-im-ag-i-na-ble
bassist	bass-ist
aris-toc-ra-cy	ar-is-toc-ra-cy
e-co-log-i-cal-ly	ec-o-log-i-cal-ly
obei-sance	o-bei-sance
balder-dash	bal-der-dash
canon-ic	ca-non-ic
dowry	dow-ry
spooky	spook-y
over-step	o-ver-step
milliner	mil-li-ner
geopo-lit-i-cal	ge-o-po-lit-i-cal
pros-e	prose
heartache	heart-ache
i-n-ad-mis-si-ble	in-ad-mis-si-ble
epi-cure	ep-i-cure
mus-ke-teer	mus-ket-eer
su-per-in-ten-dence	su-per-in-tend-ence
u-n-ac-cept-ably	un-ac-cept-a-bly
re-gret-table	re-gret-ta-ble
eerie	ee-rie
tem-per-a-men-t	tem-per-a-ment
caseload	case-load
repli-ca-ble	rep-li-ca-ble
di-gester	di-gest-er
sui-ci-dal	su-i-cid-al
posy	po-sy
s-nap	snap
land-for-m	land-form
briefly	brief-ly
en-chan-t	en-chant
killing	kill-ing
squeegee	squee-gee
con-flic-t	con-flict
s-cent-ed	scent-ed
ion	i-on
founder	found-er
pom-p	pomp
dis-abling	disabling
s-mash	smash
uterus	u-ter-us
macron	ma-cron
pold-er	pol-der
lilac	li-lac
mer-chantable	mer-chant-a-ble
s-mut	smut
cagoule	ca-goule
frip-pery	frip-per-y
delir-i-um	de-lir-i-um
u-nim-peach-able	un-im-peach-a-ble
sug-gestible	sug-gest-i-ble
s-pas-tic	spas-tic
jin-go-is-m	jin-go-ism
man-age-ri-al	man-a-ge-ri-al
premise	prem-ise
whif-f	whiff
parox-ys-m	par-ox-ysm
melody	mel-o-dy
un-demon-stra-tive	un-de-mon-stra-tive
mea-sure-less	meas-ure-less
s-culp-tress	sculp-tress
func-tionary	func-tion-ar-y
con-flict-ed	conflicted
s-trange-ly	strange-ly
di-etet-ic	di-e-tet-ic
book-stal-l	book-stall
de-cayed	decayed
decile	dec-ile
Words with errors: 2254
Words with incorrect number of syllables: 2054
Total evluated: 6500
Perfect accuracy: 0.65
Number of syllables accuracy: 0.68
Average Levenshtein Distance(across incorrect words): 1.22
