Attempt	Real
s-tiff-en	stiff-en
sub-con-ti-nen-t	sub-con-ti-nent
u-n-apolo-get-ic	un-a-pol-o-get-ic
mono-lith-ic	mon-o-lith-ic
wag-gery	wag-ger-y
psy-chother-a-py	psy-cho-ther-a-py
pas-toral	pas-to-ral
u-nar-guable	un-ar-gu-a-ble
com-man-der	com-mand-er
sa-tanis-m	sa-tan-ism
melee	me-lee
islet	is-let
re-com-bi-nan-t	re-com-bi-nant
out-sel-l	out-sell
chamomile	cham-o-mile
mag-nif-i-cen-t	mag-nif-i-cent
un-con-scionable	un-con-scion-a-ble
prospec-tive	pro-spec-tive
skul-l	skull
aven-s	av-ens
a-p-a-thet-ic	ap-a-thet-ic
quintessen-tial-ly	quin-tes-sen-tial-ly
choline	cho-line
s-tar-tling-ly	star-tling-ly
metempsy-chosis	me-tem-psy-cho-sis
monomolec-u-lar	mon-o-mo-lec-u-lar
mope-d	mo-ped
delic-t	de-lict
wel-com-ing	wel-co-ming
far-away	far-a-way
medi-ocre	me-di-o-cre
s-ca-lene	sca-lene
necrop-o-lis	ne-crop-o-lis
schema	sche-ma
dis-pens-able	dis-pen-sa-ble
gloat-ing	gloating
pro-gram-mable	pro-gram-ma-ble
in-scrutable	in-scru-ta-ble
over-shoot	o-ver-shoot
squally	squal-ly
delin-quen-cy	de-lin-quen-cy
recre-ation-al	rec-re-a-tion-al
s-light	slight
ini-ti-ate	in-i-ti-ate
geno-cide	gen-o-cide
rub-bishy	rub-bish-y
s-cat-ter	scat-ter
in-cor-rec-t	in-cor-rect
g-nom-ic	gno-mic
s-port-ing	sport-ing
bi-modal	bi-mod-al
racis-m	rac-ism
poly-tech-nic	pol-y-tech-nic
in-valid	in-va-lid
cu-rare	cu-ra-re
beau-teous	beau-te-ous
machi-na-tion	mach-i-na-tion
epis-te-mo-log-i-cal	e-pis-te-mo-log-i-cal
bluesy	blues-y
s-log	slog
spokes-woman	spokes-wom-an
cy-tochrome	cy-to-chrome
fuz-z	fuzz
foot-balling	foot-ball-ing
flow-ery	flow-er-y
rel-a-tivis-tic	rel-a-tiv-is-tic
monothe-is-m	mon-o-the-ism
c-on-cil-ia-tor	con-cil-i-a-tor
re-seller	re-sell-er
goa-tee	goat-ee
im-pro-pri-ety	im-pro-pri-e-ty
op-po-nen-t	op-po-nent
sky-scraper	sky-scrap-er
s-trato-spher-ic	strat-o-spher-ic
sen-ti-men-tal-is-m	sen-ti-men-tal-ism
com-man-dan-t	com-man-dant
clif-f	cliff
com-mence-men-t	com-mence-ment
monochro-mat-ic	mon-o-chro-mat-ic
novice	nov-ice
sav-agery	sav-age-ry
pu-tres-cen-t	pu-tres-cent
fetishis-m	fet-ish-ism
nour-ish-men-t	nour-ish-ment
s-ketch	sketch
polypep-tide	pol-y-pep-tide
a-tol-l	at-oll
panache	pa-nache
mid-wifer-y	mid-wife-ry
roughage	rough-age
s-pan-ner	span-ner
u-p-lift-ed	uplifted
tablet	tab-let
romper	romp-er
in-ter-preter	in-ter-pret-er
ra-tio-nal	ra-tion-al
ingress	in-gress
pil-l	pill
syl-lo-gis-m	syl-lo-gism
ful-l	full
p-re-sen-ta-tion-al	pres-en-ta-tion-al
un-der-e-d-u-cat-ed	un-der-ed-u-cat-ed
trap-s	traps
y-ou	you
un-en-vi-able	un-en-vi-a-ble
paving	pav-ing
em-bolis-m	em-bo-lism
p-re-serve	pre-serve
un-en-durable	un-en-dur-a-ble
suc-cu-len-t	suc-cu-lent
cor-rup-t	cor-rupt
in-de-pen-dence	in-de-pend-ence
con-vert-ible	con-vert-i-ble
s-lo-gan	slo-gan
tremo-lo	trem-o-lo
fore-ar-m	fore-arm
u-niden-ti-fied	un-i-den-ti-fied
sus-tain-able	sus-tain-a-ble
con-tac-t	con-tact
semi-fi-nal	sem-i-fi-nal
catholic	cath-o-lic
eleventh	e-lev-enth
in-ter-op-er-abil-i-ty	in-ter-op-er-a-bil-i-ty
bom-bard-men-t	bom-bard-ment
s-mooth-ly	smooth-ly
frip-pery	frip-per-y
tetrox-ide	te-trox-ide
oph-thalmic	oph-thal-mic
quest-ing	questing
in-de-scrib-able	in-de-scrib-a-ble
rapi-er	ra-pi-er
duress	du-ress
black-ened	blackened
plenipo-ten-tiary	plen-i-po-ten-ti-ar-y
ethno-graph-ic	eth-no-graph-ic
un-suit-able	un-suit-a-ble
furtive	fur-tive
l-it-mus	lit-mus
blus-tery	blus-ter-y
oxy-moron	ox-y-mo-ron
no-tably	no-ta-bly
vagabond	vag-a-bond
opin-ion	o-pin-ion
su-per-scrip-t	su-per-script
lig-a-men-t	lig-a-ment
baby-ish	ba-by-ish
d-if-fer-en-ti-a-tion	dif-fer-en-ti-a-tion
eat-able	eat-a-ble
able	a-ble
gua-camole	gua-ca-mo-le
ini-tia-tor	in-i-ti-a-tor
es-pi-onage	es-pi-o-nage
gas-work-s	gas-works
dirty	dirt-y
fore-see-able	fore-see-a-ble
im-pass-able	im-pass-a-ble
flanker	flank-er
el-e-men-tary	el-e-men-ta-ry
dis-putable	dis-put-a-ble
shandy	shan-dy
daun-t	daunt
pesti-len-tial	pes-ti-len-tial
wa-ter-fron-t	wa-ter-front
de-viance	de-vi-ance
cele-b	ce-leb
throaty	throat-y
hoard-ed	hoarded
repa-tri-a-tion	re-pa-tri-a-tion
damni-fy	dam-ni-fy
tec-ton-ic-s	tec-ton-ics
syl-labus	syl-la-bus
clas-si-cis-m	clas-si-cism
pussy	pus-sy
re-li-able	re-li-a-ble
renum-ber	re-num-ber
tur-bocharg-er	tur-bo-charg-er
gherkin	gher-kin
s-carci-ty	scar-ci-ty
spir-i-tu-al-is-m	spir-it-u-al-ism
me-te-oric	me-te-or-ic
v-enue	ven-ue
eli-sion	e-li-sion
un-der-ar-m	un-der-arm
scrip-t	script
spi-ran-t	spi-rant
in-di-can-t	in-di-cant
fidu-cia-ry	fi-du-ci-ar-y
un-trans-lat-able	un-trans-lat-a-ble
sel-l	sell
dis-ori-ent-ed	disoriented
de-ni-able	de-ni-a-ble
e-ti-quette	et-i-quette
turquoise	tur-quoise
ir-ra-tional-i-ty	ir-ra-tion-al-i-ty
s-now-bal-l	snow-ball
vial	vi-al
trace-able	trace-a-ble
verisimil-i-tude	ver-i-si-mil-i-tude
con-trol-lable	con-trol-la-ble
miser-li-ness	mi-ser-li-ness
deco-rum	de-co-rum
gai-ety	gai-e-ty
kil-n	kiln
en-gage-men-t	en-gage-ment
hin-t	hint
in-ter-change-ably	in-ter-change-a-bly
in-vari-ant	in-var-i-ant
de-cam-p	de-camp
tropopause	trop-o-pause
hi-jack-ing	hi-jac-king
pen-tathlon	pen-tath-lon
murky	murk-y
re-cidi-vist	re-cid-i-vist
ir-re-press-ible	ir-re-press-i-ble
lessee	les-see
tetchy	tetch-y
apoth-e-o-sis	a-poth-e-o-sis
ex-trem-is-m	ex-trem-ism
over-whelm	o-ver-whelm
satin	sat-in
per-ineum	per-i-ne-um
despo-tism	des-pot-ism
pol-luter	pol-lut-er
verdi-gris	ver-di-gris
hazel	ha-zel
s-apling	sap-ling
sovereign-ty	sov-er-eign-ty
u-nau-dit-ed	un-au-dit-ed
pavil-ion	pa-vil-ion
piti-less	pit-i-less
un-nerv-ing	unnerving
front-ed	fronted
sloven-ly	slov-en-ly
as-p	asp
con-tin-gen-t	con-tin-gent
re-luc-tan-t	re-luc-tant
ar-c	arc
s-lum	slum
im-pri-matur	im-pri-ma-tur
poignant-ly	poign-ant-ly
jus-ti-fi-able	jus-ti-fi-a-ble
s-tark-ly	stark-ly
sitar	si-tar
weary-ing	wea-ry-ing
con-fine-men-t	con-fine-ment
crit-i-cis-m	crit-i-cism
s-can-sion	scan-sion
psy-chopathol-o-gy	psy-cho-pa-thol-o-gy
con-ser-va-tive	con-serv-a-tive
s-tra-tum	stra-tum
aquar-i-um	a-quar-i-um
plu-per-fec-t	plu-per-fect
vi-o-len-t	vi-o-lent
s-word	sword
vac-uole	vac-u-ole
ple-beian	ple-be-ian
warthog	wart-hog
nugget	nug-get
com-pan-ion-able	com-pan-ion-a-ble
detox-i-fy	de-tox-i-fy
foamy	foam-y
ple-nary	ple-na-ry
be-atif-ic	be-a-tif-ic
best-selling	best-sell-ing
retroac-tive	ret-ro-ac-tive
in-fras-truc-tural	in-fra-struc-tur-al
breathy	breath-y
mega	meg-a
dis-agree-men-t	dis-a-gree-ment
biop-sy	bi-op-sy
funky	funk-y
diploid	dip-loid
quater-nion	qua-ter-ni-on
s-tormer	storm-er
de-spon-den-cy	de-spond-en-cy
trea-son-able	trea-son-a-ble
com-paction	com-pac-tion
in-suf-fer-able	in-suf-fer-a-ble
apoplexy	ap-o-plex-y
markup	mark-up
he-li-copter	hel-i-cop-ter
fraud-u-len-t	fraud-u-lent
undy-ing	un-dy-ing
censer	cen-ser
repast	re-past
mo-torist	mo-tor-ist
deep-en-ing	deepening
pro-pa-gan-da	prop-a-gan-da
c-it-rus	cit-rus
springy	spring-y
epis-co-pa-cy	e-pis-co-pa-cy
s-linky	slink-y
playfel-low	play-fel-low
semi-fi-nal-ist	sem-i-fi-nal-ist
wrestler	wres-tler
coleslaw	cole-slaw
repro-bate	rep-ro-bate
satire	sat-ire
gam-bling	gam-bling
fetish	fet-ish
eggshel-l	egg-shell
willpow-er	will-pow-er
imag-i-nary	im-ag-i-nar-y
post-mortem	post-mor-tem
ca-cao	ca-ca-o
her-i-ta-ble	her-it-a-ble
gourmet	gour-met
en-vi-able	en-vi-a-ble
dosage	dos-age
prof-i-teer-ing	profiteering
un-com-fort-ably	un-com-fort-a-bly
en-doge-nous	en-dog-e-nous
bul-gy	bulg-y
zany	za-ny
d-u-al-i-ty	du-al-i-ty
shaven	shav-en
pur-port-ed	purported
curie	cu-rie
s-e-lec-tive	se-lec-tive
sub-servien-t	sub-ser-vi-ent
con-stab-u-lary	con-stab-u-lar-y
reis-sue	re-is-sue
math-e-mat-ic-s	math-e-mat-ics
umpteen	ump-teen
good-s	goods
ex-cus-able	ex-cus-a-ble
c-i-ta-tion	ci-ta-tion
s-lob-ber-ing	slobbering
mul-l	mull
mo-lesta-tion	mo-les-ta-tion
sur-vival	sur-viv-al
bracelet	brace-let
re-union	re-un-ion
wartime	war-time
poly-mor-phis-m	pol-y-mor-phism
cru-ci-for-m	cru-ci-form
ni-hilis-m	ni-hil-ism
reti-na	ret-i-na
im-mea-sur-ably	im-meas-ur-a-bly
heater	heat-er
ta-per-ing	ta-pe-ring
so-porif-ic	sop-o-rif-ic
peas-an-t	peas-ant
chal-lenger	chal-leng-er
geo-ther-mal	ge-o-ther-mal
rescale	re-scale
astray	a-stray
owlet	owl-et
eigen-func-tion	ei-gen-func-tion
di-ary	di-a-ry
lo-bot-omy	lo-bot-o-my
protest-ing	protesting
s-par-ing	spar-ing
u-n-al-loyed	un-al-loyed
suprema-cy	su-prem-a-cy
de-scend-ing	descending
rum-pled	rumpled
waxy	wax-y
surly	sur-ly
in-frared	in-fra-red
s-tair-way	stair-way
in-dif-fer-en-t	in-dif-fer-ent
desider-a-tum	de-sid-er-a-tum
up-hol-stery	up-hol-ster-y
dy-namo	dy-na-mo
m-is-fit	mis-fit
s-carce-ly	scarce-ly
dis-mis-s	dis-miss
pick-ax-e	pick-axe
nurs-ery-man	nurs-er-y-man
stric-t	strict
s-tar-ry	star-ry
marcher	march-er
stringy	string-y
u-nasked	un-asked
dis-rup-t	dis-rupt
my-opi-a	my-o-pi-a
hys-terec-to-my	hys-ter-ec-to-my
metaphor	met-a-phor
con-juror	con-ju-ror
hostler	hos-tler
elic-it	e-lic-it
poly-merase	pol-y-mer-ase
balder-dash	bal-der-dash
at-ten-dan-t	at-tend-ant
phono-graph	pho-no-graph
s-e-lectee	se-lect-ee
dis-so-nan-t	dis-so-nant
per-i	pe-ri
s-nowflake	snow-flake
c-ityscape	cit-y-scape
con-traindi-ca-tion	con-tra-in-di-ca-tion
whar-f	wharf
bribery	brib-er-y
e-quip-men-t	e-quip-ment
s-now-man	snow-man
bat-tle-men-t	bat-tle-ment
re-al-ness	real-ness
in-spec-t	in-spect
poly-the-is-tic	pol-y-the-is-tic
type-scrip-t	type-script
s-corched	scorched
liken	lik-en
bizarre	bi-zarre
vi-o-l	vi-ol
out-cal-l	out-call
tele-vise	tel-e-vise
midrif-f	mid-riff
rege-late	re-ge-late
un-frozen	un-fro-zen
manger	man-ger
s-e-lec-tor	se-lec-tor
piv-otal	piv-ot-al
retroac-tive-ly	ret-ro-ac-tive-ly
b-less	bless
ren-dered	rendered
meso-sphere	mes-o-sphere
con-sid-er-able	con-sid-er-a-ble
gener-ic	ge-ner-ic
ex-oge-nous	ex-og-e-nous
s-parse	sparse
blither-ing	blith-er-ing
briefer	brief-er
im-pris-on-men-t	im-pris-on-ment
hege-mo-ny	he-gem-o-ny
cast-away	cast-a-way
sophistry	soph-ist-ry
elec-trode	e-lec-trode
di-gestible	di-gest-i-ble
para-sol	par-a-sol
sym-po-sium	sym-po-si-um
fire-bom-b	fire-bomb
man-ager-ess	man-ag-er-ess
par-a-sitism	par-a-sit-ism
jaun-t	jaunt
s-lith-er	slith-er
hypochon-dri-a-cal	hy-po-chon-dri-a-cal
rem-nan-t	rem-nant
en-tropy	en-tro-py
quan-tifi-ca-tion	quan-ti-fi-ca-tion
wa-ter-work-s	wa-ter-works
weaver	weav-er
un-san-i-tary	un-san-i-tar-y
in-stal-l	in-stall
seal-ing	sealing
hand-bil-l	hand-bill
su-perbly	su-perb-ly
unre-deemed	un-re-deemed
wicked-ness	wick-ed-ness
crenel-la-tion-s	cren-el-la-tions
cheesy	chees-y
a-pos-tolic	ap-os-tol-ic
book-binder	book-bind-er
ar-gu-men-t	ar-gu-ment
podgy	podg-y
refugee	ref-u-gee
poly-phon-ic	pol-y-phon-ic
sala-cious	sa-la-cious
im-pu-den-t	im-pu-dent
de-bauch-ery	de-bauch-er-y
premis-es	prem-is-es
neonate	ne-o-nate
rif-f	riff
lazy	la-zy
epicy-cloid	ep-i-cy-cloid
transna-tion-al	trans-na-tion-al
s-taunch	staunch
telethon	tel-e-thon
where-about-s	where-a-bouts
im-pair-men-t	im-pair-ment
restora-tive	re-stor-a-tive
s-cabbed	scabbed
white-washed	whitewashed
s-cur-rilous	scur-ril-ous
tripoli	trip-o-li
necro-man-cy	nec-ro-man-cy
rock-ery	rock-er-y
hermeneu-tic	her-me-neu-tic
cor-pu-len-t	cor-pu-lent
re-sis-tan-t	re-sist-ant
eroti-cis-m	e-rot-i-cism
asym-met-ri-cal	a-sym-met-ri-cal
trans-ac-t	trans-act
elec-tion	e-lec-tion
id-i-olec-t	id-i-o-lect
seg-ment-ed	seg-men-ted
pro-ges-terone	pro-ges-ter-one
ined-i-ble	in-ed-i-ble
s-ludge	sludge
s-lip-way	slip-way
dis-coun-t	dis-count
ashen	ash-en
in-ho-mo-ge-neous	in-ho-mo-ge-ne-ous
erec-tile	e-rec-tile
lamen-t	la-ment
gelig-nite	gel-ig-nite
eye-d	eyed
over-pass	o-ver-pass
over-step	o-ver-step
techno-pho-bi-a	tech-no-pho-bia
obe-di-ent-ly	o-be-di-ent-ly
dis-in-vest-men-t	dis-in-vest-ment
o-nion	on-ion
ape-ri-od-ic	a-pe-ri-od-ic
en-treaty	en-treat-y
cryo-genic	cry-o-gen-ic
hos-pitable	hos-pi-ta-ble
phe-nomeno-log-i-cal	phe-nom-e-no-log-i-cal
frisky	frisk-y
over-am-bi-tious	o-ver-am-bi-tious
diplo-ma-cy	di-plo-ma-cy
caramel	car-a-mel
hero-ic	he-ro-ic
wan-t	want
s-cared	scared
lethal-ly	le-thal-ly
herbage	herb-age
as-cetic	as-cet-ic
louis	lou-is
ra-dionu-clide	ra-di-o-nu-clide
tal-l	tall
re-vo-ca-tion	rev-o-ca-tion
omega	o-me-ga
cir-cum-spec-t	cir-cum-spect
zealotry	zeal-ot-ry
u-nion-ist	un-ion-ist
con-tem-po-rary	con-tem-po-rar-y
dullard	dull-ard
en-gi-neered	engineered
over-e-mo-tion-al	o-ver-e-mo-tion-al
s-hears	shears
vel-veteen	vel-vet-een
duf-f	duff
con-ven-t	con-vent
buoy	bu-oy
in-flat-able	in-flat-a-ble
pen-i-ten-t	pen-i-tent
rein-ven-tion	re-in-ven-tion
car-rion	car-ri-on
em-bank-men-t	em-bank-ment
meta-mor-pho-sis	met-a-mor-pho-sis
discog-ra-phy	dis-cog-ra-phy
bazooka	ba-zoo-ka
d-e-fi-cien-cy	de-fi-cien-cy
plan-e-tary	plan-e-tar-y
bubon-ic	bu-bon-ic
sub-terfuge	sub-ter-fuge
colonist	col-o-nist
s-pank-ing	spank-ing
es-tab-lish-men-t	es-tab-lish-ment
inkling	ink-ling
suf-fi-cien-t	suf-fi-cient
ravi-o-li	ra-vi-o-li
u-n-aid-ed	un-aid-ed
s-low-down	slow-down
livid	liv-id
nineti-eth	nine-ti-eth
en-cycli-cal	en-cyc-li-cal
jam-b	jamb
bristly	bris-tly
melody	mel-o-dy
theoc-ra-cy	the-oc-ra-cy
over-due	o-ver-due
per-ish-able	per-ish-a-ble
za-p	zap
tun-able	tun-a-ble
squalor	squal-or
avoid	a-void
nadir	na-dir
lisp-ing	lis-ping
de-for-mi-ty	de-form-i-ty
wringer	wring-er
s-plice	splice
s-tub-by	stub-by
showy	show-y
re-liv-e	re-live
place-men-t	place-ment
sisal	si-sal
land-fal-l	land-fall
par-a-sitic	par-a-sit-ic
le-gal-is-m	le-gal-ism
perdi-tion	per-di-tion
neu-tral-is-m	neu-tral-ism
n-ode	node
pinafore	pin-a-fore
serol-o-gy	se-rol-o-gy
ide-o-log-i-cal-ly	i-de-o-log-i-cal-ly
deathbed	death-bed
s-ling-shot	sling-shot
mas-cara	mas-car-a
bak-ery	bak-er-y
melan-cho-li-a	mel-an-cho-li-a
decile	dec-ile
ex-plorato-ry	ex-plor-a-to-ry
un-print-able	un-print-a-ble
fri-ary	fri-ar-y
l-o-gis-tic-s	lo-gis-tics
layabout	lay-a-bout
i-n-escapably	in-es-cap-a-bly
k-nav-ish	knav-ish
s-nap-py	snap-py
dis-ap-point-men-t	dis-ap-point-ment
uri-nary	u-ri-nar-y
lava-to-ry	lav-a-to-ry
bion-ic	bi-on-ic
servi-tude	ser-vi-tude
oldie	old-ie
fly-over	fly-o-ver
mis-cel-lanea	mis-cel-la-ne-a
peremp-to-ry	per-emp-to-ry
degra-da-tion	deg-ra-da-tion
r-e-fit	re-fit
dumpy	dump-y
exe-un-t	ex-e-unt
re-mark-ably	re-mark-a-bly
frosty	frost-y
run-away	run-a-way
va-grancy	va-gran-cy
un-taugh-t	un-taught
pre-fec-t	pre-fect
overkil-l	o-ver-kill
in-stan-ta-neous	in-stan-ta-ne-ous
beanstalk-s	bean-stalks
place-bo	pla-ce-bo
gleam-ing	gleaming
t-wofold	two-fold
stopover	stop-o-ver
ar-senic	ar-se-nic
trick-ery	trick-er-y
e-clec-ti-cis-m	ec-lec-ti-cism
in-stan-ta-neous-ly	in-stan-ta-ne-ous-ly
in-nocu-ous	in-noc-u-ous
un-ob-serv-able	un-ob-serv-a-ble
show-ery	show-er-y
there-upon	there-up-on
driver-less	driv-er-less
manes	ma-nes
thril-l	thrill
chi-ropodis-t	chi-rop-o-dist
b-o-rate	bo-rate
com-men-t	com-ment
in-sipid	in-sip-id
ush-erette	ush-er-ette
out-ward-s	out-wards
l-itotes	li-to-tes
re-cov-ery	re-cov-er-y
drinker	drink-er
stron-tium	stron-ti-um
as-segai	as-se-gai
bio-chem-istry	bi-o-chem-is-try
bal-alai-ka	bal-a-lai-ka
in-spi-ra-tional	in-spi-ra-tion-al
grassy	grass-y
idio-syn-cratic	id-i-o-syn-crat-ic
triple	tri-ple
dis-en-fran-chise-men-t	dis-en-fran-chise-ment
lamb-swool	lambs-wool
en-dorse-men-t	en-dorse-ment
buf-foon-ery	buf-foon-er-y
con-for-m	con-form
an-swer-able	an-swer-a-ble
ex-pe-di-tionary	ex-pe-di-tion-ar-y
spon-tane-ity	spon-ta-ne-i-ty
e-lo-cu-tion	el-o-cu-tion
es-capis-m	es-cap-ism
b-room	broom
con-strict-ed	constricted
beefy	beef-y
man-dolin	man-do-lin
mor-tu-ary	mor-tu-ar-y
rhodo-den-dron	rho-do-den-dron
sor-cery	sor-cer-y
over-rate	o-ver-rate
i-n-ac-tion	in-ac-tion
cur-d	curd
s-now-stor-m	snow-storm
princess	prin-cess
meringue	me-ringue
es-cu-d-o	es-cu-do
pleat-ed	pleated
re-alpoli-tik	re-al-po-li-tik
polon-aise	pol-o-naise
viril-i-ty	vi-ril-i-ty
im-mi-nen-t	im-mi-nent
hooray	hoo-ray
s-tovepipe	stove-pipe
baron-age	bar-on-age
cough-ing	coughing
mys-ti-cis-m	mys-ti-cism
tril-l	trill
spinal	spi-nal
de-file-men-t	de-file-ment
s-tiff-en-ing	stiff-en-ing
ob-serv-able	ob-serv-a-ble
cradling	cra-dling
piti-ful-ly	pit-i-ful-ly
debonair	deb-o-nair
s-ce-nari-o	sce-nar-i-o
sex-tan-t	sex-tant
in-sa-tiable	in-sa-tia-ble
sales-woman	sales-wom-an
en-chant-ed	enchanted
hori-zon	ho-ri-zon
enig-ma	e-nig-ma
kosher	ko-sher
y-on	yon
dis-hon-esty	dis-hon-es-ty
deli	del-i
un-quan-tifi-able	un-quan-ti-fi-a-ble
rein-car-nate	re-in-car-nate
pe-riphrastic	per-i-phras-tic
greasy	greas-y
any	an-y
res-o-nan-t	res-o-nant
jugu-lar	jug-u-lar
eon	e-on
ev-i-den-t	ev-i-dent
awning	awn-ing
windswep-t	wind-swept
un-de-tectable	un-de-tect-a-ble
os-teopath	os-te-o-path
broadsword	broad-sword
quel-l	quell
s-tu-pen-dous	stu-pen-dous
erup-tion	e-rup-tion
vale-dic-tion	val-e-dic-tion
tenet	ten-et
con-join-t	con-joint
as-cen-dan-t	as-cend-ant
schoolmistress	school-mis-tress
s-nig-ger-ing	sniggering
con-sum-able	con-sum-a-ble
di-ver-sion-ary	di-ver-sion-ar-y
bur-r	burr
par-tici-ple	par-ti-ci-ple
o-r-a-tor-i-cal	or-a-tor-i-cal
sinewy	sin-ew-y
hasti-ly	hast-i-ly
sec-toral	sec-tor-al
mili-tia-man	mi-li-tia-man
o-vary	o-va-ry
over-haul	o-ver-haul
fi-deli-ty	fi-del-i-ty
apron	a-pron
n-erd	nerd
seedbed	seed-bed
fum-bling	fumbling
crim-p	crimp
i-a-tro-genic	i-at-ro-gen-ic
e-quable	eq-ua-ble
genoa	gen-o-a
s-tunt-man	stunt-man
risot-to	ri-sot-to
juicy	juic-y
ide-al-is-tic	i-de-al-is-tic
es-capist	es-cap-ist
in-ves-tiga-tive	in-ves-ti-ga-tive
s-par-row	spar-row
macabre	ma-ca-bre
h-es-i-tan-t	hes-i-tant
fig-men-t	fig-ment
mul-ti-me-ter	mul-tim-e-ter
con-vic-t	con-vict
punter	punt-er
smoky	smok-y
heifer	heif-er
s-lop-ing	slop-ing
baronet	bar-on-et
mer-chantable	mer-chant-a-ble
s-lum-ber	slum-ber
manome-ter	ma-nom-e-ter
cashew	cash-ew
pur-suan-t	pur-su-ant
meri-no	me-ri-no
colosto-my	co-los-to-my
com-modor-e	com-mo-dore
fetishis-tic	fet-ish-is-tic
u-nimag-in-able	un-im-ag-i-na-ble
elec-tri-cal	e-lec-tri-cal
ar-guably	ar-gu-a-bly
skim-p	skimp
seance	se-ance
megawat-t	meg-a-watt
patchy	patch-y
perky	perk-y
re-us-able	re-us-a-ble
el-e-gan-t	el-e-gant
sier-ra	si-er-ra
un-de-sir-able	un-de-sir-a-ble
april	a-pril
de-flec-t	de-flect
killing	kill-ing
s-lug	slug
reser-voir	res-er-voir
so-lace	sol-ace
sabra	sa-bra
rein-car-na-tion	re-in-car-na-tion
a-ban-don-men-t	a-ban-don-ment
trans-for-ma-tive	trans-form-a-tive
ref-er-en-t	ref-er-ent
un-pro-cessed	un-proc-essed
re-gret-table	re-gret-ta-ble
welder	weld-er
iono-sphere	i-on-o-sphere
c-it-ric	cit-ric
down-fal-l	down-fall
busker	busk-er
s-light-ing	slight-ing
spillage	spill-age
hec-tor-ing	hectoring
over-sight	o-ver-sight
shaman-ic	sha-man-ic
an-tifreeze	an-ti-freeze
syl-labub	syl-la-bub
suc-cinc-t	suc-cinct
phos-pho-r	phos-phor
foible	foi-ble
whiskey	whis-key
arch-dio-cese	arch-di-o-cese
s-link	slink
unso-cial	un-so-cial
stager	stag-er
e-lastin	e-las-tin
oa-sis	o-a-sis
debu-tante	deb-u-tante
retic-u-lum	re-tic-u-lum
forepaw	fore-paw
prepar-a-tive	pre-par-a-tive
inim-itable	in-im-i-ta-ble
im-por-tan-t	im-por-tant
un-prov-able	un-prov-a-ble
aware-ness	a-ware-ness
mighty	might-y
ar-bi-trari-ness	ar-bi-trar-i-ness
plan-t	plant
gazelle	ga-zelle
gloomy	gloom-y
sym-bol-is-m	sym-bol-ism
dais	da-is
pro-tease	pro-te-ase
undis-mayed	un-dis-mayed
boatswain	boat-swain
sub-ur-bia	sub-ur-bi-a
n-od-ule	nod-ule
s-trap	strap
trea-sur-er	treas-ur-er
nascen-t	nas-cent
sev-ered	severed
mod-ernism	mod-ern-ism
un-re-solv-able	un-re-solv-a-ble
s-tatu-to-ry	stat-u-to-ry
fora-men	fo-ra-men
rangy	rang-y
sim-plis-m	sim-plism
s-pear-head	spear-head
mirac-u-lous	mi-rac-u-lous
award	a-ward
pro-tea	pro-te-a
lawyer	law-yer
s-cotch	scotch
s-lack	slack
sub-servience	sub-ser-vi-ence
cesspit	cess-pit
floozy	floo-zy
un-charis-mat-ic	un-char-is-mat-ic
odor-ous	o-dor-ous
over	o-ver
c-it-rate	cit-rate
de-pres-san-t	de-pres-sant
delux-e	de-luxe
dis-re-spec-t	dis-re-spect
con-flu-en-t	con-flu-ent
marginal-ly	mar-gin-al-ly
ren-t	rent
g-lyph	glyph
teatime	tea-time
power-boat	pow-er-boat
dean-ery	dean-er-y
s-trat-i-fi-ca-tion	strat-i-fi-ca-tion
in-ter-plan-e-tary	in-ter-plan-e-tar-y
ini-ti-a-tion	in-i-ti-a-tion
a-gree-men-t	a-gree-ment
in-ex-press-ible	in-ex-press-i-ble
over-pro-duced	overproduced
con-stituen-t	con-stit-u-ent
d-win-dle	dwin-dle
con-coc-t	con-coct
api-an	a-pi-an
un-for-giv-able	un-for-giv-a-ble
paren-the-sis	pa-ren-the-sis
pig-ment-ed	pig-men-ted
isosce-les	i-sos-ce-les
quit-s	quits
velum	ve-lum
causal-ly	caus-al-ly
abuse	a-buse
no-ti-fi-able	no-ti-fi-a-ble
pream-pli-fi-er	pre-am-pli-fi-er
winger	wing-er
tri-umphan-t	tri-um-phant
de-jec-t	de-ject
cesspool	cess-pool
buz-z	buzz
skimpy	skimp-y
bre-viary	bre-vi-ar-y
preva-len-t	prev-a-lent
pan-golin	pan-go-lin
de-gauss-ing	degaussing
print-able	print-a-ble
lapel	la-pel
out-stretched	outstretched
deca-dence	dec-a-dence
for-man-t	for-mant
s-teeple-chase	stee-ple-chase
isother-mal	i-so-ther-mal
s-tam-p	stamp
wafer	wa-fer
read-abil-i-ty	read-a-bil-i-ty
as-pirin	as-pi-rin
ver-biage	ver-bi-age
s-lam	slam
hauli-er	haul-ier
notepad	note-pad
com-plain-ing	complaining
in-dis-tin-guish-able	in-dis-tin-guish-a-ble
b-lis-tered	blistered
clavi-chord	clav-i-chord
en-tomb-men-t	en-tomb-ment
epi-graph	ep-i-graph
bal-cony	bal-co-ny
gas-troin-testi-nal	gas-tro-in-tes-ti-nal
di-ana	di-an-a
spec-troscopy	spec-tros-co-py
iso-tope	i-so-tope
neo-prene	ne-o-prene
shilling	shil-ling
jin-go-is-m	jin-go-ism
culi-nary	cu-li-nar-y
filmic	film-ic
con-fec-tionery	con-fec-tion-er-y
gen-er-a-tional	gen-er-a-tion-al
u-nion	un-ion
an-techam-ber	an-te-cham-ber
re-assess	re-as-sess
ge-o-mag-net-i-cal-ly	ge-o-mag-ne-ti-cal-ly
re-place-men-t	re-place-ment
telling	tell-ing
cross-road-s	cross-roads
pe-cu-niary	pe-cu-ni-ar-y
s-train	strain
mar-tinet	mar-ti-net
wear-able	wear-a-ble
fa-tal-is-m	fa-tal-ism
ob-tain-able	ob-tain-a-ble
atyp-i-cal	a-typ-i-cal
humerus	hu-mer-us
ki-mono	ki-mo-no
d-u-al-is-tic	du-al-is-tic
con-sular	con-su-lar
re-dun-dan-t	re-dun-dant
fo-liage	fo-li-age
pigsty	pig-sty
s-low-ness	slow-ness
veni-son	ven-i-son
swar-m	swarm
dis-il-lu-sion-men-t	dis-il-lu-sion-ment
phy-loge-ny	phy-log-e-ny
com-mit-men-t	com-mit-ment
buf-f	buff
promi-nence	prom-i-nence
grouchy	grouch-y
penul-ti-mate	pe-nul-ti-mate
tan-gen-t	tan-gent
halon	hal-on
biotech-nol-o-gy	bi-o-tech-nol-o-gy
mus-cle-d	mus-cled
risky	risk-y
dy-nasty	dy-nas-ty
de-trac-t	de-tract
kil-l	kill
gu-nite	gun-ite
in-ci-den-t	in-ci-dent
in-de-pen-dent-ly	in-de-pend-ent-ly
arise	a-rise
decla-ma-tion	dec-la-ma-tion
re-de-vel-op-men-t	re-de-vel-op-ment
tri-tium	trit-i-um
debtor	debt-or
pelvis	pel-vis
so-ci-ety	so-ci-e-ty
halo-gen	hal-o-gen
de-tach-men-t	de-tach-ment
re-set-tle-men-t	re-set-tle-ment
whisker	whisk-er
gen-i-tali-a	gen-i-ta-li-a
antonym	an-to-nym
ex-pi-ra-to-ry	ex-pir-a-to-ry
t-in-gle	tin-gle
give-away	give-a-way
bailif-f	bail-iff
dis-parate	dis-pa-rate
s-cab	scab
leg-isla-tive	leg-is-la-tive
tute-lage	tu-te-lage
s-teel	steel
s-nub	snub
midair	mid-air
mar-ke-teer	mar-ket-eer
s-tock	stock
sur-re-al-is-m	sur-re-al-ism
preschool	pre-school
squeaky	squeak-y
clam-p-down	clamp-down
s-later	slat-er
im-prison	im-pris-on
macro	mac-ro
teenage	teen-age
raspy	rasp-y
knel-l	knell
p-salmody	psal-mo-dy
black-bal-l	black-ball
freely	free-ly
chrono-log-i-cal-ly	chron-o-log-i-cal-ly
block-buster	block-bust-er
aster-n	a-stern
bal-lis-tic-s	bal-lis-tics
anger	an-ger
me-nial	me-ni-al
be-whiskered	be-whisk-ered
in-flic-t	in-flict
rainy	rain-y
diskette	disk-ette
valiant-ly	val-iant-ly
askance	a-skance
up-fron-t	up-front
cor-moran-t	cor-mo-rant
s-trange	strange
toughie	tough-ie
prom-is-sory	prom-is-so-ry
in-de-ter-minable	in-de-ter-mi-na-ble
s-neer-ing	sneering
opi-ate	o-pi-ate
s-tu-dentship	stu-dent-ship
silky	silk-y
ion-ic	i-on-ic
herba-ceous	her-ba-ceous
so-cio-bi-ol-o-gy	so-ci-o-bi-ol-o-gy
i-n-ad-vis-able	in-ad-vis-a-ble
at-trib-ut-able	at-trib-ut-a-ble
reap-pear-ance	re-ap-pear-ance
co-her-en-t	co-her-ent
vam-p	vamp
arable	ar-a-ble
rooftop	roof-top
feath-ery	feath-er-y
axle	ax-le
ethic-s	eth-ics
video-taped	videotaped
eu-gen-ic-s	eu-gen-ics
colon-nade	col-on-nade
dil-l	dill
bodice	bod-ice
hel-l	hell
s-tat-uette	stat-u-ette
mag-ne-sium	mag-ne-si-um
valid-ly	val-id-ly
penin-su-la	pen-in-su-la
s-lan-der	slan-der
tum-bled	tumbled
meta-bol-ic	met-a-bol-ic
e-mer-ald	em-er-ald
quizzi-cal	quiz-zi-cal
u-n-ap-peal-ing	un-ap-peal-ing
aphid	a-phid
ashy	ash-y
itin-er-ary	i-tin-er-ar-y
wom-ankind	wom-an-kind
s-e-lec-tiv-i-ty	se-lec-tiv-i-ty
counter	coun-ter
salty	salt-y
chau-vin-is-m	chau-vin-ism
bases	ba-ses
callable	call-a-ble
car-cino-gen-e-sis	car-cin-o-gen-e-sis
fusil-lade	fu-sil-lade
melod-ic	me-lod-ic
s-cat-tered	scattered
glossy	gloss-y
pol-l	poll
in-san-i-tary	in-san-i-tar-y
s-neak-i-ly	sneak-i-ly
car-cino-genic	car-cin-o-gen-ic
o-culist	oc-u-list
d-if-fi-den-t	dif-fi-dent
pom-p	pomp
rein-ter-pre-ta-tion	re-in-ter-pre-ta-tion
in-ter-roga-tor	in-ter-ro-ga-tor
pre-pared-ness	pre-par-ed-ness
s-lime	slime
io-dine	i-o-dine
loft-ed	lofted
steve-dore	ste-ve-dore
salaried	sal-a-ried
grapeshot	grape-shot
n-im-bus	nim-bus
s-phyg-mo-manome-ter	sphyg-mo-ma-nom-e-ter
re-sis-tance	re-sist-ance
lazy-bones	la-zy-bones
s-cold-ing	scold-ing
con-sumer	con-sum-er
y-olk	yolk
shaman	sha-man
pedantry	ped-ant-ry
brazen	bra-zen
lit-er-ary	lit-er-ar-y
giro	gi-ro
chi-ropody	chi-rop-o-dy
s-mil-ing	smil-ing
neme-sis	nem-e-sis
lurid	lu-rid
damper	damp-er
im-preg-nable	im-preg-na-ble
ex-ult-ing	exulting
turn-about	turn-a-bout
legal-ly	le-gal-ly
dimwit	dim-wit
napoleon	na-po-le-on
re-strain-ing	restraining
edit-ed	edited
repli-ca	rep-li-ca
in-ter-lock-ing	in-ter-loc-king
s-pay	spay
u-til-i-tar-i-an-is-m	u-til-i-tar-i-an-ism
felo-nious	fe-lo-ni-ous
wardrobe	ward-robe
bad-minton	bad-min-ton
a-ca-dem-ic	ac-a-dem-ic
re-tire-men-t	re-tire-ment
warmer	warm-er
triage	tri-age
monog-a-mous	mo-nog-a-mous
col-lec-tivi-sa-tion	col-lec-ti-vi-sa-tion
s-tub-bly	stub-bly
in-ter-mit-ten-t	in-ter-mit-tent
mini-bar	min-i-bar
madri-gal	mad-ri-gal
ef-fron-tery	ef-fron-ter-y
or-ga-nized	or-gan-ized
spoilage	spoil-age
bib-lio-phile	bib-li-o-phile
flut-tery	flut-ter-y
lech-ery	lech-er-y
melan-choly	mel-an-chol-y
japon-i-ca	ja-pon-i-ca
blue-bel-l	blue-bell
bond-ing	bonding
hy-drangea	hy-dran-gea
undis-tin-guished	un-dis-tin-guished
gob-bledy-gook	gob-ble-dy-gook
in-dig-nan-t	in-dig-nant
in-dul-gen-t	in-dul-gent
ac-cen-t	ac-cent
s-tar-tling	star-tling
tour-na-men-t	tour-na-ment
cu-rios-i-ty	cu-ri-os-i-ty
schemer	schem-er
s-nug-gle	snug-gle
bur-geon-ing	burgeoning
ad-ver-tise-men-t	ad-ver-tise-ment
babysit-ter	ba-by-sit-ter
over-load-ed	overloaded
javelin	jave-lin
vinyl	vi-nyl
stag-ger-ing	staggering
cred-itable	cred-it-a-ble
in-cen-di-ary	in-cen-di-ar-y
restora-tion	res-to-ra-tion
chuf-f	chuff
fundrais-ing	fund-rais-ing
con-fronta-tion	con-fron-ta-tion
apol-o-gy	a-pol-o-gy
pave-men-t	pave-ment
suc-cum-b	suc-cumb
in-ter-jec-t	in-ter-ject
dumpling	dump-ling
dactylic	dac-tyl-ic
cham-p	champ
over-dra-mat-ic	o-ver-dra-mat-ic
barony	bar-o-ny
gumshoe	gum-shoe
monas-tic	mo-nas-tic
s-plen-did	splen-did
c-om-mend-ably	com-mend-a-bly
deriva-tion	der-i-va-tion
owlish	owl-ish
in-es-timable	in-es-ti-ma-ble
satel-lite	sat-el-lite
pa-ter-nal-is-m	pa-ter-nal-ism
moral	mor-al
hubris-tic	hu-bris-tic
jokey	jok-ey
breather	breath-er
re-ori-en-ta-tion	re-o-ri-en-ta-tion
un-rea-son-ably	un-rea-son-a-bly
ap-proach-ing	approaching
s-trate-gist	strat-e-gist
as-cen-t	as-cent
k-ilt	kilt
glitzy	glitz-y
mi-mosa	mi-mo-sa
gar-b	garb
om-ni-science	om-nis-cience
s-cum	scum
moun-tain-sid-e	moun-tain-side
fa-nati-cis-m	fa-nat-i-cism
dili-gent-ly	dil-i-gent-ly
lay-of-f	lay-off
pa-pri-ka	pap-ri-ka
the-o-reti-cian	the-o-re-ti-cian
but-t	butt
cer-tifi-cate	cer-tif-i-cate
fit-men-t	fit-ment
pec-toral	pec-to-ral
aper-i-tif	a-pe-ri-tif
na-tion-al-is-m	na-tion-al-ism
felon	fel-on
para-mount	par-a-mount
pyrite	py-rite
d-ab-ble	dab-ble
urchin	ur-chin
en-trench-men-t	en-trench-ment
pectin	pec-tin
elfin	elf-in
gaucherie	gau-che-rie
py-rotech-nic	py-ro-tech-nic
pun-gen-t	pun-gent
moorhen	moor-hen
shoring	shor-ing
here-about-s	here-a-bouts
s-pac-er	spac-er
crypt-anal-y-sis	crypt-a-nal-y-sis
un-linked	unlinked
painkiller	pain-kil-ler
bur-sary	bur-sa-ry
hauler	haul-er
retro-fit	ret-ro-fit
desul-to-ry	des-ul-to-ry
id-io-cy	id-i-o-cy
aun-t	aunt
u-n-am-bi-tious	un-am-bi-tious
laugh-able	laugh-a-ble
stipen-di-ary	sti-pen-di-ar-y
wran-gling	wrangling
al-ready	al-read-y
which-ever	which-ev-er
gui-tarist	gui-tar-ist
do-lerite	dol-er-ite
in-duce-men-t	in-duce-ment
un-der-de-vel-ope-d	un-der-de-vel-oped
as-cen-dan-cy	as-cend-an-cy
s-in-cere-ly	sin-cere-ly
any-one	an-y-one
con-ceiv-able	con-ceiv-a-ble
mon-e-taris-m	mon-e-ta-rism
en-crust-ed	encrusted
wa-ver-ing	wavering
fir-ma-men-t	fir-ma-ment
dis-en-chant-men-t	dis-en-chant-ment
s-peak	speak
lov-able	lov-a-ble
un-du-lat-ing	un-du-la-ting
iron-work-s	i-ron-works
an-tithe-sis	an-tith-e-sis
pur-suance	pur-su-ance
wa-terbed	wa-ter-bed
growl-ing	growling
dis-am-biguate	dis-am-big-u-ate
brava-do	bra-va-do
com-mis-sioned	commissioned
squeegee	squee-gee
char-m	charm
en-fran-chise-men-t	en-fran-chise-ment
en-treat-ing	entreating
tonal-i-ty	to-nal-i-ty
meta-lan-guage	met-a-lan-guage
paradig-mat-ic	par-a-dig-mat-ic
s-to-ry-book	sto-ry-book
be-lea-guered	beleaguered
un-ques-tion-able	un-ques-tion-a-ble
gavial	ga-vi-al
anony-mous	a-non-y-mous
s-e-lec-t	se-lect
rapid-ly	rap-id-ly
oper-a	o-pe-ra
any-way	an-y-way
s-cant	scant
ate-lier	at-el-ier
har-mo-nious	har-mo-ni-ous
p-ith	pith
s-ta-di-um	sta-di-um
playable	play-a-ble
con-gru-en-t	con-gru-ent
elec-trophore-sis	e-lec-tro-pho-re-sis
delir-i-um	de-lir-i-um
chasti-ty	chas-ti-ty
s-chem-ing	schem-ing
won-der-men-t	won-der-ment
semi-con-duct-ing	sem-i-con-duct-ing
book-stal-l	book-stall
pho-to-genic	pho-to-gen-ic
cur-tail-men-t	cur-tail-ment
par-si-mo-nious	par-si-mo-ni-ous
droplet	drop-let
stil-l	still
chrono-log-i-cal	chron-o-log-i-cal
helper	help-er
p-re-set	pre-set
y-ore	yore
stylis-tic-s	sty-lis-tics
s-tiffly	stiff-ly
clam-orous	clam-or-ous
syrup	syr-up
liftof-f	lift-off
glacier	gla-cier
pro-po-nen-t	pro-po-nent
scrol-l	scroll
e-voca-tive	e-voc-a-tive
hero-ical-ly	he-ro-i-cal-ly
roof-in-g	roof-ing
over-drive	o-ver-drive
po-ten-tial-i-ty	po-ten-ti-al-i-ty
tel-l	tell
fer-n	fern
found-ing	founding
gos-sipy	gos-sip-y
re-sent-men-t	re-sent-ment
di-nosaur	di-no-saur
va-ri-etal	va-ri-e-tal
s-loop	sloop
over-throw	o-ver-throw
pre-dictabil-i-ty	pre-dict-a-bil-i-ty
im-peri-um	im-pe-ri-um
panoply	pan-o-ply
thiev-ery	thiev-er-y
no-table	no-ta-ble
in-fec-t	in-fect
crisper	crisp-er
sander	sand-er
pinkie	pink-ie
choral	cho-ral
un-der-stand-ably	un-der-stand-a-bly
gale-na	ga-le-na
em-place-men-t	em-place-ment
sodi-um	so-di-um
ru-ina-tion	ru-in-a-tion
in-vig-o-rat-ing	in-vig-or-at-ing
po-litesse	pol-i-tesse
re-assess-men-t	re-as-sess-ment
s-port-ing-ly	sport-ing-ly
ex-tra-or-di-nary	ex-traor-di-nar-y
mono-pole	mon-o-pole
paci-fy	pac-i-fy
s-tatute	stat-ute
psy-cho-me-t-ric	psy-cho-met-ric
s-nake-skin	snake-skin
satyr	sa-tyr
re-stroom	rest-room
phrenol-o-gy	phre-nol-o-gy
colos-sus	co-los-sus
pro-to-zoan	pro-to-zo-an
re-sol-ven-t	re-sol-vent
s-nifter	snif-ter
fi-nale	fi-na-le
me-thio-n-ine	me-thi-o-nine
s-peak-ing	speak-ing
my-ocar-dial	my-o-car-di-al
post-mod-ernist	post-mod-ern-ist
wa-ter-fal-l	wa-ter-fall
ini-tial	in-i-tial
spinach	spin-ach
detox-i-fi-ca-tion	de-tox-i-fi-ca-tion
at-trac-t	at-tract
s-nout	snout
randy	rand-y
t-elecom-mu-ni-ca-tion	tel-e-com-mu-ni-ca-tion
saucy	sau-cy
b-e-fit	be-fit
pen-i-ten-tiary	pen-i-ten-tia-ry
raisin	rai-sin
di-aphanous	di-aph-a-nous
idio-syn-crasy	id-i-o-syn-cra-sy
pin-t	pint
over-pay-men-t	o-ver-pay-ment
athe-ist	a-the-ist
cos-mopoli-tan	cos-mo-pol-i-tan
caprice	ca-price
ar-chi-tec-tural	ar-chi-tec-tur-al
diplo-mat	dip-lo-mat
grand-par-en-t	grand-par-ent
tai-lorable	tai-lor-a-ble
jaz-z	jazz
viceroy	vice-roy
blaster	blast-er
elvish	elv-ish
pro-ceed-s	pro-ceeds
mantling	man-tling
vary	var-y
s-tub-ble	stub-ble
avail-able	a-vail-a-ble
boyfriend	boy-friend
s-mash-ing	smash-ing
d-i-nar	di-nar
eigen-state	ei-gen-state
un-elect-ed	un-e-lect-ed
b-i-fo-cal	bi-fo-cal
beaver	bea-ver
con-fi-den-tial-i-ty	con-fi-den-ti-al-i-ty
s-tock-bro-ker	stock-brok-er
trencher	trench-er
doubtless-ly	doubt-less-ly
holy	ho-ly
silk-wor-m	silk-worm
phys-io-ther-a-py	phys-i-o-ther-a-py
at-tribute	at-trib-ute
sur-d	surd
quaf-f	quaff
inkwell	ink-well
vestibu-lar	ves-tib-u-lar
ero-sion	e-ro-sion
su-per-cil-ious	su-per-cil-i-ous
pouter	pout-er
non-vi-o-len-t	non-vi-o-lent
tourni-quet	tour-ni-quet
doyen	doy-en
an-te-dilu-vian	an-te-di-lu-vi-an
hedgerow	hedge-row
over-stretch	o-ver-stretch
non-cha-lan-t	non-cha-lant
en-vi-ron-men-tal-is-m	en-vi-ron-men-tal-ism
in-evitabil-i-ty	in-ev-i-ta-bil-i-ty
s-pat-u-la	spat-u-la
liq-uida-tor	liq-ui-da-tor
u-n-ap-proved	un-ap-proved
flesh-pot-s	flesh-pots
promi-nent-ly	prom-i-nent-ly
dizzi-ness	diz-zi-ness
short-fal-l	short-fall
ex-cite-men-t	ex-cite-ment
s-lay	slay
fre-quent-ed	frequented
over-land	o-ver-land
renowned	re-nowned
un-ob-ser-van-t	un-ob-serv-ant
u-nassertive	un-as-ser-tive
psy-chi-atric	psy-chi-at-ric
deben-ture	de-ben-ture
holdal-l	hold-all
con-sumerist	con-sum-er-ist
p-reser-va-tion	pres-er-va-tion
s-ta-tion-er	sta-tion-er
haver-sack	hav-er-sack
co-pra	cop-ra
rock-et-ing	rocketing
ser-van-t	serv-ant
balmy	balm-y
quiv-er-ing	quivering
ac-coun-t	ac-count
im-muno-com-pro-mised	im-mu-no-com-pro-mised
astride	a-stride
epig-ra-phy	e-pig-ra-phy
scream-ing	screaming
trust-ed	trusted
hail-stor-m	hail-storm
per-ilous-ly	per-il-ous-ly
arthro-pod	ar-thro-pod
mar-riage-able	mar-riage-a-ble
ban-ish-men-t	ban-ish-ment
re-pug-nan-t	re-pug-nant
hunter	hunt-er
re-frig-er-an-t	re-frig-er-ant
for-warder	for-ward-er
y-o-del	yo-del
micro-organ-ism	mi-cro-or-gan-ism
in-equal-i-ty	in-e-qual-i-ty
platy-pus	plat-y-pus
melt-ing	melting
groupie	group-ie
prophet-ic	pro-phet-ic
re-dis-cov-ery	re-dis-cov-er-y
un-sink-able	un-sink-a-ble
un-electable	un-e-lect-a-ble
testis	tes-tis
de-pen-den-cy	de-pend-en-cy
bonobo	bo-no-bo
de-ser-ti-fi-ca-tion	de-sert-i-fi-ca-tion
mis-con-duc-t	mis-con-duct
o-r-a-cle	or-a-cle
cen-t	cent
usury	u-su-ry
s-car-i-fy	scar-i-fy
s-to-ic	sto-ic
tri-bunal	tri-bu-nal
green-ery	green-er-y
s-car-let	scar-let
fuch-si-a	fuch-sia
con-sul-tan-cy	con-sult-an-cy
seren-i-ty	se-ren-i-ty
mores	mo-res
de-pen-den-t	de-pend-ent
badtem-pered	bad-tem-pered
e-u-phemis-m	eu-phe-mism
oviduc-t	o-vi-duct
re-place-able	re-place-a-ble
lack-adaisi-cal	lack-a-dai-si-cal
draftee	draft-ee
holo-caust	hol-o-caust
over-heat	o-ver-heat
at-tack-ing	attacking
grouper	group-er
com-ple-men-t	com-ple-ment
qua-dru-pli-cate	quad-ru-pli-cate
cli-toris	clit-o-ris
breast-feed-ing	breastfeeding
per-pe-tu-ity	per-pe-tu-i-ty
sala-man-der	sal-a-man-der
biomorph	bi-o-morph
lul-la-by	lull-a-by
flamin-go	fla-min-go
laden	lad-en
gospel	gos-pel
machis-mo	ma-chis-mo
crazi-ness	cra-zi-ness
re-in-force-men-t	re-in-force-ment
aque-duc-t	aq-ue-duct
g-lut-tony	glut-ton-y
toluene	tol-u-ene
re-versed	reversed
hourly	hour-ly
sharp-en-er	shar-pen-er
foren-sic	fo-ren-sic
un-usu-al-ly	un-u-su-al-ly
aqua-ma-rine	aq-ua-ma-rine
over-win-ter	o-ver-win-ter
ex-is-tence	ex-ist-ence
cheer-s	cheers
del-i-ques-cen-t	del-i-ques-cent
ge-nom-ic	ge-no-mic
castel-lat-ed	cas-tel-lat-ed
crevice	crev-ice
hosan-na	ho-san-na
b-lis-ter-ing	blis-ter-ing
mar-que	marque
s-lat-ted	slat-ted
p-re-sentable	pre-sent-a-ble
b-lessed	bless-ed
molten	mol-ten
sur-fac-tan-t	sur-fac-tant
friendlily	friend-li-ly
thral-l	thrall
ex-cerp-t	ex-cerpt
geezer	gee-zer
lit-er-al-is-m	lit-er-al-ism
nestling	nest-ling
au-dio-vi-su-al	au-di-o-vis-u-al
moist-en	mois-ten
navvy	nav-vy
k-itch-enette	kitch-en-ette
s-corch-ing	scorch-ing
so-lic-it-ing	soliciting
s-mooch	smooch
s-tacked	stacked
over-es-ti-ma-tion	o-ver-es-ti-ma-tion
re-in-state-men-t	re-in-state-ment
in-elas-tic	in-e-las-tic
s-nag	snag
springer	spring-er
un-men-tion-able	un-men-tion-a-ble
sepul-chral	se-pul-chral
philoso-pher	phi-los-o-pher
hu-man-is-m	hu-man-ism
s-mug-gler	smug-gler
tex-t	text
climber	climb-er
s-pam	spam
goatskin	goat-skin
ra-dia-tive	ra-di-a-tive
hussy	hus-sy
in-hibitor	in-hib-i-tor
s-core-board	score-board
semi-cir-cu-lar	sem-i-cir-cu-lar
armpit	arm-pit
bio-chemist	bi-o-chem-ist
or-b	orb
in-ter-dis-ci-pli-nary	in-ter-dis-ci-pli-nar-y
prepo-si-tion-al	prep-o-si-tion-al
marten	mar-ten
surgery	sur-ger-y
tac-t	tact
eatery	eat-er-y
s-tain-less	stain-less
in-for-m	in-form
mankind	man-kind
poly-atom-ic	pol-y-a-tom-ic
u-n-avoid-ably	un-a-void-a-bly
recheck	re-check
dis-join-t	dis-joint
s-corn	scorn
ref-er-ee-ing	re-fe-ree-ing
moray	mo-ray
para-met-ric	par-a-met-ric
atom-ic	a-tom-ic
goofy	goof-y
tele-scop-ic	tel-e-scop-ic
elec-tric-i-ty	e-lec-tric-i-ty
s-limy	slim-y
lega-tor	le-ga-tor
crum-b	crumb
wis-p	wisp
k-ilo-ton	kil-o-ton
flashy	flash-y
radar	ra-dar
spooky	spook-y
julep	ju-lep
rheumat-ic-s	rheu-mat-ics
unerring	un-err-ing
glan-s	glans
punch-line	punchline
sender	send-er
un-con-quer-able	un-con-quer-a-ble
y-acht-ing	yacht-ing
pre-de-ter-mined	predetermined
jean-s	jeans
sawyer	saw-yer
bio-engi-neer-ing	bi-o-en-gi-neer-ing
grun-t	grunt
unabridged	un-a-bridged
zona-tion	zo-na-tion
ravine	ra-vine
poly-syl-lab-ic	pol-y-syl-lab-ic
symp-to-matic	symp-to-mat-ic
s-courge	scourge
lol-lipop	lol-li-pop
s-tar-tled	star-tled
gestalt	ge-stalt
s-tim-u-la-tion	stim-u-la-tion
lop-per-s	lop-pers
fleshy	flesh-y
ar-ranger	ar-rang-er
un-be-liev-able	un-be-liev-a-ble
com-pen-sato-ry	com-pen-sa-to-ry
pornog-ra-phy	por-nog-ra-phy
s-lap	slap
stri-den-t	stri-dent
turnout	turn-out
haulage	haul-age
propul-sive	pro-pul-sive
table-cloth	ta-ble-cloth
qui-etus	qui-e-tus
u-topi-an	u-to-pi-an
charge-able	charge-a-ble
in-fantry-man	in-fan-try-man
coax-ing	coaxing
preterite	pret-er-ite
im-pa-tien-t	im-pa-tient
re-pairable	re-pair-a-ble
with-er-s	with-ers
billing	bil-ling
frailty	frail-ty
quixot-ic	quix-ot-ic
jour-nalese	jour-nal-ese
im-per-fec-t	im-per-fect
mine-strone	min-e-stro-ne
lament-ed	la-ment-ed
courage	cour-age
s-porran	spor-ran
poly-mer	pol-y-mer
far-m	farm
corky	cork-y
pro-tean	pro-te-an
in-vol-un-tary	in-vol-un-tar-y
oily	oil-y
mem-o-rable	mem-o-ra-ble
garter	gar-ter
elec-tro-stat-ic-s	e-lec-tro-stat-ics
skew-ered	skewered
rigid-i-ty	ri-gid-i-ty
berserk	ber-serk
s-plin-t	splint
g-lut	glut
chock-ablock	chock-a-block
hon-esty	hon-es-ty
muti-nous	mu-ti-nous
night-fal-l	night-fall
s-trait	strait
aper-ture	ap-er-ture
di-ure-sis	di-u-re-sis
bac-carat	bac-ca-rat
liquor	liq-uor
in-con-tro-vert-ible	in-con-tro-vert-i-ble
re-cidi-vis-m	re-cid-i-vism
tawdry	taw-dry
de-tec-t	de-tect
de-mo-graph-ic-s	dem-o-graph-ics
eardrum	ear-drum
ap-proval	ap-prov-al
in-ter-vie-wee	in-ter-view-ee
con-queror	con-quer-or
s-abo-teur	sab-o-teur
habi-tat	hab-i-tat
charis-mat-ic	char-is-mat-ic
per-fidy	per-fi-dy
ju-di-cia-ry	ju-di-ci-ar-y
vivi-sec-tion	viv-i-sec-tion
diesel	die-sel
sali-va	sa-li-va
em-ploy-able	em-ploy-a-ble
mono-graph	mon-o-graph
chaos	cha-os
pewter	pew-ter
felony	fel-o-ny
s-natch	snatch
kinswom-an	kins-wom-an
p-neu-mat-ic	pneu-mat-ic
hectare	hec-tare
ex-clu-sion-ary	ex-clu-sion-ar-y
top-i-ary	to-pi-ar-y
cu-rat-ed	curated
tal-en-t	tal-ent
s-tock-ist	stock-ist
palace	pal-ace
oblig-ing-ly	o-blig-ing-ly
heavy-weight	heav-y-weight
s-ab-bat-i-cal	sab-bat-i-cal
the-atri-cal-s	the-at-ri-cals
ir-re-versible	ir-re-vers-i-ble
twitchy	twitch-y
coro-nary	cor-o-nar-y
s-loshed	sloshed
pop-ulis-m	pop-u-lism
atop	a-top
u-n-ac-cus-tomed	un-ac-cus-tomed
in-fir-mary	in-fir-ma-ry
e-u-phoric	eu-phor-ic
foun-t	fount
groom-ing	grooming
in-ex-haustible	in-ex-haust-i-ble
ar-biter	ar-bi-ter
u-nan-swered	un-an-swered
h-es-i-ta-tion	hes-i-ta-tion
ra-bid	rab-id
laity	la-i-ty
s-can	scan
chas-ten-ing	chastening
rounder	round-er
overop-ti-mistic	o-ver-op-ti-mis-tic
s-lipped	slipped
medic	med-ic
palimpses-t	pal-imp-sest
ter-rafor-m	ter-ra-form
oxy-gen	ox-y-gen
provo-ca-tion	prov-o-ca-tion
un-no-tice-able	un-no-tice-a-ble
labyrinth	lab-y-rinth
some-body	some-bod-y
menswear	mens-wear
as-bestos	as-bes-tos
tiny	ti-ny
fer-men-t	fer-ment
monogamy	mo-nog-a-my
un-ortho-doxy	un-or-tho-dox-y
s-tar-let	star-let
azure	az-ure
crin-kled	crinkled
promon-to-ry	prom-on-to-ry
mel-liflu-ous	mel-lif-lu-ous
ban-knote	bank-note
un-ordered	un-or-dered
hy-drazine	hy-dra-zine
n-ear-by	near-by
lava-to-ri-al	lav-a-to-ri-al
lam-plit	lamp-lit
eter-nal	e-ter-nal
dis-band-men-t	dis-band-ment
evil	e-vil
in-equitable	in-eq-ui-ta-ble
ret-ro-spec-t	ret-ro-spect
over-pay	o-ver-pay
coro-ner	cor-o-ner
ro-mancer	ro-manc-er
asyn-chro-nous	a-syn-chro-nous
ram-p	ramp
un-so-licit-ed	un-so-lic-it-ed
hy-per-bole	hy-per-bo-le
atavis-m	at-a-vism
homi-ly	hom-i-ly
dio-cese	di-o-cese
m-is-fire	mis-fire
tempter	tempt-er
resched-ule	re-sched-ule
k-itchen	kitch-en
d-is-fig-ure	dis-fig-ure
roulette	rou-lette
me-te-o-ro-log-i-cal	me-te-or-o-log-i-cal
de-b	deb
le-gionary	le-gion-ar-y
dis-able	dis-a-ble
ru-inous	ru-in-ous
unloved	un-loved
s-lip-pery	slip-per-y
u-n-armed	un-armed
renter	rent-er
di-atom-ic	di-a-tom-ic
t-suna-mi	tsu-na-mi
polit-buro	po-lit-bu-ro
re-liance	re-li-ance
an-thracite	an-thra-cite
de-press-ing	de-pres-sing
think-able	think-a-ble
mytho-log-i-cal	myth-o-log-i-cal
aris-to-crat-ic	a-ris-to-crat-ic
s-cav-enge	scav-enge
sideshow	side-show
testos-terone	tes-tos-ter-one
shiny	shin-y
d-warfed	dwarfed
s-parse-ly	sparse-ly
s-mash-er	smash-er
babes	babes
the-saurus	the-sau-rus
boater	boat-er
recom-mence	re-com-mence
prison	pris-on
ha-track	hat-rack
baleen	ba-leen
dis-ori-en-t	dis-o-ri-ent
in-flammable	in-flam-ma-ble
un-opened	un-o-pened
seg-men-t	seg-ment
avi-ate	a-vi-ate
philol-o-gy	phi-lol-o-gy
de-ten-t	de-tent
re-trac-t	re-tract
s-tan-chion	stan-chion
pedestal	ped-es-tal
poli-ty	pol-i-ty
cade-t	ca-det
pres-i-den-t	pres-i-dent
domi-no	dom-i-no
s-tim-u-lat-ing	stim-u-lat-ing
cider	ci-der
s-norkel	snor-kel
rein-sert	re-in-sert
stretchy	stretch-y
fash-ion-able	fash-ion-a-ble
s-targaze	star-gaze
gymkhana	gym-kha-na
s-plen-did-ly	splen-did-ly
ma-hogany	ma-hog-a-ny
s-tature	stat-ure
of-f	off
moral-ist	mor-al-ist
ob-jec-tion-able	ob-jec-tion-a-ble
b-o-rax	bo-rax
re-cum-ben-t	re-cum-bent
eva-sive	e-va-sive
per-e-stroi-ka	pe-re-stroi-ka
in-el-e-gan-t	in-el-e-gant
odd-men-t	odd-ment
silken	silk-en
w-hole-some	whole-some
fleecy	fleec-y
door-bel-l	door-bell
undis-closed	un-dis-closed
glit-tery	glit-ter-y
dis-tillery	dis-till-er-y
seafood	sea-food
gravedig-ger	grave-dig-ger
vex-ing	vexing
s-tomp-ing	stomp-ing
sys-temic	sys-tem-ic
thruster	thrust-er
s-mite	smite
over-charge	o-ver-charge
syn-chrony	syn-chro-ny
pirou-ette	pir-ou-ette
com-menter	com-ment-er
tu-ition	tu-i-tion
hang-glid-ed	hang-gli-ded
canon-i-cal	ca-non-i-cal
s-tu-pe-fac-tion	stu-pe-fac-tion
catheter	cath-e-ter
cuprous	cu-prous
bound-ary	bound-a-ry
sa-van-t	sa-vant
s-portive	spor-tive
ob-stet-ric-s	ob-stet-rics
guille-mot	guil-le-mot
pikestaff	pike-staff
sum-mery	sum-mer-y
s-neak	sneak
chunky	chunk-y
porno-graph-ic	por-no-graph-ic
weasel	wea-sel
lad-dered	laddered
anvil	an-vil
monar-chy	mon-ar-chy
un-bridge-able	un-bridge-a-ble
pro-pri-etor-ship	pro-pri-e-tor-ship
in-fini-tive	in-fin-i-tive
is-lander	is-land-er
metro	met-ro
in-ter-change-able	in-ter-change-a-ble
as-sured-ly	as-sur-ed-ly
duet	du-et
uten-sil	u-ten-sil
re-gret-tably	re-gret-ta-bly
out-pa-tien-t	out-pa-tient
avalanche	av-a-lanche
aro-matic-i-ty	ar-o-ma-tic-i-ty
doorstop	door-stop
s-teel-work	steel-work
foghorn	fog-horn
aphro-disi-ac	aph-ro-dis-i-ac
radix	ra-dix
over-ween-ing	o-ver-ween-ing
ra-dio-graph	ra-di-o-graph
s-can-dalous	scan-dal-ous
es-tu-ary	es-tu-ar-y
baroque	ba-roque
s-lug-gard	slug-gard
pro-tec-torate	pro-tec-tor-ate
p-ri-mo-gen-i-ture	pri-mo-gen-i-ture
fundrais-er	fund-rais-er
s-plut-ter	splut-ter
s-tore-keep-er	store-keep-er
vis-i-ta-tion	vis-it-a-tion
salver	sal-ver
wrap-around	wrap-a-round
hero-in	her-o-in
s-coop	scoop
s-tim-u-late	stim-u-late
nifty	nif-ty
s-cle-ro-sis	scle-ro-sis
turn-around	turn-a-round
u-niden-ti-fi-able	un-i-den-ti-fi-a-ble
par-enter-al	par-en-ter-al
sausage	sau-sage
coun-ter-in-tu-itive	coun-ter-in-tu-i-tive
athe-is-tic	a-the-is-tic
ephemer-a	e-phem-er-a
aro-mather-a-py	a-ro-ma-ther-a-py
lyric	lyr-ic
mar-chioness	mar-chion-ess
s-cam	scam
over-act-ing	overacting
s-coundrel	scoun-drel
diplo-mat-ic	dip-lo-mat-ic
colo-nial	co-lo-ni-al
en-chant-men-t	en-chant-ment
fold-ing	folding
her-itage	her-it-age
mantrap	man-trap
mis-ery	mis-er-y
ar-range-men-t	ar-range-ment
in-cite-men-t	in-cite-ment
hawthorn	haw-thorn
ra-dio-car-bon	ra-di-o-car-bon
um-bili-cus	um-bil-i-cus
pastis	pas-tis
brinkman-ship	brink-man-ship
gan-glion	gan-gli-on
satiny	sat-in-y
marshy	marsh-y
ca-ress-ing	ca-res-sing
poly-gon	pol-y-gon
meta-phys-i-cal	met-a-phys-i-cal
s-nap-per	snap-per
fil-ial	fil-i-al
pho-to-volta-ic	pho-to-vol-ta-ic
spec-s	specs
soupy	soup-y
can-taloupe	can-ta-loupe
pos-i-tivis-m	pos-i-tiv-ism
physi-cian	phy-si-cian
irony	i-ro-ny
vet-eri-nary	vet-er-i-nar-y
foam-ing	foaming
mis-treat-men-t	mis-treat-ment
fig-u-ra-tive	fig-ur-a-tive
in-duc-t	in-duct
an-thro-pogenic	an-thro-po-gen-ic
liveli-hood	live-li-hood
derelic-t	der-e-lict
tar-ty	tart-y
celiba-cy	cel-i-ba-cy
stuffy	stuff-y
razzmataz-z	razz-ma-tazz
s-low	slow
tear-away	tear-a-way
dis-turbing-ly	dis-turb-ing-ly
seaboard	sea-board
penury	pen-u-ry
in-quiry	in-quir-y
t-setse	tset-se
lauda-to-ry	laud-a-to-ry
con-denser	con-dens-er
wun-derkind	wun-der-kind
over-writ-ing	overwriting
b-land-ly	bland-ly
in-jec-t	in-ject
killer	kil-ler
cas-sowary	cas-so-war-y
retel-l	re-tell
re-spon-der	re-spond-er
trel-lised	trellised
rene-gade	ren-e-gade
can-tilever	can-ti-le-ver
unlov-ing	un-lov-ing
re-open	re-o-pen
be-liev-abil-i-ty	be-liev-a-bil-i-ty
ir-re-duc-ible	ir-re-duc-i-ble
creak-ing	creaking
lu-bri-can-t	lu-bri-cant
madras	mad-ras
s-teep	steep
un-handy	un-hand-y
hy-draulic-s	hy-drau-lics
beery	beer-y
apery	ap-er-y
erad-i-ca-tion	e-rad-i-ca-tion
poly-he-dron	pol-y-he-dron
re-align	re-a-lign
ex-pec-t	ex-pect
s-train-er	strain-er
en-thalpy	en-thal-py
de-odor-an-t	de-o-dor-ant
b-light	blight
com-bat-an-t	com-bat-ant
tri-atom-ic	tri-a-tom-ic
s-ketch-book	sketch-book
per-centile	per-cen-tile
nice-ty	ni-ce-ty
papule	pap-ule
monothe-is-tic	mon-o-the-is-tic
recharge	re-charge
com-mu-nion	com-mun-ion
crazi-ly	cra-zi-ly
se-nior-i-ty	sen-ior-i-ty
s-tand-by	stand-by
painful	pain-ful
un-equiv-o-cal-ly	un-e-quiv-o-cal-ly
many	man-y
junker	jun-ker
s-pace	space
electro-mechan-i-cal	e-lec-tro-me-chan-i-cal
tyran-ni-cide	ty-ran-ni-cide
saga	sa-ga
en-dother-mic	en-do-ther-mic
rosin	ros-in
autarchy	au-tar-chy
se-ca-teurs	sec-a-teurs
re-align-men-t	re-a-lign-ment
lar-ynx-es	la-rynx-es
mod-esty	mod-es-ty
b-lench	blench
so-h	soh
sub-scriber	sub-scrib-er
talkie	talk-ie
aorist	a-o-rist
iso-la-tion-ist	i-so-la-tion-ist
elec-tri-cian	e-lec-tri-cian
about	a-bout
land-fil-l	land-fill
dairy-ing	dair-y-ing
potas-si-um	po-tas-si-um
api-ary	a-pi-ar-y
res-i-den-t	res-i-dent
s-lant-wise	slant-wise
in-de-clin-able	in-de-clin-a-ble
su-per-nu-mer-ary	su-per-nu-mer-ar-y
pari-etal	pa-ri-e-tal
sponger	spong-er
re-pen-t	re-pent
s-louch-ing	slouching
bud-get	budg-et
flick-er-ing	flickering
s-tun-ner	stun-ner
catch-men-t	catch-ment
au-thor-i-tar-i-an-is-m	au-thor-i-tar-i-an-ism
pedol-o-gy	pe-dol-o-gy
s-melly	smell-y
lofty	loft-y
wigeon	wig-eon
d-in-gle	din-gle
a-pogee	ap-o-gee
poly-thene	pol-y-thene
calami-ty	ca-lam-i-ty
be-wil-der-men-t	be-wil-der-ment
plaza	pla-za
boun-teous	boun-te-ous
rein-tro-duc-tion	re-in-tro-duc-tion
s-paniel	span-iel
fre-quen-t	fre-quent
ex-tend-able	ex-tend-a-ble
in-for-man-t	in-form-ant
s-plat-ter	splat-ter
masseur	mas-seur
oblate	ob-late
but-tressed	buttressed
quadruped	quad-ru-ped
skul-dug-gery	skul-dug-ger-y
mati-nee	mat-i-nee
her-b	herb
s-tate-craft	state-craft
length-en-ing	lengthening
s-teer	steer
pos-i-tivist	pos-i-tiv-ist
trashy	trash-y
linen	lin-en
foothill	foot-hill
ju-rispru-dence	ju-ris-pru-dence
artery	ar-ter-y
dioce-san	di-oc-e-san
cou-pled	coupled
dis-com-fort-ing	discomforting
leisured	lei-sured
net-work-ing	networking
elixir	e-lix-ir
chi-canery	chi-can-er-y
loca-tive	loc-a-tive
macaque	ma-caque
malev-o-len-t	ma-lev-o-lent
mauler	maul-er
doc-u-men-t	doc-u-ment
satir-i-cal	sa-tir-i-cal
e-d-u-ca-tion-al	ed-u-ca-tion-al
avenger	a-veng-er
ac-ci-den-t	ac-ci-dent
demo-crat-i-cal-ly	dem-o-crat-i-cal-ly
wind-surf-in-g	wind-surf-ing
rook-ery	rook-er-y
dis-burse-men-t	dis-burse-ment
trapeze	tra-peze
over-load	o-ver-load
hy-draulic	hy-drau-lic
ni-troge-nous	ni-trog-e-nous
silt-ing	silting
in-de-pen-den-t	in-de-pend-ent
s-tam-pede	stam-pede
piezo-elec-tric	pi-e-zo-e-lec-tric
s-tar-lit	star-lit
quil-l	quill
undi-lut-ed	un-di-lut-ed
trans-par-en-t	trans-par-ent
pic-turesque	pic-tur-esque
glaciat-ed	gla-ci-at-ed
s-tuc-co	stuc-co
parent-age	par-ent-age
wal-l	wall
hye-na	hy-e-na
polypropy-lene	pol-y-pro-pyl-ene
velour	ve-lour
pumice	pum-ice
rhodi-um	rho-di-um
omis-sion	o-mis-sion
for-get-table	for-get-ta-ble
boot-s	boots
mi-crochip	mi-cro-chip
dredger	dredg-er
he-lio-sphere	he-li-o-sphere
lachry-mose	lach-ry-mose
moth-bal-l	moth-ball
banker	bank-er
across	a-cross
redo-len-t	red-o-lent
oc-tagon	oc-ta-gon
hand-picked	handpicked
steadi-ness	stead-i-ness
crack-er-s	crack-ers
s-trag-gly	strag-gly
scholas-ti-cis-m	scho-las-ti-cism
co-pro-lite	cop-ro-lite
war-ran-t	war-rant
undis-tribut-ed	un-dis-trib-ut-ed
in-tel-lec-tu-al-is-m	in-tel-lec-tu-al-ism
gov-er-nance	gov-ern-ance
s-cone	scone
paraf-fin	par-af-fin
s-tar	star
es-timable	es-ti-ma-ble
taunt-ing	taunting
poly-eth-yl-ene	pol-y-eth-yl-ene
bank-able	bank-a-ble
re-silience	re-sil-ience
cedil-la	ce-dil-la
retic-u-lar	re-tic-u-lar
nomen-cla-ture	no-men-cla-ture
sandy	sand-y
s-loth-ful	sloth-ful
unlov-able	un-lov-a-ble
copy-writ-er	cop-y-writ-er
mer-chan-dis-e	mer-chan-dise
backchat	back-chat
polyurethane	pol-y-u-re-thane
cus-tom-s	cus-toms
p-res-ence	pres-ence
telex	tel-ex
trunk-s	trunks
s-mall-ness	small-ness
handrail	hand-rail
op-ti-misti-cal-ly	op-ti-mis-ti-cal-ly
r-eread	re-read
ab-sen-t	ab-sent
cy-ber-net-ic-s	cy-ber-net-ics
s-tarlight	star-light
pu-ri-tanis-m	pu-ri-tan-ism
over-sup-ply	o-ver-sup-ply
s-nob	snob
sym-bion-t	sym-bi-ont
prankster	prank-ster
retic-u-la-tion	re-tic-u-la-tion
as-sign-men-t	as-sign-ment
sub-scrip-t	sub-script
spel-l	spell
rain-stor-m	rain-storm
tubu-lar	tu-bu-lar
pick-pock-et-ing	pickpocketing
hon-our	ho-nour
drafty	draft-y
char-cu-terie	char-cu-te-rie
pris-m	prism
golfer	golf-er
cel-ery	cel-er-y
naked	na-ked
for-tu-itous-ly	for-tu-i-tous-ly
roadmap	road-map
re-con-nec-t	re-con-nect
coven	cov-en
hypocrisy	hy-poc-ri-sy
in-signi-a	in-sig-ni-a
in-ter-sec-t	in-ter-sect
dis-may-ing	dismaying
or-ga-nize	or-gan-ize
in-tractable	in-trac-ta-ble
d-e-duce	de-duce
rack-e-teer-ing	rack-et-eer-ing
les-bian	les-bi-an
ir-re-proach-able	ir-re-proach-a-ble
em-bod-i-men-t	em-bod-i-ment
ge-nial	ge-ni-al
demigod	dem-i-god
here-inafter	here-in-af-ter
cor-duroy	cor-du-roy
so-bri-ety	so-bri-e-ty
lever-age	lev-er-age
au-thoress	au-thor-ess
s-po-radic	spo-rad-ic
patel-la	pa-tel-la
rein-vest-men-t	re-in-vest-ment
lantern	lan-tern
s-nake	snake
creaky	creak-y
semide-tached	sem-i-de-tached
ma-joli-ca	ma-jol-i-ca
visa	vi-sa
o-cean-ic	o-ce-an-ic
in-com-pe-ten-t	in-com-pe-tent
as-tronomer	as-tron-o-mer
con-junc-t	con-junct
u-nim-paired	un-im-paired
avail	a-vail
posit	pos-it
veg-e-tar-i-an-is-m	veg-e-tar-i-an-ism
epiphe-nomenon	ep-i-phe-nom-e-non
s-carp	scarp
yokel	yo-kel
s-calp	scalp
holo-graph-ic	hol-o-graph-ic
par-venu	par-ve-nu
alone	a-lone
erad-i-cate	e-rad-i-cate
tele-graph	tel-e-graph
im-pru-den-t	im-pru-dent
s-pa-tial	spa-tial
epic	ep-ic
flammable	flam-ma-ble
tax-able	tax-a-ble
ot-toman	ot-to-man
glis-ten-ing	gli-ste-ning
pal-l	pall
ef-ful-gen-t	ef-ful-gent
s-now-drift	snow-drift
oblique	o-blique
mono-graph-ic	mon-o-graph-ic
ele-phan-tine	el-e-phan-tine
in-fi-deli-ty	in-fi-del-i-ty
chameleon	cha-me-le-on
meta-mor-phose	met-a-mor-phose
ca-cophonous	ca-coph-o-nous
s-tim-u-lus	stim-u-lus
ge-net-ic-s	ge-net-ics
duchy	duch-y
chaf-f	chaff
copi-lot	co-pi-lot
s-trait-ened	strait-ened
Words with errors: 2305
Words with incorrect number of syllables: 2106
Total evluated: 6500
Perfect accuracy: 0.65
Number of syllables accuracy: 0.68
Average Levenshtein Distance(across incorrect words): 1.22
