Attempt	Real
gos-sipy	gos-sip-y
elec-tor	e-lec-tor
mer-curic	mer-cu-ric
a-pos-tolic	ap-os-tol-ic
tho-raci-c	tho-rac-ic
mov-able	mov-a-ble
habi-ta-tion	hab-i-ta-tion
sleepi-ness	sleep-i-ness
nepo-tism	nep-o-tism
baron	bar-on
meringue	me-ringue
s-tar-tle	star-tle
de-tach-able	de-tach-a-ble
in-vig-o-rate	in-vig-or-ate
dis-parag-ing	dis-par-ag-ing
temptress	tempt-ress
mari-nade	mar-i-nade
book-wor-m	book-worm
over-ween-ing	o-ver-ween-ing
para-nor-mal	par-a-nor-mal
s-port-ing-ly	sport-ing-ly
beefy	beef-y
s-calpel	scal-pel
col-lec-tivi-sa-tion	col-lec-ti-vi-sa-tion
cesspit	cess-pit
gloomy	gloom-y
tawny	taw-ny
legalese	le-gal-ese
steam-roller	steam-roll-er
aslan-t	a-slant
rafter	raft-er
carotene	car-o-tene
wrin-kled	wrinkled
triple	tri-ple
maser	ma-ser
melody	mel-o-dy
dairy	dair-y
re-in-state-men-t	re-in-state-ment
k-ilt	kilt
taxi-dermy	tax-i-der-my
bel-liger-ence	bel-lig-er-ence
mis-cre-an-t	mis-cre-ant
foot-bal-l	foot-ball
kestrel	kes-trel
brazen-ly	bra-zen-ly
de-ity	de-i-ty
undi-rect-ed	un-di-rect-ed
whistler	whis-tler
avenge	a-venge
ac-cen-t	ac-cent
artery	ar-ter-y
pro-pri-etor-ship	pro-pri-e-tor-ship
w-hole-wheat	wholewheat
mayflow-er	may-flow-er
u-nim-pressed	un-im-pressed
spinach	spin-ach
ratepay-er	rate-pay-er
forego	fore-go
perdi-tion	per-di-tion
can-tilever	can-ti-le-ver
sym-bion-t	sym-bi-ont
literati	lit-e-ra-ti
ex-plorato-ry	ex-plor-a-to-ry
t-in-foil	tin-foil
por-ous	po-rous
phys-io-ther-a-pist	phys-i-o-ther-a-pist
ar-chi-tec-tural	ar-chi-tec-tur-al
o-r-a-cle	or-a-cle
id-io-path-ic	id-i-o-path-ic
unedit-ed	un-ed-it-ed
quadru-ple	quad-ru-ple
s-carce	scarce
cheeky	cheek-y
undis-cov-ered	un-dis-cov-ered
s-tudy	stud-y
s-paniel	span-iel
lad-dered	laddered
gen-eros-i-ty	gen-er-os-i-ty
loopy	loop-y
felony	fel-o-ny
nice-ty	ni-ce-ty
in-con-stan-t	in-con-stant
bot-tled	bottled
re-de-vel-op-men-t	re-de-vel-op-ment
in-vi-o-lable	in-vi-o-la-ble
biorhyth-m	bi-o-rhythm
cal-care-ous	cal-car-e-ous
swimwear	swim-wear
un-in-hab-it-able	un-in-hab-it-a-ble
area	ar-e-a
u-n-at-tached	un-at-tached
trilo-bite	tri-lo-bite
markup	mark-up
vine-gar	vin-e-gar
ar-m	arm
kril-l	krill
eter-nal-ly	e-ter-nal-ly
in-ter-plan-e-tary	in-ter-plan-e-tar-y
midair	mid-air
en-chantress	en-chant-ress
dis-re-spec-t	dis-re-spect
un-wrap-s	un-wraps
handrail	hand-rail
gleam-ing	gleaming
menar-che	men-ar-che
touristy	tour-ist-y
crater	cra-ter
growler	growl-er
con-trast-ing	contrasting
deco-rous	dec-o-rous
gavial	ga-vi-al
syl-labus	syl-la-bus
sacra-men-tal	sac-ra-men-tal
ed-itable	ed-it-a-ble
un-electable	un-e-lect-a-ble
de-scend-ing	descending
tele-graph-ic	tel-e-graph-ic
s-cal-able	scal-a-ble
un-en-durable	un-en-dur-a-ble
un-tidy	un-ti-dy
lapel	la-pel
u-niden-ti-fi-able	un-i-den-ti-fi-a-ble
com-mence-men-t	com-mence-ment
joyrid-ing	joy-rid-ing
reprise	re-prise
delux-e	de-luxe
distaff	dis-taff
s-pas-tic	spas-tic
fetish	fet-ish
paci-fist	pac-i-fist
con-sid-er-ably	con-sid-er-a-bly
round-about	round-a-bout
elic-it	e-lic-it
fool-ery	fool-er-y
u-n-awak-ened	un-a-wak-ened
mod-e	mode
s-cout-ing	scout-ing
bar-rack-s	bar-racks
with-er-s	with-ers
holis-m	ho-lism
fet-tered	fettered
y-outh-ful	youth-ful
tailplane	tail-plane
rescale	re-scale
phys-io-ther-a-py	phys-i-o-ther-a-py
mal-l	mall
haver-ing	ha-ve-ring
elo-quence	el-o-quence
duf-f	duff
chrono-graph	chron-o-graph
e-vac-uee	e-vac-u-ee
origa-mi	o-ri-ga-mi
firkin	fir-kin
per-ma-nen-t	per-ma-nent
as-siduity	as-si-du-i-ty
eva-sive	e-va-sive
wan-t	want
vit-ri-olic	vit-ri-ol-ic
i-con-o-clas-m	i-con-o-clasm
flip-pan-t	flip-pant
rachis	ra-chis
queru-lous	quer-u-lous
hero-ine	her-o-ine
in-ter-op-er-abil-i-ty	in-ter-op-er-a-bil-i-ty
u-n-armed	un-armed
bunker	bun-ker
anonymi-ty	an-o-nym-i-ty
anon	a-non
gavotte	ga-votte
hip-pocam-pus	hip-po-cam-pus
s-ta-tion	sta-tion
puree	pu-ree
cham-pi-onship	cham-pi-on-ship
gal-axy	gal-ax-y
rum-pled	rumpled
cam-p	camp
mastodon	mas-to-don
in-san-i-tary	in-san-i-tar-y
s-neak	sneak
satel-lite	sat-el-lite
rigid-ly	rig-id-ly
untest-ed	un-test-ed
un-even-ly	un-e-ven-ly
s-mite	smite
bug-gery	bug-ger-y
octet	oc-tet
b-land-ly	bland-ly
porce-lain	por-ce-lain
lessee	les-see
evince	e-vince
ten-t	tent
bunkum	bun-kum
ben-e-fi-cia-ry	ben-e-fi-ci-ar-y
septet	sep-tet
tight-s	tights
springy	spring-y
kudu	ku-du
open	o-pen
s-ingly	sin-gly
serendip-i-tous	ser-en-dip-i-tous
iso-la-tion-is-m	i-so-la-tion-ism
cre-ation-is-m	cre-a-tion-ism
s-norkel	snor-kel
chanter	chant-er
spicy	spic-y
tiara	ti-ar-a
un-con-scionable	un-con-scion-a-ble
undi-min-ished	un-di-min-ished
puma	pu-ma
wether	weth-er
s-nif-fer	sniff-er
car-away	car-a-way
bar-bel-l	bar-bell
ap-pre-cia-bly	ap-pre-ci-a-bly
re-pay-men-t	re-pay-ment
jaz-z	jazz
ravi-o-li	ra-vi-o-li
sub-ter-ranean	sub-ter-ra-ne-an
s-lam	slam
caramel	car-a-mel
trusty	trust-y
hal-lelu-jah	hal-le-lu-jah
in-de-ci-pher-able	in-de-ci-pher-a-ble
lento	len-to
moral-ist	mor-al-ist
w-hole-ness	whole-ness
at-ten-dance	at-tend-ance
ep-ithe-li-um	ep-i-the-li-um
for-mu-la-ry	for-mu-lar-y
usu-al	u-su-al
de-served-ly	de-serv-ed-ly
re-as-sign-men-t	re-as-sign-ment
con-ceiv-able	con-ceiv-a-ble
over-draw	o-ver-draw
any-how	an-y-how
s-tupid	stu-pid
rosy	ros-y
com-ple-men-tary	com-ple-men-ta-ry
seamy	seam-y
s-pare	spare
dis-il-lu-sion-men-t	dis-il-lu-sion-ment
cus-tomer	cus-tom-er
triplex	tri-plex
nympho-ma-ni-ac	nym-pho-ma-ni-ac
itin-er-ary	i-tin-er-ar-y
tele-vi-su-al	tel-e-vis-u-al
con-cor-dance	con-cord-ance
can-nery	can-ner-y
ex-is-ten-tial-is-m	ex-is-ten-tial-ism
s-word-fish	sword-fish
oblig-ing-ly	o-blig-ing-ly
con-sul-tan-t	con-sult-ant
oph-thalmic	oph-thal-mic
or-ga-ni-za-tion	or-gan-i-za-tion
sophistry	soph-ist-ry
cor-dial	cor-di-al
glaciol-o-gy	gla-ci-ol-o-gy
sav-agery	sav-age-ry
paradig-mat-ic	par-a-dig-mat-ic
in-sou-ciance	in-sou-ci-ance
rigid	rig-id
grandiose	gran-di-ose
en-trail-s	en-trails
seg-men-t	seg-ment
rock-ery	rock-er-y
gas-troin-testi-nal	gas-tro-in-tes-ti-nal
bawl-ing	baw-ling
s-tar-dust	star-dust
ce-men-t	ce-ment
sub-sis-tence	sub-sist-ence
res-onator	res-o-na-tor
unchris-tian	un-chris-tian
re-design	re-de-sign
s-nort	snort
pop-ulis-m	pop-u-lism
in-fi-deli-ty	in-fi-del-i-ty
hireling	hire-ling
ar-ma-men-t	ar-ma-ment
butch-ery	butch-er-y
ar-ro-gan-t	ar-ro-gant
d-is-fran-chise	dis-fran-chise
over-tone	o-ver-tone
kwacha	kwa-cha
dis-ori-en-ta-tion	dis-o-ri-en-ta-tion
sub-si-dence	sub-sid-ence
ret-ro-spec-t	ret-ro-spect
scrib-bling	scribbling
per-fectibil-i-ty	per-fect-i-bil-i-ty
overuse	o-ver-use
apolo-gia	ap-o-lo-gi-a
ra-tio-nal-is-m	ra-tion-al-ism
dressy	dress-y
psy-chother-a-py	psy-cho-ther-a-py
flutist	flut-ist
in-ter-minable	in-ter-mi-na-ble
ho-mo-ge-neous	ho-mo-ge-ne-ous
in-ces-t	in-cest
de-brief-in-g	debriefing
coral	cor-al
sky-scraper	sky-scrap-er
e-bul-lien-t	e-bul-lient
s-care-mon-ger	scare-mon-ger
minaret	min-a-ret
per-hap-s	per-haps
i-nat-ten-tive	in-at-ten-tive
di-ver-gen-t	di-ver-gent
pre-sum-ably	pre-sum-a-bly
perquisite	per-qui-site
s-i-nu-soid	si-nus-oid
bristling	bris-tling
naughty	naugh-ty
echid-na	e-chid-na
ath-let-ic-s	ath-let-ics
but-tery	but-ter-y
tav-er-na	ta-ver-na
quadrupole	quad-ru-pole
earnest-ness	ear-nest-ness
herbal-is-m	her-bal-ism
lava-to-ry	lav-a-to-ry
em-bassy	em-bas-sy
ide-al-ist	i-de-al-ist
buf-foon-ery	buf-foon-er-y
zigza-g	zig-zag
coinage	coin-age
s-lob-ber	slob-ber
spin-naker	spin-na-ker
s-to-ry-line	sto-ry-line
disin-gen-u-ous	dis-in-gen-u-ous
per-fec-t	per-fect
fin-ery	fin-er-y
net-bal-l	net-ball
cor-rec-t	cor-rect
ca-reerist	ca-reer-ist
avoid-able	a-void-a-ble
zany	za-ny
zona-tion	zo-na-tion
eru-di-tion	er-u-di-tion
liqueur	li-queur
in-ter-change-ably	in-ter-change-a-bly
un-cre-ative	un-cre-a-tive
reap-ply	re-ap-ply
c-it-i-zen-ship	cit-i-zen-ship
diathermy	di-a-ther-my
bony	bon-y
o-culist	oc-u-list
rhyth-m	rhythm
or-di-nary	or-di-nar-y
cred-it-wor-thy	cred-it-worth-y
ap-petite	ap-pe-tite
ge-o-mag-net-i-cal-ly	ge-o-mag-ne-ti-cal-ly
k-ismet	kis-met
s-tu-dious	stu-di-ous
painter	paint-er
u-n-ad-dressed	un-ad-dressed
struc-tural-ly	struc-tur-al-ly
gloat-ing	gloating
re-formist	re-form-ist
backspace	back-space
ap-pel-lan-t	ap-pel-lant
d-if-fract	dif-fract
de-mo-graph-ic-s	dem-o-graph-ics
talon	tal-on
preva-len-t	prev-a-lent
parent-age	par-ent-age
hab-it-able	hab-it-a-ble
or-tho-doxy	or-tho-dox-y
cata-ton-ic	cat-a-ton-ic
macro-cos-m	mac-ro-cosm
hy-gien-ic	hy-gi-en-ic
sub-servience	sub-ser-vi-ence
catas-tro-phe	ca-tas-tro-phe
di-nosaur	di-no-saur
plenipo-ten-tiary	plen-i-po-ten-ti-ar-y
ref-er-ee-ing	re-fe-ree-ing
dis-abil-i-ty	dis-a-bil-i-ty
junkie	jun-kie
for-syth-ia	for-syth-i-a
in-flat-able	in-flat-a-ble
the-is-m	the-ism
dither	dith-er
pleas-an-t	pleas-ant
dis-burse-men-t	dis-burse-ment
un-fet-tered	unfettered
s-panker	spank-er
at-tach-men-t	at-tach-ment
sec-re-tar-iat	sec-re-tar-i-at
caliper	cal-i-per
im-prison	im-pris-on
over-throw	o-ver-throw
mis-rep-re-sen-t	mis-rep-re-sent
sac-risty	sac-ris-ty
zoo-plank-ton	zo-o-plank-ton
dol-drum-s	dol-drums
fil-a-men-t	fil-a-ment
s-in-cere	sin-cere
wapi-ti	wap-i-ti
grasshop-per	grass-hop-per
twister	twist-er
frag-men-tary	frag-men-tar-y
sou-venir	sou-ve-nir
di-ver-sion-ary	di-ver-sion-ar-y
ovu-la-tion	ov-u-la-tion
poly-thene	pol-y-thene
im-pe-cu-nious	im-pe-cu-ni-ous
s-e-lec-tive-ly	se-lec-tive-ly
s-can-dal	scan-dal
s-mirk	smirk
millinery	mil-li-ner-y
promi-nent-ly	prom-i-nent-ly
e-quidis-tan-t	e-qui-dis-tant
spir-i-tu-al	spir-it-u-al
omen	o-men
s-pace-craft	space-craft
essence	es-sence
glam-orous	glam-or-ous
luke-war-m	luke-warm
un-suit-able	un-suit-a-ble
stealth-ily	stealth-i-ly
promis-cu-ity	prom-is-cu-i-ty
tele-scope	tel-e-scope
nifty	nif-ty
tele-vi-sion	tel-e-vi-sion
s-i-nu-soidal	si-nus-oi-dal
phleg-m	phlegm
even-tu-al	e-ven-tu-al
s-noop	snoop
s-trate-gi-cal-ly	stra-te-gi-cal-ly
s-toope-d	stooped
quiet-ness	qui-et-ness
mea-sure-men-t	meas-ure-ment
cys-t	cyst
dig-ni-tary	dig-ni-tar-y
cretin	cre-tin
de-men-t	de-ment
min-istry	min-is-try
i-nar-tic-u-late	in-ar-tic-u-late
out-stretched	outstretched
coun-ter-ac-t	coun-ter-act
wicked	wick-ed
s-lug-gard	slug-gard
pikestaff	pike-staff
de-nial	de-ni-al
nitwit	nit-wit
p-light	plight
epi-logue	ep-i-logue
pseudony-mous	pseu-don-y-mous
i-n-ac-cu-rate	in-ac-cu-rate
lever	lev-er
aver	a-ver
hexag-o-nal	hex-ag-o-nal
pyra-mid	pyr-a-mid
ox-i-dan-t	ox-i-dant
ori-en-t	o-ri-ent
over-pow-er	o-ver-pow-er
dis-senter	dis-sent-er
grapeshot	grape-shot
debonair	deb-o-nair
wastrel	wast-rel
feu-dal-is-m	feu-dal-ism
be-fal-l	be-fall
hon-esty	hon-es-ty
op-ti-mis-m	op-ti-mism
enor-mi-ty	e-nor-mi-ty
n-erve	nerve
bug-gered	buggered
lethar-gy	leth-ar-gy
epis-temic	ep-i-ste-mic
sym-po-sium	sym-po-si-um
opine	o-pine
carafe	ca-rafe
dis-con-ti-nu-ity	dis-con-ti-nu-i-ty
trigonom-e-try	trig-o-nom-e-try
chimera	chi-me-ra
budgeri-gar	budg-er-i-gar
pro-gressed	progressed
batik	ba-tik
aqualung	aq-ua-lung
zealot	zeal-ot
s-tat-ue	stat-ue
devo-tee	dev-o-tee
g-lyc-erol	glyc-er-ol
im-muno-sup-pres-sive	im-mu-no-sup-pres-sive
im-per-son-ator	im-per-son-a-tor
hermeneu-tic	her-me-neu-tic
raver	rav-er
s-nuff-box	snuff-box
u-n-avoid-able	un-a-void-a-ble
e-h	eh
dis-rup-t	dis-rupt
ben-der	bend-er
mon-u-men-t	mon-u-ment
e-s-prit	es-prit
hypochon-dri-a	hy-po-chon-dri-a
prophet-ic	pro-phet-ic
re-dis-cov-ery	re-dis-cov-er-y
cin-e-matog-ra-phy	cin-e-ma-tog-ra-phy
dis-union	dis-un-ion
polem-i-cal	po-lem-i-cal
physique	phy-sique
aque-ous	a-que-ous
py-rotech-nic-s	py-ro-tech-nics
s-tan-dard	stand-ard
s-lug	slug
ori-en-tal-is-m	o-ri-en-tal-ism
prof-itabil-i-ty	prof-it-a-bil-i-ty
repa-tri-ate	re-pa-tri-ate
ini-tial-ly	in-i-tial-ly
s-traight-for-ward-ly	straight-for-ward-ly
pla-gia-ris-m	pla-gia-rism
loca-tive	loc-a-tive
so-ci-olin-guis-tic-s	so-ci-o-lin-guis-tics
plan-e-tary	plan-e-tar-y
scrip-t	script
p-re-sen-ta-tion-al	pres-en-ta-tion-al
bio-di-ver-si-ty	bi-o-di-ver-si-ty
repa-tri-a-tion	re-pa-tri-a-tion
es-tu-ary	es-tu-ar-y
chap-s	chaps
painful	pain-ful
im-politic	im-pol-i-tic
above	a-bove
rein-sur-ance	re-in-sur-ance
sauna	sau-na
tour-na-men-t	tour-na-ment
s-plin-ter	splin-ter
s-cores	scores
squadron	squad-ron
reper-toire	rep-er-toire
defini-tive-ly	de-fin-i-tive-ly
or-ga-nize	or-gan-ize
reclu-sive	re-clu-sive
pig-men-t	pig-ment
aster	as-ter
epi-cure	ep-i-cure
penal-ty	pen-al-ty
de-cryp-t	de-crypt
in-fan-t	in-fant
t-int-ed	tinted
elec-troneg-a-tive	e-lec-tro-neg-a-tive
s-nook-er	snook-er
bac-te-rio-phage	bac-te-ri-o-phage
sunken	sunk-en
across	a-cross
flut-ter-ing	fluttering
hit-table	hit-ta-ble
c-on-cil-i-ate	con-cil-i-ate
hap-py-goluck-y	hap-py-go-luck-y
regi-cide	reg-i-cide
mandible	man-di-ble
out-landish	out-land-ish
plumy	plum-y
top-i-ary	to-pi-ar-y
sala-man-der	sal-a-man-der
recorder	re-cord-er
ca-cophonous	ca-coph-o-nous
carmine	car-mine
tel-l	tell
mul-ti-pro-ces-sor	mul-ti-proc-es-sor
brawny	brawn-y
ex-tra-galac-tic	ex-tra-ga-lac-tic
porta-bil-i-ty	port-a-bil-i-ty
sev-ered	severed
racial-ly	ra-cial-ly
gazette	ga-zette
cata-ma-ran	cat-a-ma-ran
posse	pos-se
aphid	a-phid
n-u-mis-mat-ic	nu-mis-mat-ic
at-trac-t	at-tract
bungee	bun-gee
dis-avow	dis-a-vow
ji-u-jit-su	jiu-jit-su
a-tone-men-t	a-tone-ment
en-trap-men-t	en-trap-ment
wind-mil-l	wind-mill
stager	stag-er
e-voca-tive	e-voc-a-tive
moral-i-ty	mo-ral-i-ty
taskmas-ter	task-mas-ter
tidi-ness	ti-di-ness
s-moother	smooth-er
n-ear-sight-ed	near-sight-ed
en-light-en-men-t	en-light-en-ment
tele-vise	tel-e-vise
en-gage-men-t	en-gage-ment
mi-crocode	mi-cro-code
laager	laa-ger
codex	co-dex
base-men-t	base-ment
shrub-bery	shrub-ber-y
forest-ed	forested
mem-o-rable	mem-o-ra-ble
pi-ran-ha	pi-ra-nha
quaf-f	quaff
mas-tery	mas-ter-y
huffy	huff-y
vestibule	ves-ti-bule
an-tipa-thy	an-tip-a-thy
mela-tonin	mel-a-to-nin
philoso-pher	phi-los-o-pher
n-erd	nerd
legged	leg-ged
telling	tell-ing
s-to-ical	sto-i-cal
in-no-cen-t	in-no-cent
gig-gling	giggling
e-vic-t	e-vict
pre-de-ter-mined	predetermined
mori-bund	mor-i-bund
be-lit-tling	belittling
pre-tender	pre-tend-er
mis-s	miss
tal-en-t	tal-ent
hi-jack-ing	hi-jac-king
penol-o-gy	pe-nol-o-gy
clash-ing	clashing
impi	im-pi
frailty	frail-ty
poly-math	pol-y-math
karate	ka-ra-te
phy-lac-tery	phy-lac-ter-y
c-og-nizan-t	cog-ni-zant
break-able	break-a-ble
tute-lary	tu-te-lar-y
fruity	fruit-y
in-farc-t	in-farct
im-pair-men-t	im-pair-ment
mul-ti-for-m	mul-ti-form
tute-lage	tu-te-lage
u-nau-dit-ed	un-au-dit-ed
floaty	float-y
soli-tude	sol-i-tude
vex-ing	vexing
co-in-ci-den-t	co-in-ci-dent
mega-volt	meg-a-volt
cheater	cheat-er
talkie	talk-ie
de-con-struc-t	de-con-struct
the-saurus	the-sau-rus
re-al-is-m	re-al-ism
sur-vivor	sur-vi-vor
sec-tar-i-an-is-m	sec-tar-i-an-ism
preg-nan-t	preg-nant
lol-l	loll
s-teer	steer
di-elec-tric	di-e-lec-tric
peas-an-t	peas-ant
karakul	kar-a-kul
em-bez-zle-men-t	em-bez-zle-ment
ovoid	o-void
baldy	bald-y
grass-root-s	grass-roots
cru-ci-for-m	cru-ci-form
aor-tic	a-or-tic
doyen	doy-en
styrene	sty-rene
o-nion	on-ion
sabra	sa-bra
solid-ly	sol-id-ly
chal-lenger	chal-leng-er
poly-graph	pol-y-graph
sewage	sew-age
bribery	brib-er-y
ar-guable	ar-gu-a-ble
u-n-ac-cept-ably	un-ac-cept-a-bly
m-i-lieu	mi-lieu
in-fras-truc-tural	in-fra-struc-tur-al
trea-sure	treas-ure
toma-to	to-ma-to
frilly	frill-y
sinewy	sin-ew-y
la-ten-t	la-tent
en-chant-men-t	en-chant-ment
gourmet	gour-met
woody	wood-y
as-tro-nau-tic-s	as-tro-nau-tics
drainage	drain-age
c-it-rus	cit-rus
chore-a	cho-re-a
spec-tropho-tome-ter	spec-tro-pho-tom-e-ter
ri-ot-ing	ri-o-ting
gan-g-ly	gan-gly
taber-na-cle	tab-er-nac-le
quirky	quirk-y
iron-mon-ger	i-ron-mon-ger
un-con-trol-lable	un-con-trol-la-ble
macrophage	mac-ro-phage
seaborne	sea-borne
rigid-i-fy	ri-gid-i-fy
in-con-sid-er-able	in-con-sid-er-a-ble
busy-body	bus-y-bod-y
bumper	bump-er
ketchup	ketch-up
e-jec-t	e-ject
adap-t	a-dapt
s-nub	snub
over-write	o-ver-write
cowslip	cow-slip
rub-bery	rub-ber-y
ukulele	u-ku-le-le
hearti-ly	heart-i-ly
undiplo-mat-ic	un-dip-lo-mat-ic
s-tra-tus	stra-tus
dairy-ing	dair-y-ing
pyra-mi-dal	py-ram-i-dal
ru-mi-nan-t	ru-mi-nant
quar-t	quart
in-dic-t	in-dict
pachy-der-m	pach-y-derm
com-plainan-t	com-plain-ant
ped-a-gogy	ped-a-go-gy
over-load-ed	overloaded
s-laugh-ter	slaugh-ter
winger	wing-er
tele-pho-to	tel-e-pho-to
prebendary	preb-en-dar-y
cop-pery	cop-per-y
flood-ing	flooding
sym-bol-is-m	sym-bol-ism
over-wrought	o-ver-wrought
en-trench-men-t	en-trench-ment
in-hibitor	in-hib-i-tor
rar-efac-tion	rar-e-fac-tion
con-cussed	concussed
awak-en	a-wak-en
var-ie-gat-ed	var-i-e-gat-ed
cob-we-b	cob-web
wa-ter-fal-l	wa-ter-fall
boun-teous	boun-te-ous
there-about-s	there-a-bouts
in-fil-l	in-fill
hooray	hoo-ray
eggshel-l	egg-shell
mono-gram	mon-o-gram
over-writ-ing	overwriting
necro-mancer	nec-ro-man-cer
s-chem-ing	schem-ing
glan-s	glans
on-ag-er	on-a-ger
s-tarfish	star-fish
con-fir-m	con-firm
er-a	e-ra
plan-gen-t	plan-gent
paci-fis-m	pac-i-fism
un-demo-crat-ic	un-dem-o-crat-ic
un-prece-dent-ed	un-prec-e-dent-ed
s-nob-bery	snob-ber-y
s-teer-ing	steer-ing
ves-ti-gial	ves-tig-i-al
green-ery	green-er-y
flow-ery	flow-er-y
im-per-turbable	im-per-turb-a-ble
ringlet	ring-let
lanky	lank-y
d-e-ductible	de-duct-i-ble
cham-p	champ
de-bat-able	de-bat-a-ble
helpline	help-line
un-easi-ness	un-eas-i-ness
dearie	dear-ie
sinker	sink-er
math-s	maths
thau-maturge	thau-ma-turge
s-teeple-jack	stee-ple-jack
maya	ma-ya
aque-duc-t	aq-ue-duct
arach-noid	a-rach-noid
as-trin-gen-t	as-trin-gent
s-noop-ing	snooping
s-toep	stoep
y-olk	yolk
para-mount	par-a-mount
over-shoot	o-ver-shoot
lurid	lu-rid
glasshouse	glass-house
lectern	lec-tern
cor-rup-t	cor-rupt
vo-cab-u-lary	vo-cab-u-lar-y
re-spectabil-i-ty	re-spect-a-bil-i-ty
more-over	more-o-ver
sideshow	side-show
hook-ing	hooking
volup-tuous	vo-lup-tu-ous
re-tiree	re-tir-ee
apoc-a-lypse	a-poc-a-lypse
merid-i-an	me-rid-i-an
con-scrip-t	con-script
poly-mor-phis-m	pol-y-mor-phism
re-plen-ish-men-t	re-plen-ish-ment
fa-ther-ing	fathering
con-juror	con-ju-ror
lessor	les-sor
p-salmist	psalm-ist
borstal	bor-stal
balder-dash	bal-der-dash
re-gret-table	re-gret-ta-ble
heart-en-ing	heartening
mis-align-men-t	mis-a-lign-ment
virus	vi-rus
how-itzer	how-itz-er
weary-ing	wea-ry-ing
er-bium	er-bi-um
s-ta-tis-ti-cal	sta-tis-ti-cal
dullard	dull-ard
por-ta-ble	port-a-ble
s-car	scar
trust-ed	trusted
no-body	no-bod-y
record-ing	re-cord-ing
physic	phys-ic
barter	bar-ter
s-caf-fold	scaf-fold
per-mit-ting	permitting
dis-mal-l-y	dis-mal-ly
sub-terfuge	sub-ter-fuge
pes-simis-m	pes-si-mism
frip-pery	frip-per-y
cir-cum-lo-cu-to-ry	cir-cum-loc-u-to-ry
heather	heath-er
odome-ter	o-dom-e-ter
er-gonom-ic	er-go-nom-ic
syl-labary	syl-la-bar-y
hi-ero-glyph	hi-er-o-glyph
chas-m	chasm
beloved	be-lov-ed
take-away	take-a-way
dyad	dy-ad
duo-de-num	du-o-de-num
d-if-fi-cul-ty	dif-fi-cul-ty
s-light	slight
pi-anis-si-mo	pi-a-nis-si-mo
cathar-tic	ca-thar-tic
undis-guised	un-dis-guised
en-vi-ron-men-tal-is-m	en-vi-ron-men-tal-ism
shal-l	shall
archetype	ar-che-type
ev-ery-day	eve-ry-day
fron-t	front
s-tub-born	stub-born
vol-un-tary	vol-un-tar-y
com-man-dan-t	com-man-dant
sim-per-ing	simpering
charis-ma	cha-ris-ma
un-for-giv-able	un-for-giv-a-ble
s-ap	sap
de-lin-eation	de-lin-e-a-tion
i-n-ad-mis-si-ble	in-ad-mis-si-ble
b-o-rate	bo-rate
y-oung	young
roast-ed	roasted
un-ob-serv-able	un-ob-serv-a-ble
grumpy	grump-y
whomev-er	whom-ev-er
ir-re-proach-able	ir-re-proach-a-ble
oc-cu-pan-t	oc-cu-pant
margina-li-a	mar-gi-na-li-a
s-toop	stoop
spooky	spook-y
caprice	ca-price
triv-ial	triv-i-al
melee	me-lee
painkiller	pain-kil-ler
s-ludge	sludge
over-ful-l	o-ver-full
s-lat-ted	slat-ted
s-cen-t	scent
as-cetic	as-cet-ic
in-fect-ed	in-fec-ted
herbal-ist	herb-al-ist
cir-cum-ven-t	cir-cum-vent
hin-t	hint
guardian	guard-i-an
i-n-ac-cu-ra-cy	in-ac-cu-ra-cy
over-win-ter	o-ver-win-ter
un-charis-mat-ic	un-char-is-mat-ic
odd-s	odds
un-scrupu-lous	un-scru-pu-lous
blue-bel-l	blue-bell
s-moth-ered	smothered
u-n-ac-knowl-edged	un-ac-knowl-edged
sepi-a	se-pi-a
ra-dia-tive	ra-di-a-tive
n-im-ble-ness	nim-ble-ness
ty-pog-ra-pher-s	ty-po-gra-phers
di-rec-t	di-rect
ouster	oust-er
ar-madil-lo	ar-ma-dil-lo
majesty	maj-es-ty
out-sel-l	out-sell
pota-to	po-ta-to
bac-teri-um	bac-te-ri-um
math-e-mat-ic-s	math-e-mat-ics
s-nag	snag
pro-pa-gan-da	prop-a-gan-da
jerky	jerk-y
pauci-ty	pau-ci-ty
un-de-tectable	un-de-tect-a-ble
voodoo	voo-doo
misty	mist-y
diminu-tive	di-min-u-tive
baili-wick	bail-i-wick
semi-cir-cu-lar	sem-i-cir-cu-lar
robin	rob-in
as-cen-der	as-cend-er
re-trac-t	re-tract
de-sir-able	de-sir-a-ble
geno-ci-dal	gen-o-cid-al
s-mug-gling	smuggling
col-lec-tivis-m	col-lec-tiv-ism
felo-nious	fe-lo-ni-ous
crum-by	crumb-y
es-capist	es-cap-ist
g-narl	gnarl
pre-dom-i-nan-t	pre-dom-i-nant
in-es-timable	in-es-ti-ma-ble
enig-mat-ic	en-ig-mat-ic
moder-ni-ty	mo-der-ni-ty
har-m	harm
li-censee	li-cen-see
pome-lo	pom-e-lo
crum-b	crumb
s-mashed	smashed
chas-ten-ing	chastening
avari-cious	av-a-ri-cious
charge-able	charge-a-ble
laugh-able	laugh-a-ble
over-man-tel	o-ver-man-tel
g-lut	glut
demon-strate	dem-on-strate
reaf-fir-ma-tion	re-af-fir-ma-tion
con-ceal-men-t	con-ceal-ment
breather	breath-er
recom-mence	re-com-mence
s-cour	scour
tangy	tang-y
un-trans-lat-able	un-trans-lat-a-ble
con-stituen-cy	con-stit-u-en-cy
ter-rapin	ter-ra-pin
over-sub-scribed	o-ver-sub-scribed
en-graver	en-grav-er
com-forter	com-fort-er
doughty	dough-ty
epis-te-mol-o-gy	e-pis-te-mol-o-gy
cen-t	cent
screwy	screw-y
un-speak-able	un-speak-a-ble
fontanel	fon-ta-nel
lu-bri-can-t	lu-bri-cant
pinkie	pink-ie
in-ter-locu-to-ry	in-ter-loc-u-to-ry
brethren	breth-ren
visa	vi-sa
bur-gundy	bur-gun-dy
bistable	bi-sta-ble
reser-va-tion	res-er-va-tion
artistry	art-ist-ry
thrifty	thrift-y
phi-lan-thropist	phi-lan-thro-pist
s-cape	scape
ra-tio-nal-ly	ra-tion-al-ly
lim-iter	lim-it-er
as-cen-dan-t	as-cend-ant
mush-room-ing	mushrooming
de-pen-dence	de-pend-ence
s-lan-der-ous	slan-der-ous
in-ge-nious-ly	in-gen-ious-ly
cedar	ce-dar
u-n-al-lo-cat-ed	un-al-lo-cat-ed
gener-ic	ge-ner-ic
han-dover	hand-o-ver
as-sort-men-t	as-sort-ment
sub-unit	sub-u-nit
laser	la-ser
over-strung	o-ver-strung
penknife	pen-knife
chem-istry	chem-is-try
ca-su-al-ty	cas-u-al-ty
solem-ni-ty	so-lem-ni-ty
hered-i-tary	he-red-i-tar-y
an-thro-po-mor-phis-m	an-thro-po-mor-phism
b-lessed-ness	bless-ed-ness
s-corcher	scorch-er
risky	risk-y
pan-the-is-m	pan-the-ism
de-cathlon	de-cath-lon
salu-tary	sal-u-tar-y
sub-lu-nary	sub-lu-nar-y
tillage	till-age
protest	pro-test
freighter	freight-er
pout-ing	pouting
goa-tee	goat-ee
re-arrange-ment	re-ar-range-ment
s-toked	stoked
punc-til-ious	punc-til-i-ous
telepa-thy	te-lep-a-thy
curvy	curv-y
d-win-dle	dwin-dle
di-alec-ti-cal	di-a-lec-ti-cal
com-pact-ed	compacted
ma-chin-ery	ma-chin-er-y
famine	fam-ine
lik-able	lik-a-ble
episode	ep-i-sode
claiman-t	claim-ant
mono-logue	mon-o-logue
stil-l	still
valu-able	val-u-a-ble
award	a-ward
im-pro-vi-sa-tion-al	im-prov-i-sa-tion-al
con-junc-t	con-junct
dis-abled	dis-a-bled
over-board	o-ver-board
mine-strone	min-e-stro-ne
psy-chother-a-pist	psy-cho-ther-a-pist
u-n-alike	un-a-like
vir-tu-oso	vir-tu-o-so
im-muno-com-pro-mised	im-mu-no-com-pro-mised
in-vert-ed	inverted
meta-lan-guage	met-a-lan-guage
yeti	yet-i
epi-demi-o-log-i-cal	ep-i-de-mi-o-log-i-cal
anony-mous	a-non-y-mous
in-tel-li-gentsi-a	in-tel-li-gent-si-a
chara-banc	char-a-banc
in-ter-men-t	in-ter-ment
hypochon-dri-a-cal	hy-po-chon-dri-a-cal
nestling	nest-ling
humbly	hum-bly
bi-car-b	bi-carb
pil-l	pill
squea-mish	squeam-ish
u-nat-tend-ed	un-at-tend-ed
baby-ish	ba-by-ish
over-ca-pac-i-ty	o-ver-ca-pac-i-ty
eigh-teenth	eight-eenth
s-neak-ing	sneak-ing
poundage	pound-age
dizzy	diz-zy
cleaver-s	cleav-ers
dopey	dope-y
e-vanes-cen-t	ev-a-nes-cent
notepa-per	note-pa-per
li-able	li-a-ble
s-pace-ship	space-ship
pro-pri-ety	pro-pri-e-ty
over-hear	o-ver-hear
prod-uc-t	prod-uct
het-ero-sex-u-al	het-er-o-sex-u-al
scrol-l	scroll
avowed-ly	a-vow-ed-ly
predilec-tion	pre-di-lec-tion
t-in-pot	tin-pot
op-por-tunis-tic	op-por-tun-is-tic
de-po-si-tion	dep-o-si-tion
filmy	film-y
n-er-vous	nerv-ous
nympho-ma-ni-a	nym-pho-ma-ni-a
civic-s	civ-ics
y-acht-ing	yacht-ing
colo-nial-ist	co-lo-ni-al-ist
con-fron-t	con-front
u-n-al-loyed	un-al-loyed
madri-gal	mad-ri-gal
palate	pal-ate
sus-tain-abil-i-ty	sus-tain-a-bil-i-ty
pa-tien-t	pa-tient
bushy	bush-y
floury	flour-y
chewy	chew-y
at-mo-spher-ic	at-mos-pher-ic
sys-temic	sys-tem-ic
over-heat-ed	overheated
bedrid-den	bed-rid-den
can-dlelit	can-dle-lit
evo-lute	ev-o-lute
as-so-ciate	as-so-ci-ate
cra-nial	cra-ni-al
scrip-tural	scrip-tur-al
man-i-cured	ma-ni-cured
pen-tathlon	pen-tath-lon
gaze-bo	ga-ze-bo
t-in-gle	tin-gle
flotil-la	flo-til-la
hussy	hus-sy
com-pan-ion-able	com-pan-ion-a-ble
petro-chem-i-cal	pet-ro-chem-i-cal
joust-ing	jousting
moi-ety	moi-e-ty
ob-streper-ous	ob-strep-er-ous
gullible	gul-li-ble
at-tribu-tive	at-trib-u-tive
mean-s	means
breast-feed	breastfeed
medic	med-ic
in-tel-li-gen-t	in-tel-li-gent
polo-ni-um	po-lo-ni-um
ranter	rant-er
y-oung-ster	young-ster
pan-das	pan-das
en-counter	en-coun-ter
laun-dered	laundered
paving	pav-ing
clien-t	cli-ent
undis-tin-guished	un-dis-tin-guished
oakum	oa-kum
quartzite	quartz-ite
smithy	smith-y
s-e-lec-tor	se-lec-tor
spher-oid	sphe-roid
over-e-mo-tion-al	o-ver-e-mo-tion-al
elec-troen-cephalo-gram	e-lec-tro-en-ceph-a-lo-gram
crazi-ly	cra-zi-ly
furtive	fur-tive
curlew	cur-lew
en-tan-gle-men-t	en-tan-gle-ment
pesky	pes-ky
ful-mi-nan-t	ful-mi-nant
supreme-ly	su-preme-ly
satchel	satch-el
re-liance	re-li-ance
brassiere	bras-siere
timid	tim-id
s-tock-ist	stock-ist
mis-treat-men-t	mis-treat-ment
crack-er-s	crack-ers
per-ish-able	per-ish-a-ble
tyran-ni-cide	ty-ran-ni-cide
re-liv-e	re-live
grouper	group-er
demon-stra-ble	de-mon-stra-ble
car-bona-ceous	car-bo-na-ceous
mu-cosa	mu-co-sa
con-so-nan-t	con-so-nant
en-tourage	en-tou-rage
foothill	foot-hill
s-tub-bly	stub-bly
handy	hand-y
s-corn-ful	scorn-ful
in-de-fati-ga-ble	in-de-fat-i-ga-ble
per-cu-ta-neous	per-cu-ta-ne-ous
knol-l	knoll
un-remit-ting	un-re-mit-ting
elvish	elv-ish
en-able	en-a-ble
warpaint	war-paint
man-dolin	man-do-lin
gala	ga-la
in-di-rec-t	in-di-rect
biom-e-try	bi-om-e-try
which-ever	which-ev-er
foxy	fox-y
xeno-pho-bic	xen-o-pho-bic
re-sis-tance	re-sist-ance
verisimil-i-tude	ver-i-si-mil-i-tude
bal-cony	bal-co-ny
ra-dio-g-ra-pher	ra-di-og-ra-pher
s-nap	snap
mag-ne-tome-ter	mag-ne-tom-e-ter
vig-i-lan-t	vig-i-lant
archangel	arch-an-gel
apish	ap-ish
theoc-ra-cy	the-oc-ra-cy
com-mis-sioned	commissioned
stopover	stop-o-ver
asymp-tote	as-ymp-tote
sala-mi	sa-la-mi
ship-men-t	ship-ment
pro-pri-eto-ri-al	pro-pri-e-to-ri-al
legu-mi-nous	le-gu-mi-nous
over-ex-po-sure	o-ver-ex-po-sure
u-n-a-mused	un-a-mused
re-liant	re-li-ant
gov-ern-men-t	gov-ern-ment
perky	perk-y
coven	cov-en
translu-cen-t	trans-lu-cent
s-cary	scar-y
awning	awn-ing
rapid	rap-id
nu-tri-en-t	nu-tri-ent
mega-phone	meg-a-phone
cho-ris-ter	chor-is-ter
hy-gien-e	hy-giene
s-tim-u-lat-ing	stim-u-lat-ing
tweedy	tweed-y
s-tate-less	state-less
dactyl	dac-tyl
e-q-ui-table	eq-ui-ta-ble
s-to-ry-book	sto-ry-book
l-o-gis-ti-cal	lo-gis-ti-cal
mantrap	man-trap
di-ary	di-a-ry
in-stan-ta-neous	in-stan-ta-ne-ous
a-ca-dem-ic	ac-a-dem-ic
lol-lipop	lol-li-pop
ca-ress-ing	ca-res-sing
pru-den-t	pru-dent
milky	milk-y
mis-cel-lany	mis-cel-la-ny
mae-stro	maes-tro
ver-dic-t	ver-dict
ridicu-lous-ly	ri-dic-u-lous-ly
coro-n-a	co-ro-na
s-nail	snail
her-i-tabil-i-ty	her-it-a-bil-i-ty
s-mut-ty	smut-ty
bur-bling	burbling
un-men-tion-able	un-men-tion-a-ble
s-tan-za	stan-za
seascape	sea-scape
con-duct-ed	conducted
sul-tana	sul-tan-a
myelin	my-e-lin
her-s	hers
s-tack	stack
spon-sored	sponsored
ex-pec-tant-ly	ex-pect-ant-ly
ri-otous	ri-ot-ous
habit	hab-it
overindul-gence	o-ver-in-dul-gence
tur-bocharged	turbocharged
un-bear-ably	un-bear-a-bly
com-pli-men-t	com-pli-ment
s-in-ful	sin-ful
d-inghy	din-ghy
papil-la	pa-pil-la
ranker	rank-er
em-piri-cis-m	em-pir-i-cism
lit-er-al-is-m	lit-er-al-ism
brief-in-g	brief-ing
an-nu-ity	an-nu-i-ty
in-cen-di-ary	in-cen-di-ar-y
e-vo-ca-tion	ev-o-ca-tion
i-n-or-di-nate-ly	in-or-di-nate-ly
elitism	e-lit-ism
whirlpool	whirl-pool
sounder	sound-er
misog-y-ny	mi-sog-y-ny
he-liotrope	he-li-o-trope
cir-cling	circling
re-sult-ing	resulting
saga	sa-ga
quan-tifi-ca-tion	quan-ti-fi-ca-tion
the-atri-cal-s	the-at-ri-cals
fur-rowed	furrowed
b-land-ness	bland-ness
so-ci-etal	so-ci-e-tal
unso-cial	un-so-cial
heraldic	he-ral-dic
di-rec-torate	di-rec-to-rate
rhubar-b	rhu-barb
par-alin-guis-tic	par-a-lin-guis-tic
i-n-un-date	in-un-date
knitwear	knit-wear
un-spen-t	un-spent
aqua-ma-rine	aq-ua-ma-rine
l-it-i-gate	lit-i-gate
ap-pease-men-t	ap-pease-ment
tele-path-ic	tel-e-path-ic
brun-t	brunt
so-lic-it-ing	soliciting
ha-cien-da	ha-ci-en-da
sausage	sau-sage
minu-ti-ae	mi-nu-ti-ae
pim-p	pimp
arabesque	ar-a-besque
tena-cious-ly	te-na-cious-ly
beanie	bean-ie
dandy	dan-dy
coloured	co-loured
feath-ery	feath-er-y
ex-ten-der	ex-tend-er
re-pro-cess	re-proc-ess
patho-log-i-cal	path-o-log-i-cal
charis-mat-ic	char-is-mat-ic
haver-sack	hav-er-sack
y-our	your
poly-no-mi-al	pol-y-no-mi-al
sud-s	suds
rose-mary	rose-mar-y
gu-nite	gun-ite
e-u-pho-ri-a	eu-pho-ri-a
ego	e-go
s-tair	stair
posit	pos-it
fizzy	fizz-y
lin-gerie	lin-ge-rie
pesti-lence	pes-ti-lence
un-en-force-able	un-en-force-a-ble
peri-toneum	per-i-to-ne-um
au-gury	au-gu-ry
oboe	o-boe
bracelet	brace-let
over-done	o-ver-done
clumpy	clump-y
body-guard	bod-y-guard
imag-i-nary	im-ag-i-nar-y
pom-padour	pom-pa-dour
de-mo-li-tion	dem-o-li-tion
litho-graph-ic	lith-o-graph-ic
polyurethane	pol-y-u-re-thane
en-cycli-cal	en-cyc-li-cal
arc-ing	arcing
un-miss-able	un-miss-a-ble
con-temptible	con-tempt-i-ble
seden-tary	sed-en-tar-y
hardy	har-dy
re-strain-t	re-straint
knick-er-s	knick-ers
scrupu-lous	scru-pu-lous
polypep-tide	pol-y-pep-tide
workspace	work-space
g-lu-ta-mate	glu-ta-mate
in-sid-e	in-side
an-teceden-t	an-te-ced-ent
s-to-ic	sto-ic
pan-t	pant
ve-he-men-t	ve-he-ment
ap-t	apt
s-lo-gan	slo-gan
dis-penser	dis-pens-er
playfel-low	play-fel-low
un-for-get-table	un-for-get-ta-ble
teacup	tea-cup
over-stretch	o-ver-stretch
pre-dict-ed	predicted
ves-per-s	ves-pers
prebend	preb-end
un-taugh-t	un-taught
in-cisor	in-ci-sor
phi-lan-thropy	phi-lan-thro-py
e-s-pouse	es-pouse
s-plut-ter	splut-ter
book-able	book-a-ble
geopo-lit-i-cal	ge-o-po-lit-i-cal
pen-i-ten-tiary	pen-i-ten-tia-ry
rekin-dle	re-kin-dle
hooky	hook-y
paean	pae-an
i-cosa-he-dron	i-co-sa-he-dron
bur-geon-ing	burgeoning
dis-cor-dance	dis-cord-ance
he-do-nis-m	he-don-ism
despot-ic	des-pot-ic
con-fi-den-t	con-fi-dent
polygamy	po-lyg-a-my
un-in-tel-li-gen-t	un-in-tel-li-gent
assig-na-tion	as-sig-na-tion
s-cant-y	scant-y
ig-no-ran-t	ig-no-rant
mu-nif-i-cen-t	mu-nif-i-cent
thievish	thiev-ish
bul-letin	bul-le-tin
to-bac-conist	to-bac-co-nist
im-por-tan-t	im-por-tant
strug-gling	struggling
tem-po-rar-ily	tem-po-rar-i-ly
mul-ti-lat-er-al-is-m	mul-ti-lat-er-al-ism
petrol	pet-rol
col-le-gial	col-le-gi-al
ripen	rip-en
cheva-lier	chev-a-lier
speedy	speed-y
grantee	gran-tee
iso-la-tion	i-so-la-tion
s-tock-bro-ker	stock-brok-er
milord	mi-lord
brutish	brut-ish
s-can-dalous	scan-dal-ous
malty	malt-y
af-fec-t	af-fect
skater	skat-er
in-her-en-t	in-her-ent
er-ran-t	er-rant
s-targaze	star-gaze
igua-na	i-gua-na
duik-er	dui-ker
com-mand-men-t	com-mand-ment
dis-gust-ed	disgusted
in-sou-ciant	in-sou-ci-ant
flinch-ing	flin-ching
gazetteer	gaz-et-teer
s-pade	spade
un-de-sir-able	un-de-sir-a-ble
re-vam-p	re-vamp
s-pac-er	spac-er
le-nien-t	le-ni-ent
in-ten-t	in-tent
s-cat-ter	scat-ter
promi-nence	prom-i-nence
podgy	podg-y
d-u-al-i-ty	du-al-i-ty
cus-tom-s	cus-toms
mist-imed	mis-timed
fuch-si-a	fuch-sia
tempter	tempt-er
roughshod	rough-shod
ex-porta-bil-i-ty	ex-por-ta-bi-li-ty
an-techam-ber	an-te-cham-ber
in-den-t	in-dent
s-trag-gle	strag-gle
s-nap-per	snap-per
cy-berspace	cy-ber-space
tran-scrip-t	tran-script
as-trologer	as-trol-o-ger
s-neaky	sneak-y
blowfly	blow-fly
mega-lith	meg-a-lith
ra-dio-gram	ra-di-o-gram
rugged	rug-ged
kaiser	kai-ser
method-ol-o-gy	meth-od-ol-o-gy
con-strain-t	con-straint
ragged	rag-ged
i-conog-ra-phy	i-co-nog-ra-phy
de-canter	de-cant-er
covert-ly	cov-ert-ly
pro-ba-tion-ary	pro-ba-tion-ar-y
malev-o-len-t	ma-lev-o-lent
gam-bling	gam-bling
bailif-f	bail-iff
salu-ta-tion	sal-u-ta-tion
in-fantry	in-fan-try
monoc-u-lar	mo-noc-u-lar
um-bili-cus	um-bil-i-cus
archival	ar-chi-val
af-ter-ward-s	af-ter-wards
schema	sche-ma
basalt	ba-salt
meta-phys-i-cal	met-a-phys-i-cal
s-tair-head	stair-head
corvette	cor-vette
skir-mish-ing	skirmishing
foothold	foot-hold
dis-agree-able	dis-a-gree-a-ble
laud-ed	lauded
cross-over	cross-o-ver
us-able	us-a-ble
un-de-ni-able	un-de-ni-a-ble
in-choate	in-cho-ate
chee-ri-o	cheer-i-o
mort-gagee	mort-ga-gee
s-trange-ness	strange-ness
tetra	tet-ra
s-ketch	sketch
squeaky	squeak-y
steady	stead-y
weasel	wea-sel
tremo-lo	trem-o-lo
el-ven	elv-en
pira-cy	pi-ra-cy
s-tu-pe-fac-tion	stu-pe-fac-tion
data-base	da-ta-base
in-gre-di-en-t	in-gre-di-ent
con-join-t	con-joint
habi-tat	hab-i-tat
s-tut-ter	stut-ter
metronome	met-ro-nome
s-lick	slick
unin-su-lat-ed	un-in-su-lat-ed
u-nattain-able	un-at-tain-a-ble
vol-can-is-m	vol-can-ism
sier-ra	si-er-ra
ban-ter-ing	bantering
coast-ing	coasting
heady	head-y
fir-m	firm
pep-pered	peppered
spec-troscopy	spec-tros-co-py
over-ture	o-ver-ture
usurer	u-su-rer
here-about-s	here-a-bouts
firmware	firm-ware
s-todgy	stodg-y
nymp-holep-sy	nym-pho-lep-sy
piti-ful-ly	pit-i-ful-ly
com-paction	com-pac-tion
rock-etry	rock-et-ry
as-sess-men-t	as-sess-ment
hus-bandry	hus-band-ry
cere-bel-lum	cer-e-bel-lum
over-print	o-ver-print
stinky	stink-y
paraf-fin	par-af-fin
hawthorn	haw-thorn
aux-il-iary	aux-il-ia-ry
un-der-ar-m	un-der-arm
whiten	whit-en
volatile	vol-a-tile
turpi-tude	tur-pi-tude
bronchial	bron-chi-al
cylin-der	cyl-in-der
triathlon	tri-ath-lon
sonorous	so-no-rous
u-n-ap-proach-able	un-ap-proach-a-ble
be-muse-men-t	be-muse-ment
ptero-dactyl	pter-o-dac-tyl
in-quisi-tor	in-quis-i-tor
curie	cu-rie
s-tate	state
mid-wifer-y	mid-wife-ry
epig-ra-phy	e-pig-ra-phy
su-per-posed	superposed
balmy	balm-y
meat-bal-l	meat-ball
pheas-an-t	pheas-ant
in-fini-tive	in-fin-i-tive
un-promis-ing	un-prom-is-ing
pael-la	pa-el-la
s-mash	smash
obe-di-ent-ly	o-be-di-ent-ly
army	ar-my
in-ter-cep-t	in-ter-cept
phos-phatase	phos-pha-tase
cov-et-ed	coveted
d-if-fi-dence	dif-fi-dence
grater	grat-er
s-tu-pid-i-ty	stu-pid-i-ty
sus-tain-ably	sus-tain-a-bly
e-mol-lien-t	e-mol-lient
pas-toral	pas-to-ral
in-ge-nious	in-gen-ious
di-uret-ic	di-u-ret-ic
car-diac	car-di-ac
bagatelle	bag-a-telle
s-nuf-fle	snuf-fle
plea-sur-able	pleas-ur-a-ble
poplar	pop-lar
forester	for-est-er
ver-biage	ver-bi-age
reagen-t	re-a-gent
poseur	po-seur
over-shot	o-ver-shot
ex-ten-t	ex-tent
e-cho	ech-o
thorny	thorn-y
preterite	pret-er-ite
wear-able	wear-a-ble
asep-tic	a-sep-tic
roundup	round-up
over-crowd-ing	o-ver-crow-ding
lacrosse	la-crosse
celiba-cy	cel-i-ba-cy
dossier	dos-si-er
un-sellable	un-sell-a-ble
fid-get	fidg-et
con-toured	contoured
can-taloupe	can-ta-loupe
beanstalk-s	bean-stalks
fun-da-men-tal-is-m	fun-da-men-tal-ism
jester	jest-er
ef-ful-gen-t	ef-ful-gent
steplad-der	step-lad-der
in-dis-tin-guish-able	in-dis-tin-guish-a-ble
ar-gen-t	ar-gent
plat-i-tudi-nous	plat-i-tu-di-nous
le-gionary	le-gion-ar-y
book-binder	book-bind-er
birthright	birth-right
awry	a-wry
couloir	cou-loir
nobly	no-bly
s-can-sion	scan-sion
penin-su-lar	pen-in-su-lar
facet	fac-et
idea	i-de-a
g-luti-nous	glu-ti-nous
neme-sis	nem-e-sis
in-tol-er-an-t	in-tol-er-ant
nan-otech-nol-o-gy	nan-o-tech-nol-o-gy
rep-til-ian	rep-til-i-an
boohoo	boo-hoo
rem-nan-t	rem-nant
iso-stat-ic	i-so-stat-ic
arise	a-rise
cor-re-spon-dence	cor-re-spond-ence
bubon-ic	bu-bon-ic
im-pov-er-ish-men-t	im-pov-er-ish-ment
break-away	break-a-way
s-worn	sworn
drom-e-dary	drom-e-dar-y
es-pi-onage	es-pi-o-nage
dis-per-san-t	dis-per-sant
taboo	ta-boo
rib-aldry	rib-ald-ry
usurp	u-surp
s-ta-men	sta-men
canon-ry	can-on-ry
s-tark	stark
s-tuc-co	stuc-co
aloud	a-loud
seafood	sea-food
mi-di	mid-i
wrinkly	wrin-kly
rain-fal-l	rain-fall
s-laugh-ter-house	slaugh-ter-house
tu-ition	tu-i-tion
s-tarter	start-er
eru-dite	er-u-dite
causal-i-ty	cau-sal-i-ty
pedes-tri-an	pe-des-tri-an
s-tri-at-ed	stri-at-ed
tri-atom-ic	tri-a-tom-ic
mil-i-taris-m	mil-i-ta-rism
panacea	pan-a-ce-a
minesweep-er	mine-sweep-er
deli	del-i
in-equitable	in-eq-ui-ta-ble
b-i-fur-ca-tion	bi-fur-ca-tion
black-bal-l	black-ball
im-agery	im-age-ry
n-ev-er-the-less	nev-er-the-less
renter	rent-er
satiny	sat-in-y
s-lop-pi-ness	slop-pi-ness
florin	flor-in
merid-ion-al	me-rid-i-o-nal
s-ports-man	sports-man
helper	help-er
any-way	an-y-way
in-dis-putably	in-dis-put-a-bly
w-hole-heart-ed	whole-heart-ed
burn-t	burnt
glas-nos-t	glas-nost
chancy	chanc-y
windswep-t	wind-swept
s-lush	slush
in-cip-i-en-t	in-cip-i-ent
un-ques-tion-able	un-ques-tion-a-ble
trel-lised	trellised
gable	ga-ble
trac-ery	trac-er-y
trac-t	tract
taxi-cab	tax-i-cab
iron-i-cal-ly	i-ron-i-cal-ly
con-veyance	con-vey-ance
y-oungish	young-ish
comber	comb-er
catarac-t	cat-a-ract
ev-ery-body	eve-ry-bod-y
pyrite	py-rite
feal-ty	fe-al-ty
erad-i-ca-tion	e-rad-i-ca-tion
quiver	quiv-er
ar-cana	ar-ca-na
coro-na-tion	cor-o-na-tion
so-porif-ic	sop-o-rif-ic
rev-enue	rev-e-nue
odd-men-t	odd-ment
un-car-ed	un-cared
n-od-ule	nod-ule
lazy-bones	la-zy-bones
learned	learn-ed
i-n-ad-ver-tent-ly	in-ad-vert-ent-ly
over-anx-ious	o-ver-anx-ious
s-ta-tis-tics	sta-tis-tics
maisonette	mai-son-ette
bio-sphere	bi-o-sphere
s-nif-f	sniff
sug-gestible	sug-gest-i-ble
re-assess	re-as-sess
apex	a-pex
handy-man	hand-y-man
many	man-y
l-iti-gious	li-ti-gious
cagey	cag-ey
s-aber	sa-ber
bar-baris-m	bar-ba-rism
s-niper	snip-er
reval-ue	re-val-ue
ca-ma-raderie	ca-ma-ra-de-rie
hearthrug	hearth-rug
s-traw-ber-ry	straw-ber-ry
sec-on-dar-i-ly	sec-ond-ar-i-ly
pro-tec-tion-is-m	pro-tec-tion-ism
bub-bling	bubbling
s-trap	strap
cy-ber-net-ic-s	cy-ber-net-ics
s-cotch	scotch
prof-i-teer-ing	profiteering
con-for-mance	con-form-ance
erased	e-rased
gal-lantry	gal-lant-ry
c-i-ta-tion	ci-ta-tion
naive	na-ive
biosyn-the-sis	bi-o-syn-the-sis
mis-an-thropy	mis-an-thro-py
in-stinc-t	in-stinct
hov-e	hove
forestry	for-est-ry
oafish	oaf-ish
con-duc-t	con-duct
d-elec-ta-tion	de-lec-ta-tion
reim-pose	re-im-pose
de-noue-men-t	de-noue-ment
bac-carat	bac-ca-rat
politic	pol-i-tic
volatil-i-ty	vol-a-til-i-ty
mas-sacre	mas-sa-cre
manger	man-ger
both-ered	bothered
undi-gest-ed	un-di-gest-ed
chi-nois-erie	chi-noi-se-rie
s-tud-ded	stud-ded
causative	caus-a-tive
ex-ecu-tor	ex-ec-u-tor
con-vert-ible	con-vert-i-ble
table-land	ta-ble-land
censer	cen-ser
ef-fron-tery	ef-fron-ter-y
roof-in-g	roof-ing
s-port	sport
pushy	push-y
aris-to-crat-ic	a-ris-to-crat-ic
unini-ti-at-ed	un-in-i-ti-at-ed
in-spec-torate	in-spec-tor-ate
beach-comber	beach-comb-er
pre-fec-t	pre-fect
treat-men-t	treat-ment
sym-bio-sis	sym-bi-o-sis
holis-tic	ho-lis-tic
elec-tri-cian	e-lec-tri-cian
col-lapsi-ble	col-laps-i-ble
ir-re-versibly	ir-re-vers-i-bly
avi-ate	a-vi-ate
e-s-pe-cial-ly	es-pe-cial-ly
s-taunch	staunch
trashy	trash-y
co-pro-ces-sor	co-proc-es-sor
repack	re-pack
tara-masala-ta	ta-ra-ma-sa-la-ta
heinous	hei-nous
f-reak	freak
dum-b	dumb
mar-chioness	mar-chion-ess
s-car-i-ly	scar-i-ly
mega-lo-ma-ni-ac	meg-a-lo-ma-ni-ac
s-tran-gu-la-tion	stran-gu-la-tion
car-diopul-monary	car-di-o-pul-mo-nar-y
s-ta-tion-mas-ter	sta-tion-mas-ter
gamy	gam-y
foun-t	fount
pre-lude	prel-ude
hare-bel-l	hare-bell
s-word	sword
v-enue	ven-ue
lantern	lan-tern
un-sup-port-able	un-sup-port-a-ble
buzzer	buzz-er
s-tum-bling	stum-bling
s-plen-did-ly	splen-did-ly
bindweed	bind-weed
api-an	a-pi-an
iso-tope	i-so-tope
com-modor-e	com-mo-dore
epis-co-pal	e-pis-co-pal
soft-bal-l	soft-ball
omi-nous-ly	om-i-nous-ly
pi-rat-ed	pirated
sergean-t	ser-geant
por-ten-t	por-tent
pro-boscis	pro-bos-cis
bel-l	bell
y-outh	youth
wolfish	wolf-ish
howdy	how-dy
blus-ter-ing	blustering
suet	su-et
rook-ery	rook-er-y
syn-onym	syn-o-nym
proac-tive	pro-ac-tive
as-p	asp
as-sailan-t	as-sail-ant
bear-able	bear-a-ble
ide-al-is-m	i-de-al-ism
aor-ta	a-or-ta
pep-pery	pep-per-y
perigee	per-i-gee
haulage	haul-age
pan-creas	pan-cre-as
pala-tine	pal-a-tine
ver-i-fi-able	ver-i-fi-a-ble
footage	foot-age
blood-thirsty	blood-thirst-y
rosin	ros-in
cav-ernous	cav-ern-ous
over-staffed	overstaffed
mo-torist	mo-tor-ist
de-caf-feinate	de-caf-fein-ate
un-der-e-d-u-cat-ed	un-der-ed-u-cat-ed
side-re-al	si-de-re-al
boule-vard	boul-e-vard
labur-num	la-bur-num
satir-i-cal	sa-tir-i-cal
overt-ly	o-vert-ly
un-fa-mil-iar-i-ty	un-fa-mil-i-ar-i-ty
u-nis-sued	un-is-sued
body	bod-y
pre-or-dained	preordained
renown	re-nown
pur-suer	pur-su-er
rheumat-ic	rheu-mat-ic
em-ploy-able	em-ploy-a-ble
im-pro-pri-ety	im-pro-pri-e-ty
rack-e-teer-ing	rack-et-eer-ing
babes	babes
re-gali-a	re-ga-li-a
sober	so-ber
car-dioid	car-di-oid
showy	show-y
sanc-tu-ary	sanc-tu-ar-y
dat-able	dat-a-ble
shep-herdess	shep-herd-ess
walkover	walk-o-ver
or-thorhom-bic	or-tho-rhom-bic
lumpen	lum-pen
un-premed-i-tat-ed	un-pre-med-i-tat-ed
silt-ing	silting
gen-uine-ness	gen-u-ine-ness
tem-po-rary	tem-po-rar-y
de-ca-pod	dec-a-pod
de-rail-men-t	de-rail-ment
dassie	das-sie
bio-chemist	bi-o-chem-ist
phonol-o-gy	pho-nol-o-gy
gra-tu-itous	gra-tu-i-tous
epi-taxy	ep-i-tax-y
bla-tan-t	bla-tant
gen-i-tali-a	gen-i-ta-li-a
con-ver-gen-t	con-ver-gent
tri-den-t	tri-dent
chamomile	cham-o-mile
ra-j	raj
voyeuris-m	vo-yeur-ism
k-ilo-wat-t	kil-o-watt
fugi-tive	fu-gi-tive
rick-ety	rick-et-y
in-com-press-ible	in-com-press-i-ble
propo-si-tion	prop-o-si-tion
tele-graph	tel-e-graph
dis-rep-utable	dis-rep-u-ta-ble
re-lax-ation	re-lax-a-tion
cashier	cash-ier
k-ing-ly	king-ly
ret-i-cen-t	ret-i-cent
ar-chi-pel-ago	ar-chi-pel-a-go
lodestar	lode-star
s-niff-in-g	sniffing
con-sign-men-t	con-sign-ment
fetid	fet-id
s-tain	stain
coura-geous-ly	cou-ra-geous-ly
re-pro-ducible	re-pro-duc-i-ble
serene	se-rene
di-gestible	di-gest-i-ble
ap-proval	ap-prov-al
in-ci-den-t	in-ci-dent
ap-pa-ra-tus	ap-pa-rat-us
electable	e-lect-a-ble
psy-chopath	psy-cho-path
mar-riage-able	mar-riage-a-ble
ure-thra	u-re-thra
tar-if-f	tar-iff
se-mi	sem-i
de-struc-t	de-struct
di-a-bolis-m	di-ab-o-lism
sadis-tic	sa-dis-tic
grand-par-en-t	grand-par-ent
touris-m	tour-ism
s-tock-ing	stock-ing
us-abil-i-ty	us-a-bil-i-ty
s-nake-skin	snake-skin
saga-cious	sa-ga-cious
vulpine	vul-pine
resid-u-al	re-sid-u-al
jit-tery	jit-ter-y
synapse	syn-apse
p-resent-ly	pres-ent-ly
stew-ardess	stew-ard-ess
pow-dery	pow-der-y
paren-the-sis	pa-ren-the-sis
s-losh	slosh
genus	ge-nus
in-signif-i-can-t	in-sig-nif-i-cant
earnest	ear-nest
usu-ri-ous	u-su-ri-ous
delta	del-ta
ful-l	full
suf-frag-ist	suf-fra-gist
foren-sic	fo-ren-sic
dogged	dog-ged
damnable	dam-na-ble
planter	plant-er
lazy	la-zy
crevice	crev-ice
s-plashy	splash-y
head-quar-ter-s	head-quar-ters
s-teeple-chase	stee-ple-chase
con-fronta-tion-al	con-fron-ta-tion-al
sus-pec-t	sus-pect
s-toat	stoat
peace-able	peace-a-ble
e-t-y-mol-o-gy	et-y-mol-o-gy
atom	at-om
de-ify	de-i-fy
s-tock	stock
raster	ras-ter
s-lice	slice
s-mut	smut
l-itur-gi-cal	li-tur-gi-cal
s-pear	spear
beau-teous	beau-te-ous
gelati-nous	ge-lat-i-nous
bad-ger	badg-er
ole-an-der	o-le-an-der
leg-endary	leg-end-ar-y
giblet-s	gib-lets
wash-basin	wash-ba-sin
gym-nas-tic-s	gym-nas-tics
neg-li-gen-t	neg-li-gent
s-tark-ly	stark-ly
dis-claimer	dis-claim-er
con-gealed	congealed
un-mis-tak-ably	un-mis-tak-a-bly
presto	pres-to
diplo-mat-i-cal-ly	dip-lo-mat-i-cal-ly
despot	des-pot
re-flec-t	re-flect
cuboid	cu-boid
em-body	em-bod-y
unloved	un-loved
en-camp-men-t	en-camp-ment
con-tex-t	con-text
blood-wor-m	blood-worm
white-washed	whitewashed
crick-eter	crick-et-er
vista	vis-ta
ob-jec-t	ob-ject
di-a-conal	di-ac-o-nal
s-tand-point	stand-point
metatarsal	met-a-tar-sal
con-coc-t	con-coct
ne-glec-t	ne-glect
punchy	punch-y
s-toned	stoned
predica-men-t	pre-dic-a-ment
s-cuf-f	scuff
in-de-fin-able	in-de-fin-a-ble
read-able	read-a-ble
s-lip-pery	slip-per-y
mit-i-gat-ing	mitigating
pos-i-tivis-m	pos-i-tiv-ism
phos-pho-r	phos-phor
undis-tort-ed	un-dis-tort-ed
tes-ta-men-t	tes-ta-ment
med-dling	meddling
c-ity	cit-y
ide-o-log-i-cal	i-de-o-log-i-cal
poignan-cy	poign-an-cy
pharao-h	phar-aoh
resid-uary	re-sid-u-ar-y
re-spec-t	re-spect
over-cook	o-ver-cook
stylis-tic-s	sty-lis-tics
iso-lat-ing	i-so-lat-ing
ovum	o-vum
ju-nior	jun-ior
en-thralling	en-thral-ling
in-ter-roga-to-ry	in-ter-rog-a-to-ry
s-lan-t	slant
medi-ocre	me-di-o-cre
u-n-aes-thet-ic	un-aes-thet-ic
re-new-able	re-new-a-ble
rangy	rang-y
doubtless-ly	doubt-less-ly
w-hole-sale	whole-sale
wail-ing	wailing
tan-gen-t	tan-gent
pa-troness	pa-tron-ess
respire	re-spire
brushy	brush-y
rover	rov-er
backpedal	back-ped-al
hero	he-ro
un-rea-son-able	un-rea-son-a-ble
mariner	mar-i-ner
s-tat-uette	stat-u-ette
g-o-nad	go-nad
midrif-f	mid-riff
mud-dling	muddling
para-noid	par-a-noid
semi-con-duc-tor	sem-i-con-duc-tor
spinal	spi-nal
syl-labub	syl-la-bub
cheery	cheer-y
prelate	prel-ate
s-mudge	smudge
hideous-ly	hid-e-ous-ly
mis-in-for-m	mis-in-form
shaven	shav-en
over-ac-tive	o-ver-ac-tive
detri-men-t	det-ri-ment
s-carab	scar-ab
poly-the-is-m	pol-y-the-ism
e-u-nuch	eu-nuch
print-able	print-a-ble
elec-tro	e-lec-tro
i-n-ad-e-quate-ly	in-ad-e-quate-ly
ephor	eph-or
mod-icum	mod-i-cum
d-e-duc-tive	de-duc-tive
sup-ple-men-tary	sup-ple-men-ta-ry
over-dra-mat-ic	o-ver-dra-mat-ic
s-neer	sneer
h-es-i-ta-tion	hes-i-ta-tion
mar-que	marque
oint-men-t	oint-ment
u-n-af-fect-ed	un-af-fect-ed
de-tectably	de-tect-a-bly
sur-viv-abil-i-ty	sur-viv-a-bil-i-ty
de-tec-t	de-tect
prefer-men-t	pre-fer-ment
wary	war-y
re-pen-tance	re-pent-ance
en-tran-t	en-trant
e-lastin	e-las-tin
re-in-stal-l	re-in-stall
docile	doc-ile
diplo-mat-ic	dip-lo-mat-ic
g-nat	gnat
greensward	green-sward
out-cal-l	out-call
k-i-lo	ki-lo
mi-cro-bial	mi-cro-bi-al
en-riched	enriched
er-ro-neous	er-ro-ne-ous
stinker	stink-er
pro-le-tari-at	pro-le-tar-i-at
s-mug-ly	smug-ly
in-deco-rous	in-dec-o-rous
para-sol	par-a-sol
drudgery	drudg-er-y
radish	rad-ish
ban-tamweight	ban-tam-weight
dy-nasty	dy-nas-ty
para-medic	par-a-med-ic
rever-ie	rev-er-ie
d-e-duc-tion	de-duc-tion
tidy	ti-dy
het-ero-sex-u-al-i-ty	het-er-o-sex-u-al-i-ty
leisurewear	lei-sure-wear
s-tar-let	star-let
s-lid-er	slid-er
squin-t	squint
gawky	gawk-y
un-sea-son-able	un-sea-son-a-ble
s-teer-age	steer-age
for-get-table	for-get-ta-ble
archery	ar-cher-y
ex-hibitor	ex-hib-i-tor
elec-trol-y-sis	e-lec-trol-y-sis
pati-na-tion	pat-i-na-tion
un-de-cid-able	un-de-cid-a-ble
func-tion-al-is-m	func-tion-al-ism
pen-nan-t	pen-nant
height-ened	heightened
duc-t	duct
mufti	muf-ti
lacteal	lac-te-al
z-inc	zinc
pathogen	path-o-gen
diode	di-ode
aplom-b	a-plomb
be-trothal	be-troth-al
dis-in-fec-tan-t	dis-in-fect-ant
seag-ul-l	sea-gull
hero-ic	he-ro-ic
limekil-n	lime-kiln
mi-ni	min-i
dis-ar-ma-men-t	dis-ar-ma-ment
con-san-guineous	con-san-guin-e-ous
leg-erde-main	leg-er-de-main
w-hole	whole
fore-stal-l	fore-stall
chirpy	chirp-y
hawser	haw-ser
hereto-fore	here-to-fore
burly	bur-ly
limpet	lim-pet
es-trange-men-t	es-trange-ment
over-flow	o-ver-flow
ar-rester	ar-rest-er
e-quip-men-t	e-quip-ment
cuirass	cui-rass
fre-quent-ed	frequented
rev-e-la-to-ry	re-vel-a-to-ry
lega-tion	le-ga-tion
ar-ran-t	ar-rant
mata-dor	mat-a-dor
lazuli	laz-u-li
s-lur	slur
respite	res-pite
brazen	bra-zen
mac-a-roni	mac-a-ro-ni
seclu-sion	se-clu-sion
frosty	frost-y
de-liv-ery	de-liv-er-y
black-ened	blackened
out-per-for-m	out-per-form
biomorph	bi-o-morph
culi-nary	cu-li-nar-y
shilling	shil-ling
en-thu-si-as-m	en-thu-si-asm
in-dus-tri-al-is-m	in-dus-tri-al-ism
geo-met-ric	ge-o-met-ric
s-lip-per	slip-per
con-certi-na	con-cer-ti-na
over-whelm-ing	o-ver-whelm-ing
taran-tu-la	ta-ran-tu-la
sacral	sa-cral
surfer	surf-er
in-tel-lec-tu-al-is-m	in-tel-lec-tu-al-ism
c-om-mend-ably	com-mend-a-bly
de-viance	de-vi-ance
dis-agree	dis-a-gree
rel-a-tivis-tic	rel-a-tiv-is-tic
rap-t	rapt
busk-ing	busking
s-parkler	spar-kler
semi-con-duct-ing	sem-i-con-duct-ing
per-son-able	per-son-a-ble
myx-o-mato-sis	myx-o-ma-to-sis
velum	ve-lum
s-neer-ing	sneering
pigsty	pig-sty
thriller	thrill-er
litho-graph	lith-o-graph
ap-nea	ap-ne-a
ho-muncu-lus	ho-mun-cu-lus
dor-man-t	dor-mant
dilem-ma	di-lem-ma
s-cant-i-ly	scant-i-ly
stingy	stin-gy
puerile	pu-er-ile
unin-sured	un-in-sured
gofer	go-fer
over-heat	o-ver-heat
hy-dropho-bi-a	hy-dro-pho-bi-a
detox-i-fy	de-tox-i-fy
medicine	med-i-cine
con-sulate	con-su-late
parox-ys-m	par-ox-ysm
s-mack-er	smack-er
chan-t	chant
specif-i-cal-ly	spe-cif-i-cal-ly
grainy	grain-y
weapon	weap-on
mi-cro-cos-m	mi-cro-cosm
in-dis-pens-able	in-dis-pen-sa-ble
parch-men-t	parch-ment
cigar	ci-gar
copy-right	cop-y-right
s-lut	slut
cre-ative	cre-a-tive
fold-ing	folding
elec-tri-fi-ca-tion	e-lec-tri-fi-ca-tion
wari-ness	war-i-ness
growl-ing	growling
s-tovepipe	stove-pipe
rec-om-mend-ed	recommended
g-naw-ing	gnaw-ing
relic-t	rel-ict
repli-ca	rep-li-ca
ex-tra-ditable	ex-tra-dit-a-ble
beaver	bea-ver
zither	zith-er
by-stander	by-stand-er
bish-opric	bish-op-ric
axle	ax-le
ten-able	ten-a-ble
co-gen-t	co-gent
harpist	har-pist
s-tu-pe-fy	stu-pe-fy
read-mis-sion	re-ad-mis-sion
clam-p-down	clamp-down
kiosk	ki-osk
evil-do-er	e-vil-do-er
menagerie	me-nag-er-ie
m-nemon-ic-s	mne-mon-ics
rol-l	roll
tourist	tour-ist
pri-apic	pri-ap-ic
s-cam-per	scamp-er
draugh-t	draught
diskette	disk-ette
block-buster	block-bust-er
wringer	wring-er
holdup	hold-up
ap-por-tion-men-t	ap-por-tion-ment
s-tam-mer	stam-mer
syn-chrony	syn-chro-ny
ter-m	term
un-abashed	un-a-bashed
liq-uida-tor	liq-ui-da-tor
ver-dan-t	ver-dant
n-u-mis-mat-ic-s	nu-mis-mat-ics
om-nipo-ten-t	om-nip-o-tent
damni-fy	dam-ni-fy
chorale	cho-rale
g-nom-ic	gno-mic
y-achts-man	yachts-man
mores	mo-res
covenan-t	cov-e-nant
ethos	e-thos
cys-teine	cys-te-ine
s-in-gle	sin-gle
u-nassertive	un-as-ser-tive
exe-un-t	ex-e-unt
s-log	slog
copy-ist	cop-y-ist
fruit-ing	fruiting
fon-dan-t	fon-dant
cor-po-ratist	cor-po-rat-ist
sero-tonin	ser-o-to-nin
e-dic-t	e-dict
il-menite	il-men-ite
k-nav-ish	knav-ish
s-tu-den-t	stu-dent
piety	pi-e-ty
gad-get	gadg-et
sui-ci-dal	su-i-cid-al
man-darin	man-da-rin
s-lur-ry	slur-ry
is-lander	is-land-er
emit	e-mit
p-reser-va-tion	pres-er-va-tion
river-ine	riv-er-ine
hym-n	hymn
e-q-ui-tably	eq-ui-ta-bly
pu-tres-cen-t	pu-tres-cent
en-v-i-ron	en-vi-ron
s-corn	scorn
ethanol	eth-a-nol
bar-barous	bar-ba-rous
car-rion	car-ri-on
kalei-do-scop-ic	ka-lei-do-scop-ic
nether	neth-er
Words with errors: 2248
Words with incorrect number of syllables: 2036
Total evluated: 6500
Perfect accuracy: 0.65
Number of syllables accuracy: 0.69
Average Levenshtein Distance(across incorrect words): 1.22
