Attempt	Real
an-swer-able	an-swer-a-ble
de-mo	dem-o
lazuli	laz-u-li
curvi-lin-ear	cur-vi-lin-e-ar
sil-vered	silvered
how-itzer	how-itz-er
aright	a-right
ar-guable	ar-gu-a-ble
thirsty	thirst-y
s-noop	snoop
s-ki	ski
geyser	gey-ser
bio-di-ver-si-ty	bi-o-di-ver-si-ty
un-der-de-vel-ope-d	un-der-de-vel-oped
in-vesti-ture	in-ves-ti-ture
cus-p	cusp
so-lic-it-ing	soliciting
ca-su-al-ty	cas-u-al-ty
bla-tan-t	bla-tant
in-ter-ac-t	in-ter-act
mis-s	miss
rapi-er	ra-pi-er
in-el-e-gan-t	in-el-e-gant
tho-raci-c	tho-rac-ic
tele-ol-o-gy	tel-e-ol-o-gy
crazi-ness	cra-zi-ness
get-away	get-a-way
n-u-mis-mat-ic-s	nu-mis-mat-ics
shaky	shak-y
neo-phyte	ne-o-phyte
minaret	min-a-ret
mi-cro-com-put-er	mi-cro-com-pu-ter
rain-swep-t	rain-swept
no-tably	no-ta-bly
mega-lith	meg-a-lith
pla-gia-ris-m	pla-gia-rism
im-per-me-able	im-per-me-a-ble
er-gonomic-s	er-go-nom-ics
marcher	march-er
patchy	patch-y
be-fal-l	be-fall
retic-u-lum	re-tic-u-lum
daun-t	daunt
chirpy	chirp-y
in-ves-tiga-tive	in-ves-ti-ga-tive
un-der-state-men-t	un-der-state-ment
in-quisi-to-ri-al	in-quis-i-to-ri-al
meta-lan-guage	met-a-lan-guage
over-hand	o-ver-hand
porter-age	por-ter-age
pro-cre-ation	pro-cre-a-tion
mover	mov-er
necro-mancer	nec-ro-man-cer
bovine	bo-vine
no-body	no-bod-y
re-ceip-t	re-ceipt
bowsprit	bow-sprit
night-fal-l	night-fall
crooked	crook-ed
pumice	pum-ice
metaphor-i-cal-ly	met-a-phor-i-cal-ly
sub-stan-dard	sub-stand-ard
gazelle	ga-zelle
diode	di-ode
debtor	debt-or
c-om-mend	com-mend
peri-patet-ic	per-i-pa-tet-ic
renowned	re-nowned
deuteron	deu-ter-on
nour-ish-men-t	nour-ish-ment
synap-tic	syn-ap-tic
s-cowl	scowl
s-nort	snort
ex-pec-t	ex-pect
com-peti-tor	com-pet-i-tor
as-tro-physic-s	as-tro-phys-ics
haystack	hay-stack
com-fort-ably	com-fort-a-bly
spir-i-tu-al-ist	spir-it-u-al-ist
chlo-ro-for-m	chlo-ro-form
elec-tro-stat-ic	e-lec-tro-stat-ic
poly-merase	pol-y-mer-ase
s-traight-for-ward	straight-for-ward
rack-e-teer-ing	rack-et-eer-ing
mal-leable	mal-le-a-ble
id-iomat-ic	id-i-o-mat-ic
heavy-weight	heav-y-weight
prepo-si-tion-al	prep-o-si-tion-al
neu-ronal	neu-ron-al
gherkin	gher-kin
ini-ti-a-tion	in-i-ti-a-tion
golfer	golf-er
physi-cian	phy-si-cian
ethnog-ra-phy	eth-nog-ra-phy
di-rec-torate	di-rec-to-rate
colos-sus	co-los-sus
s-can-dalous	scan-dal-ous
de-spi-ca-ble	des-pi-ca-ble
u-topi-an	u-to-pi-an
cashier	cash-ier
elec-tric-i-ty	e-lec-tric-i-ty
supra-na-tion-al	su-pra-na-tion-al
mag-netism	mag-net-ism
tam-p	tamp
in-ter-preter	in-ter-pret-er
fugi-tive	fu-gi-tive
buoy-an-t	buoy-ant
octet	oc-tet
mi-cro-bial	mi-cro-bi-al
in-quisi-tor	in-quis-i-tor
seis-mome-ter	seis-mom-e-ter
spon-sored	sponsored
de-riso-ry	de-ri-so-ry
lounger	loung-er
rhap-sody	rhap-so-dy
es-capade	es-ca-pade
un-prece-dent-ed	un-prec-e-dent-ed
n-odal	nod-al
s-tud-ied	stud-ied
s-now-bound	snow-bound
mono-lith	mon-o-lith
un-der-achieve-men-t	un-der-a-chieve-ment
despot	des-pot
anvil	an-vil
fer-men-t	fer-ment
de-fen-dan-t	de-fend-ant
an-nal-s	an-nals
elec-tron	e-lec-tron
li-able	li-a-ble
fri-able	fri-a-ble
lever	lev-er
shiv-ery	shiv-er-y
telling-ly	tell-ing-ly
or-di-nary	or-di-nar-y
lig-and	li-gand
mis-coun-t	mis-count
squea-mish	squeam-ish
piercer	pierc-er
un-ser-vice-able	un-ser-vice-a-ble
bud-get	budg-et
palat-able	pal-at-a-ble
erec-tion	e-rec-tion
lighter	light-er
at-temp-t	at-tempt
in-frared	in-fra-red
fil-l	fill
para-pet	par-a-pet
in-con-stan-t	in-con-stant
medal-lion	me-dal-lion
s-tarve	starve
un-re-cov-er-able	un-re-cov-er-a-ble
s-ingsong	sing-song
aba-cus	ab-a-cus
down-sid-e	down-side
pup-peteer	pup-pet-eer
pro-fes-sion-al-is-m	pro-fes-sion-al-ism
en-tropy	en-tro-py
con-stab-u-lary	con-stab-u-lar-y
erode	e-rode
warpaint	war-paint
forepaw	fore-paw
ap-pa-ra-tus	ap-pa-rat-us
rekin-dle	re-kin-dle
skua	sku-a
un-steady	un-stead-y
damsel	dam-sel
s-tra-tus	stra-tus
d-e-ductible	de-duct-i-ble
con-vic-t	con-vict
or-bital	or-bit-al
birdie	bird-ie
viaduc-t	vi-a-duct
arm-s	arms
over-charge	o-ver-charge
land-for-m	land-form
patel-la	pa-tel-la
can-dlelit	can-dle-lit
dumb-bel-l	dumb-bell
cav-ernous	cav-ern-ous
elec-tri-fy	e-lec-tri-fy
ga-lop	gal-op
tele-vised	televised
b-o-rax	bo-rax
s-plodge	splodge
sawmil-l	saw-mill
in-tel-lec-tu-al-is-m	in-tel-lec-tu-al-ism
s-lim-mer	slim-mer
s-toep	stoep
arachno-pho-bi-a	a-rach-no-pho-bi-a
elec-toral	e-lec-tor-al
r-e-fit	re-fit
sub-atom-ic	sub-a-tom-ic
necro-man-cy	nec-ro-man-cy
deliri-ous	de-lir-i-ous
wran-gling	wrangling
re-frig-er-an-t	re-frig-er-ant
pep-pered	peppered
re-doubtable	re-doubt-a-ble
k-ilo-hertz	kil-o-hertz
umpteen	ump-teen
moun-taineer-ing	moun-tain-eer-ing
dis-en-gage-men-t	dis-en-gage-ment
poky	pok-y
downy	down-y
pyra-mid	pyr-a-mid
sepul-chral	se-pul-chral
medic-i-nal	me-dic-i-nal
reval-ue	re-val-ue
hori-zon	ho-ri-zon
episod-ic	ep-i-sod-ic
re-de-ploy-men-t	re-de-ploy-ment
over-act-ing	overacting
hookah	hook-ah
s-lash-er	slash-er
anoin-t	a-noint
t-elecom-mu-ni-ca-tion	tel-e-com-mu-ni-ca-tion
aris-to-crat	a-ris-to-crat
pit-fal-l	pit-fall
body-guard	bod-y-guard
re-assem-ble	re-as-sem-ble
stealthy	stealth-y
healthi-ly	health-i-ly
un-en-vi-able	un-en-vi-a-ble
pro-lactin	pro-lac-tin
aor-ta	a-or-ta
s-nifter	snif-ter
avenge	a-venge
hearthrug	hearth-rug
d-if-fi-den-t	dif-fi-dent
litho-sphere	lith-o-sphere
gale-na	ga-le-na
prob-a-bilis-tic	prob-a-bi-lis-tic
hairy	hair-y
ex-clu-sion-ary	ex-clu-sion-ar-y
u-n-af-ford-able	un-af-ford-a-ble
sacral	sa-cral
car-cino-gen-e-sis	car-cin-o-gen-e-sis
char-m	charm
salu-tary	sal-u-tar-y
limp-ing	limping
restart	re-start
over-drive	o-ver-drive
preva-lence	prev-a-lence
ate-lier	at-el-ier
bathrobe	bath-robe
japan	ja-pan
isother-mal	i-so-ther-mal
geo-phys-i-cal	ge-o-phys-i-cal
s-louch-ing	slouching
catchy	catch-y
any-way	an-y-way
longish	long-ish
hazy	ha-zy
erot-ic	e-rot-ic
di-a-bolis-m	di-ab-o-lism
daisy	dai-sy
in-con-sid-er-able	in-con-sid-er-a-ble
shad-owy	shad-ow-y
table-ware	ta-ble-ware
bac-te-rio-phage	bac-te-ri-o-phage
with-ered	withered
de-spon-den-t	de-spond-ent
reper-toire	rep-er-toire
sub-ur-bia	sub-ur-bi-a
com-man-dan-t	com-man-dant
lamb-swool	lambs-wool
pun-t	punt
vestibule	ves-ti-bule
s-in-cere-ly	sin-cere-ly
grandios-i-ty	gran-di-os-i-ty
mau-soleum	mau-so-le-um
s-low-ness	slow-ness
s-lack	slack
s-ap	sap
parachutist	par-a-chut-ist
farad	far-ad
ax-il-lary	ax-il-lar-y
horny	horn-y
aro-mather-a-py	a-ro-ma-ther-a-py
haulage	haul-age
ep-ithe-lial	ep-i-the-li-al
k-er-nel	ker-nel
frizzy	friz-zy
em-place-men-t	em-place-ment
harshen	harsh-en
k-itsch	kitsch
hauli-er	haul-ier
elite	e-lite
mono-mi-al	mo-no-mi-al
auburn	au-burn
dither	dith-er
parochial	pa-ro-chi-al
lofty	loft-y
mul-ti-pro-cess-ing	mul-ti-proc-ess-ing
sub-jec-t	sub-ject
fermion	fer-mi-on
or-ga-nize	or-gan-ize
re-fusal	re-fus-al
physic	phys-ic
in-ward-s	in-wards
soloist	so-lo-ist
un-easi-ness	un-eas-i-ness
vil-lainy	vil-lain-y
phi-lan-thropist	phi-lan-thro-pist
cere-bel-lum	cer-e-bel-lum
ra-dio-met-ric	ra-di-o-met-ric
s-mog	smog
s-cout	scout
yippee	yip-pee
soupy	soup-y
tem-per-a-men-t	tem-per-a-ment
quadruped	quad-ru-ped
limou-sine	lim-ou-sine
translu-cen-cy	trans-lu-cen-cy
laun-dered	laundered
ir-repara-ble	ir-rep-a-ra-ble
usury	u-su-ry
megas-tar	meg-a-star
wiry	wir-y
ar-chaeopteryx	ar-chae-op-ter-yx
s-lo-gan	slo-gan
many	man-y
l-la-ma	lla-ma
legroom	leg-room
resur-gence	re-sur-gence
iono-sphere	i-on-o-sphere
fri-vol-ity	fri-vol-i-ty
cre-osote	cre-o-sote
baron-age	bar-on-age
crosstalk	cross-talk
stopover	stop-o-ver
racial-ly	ra-cial-ly
ef-ful-gen-t	ef-ful-gent
s-plice	splice
coro-ner	cor-o-ner
iso-la-tion	i-so-la-tion
liv-ery	liv-er-y
preda-to-ry	pred-a-to-ry
re-cy-clable	re-cy-cla-ble
co-gen-t	co-gent
feb-ru-ary	feb-ru-ar-y
t-ingly	tin-gly
cata-ton-ic	cat-a-ton-ic
re-fur-bish-men-t	re-fur-bish-ment
nestling	nest-ling
mis-cel-lanea	mis-cel-la-ne-a
granny	gran-ny
bur-sary	bur-sa-ry
mar-tinet	mar-ti-net
pedes-tri-an	pe-des-tri-an
in-de-ci-pher-able	in-de-ci-pher-a-ble
en-counter	en-coun-ter
tyran-ny	tyr-an-ny
premis-es	prem-is-es
e-quinoc-tial	e-qui-noc-tial
melo-dra-ma	mel-o-dra-ma
sacro-sanc-t	sac-ro-sanct
navy	na-vy
mis-treat-men-t	mis-treat-ment
bun-gled	bungled
brainy	brain-y
hy-draulic	hy-drau-lic
s-tunned	stunned
epis-temic	ep-i-ste-mic
methanol	meth-a-nol
par-si-mo-nious	par-si-mo-ni-ous
opal	o-pal
trea-sonous	trea-son-ous
owlet	owl-et
ex-trav-a-gan-t	ex-trav-a-gant
s-tiff-ness	stiff-ness
dis-join-t	dis-joint
pearly	pearl-y
shifty	shift-y
reser-voir	res-er-voir
lop-per-s	lop-pers
in-dul-gen-t	in-dul-gent
over-done	o-ver-done
elec-tro-mag-net	e-lec-tro-mag-net
prospec-t	pros-pect
in-tern-men-t	in-tern-ment
metro	met-ro
newsy	news-y
hov-e	hove
pris-m	prism
techno-pho-bi-a	tech-no-pho-bia
stylis-tic	sty-lis-tic
mod-esty	mod-es-ty
singer	sing-er
de-sir-able	de-sir-a-ble
pro-gram-mable	pro-gram-ma-ble
over-anx-ious	o-ver-anx-ious
groom-ing	grooming
piv-ot-ed	pivoted
visa	vi-sa
pres-tidig-i-ta-tion	pres-ti-dig-i-ta-tion
blood-wor-m	blood-worm
felon	fel-on
o-r-a-tor-i-cal	or-a-tor-i-cal
taster	tast-er
em-bolis-m	em-bo-lism
volup-tuous	vo-lup-tu-ous
cagoule	ca-goule
raver	rav-er
elec-tor	e-lec-tor
sym-po-sium	sym-po-si-um
oblo-quy	ob-lo-quy
japon-i-ca	ja-pon-i-ca
ther-mo-dy-nam-ic-s	ther-mo-dy-nam-ics
in-con-ve-nien-t	in-con-ven-ient
gener-i-cal-ly	ge-ner-i-cal-ly
in-de-pen-den-t	in-de-pend-ent
em-bel-lish-men-t	em-bel-lish-ment
phy-loge-ny	phy-log-e-ny
geisha	gei-sha
sub-unit	sub-u-nit
no-tary	no-ta-ry
ob-stet-ric-s	ob-stet-rics
rusty	rust-y
im-politic	im-pol-i-tic
an-titrust	an-ti-trust
re-cidi-vis-m	re-cid-i-vism
s-campi	scam-pi
beat-i-tude	be-at-i-tude
im-per-son-ator	im-per-son-a-tor
epi-taxy	ep-i-tax-y
w-hole-heart-ed	whole-heart-ed
s-cis-sor	scis-sor
para-dox-i-cal	par-a-dox-i-cal
wafer	wa-fer
grotesque	gro-tesque
auger	au-ger
medi-um	me-di-um
suprema-cy	su-prem-a-cy
em-bassy	em-bas-sy
plumber	plumb-er
syco-phan-tic	syc-o-phan-tic
un-solv-able	un-solv-a-ble
par-alin-guis-tic	par-a-lin-guis-tic
un-der-rat-ed	underrated
won-der-men-t	won-der-ment
co-ef-fi-cien-t	co-ef-fi-cient
aphid	a-phid
weightlift-ing	weight-lift-ing
oblig-ing	o-blig-ing
gril-l	grill
pi-ran-ha	pi-ra-nha
pho-to-copy	pho-to-cop-y
teardrop	tear-drop
bereft	be-reft
mon-e-tary	mon-e-tar-y
s-mog-gy	smog-gy
em-bez-zle-men-t	em-bez-zle-ment
re-order	re-or-der
ru-mi-nan-t	ru-mi-nant
fil-a-men-t	fil-a-ment
holo-caust	hol-o-caust
polyandry	pol-y-an-dry
stal-l	stall
fron-tispiece	fron-tis-piece
neona-tal	ne-o-na-tal
f-reak-ish	freak-ish
u-nion	un-ion
d-well	dwell
as-trin-gen-t	as-trin-gent
stapes	sta-pes
swindler	swin-dler
antacid	ant-ac-id
politic	pol-i-tic
per-pe-tu-ity	per-pe-tu-i-ty
moorhen	moor-hen
binoc-u-lar	bin-oc-u-lar
se-quen-t	se-quent
helpline	help-line
u-ni-lat-er-al-is-m	u-ni-lat-er-al-ism
stinger	sting-er
slaver	slav-er
batik	ba-tik
juicy	juic-y
jaz-z	jazz
over-work	o-ver-work
phy-lac-tery	phy-lac-ter-y
aubergine	au-ber-gine
pre-lim-i-nary	pre-lim-i-nar-y
hy-dro-elec-tric	hy-dro-e-lec-tric
mas-tery	mas-ter-y
medi-ocrity	me-di-oc-ri-ty
papil-la	pa-pil-la
trap-s	traps
t-wo-some	two-some
en-hancer	en-hanc-er
i-n-or-di-nate-ly	in-or-di-nate-ly
dis-cour-tesy	dis-cour-te-sy
s-nip-ing	snip-ing
pri-apic	pri-ap-ic
s-ti-fling	sti-fling
pathogen	path-o-gen
seedy	seed-y
cred-itable	cred-it-a-ble
tiler	til-er
geno-ci-dal	gen-o-cid-al
in-fil-l	in-fill
ar-madil-lo	ar-ma-dil-lo
postlude	post-lude
flossy	floss-y
brio	bri-o
pre-lude	prel-ude
over-al-l	o-ver-all
u-n-ac-cus-tomed	un-ac-cus-tomed
in-deli-bly	in-del-i-bly
rosette	ro-sette
in-de-ter-minable	in-de-ter-mi-na-ble
ve-he-men-t	ve-he-ment
queasy	quea-sy
trumpery	trump-er-y
tick-et-ed	ticketed
s-po-rad-i-cal-ly	spo-rad-i-cal-ly
nonex-is-tence	non-ex-ist-ence
s-park	spark
idly	i-dly
as-cen-der	as-cend-er
s-marten	smart-en
pol-lard-ed	pollarded
ethe-re-al	e-the-re-al
ante	an-te
por-ta-ble	port-a-ble
seclu-sion	se-clu-sion
tepid	tep-id
de-nier	de-ni-er
biofeed-back	bi-o-feed-back
de-viance	de-vi-ance
un-de-ni-able	un-de-ni-a-ble
quizzi-cal	quiz-zi-cal
over-crowd-ing	o-ver-crow-ding
for-tu-itous-ly	for-tu-i-tous-ly
mileage	mile-age
so-ciopo-lit-i-cal	so-ci-o-po-lit-i-cal
stri-den-t	stri-dent
con-tentious	con-ten-tious
mas-sacre	mas-sa-cre
repet-i-tive	re-pet-i-tive
un-print-able	un-print-a-ble
rheumat-ic	rheu-mat-ic
bio-met-ric-s	bi-o-met-rics
s-traight	straight
be-muse-men-t	be-muse-ment
cur-tilage	cur-ti-lage
con-duct-ed	conducted
hy-dran-t	hy-drant
im-pass-able	im-pass-a-ble
aback	a-back
yeti	yet-i
out-pa-tien-t	out-pa-tient
por-traitist	por-trait-ist
knowl-edge-able	knowl-edge-a-ble
epi-der-mis	ep-i-der-mis
vivi-sec-tion	viv-i-sec-tion
cen-t	cent
con-fir-ma-to-ry	con-firm-a-to-ry
blus-ter-ing	blustering
cagey	cag-ey
dart-s	darts
i-n-ad-e-quate-ly	in-ad-e-quate-ly
diplo-ma	di-plo-ma
pan-das	pan-das
brack-et-ed	bracketed
pay-men-t	pay-ment
i-n-ac-ti-va-tion	in-ac-ti-va-tion
over-throw	o-ver-throw
enor-mous-ly	e-nor-mous-ly
gen-tri-fied	gentrified
grasshop-per	grass-hop-per
re-spon-der	re-spond-er
de-bauch-ery	de-bauch-er-y
trage-di-an	tra-ge-di-an
cys-teine	cys-te-ine
liquor-ish	liq-uor-ish
pi-o-n	pi-on
s-teeple-chase	stee-ple-chase
em-bit-tered	embittered
purist	pur-ist
cheesy	chees-y
do-h	doh
sprawl-ing	sprawling
mer-chan-dis-e	mer-chan-dise
seg-ment-ed	seg-men-ted
mod-ernism	mod-ern-ism
poly-crys-talline	pol-y-crys-tal-line
en-light-en-men-t	en-light-en-ment
coinage	coin-age
over-draft	o-ver-draft
sec-re-tar-iat	sec-re-tar-i-at
stilet-to	sti-let-to
py-rotech-nic	py-ro-tech-nic
chival-rous	chiv-al-rous
fever-ish	fe-ver-ish
pres-ti-gious	pres-tig-ious
ide-ol-o-gy	i-de-ol-o-gy
ox-i-dan-t	ox-i-dant
rounder	round-er
ca-ma-raderie	ca-ma-ra-de-rie
over-time	o-ver-time
dis-cred-it-ed	discredited
drach-m	drachm
habi-ta-tion	hab-i-ta-tion
blaster	blast-er
over-flow	o-ver-flow
pave-men-t	pave-ment
s-tupid	stu-pid
forestry	for-est-ry
lu-bri-can-t	lu-bri-cant
glis-ten-ing	gli-ste-ning
mutiny	mu-ti-ny
i-n-ap-pro-pri-ate	in-ap-pro-pri-ate
weedy	weed-y
salaam	sa-laam
item	i-tem
maul-ing	mauling
car-avel	car-a-vel
in-signif-i-can-t	in-sig-nif-i-cant
de-ter-ren-t	de-ter-rent
un-emo-tion-al	un-e-mo-tion-al
s-ta-tion-mas-ter	sta-tion-mas-ter
moody	mood-y
scruf-f	scruff
p-ri-mo-gen-i-ture	pri-mo-gen-i-ture
calo-rie	cal-o-rie
sawyer	saw-yer
pari-ah	pa-ri-ah
in-stinc-t	in-stinct
con-toured	contoured
ig-nominy	ig-no-min-y
s-pat-ter	spat-ter
epi-demi-ol-o-gy	ep-i-de-mi-ol-o-gy
e-s-prit	es-prit
en-dorse-men-t	en-dorse-ment
corky	cork-y
ev-i-den-t	ev-i-dent
crum-by	crumb-y
swelling	swell-ing
gigo-lo	gig-o-lo
mine-strone	min-e-stro-ne
raider	raid-er
u-n-al-lo-cat-ed	un-al-lo-cat-ed
s-tand	stand
mili-tia-man	mi-li-tia-man
bes-tial-i-ty	bes-ti-al-i-ty
elec-tri-cian	e-lec-tri-cian
naval	na-val
ar-cana	ar-ca-na
de-pri-va-tion	dep-ri-va-tion
nu-tri-en-t	nu-tri-ent
para-ble	par-a-ble
ma-hogany	ma-hog-a-ny
blankly	blank-ly
de-port-men-t	de-port-ment
over-worked	overworked
hi-ero-glyph	hi-er-o-glyph
s-woop	swoop
pro-pel-lan-t	pro-pel-lant
in-hab-i-tan-t	in-hab-it-ant
ar-chiv-ist	ar-chi-vist
fatu-ous	fat-u-ous
re-newed	renewed
car-boxyl	car-box-yl
arouse	a-rouse
con-tent-men-t	con-tent-ment
p-salmist	psalm-ist
s-in-u-ous	sin-u-ous
hyp-nother-a-py	hyp-no-ther-a-py
positron	pos-i-tron
con-trac-t	con-tract
dat-able	dat-a-ble
s-lum	slum
spiky	spik-y
stag-ger-s	stag-gers
s-caled	scaled
hoary	hoar-y
aphe-lion	a-phe-li-on
s-cal-a-bil-i-ty	scal-a-bil-i-ty
monar-chist	mon-ar-chist
matin-s	mat-ins
minu-ti-ae	mi-nu-ti-ae
re-trench-men-t	re-trench-ment
gut-tural	gut-tur-al
poly-syl-lab-ic	pol-y-syl-lab-ic
spindly	spin-dly
mam-malian	mam-ma-li-an
ped-i-men-t	ped-i-ment
au-gury	au-gu-ry
reshuf-fle	re-shuf-fle
fara-day	far-a-day
gelig-nite	gel-ig-nite
cor-ti-cos-teroid	cor-ti-co-ster-oid
usu-al	u-su-al
pussy	pus-sy
elide	e-lide
over-come	o-ver-come
s-pank	spank
sec-ondary	sec-ond-ar-y
bunkum	bun-kum
em-piri-cis-m	em-pir-i-cism
mistype	mis-type
drea-r	drear
brawny	brawn-y
bib-lio-phile	bib-li-o-phile
petrol-o-gy	pe-trol-o-gy
hotspot	hot-spot
dipole	di-pole
in-her-en-t	in-her-ent
cater-pil-lar	cat-er-pil-lar
cin-e-matog-ra-pher	cin-e-ma-tog-ra-pher
so-cio-bi-ol-o-gy	so-ci-o-bi-ol-o-gy
ar-ran-t	ar-rant
leav-ened	leavened
playable	play-a-ble
re-quire-men-t	re-quire-ment
pre-dictably	pre-dict-a-bly
totem	to-tem
harem	har-em
usurp-er	u-surp-er
in-sup-port-able	in-sup-port-a-ble
premise	prem-ise
tar-ty	tart-y
e-voca-tive	e-voc-a-tive
dis-avow-al	dis-a-vow-al
in-dis-tinc-t	in-dis-tinct
p-light	plight
dizzy	diz-zy
s-teeply	steep-ly
elfin	elf-in
toluene	tol-u-ene
ty-pog-ra-pher-s	ty-po-gra-phers
suf-fi-cien-t	suf-fi-cient
b-i-fo-cal	bi-fo-cal
cat-alyt-ic	cat-a-lyt-ic
over-ly-ing	o-ver-ly-ing
timid-ly	tim-id-ly
pos-i-tivis-m	pos-i-tiv-ism
d-is-fig-ure	dis-fig-ure
plexus	plex-us
s-lan-der	slan-der
over-pay	o-ver-pay
bang-ing	banging
colo-nial	co-lo-ni-al
un-elect-ed	un-e-lect-ed
quit-s	quits
re-assess	re-as-sess
bullfinch	bull-finch
geron-tol-o-gy	ger-on-tol-o-gy
as-pi-ran-t	as-pir-ant
copi-lot	co-pi-lot
ec-topic	ec-top-ic
froward	fro-ward
sen-t	sent
for-man-t	for-mant
sub-con-ti-nen-t	sub-con-ti-nent
s-lipped	slipped
s-care	scare
specif-i-cal-ly	spe-cif-i-cal-ly
rege-late	re-ge-late
blun-der-ing	blundering
in-ter-op-er-abil-i-ty	in-ter-op-er-a-bil-i-ty
hor-mon-al	hor-mo-nal
harpist-s	har-pists
cater-er	ca-ter-er
lichen	li-chen
s-tark-ly	stark-ly
glos-sary	glos-sa-ry
chaffinch	chaf-finch
rasper	rasp-er
plumage	plum-age
serai	se-ra-i
e-s-pouse	es-pouse
seago-ing	sea-go-ing
painful-ly	pain-ful-ly
em-pow-er-men-t	em-pow-er-ment
joey	jo-ey
s-lap-stick	slap-stick
de-ten-t	de-tent
dentin	den-tin
chintzy	chintz-y
click-ing	clicking
p-tarmi-gan	ptar-mi-gan
en-chanter	en-chant-er
corvette	cor-vette
s-cald	scald
heresy	her-e-sy
su-per-abun-dan-t	su-per-a-bun-dant
triple	tri-ple
s-teer	steer
om-nipres-ence	om-ni-pres-ence
bacil-lus	ba-cil-lus
of-fend-ing	of-fen-ding
garter	gar-ter
plover	plov-er
polypropy-lene	pol-y-pro-pyl-ene
sur-re-al-is-m	sur-re-al-ism
notepa-per	note-pa-per
aplom-b	a-plomb
speci-fici-ty	spec-i-fic-i-ty
vestry	ves-try
s-mut	smut
s-ince	since
en-chant-ed	enchanted
laden	lad-en
pleat-ed	pleated
ovum	o-vum
babysit	ba-by-sit
in-fre-quen-t	in-fre-quent
his-toric	his-tor-ic
rock-et-ing	rocketing
mar-l	marl
plen-teous	plen-te-ous
gal-axy	gal-ax-y
dele-tion	de-le-tion
an-nounce-men-t	an-nounce-ment
re-unite	re-u-nite
labi-um	la-bi-um
s-carce-ly	scarce-ly
enu-mer-ate	e-nu-mer-ate
rhyth-m	rhythm
copy-ist	cop-y-ist
c-it-rus	cit-rus
gelatin	gel-a-tin
periglacial	per-i-gla-cial
s-tock-ade	stock-ade
l-ynx	lynx
un-der-study	un-der-stud-y
pick-ax-e	pick-axe
s-cle-ro-sis	scle-ro-sis
cre-ator	cre-a-tor
con-cor-dan-t	con-cord-ant
an-tifreeze	an-ti-freeze
dis-pos-able	dis-pos-a-ble
avowed	a-vowed
s-light	slight
cervix	cer-vix
melo-di-ous	me-lo-di-ous
s-neeze	sneeze
pronom-i-nal	pro-nom-i-nal
s-neak-i-ly	sneak-i-ly
e-vo-ca-tion	ev-o-ca-tion
necro-man-tic	nec-ro-man-tic
du-op-oly	du-op-o-ly
con-fi-dan-t	con-fi-dant
sev-ered	severed
un-in-for-ma-tive	un-in-form-a-tive
s-low-down	slow-down
sergean-t	ser-geant
mimet-ic	mi-met-ic
ma-chin-ery	ma-chin-er-y
asi-nine	as-i-nine
viceroy	vice-roy
colonel	colo-nel
quar-t	quart
lech-ery	lech-er-y
castel-lat-ed	cas-tel-lat-ed
viewfind-er	view-find-er
bather	bath-er
par-al-lelepiped	par-al-lel-e-pi-ped
residue	res-i-due
id-io-path-ic	id-i-o-path-ic
w-ere-wolf	were-wolf
talkie	talk-ie
din-t	dint
booty	boo-ty
wail-ing	wailing
woofer	woof-er
ele-phan-t	el-e-phant
mil-i-tan-t	mil-i-tant
detri-men-tal	det-ri-men-tal
re-cessed	recessed
mea-sure-men-t	meas-ure-ment
phe-nomenol-o-gy	phe-nom-e-nol-o-gy
briefer	brief-er
medusa	me-du-sa
un-bridge-able	un-bridge-a-ble
hy-per-bole	hy-per-bo-le
c-on-cil-i-a-tion	con-cil-i-a-tion
ob-so-les-cen-t	ob-so-les-cent
un-rep-re-sen-ta-tive	un-rep-re-sent-a-tive
un-for-giv-able	un-for-giv-a-ble
styling	styl-ing
s-log	slog
hin-t	hint
warthog	wart-hog
s-corn-ful	scorn-ful
clash-ing	clashing
s-ly-ly	sly-ly
farmer	farm-er
florid	flor-id
un-suit-able	un-suit-a-ble
mor-tu-ary	mor-tu-ar-y
re-word-ings	re-word-ings
con-ge-nial	con-gen-ial
frankly	frank-ly
humbly	hum-bly
fetishist	fet-ish-ist
num-b	numb
rafter	raft-er
shel-l	shell
mealie	meal-ie
fifty	fif-ty
cordiller-a	cor-dil-le-ra
transcon-ti-nen-tal	trans-con-ti-nen-tal
walkover	walk-o-ver
y-acht-ing	yacht-ing
para-mil-i-tary	par-a-mil-i-tar-y
in-sa-tiable	in-sa-tia-ble
nomen-cla-ture	no-men-cla-ture
lik-able	lik-a-ble
eosin	e-o-sin
pun-ish-men-t	pun-ish-ment
buf-foon-ery	buf-foon-er-y
pream-p	pre-amp
reap-point	re-ap-point
re-volver	re-volv-er
cedar	ce-dar
he-lio-sphere	he-li-o-sphere
monogamy	mo-nog-a-my
numb-skul-l	numb-skull
imag-ine	im-ag-ine
s-phyg-mo-manome-ter	sphyg-mo-ma-nom-e-ter
ar-senide	ar-se-nide
s-ca-lene	sca-lene
ver-b	verb
g-lu-ta-mate	glu-ta-mate
mid-ship-s	mid-ships
de-tectable	de-tect-a-ble
de-pic-t	de-pict
s-nip-pet	snip-pet
u-n-awares	un-a-wares
break-able	break-a-ble
buf-f	buff
de-fec-t	de-fect
sub-sidy	sub-si-dy
seg-men-t	seg-ment
overkil-l	o-ver-kill
elec-tron-i-cal-ly	e-lec-tron-i-cal-ly
lega-tor	le-ga-tor
fruition	fru-i-tion
cus-tom-ary	cus-tom-ar-y
rap-t	rapt
s-toat	stoat
lazi-ness	la-zi-ness
e-spres-so	es-pres-so
ir-re-solv-able	ir-re-solv-a-ble
haiku	hai-ku
ki-net-ic-s	ki-net-ics
in-ter-po-lat-able	in-ter-po-la-ta-ble
u-n-aid-ed	un-aid-ed
felo-nious	fe-lo-ni-ous
fora-men	fo-ra-men
pantry	pan-try
in-ter-mit-ten-t	in-ter-mit-tent
cladding	clad-ding
dozen	doz-en
de-monolo-gy	de-mon-ol-o-gy
pitiable	pit-i-a-ble
s-mall-ish	small-ish
ir-re-vo-ca-bly	ir-rev-o-ca-bly
moral	mor-al
duet	du-et
aver-sive	a-ver-sive
tulip	tu-lip
out-per-for-m	out-per-form
un-ready	un-read-y
s-tat-u-ary	stat-u-ar-y
bat-ter-ing	battering
re-mis-s	re-miss
macro	mac-ro
i-n-ad-ver-tent-ly	in-ad-vert-ent-ly
di-ver-sion-ary	di-ver-sion-ar-y
u-p-lift-ing	up-lift-ing
pogrom	po-grom
ven-omous	ven-om-ous
fein-t	feint
mor-dan-t	mor-dant
mono-syl-lab-ic	mon-o-syl-lab-ic
re-ceiv-able	re-ceiv-a-ble
frothy	froth-y
quasar	qua-sar
cele-b	ce-leb
ima-go	i-ma-go
chid-ing	chiding
om-nipo-tence	om-nip-o-tence
chi-nois-erie	chi-noi-se-rie
fid-gety	fidg-et-y
repack-age	re-pack-age
posthu-mous-ly	post-hu-mous-ly
ex-cus-able	ex-cus-a-ble
s-wot	swot
u-n-am-bi-tious	un-am-bi-tious
repos-i-to-ry	re-pos-i-to-ry
s-mock	smock
draught-s	draughts
ra-dio-gram	ra-di-o-gram
over-rule	o-ver-rule
furtive	fur-tive
humerus	hu-mer-us
any-one	an-y-one
tum-bled	tumbled
i-n-ac-cu-rate	in-ac-cu-rate
em-body	em-bod-y
in-tractable	in-trac-ta-ble
per-sis-tent-ly	per-sist-ent-ly
bedrag-gled	be-drag-gled
de-rail-men-t	de-rail-ment
con-ducive	con-du-cive
diathermy	di-a-ther-my
i-n-ac-cu-ra-cy	in-ac-cu-ra-cy
plan-e-tary	plan-e-tar-y
jerkin	jer-kin
u-ni-tary	u-ni-tar-y
re-splen-den-t	re-splend-ent
s-trap	strap
parish	par-ish
api-ary	a-pi-ar-y
in-do-len-t	in-do-lent
dev-il-men-t	dev-il-ment
d-if-fus-er	dif-fus-er
s-teeple	stee-ple
den-t	dent
unedit-ed	un-ed-it-ed
carpal	car-pal
un-con-trol-lably	un-con-trol-la-bly
rec-on-cil-able	rec-on-cil-a-ble
door-bel-l	door-bell
epic	ep-ic
aris-to-crat-ic	a-ris-to-crat-ic
un-der-body	un-der-bod-y
over-whelm-ing	o-ver-whelm-ing
s-tock	stock
lyrist	lyr-ist
para-graph	par-a-graph
sala-mi	sa-la-mi
ex-huma-tion	ex-hu-ma-tion
el-e-men-t	el-e-ment
es-sen-tial-is-m	es-sen-tial-ism
proac-tive	pro-ac-tive
pa-tri-lin-eal	pat-ri-lin-e-al
ne-ol-o-gis-m	ne-ol-o-gism
rev-er-en-t	rev-er-ent
clien-tele	cli-en-tele
pre-cep-t	pre-cept
vagabond	vag-a-bond
over-whelm	o-ver-whelm
archer	arch-er
in-ter-dic-t	in-ter-dict
het-ero-dox	het-er-o-dox
de-pres-san-t	de-pres-sant
in-ef-fi-cien-t	in-ef-fi-cient
de-mo-graph-ic-s	dem-o-graph-ics
cloa-ca	clo-a-ca
s-tan-chion	stan-chion
respire	re-spire
in-sis-ten-t	in-sist-ent
pro-pri-eto-ri-al	pro-pri-e-to-ri-al
pur-veyance	pur-vey-ance
frontal	fron-tal
nifty	nif-ty
hourly	hour-ly
wrestler	wres-tler
flut-ter-ing	fluttering
m-i-lieu	mi-lieu
wiz-ardry	wiz-ard-ry
s-in-gle	sin-gle
pachy-der-m	pach-y-derm
pro-ceed-s	pro-ceeds
bear-able	bear-a-ble
nu-tri-men-t	nu-tri-ment
pid-gin	pidg-in
re-spon-den-t	re-spond-ent
hys-terec-to-my	hys-ter-ec-to-my
es-cu-d-o	es-cu-do
pedestal	ped-es-tal
s-po-radic	spo-rad-ic
plebiscite	pleb-i-scite
s-cant-y	scant-y
mist-ime	mis-time
biomorph	bi-o-morph
crozi-er	cro-zier
de-tectably	de-tect-a-bly
re-al-is-m	re-al-ism
in-con-sis-ten-cy	in-con-sist-en-cy
canon-i-cal	ca-non-i-cal
re-vo-ca-ble	rev-o-ca-ble
spiny	spin-y
un-so-licit-ed	un-so-lic-it-ed
imag-i-nary	im-ag-i-nar-y
poly-car-bon-ate	pol-y-car-bon-ate
in-ter-atom-ic	in-ter-a-tom-ic
dis-cern-men-t	dis-cern-ment
un-nerv-ing	unnerving
rhodi-um	rho-di-um
grenade	gre-nade
aso-cial	a-so-cial
n-ear-sight-ed	near-sight-ed
pro-tean	pro-te-an
vex-ing	vexing
cyan	cy-an
gur-gling	gurgling
sisal	si-sal
holy	ho-ly
pa-p	pap
reload	re-load
mildewy	mil-dew-y
cheva-lier	chev-a-lier
sa-far-i	sa-fa-ri
epi-taph	ep-i-taph
spir-i-tu-al-is-m	spir-it-u-al-ism
ridicu-lous-ness	ri-dic-u-lous-ness
ex-tra-galac-tic	ex-tra-ga-lac-tic
sodi-um	so-di-um
tom-fool-ery	tom-fool-er-y
over-grown	o-ver-grown
ex-hi-bi-tion-is-m	ex-hi-bi-tion-ism
ide-al-i-ty	i-de-al-i-ty
chaf-f	chaff
un-der-ar-m	un-der-arm
codex	co-dex
artistry	art-ist-ry
tremu-lous	trem-u-lous
rhodo-den-dron	rho-do-den-dron
spokesman	spokes-man
par-tic-u-lar-is-m	par-tic-u-lar-ism
be-trothal	be-troth-al
s-toa	sto-a
bil-iary	bil-i-ar-y
s-portive	spor-tive
lunchtime	lunch-time
con-join-t	con-joint
s-tate-hood	state-hood
u-n-adorned	un-a-dorned
heater	heat-er
tal-en-t	tal-ent
sanc-ti-mo-nious	sanc-ti-mo-ni-ous
atom-ic	a-tom-ic
crack-er-s	crack-ers
brioche	bri-oche
con-temp-t	con-tempt
tyran-ni-cide	ty-ran-ni-cide
wreck-ing	wrecking
re-spectably	re-spect-a-bly
fruit-ing	fruiting
liqueur	li-queur
howdy	how-dy
dimwit	dim-wit
show-ery	show-er-y
gra-di-en-t	gra-di-ent
payable	pay-a-ble
mort-gagor	mort-ga-gor
above	a-bove
labyrinthine	lab-y-rin-thine
boathouse	boat-house
hon-our	ho-nour
pep-pery	pep-per-y
ge-nial	ge-ni-al
aviary	a-vi-ar-y
s-aber	sa-ber
con-trast-ing	contrasting
monies	mon-ies
s-tore-house	store-house
chateau	cha-teau
climber	climb-er
ar-guably	ar-gu-a-bly
over-load	o-ver-load
flutist	flut-ist
bub-blegum	bub-ble-gum
video-con-fer-enc-ing	vid-e-o-con-fer-enc-ing
un-shak-able	un-shak-a-ble
propul-sive	pro-pul-sive
com-mod-e	com-mode
u-nan-nounced	un-an-nounced
mildew	mil-dew
deca-dence	dec-a-dence
di-etet-ic	di-e-tet-ic
gatepost	gate-post
n-in-com-poop	nin-com-poop
in-hala-tion	in-ha-la-tion
al-l	all
shaver	shav-er
im-prison	im-pris-on
con-tex-t	con-text
re-li-able	re-li-a-ble
qua-drat-ic	quad-rat-ic
grenadier	gren-a-dier
mousy	mous-y
in-eluctable	in-e-luc-ta-ble
toma-to	to-ma-to
i-ambic	i-am-bic
con-fi-den-tial-i-ty	con-fi-den-ti-al-i-ty
ileum	il-e-um
mono-pole	mon-o-pole
di-uret-ic	di-u-ret-ic
satiny	sat-in-y
deroga-to-ry	de-rog-a-to-ry
quater-nion	qua-ter-ni-on
op-tic-s	op-tics
s-nowflake	snow-flake
con-ser-va-tive	con-serv-a-tive
en-docrine	en-do-crine
canopy	can-o-py
lol-lipop	lol-li-pop
frag-men-tary	frag-men-tar-y
w-hole-heart-ed-ly	whole-heart-ed-ly
sum-mery	sum-mer-y
cope-d	coped
s-tonework	stone-work
su-per-scrip-t	su-per-script
out-sel-l	out-sell
s-loth-ful	sloth-ful
om-ni-science	om-nis-cience
col-lec-tivi-sa-tion	col-lec-ti-vi-sa-tion
ot-toman	ot-to-man
ni-hilis-tic	ni-hil-is-tic
mas-cara	mas-car-a
kestrel	kes-trel
un-pleas-an-t	un-pleas-ant
philo-soph-i-cal-ly	phil-o-soph-i-cal-ly
s-lot	slot
mata-dor	mat-a-dor
meri-no	me-ri-no
tillage	till-age
velo-drome	ve-lo-drome
s-parse	sparse
freck-led	freckled
whoop-s	whoops
scruffy	scruff-y
oph-thalmic	oph-thal-mic
raspy	rasp-y
bar-b	barb
ap-pari-tion	ap-pa-ri-tion
onyx	on-yx
pre-treat-men-t	pre-treat-ment
en-chant-men-t	en-chant-ment
elec-troneg-a-tive	e-lec-tro-neg-a-tive
un-invit-ing	un-in-vit-ing
painstak-ing-ly	pains-tak-ing-ly
tele-sales	tel-e-sales
me-galith-ic	meg-a-lith-ic
s-tatis-tic	sta-tis-tic
bur-gundy	bur-gun-dy
piti-ful	pit-i-ful
bul-b	bulb
re-pen-t	re-pent
blood-thirsty	blood-thirst-y
tra-verse	trav-erse
fusible	fu-si-ble
di-atom-ic	di-a-tom-ic
liny	lin-y
opin-ion-at-ed	o-pin-ion-at-ed
corny	corn-y
rub-bery	rub-ber-y
s-loop	sloop
coau-thor	co-au-thor
com-bat-an-t	com-bat-ant
swingy	swing-y
n-ev-er-the-less	nev-er-the-less
pen-t	pent
con-jec-tural	con-jec-tur-al
clam-p	clamp
tun-able	tun-a-ble
in-co-her-en-t	in-co-her-ent
s-melt	smelt
re-pro-ducibly	re-pro-duc-i-bly
dormer	dor-mer
im-pri-matur	im-pri-ma-tur
chiefly	chief-ly
func-tion-al-is-m	func-tion-al-ism
trea-sur-er	treas-ur-er
ri-fled	rifled
s-nap-shot	snap-shot
take-away	take-a-way
k-ing	king
de-cryp-t	de-crypt
isosce-les	i-sos-ce-les
mora-to-ri-um	mor-a-to-ri-um
over-hear	o-ver-hear
crony	cro-ny
leath-ery	leath-er-y
i-n-escapable	in-es-cap-a-ble
omi-nous-ly	om-i-nous-ly
debone	de-bone
de-fer-men-t	de-fer-ment
foren-sic	fo-ren-sic
laugh-ably	laugh-a-bly
s-ti-fle	sti-fle
lo-quac-ity	lo-quac-i-ty
mut-ter-ing	muttering
avi-ate	a-vi-ate
l-it-i-ga-tion	lit-i-ga-tion
ran-corous	ran-cor-ous
om-nibus	om-ni-bus
im-muno-log-i-cal	im-mu-no-log-i-cal
p-ith	pith
tanker	tank-er
sui-ci-dal	su-i-cid-al
con-demned	condemned
goatskin	goat-skin
ab-sen-t	ab-sent
un-ques-tion-able	un-ques-tion-a-ble
silen-t	si-lent
dis-band-men-t	dis-band-ment
greedy	greed-y
tra-di-tion-al-is-m	tra-di-tion-al-ism
u-n-ap-peal-ing	un-ap-peal-ing
mope-d	mo-ped
k-ismet	kis-met
aug-men-t	aug-ment
pig-men-t	pig-ment
ap-plica-tive	ap-pli-ca-tive
at-trac-t	at-tract
quirky	quirk-y
vari-ance	var-i-ance
in-ex-orable	in-ex-o-ra-ble
s-low-poke	slow-poke
jean-s	jeans
ob-se-quious	ob-se-qui-ous
dis-qui-etude	dis-qui-e-tude
t-suna-mi	tsu-na-mi
sus-pend-ed	sus-pen-ded
book-binder	book-bind-er
enor-mous	e-nor-mous
au-dio	au-di-o
un-de-cid-able	un-de-cid-a-ble
plat-i-tudi-nous	plat-i-tu-di-nous
monas-tic	mo-nas-tic
im-petu-ous	im-pet-u-ous
bal-alai-ka	bal-a-lai-ka
glam-orous	glam-or-ous
rein-tro-duc-tion	re-in-tro-duc-tion
por-ten-t	por-tent
ru-inous	ru-in-ous
cys-t	cyst
en-joy-able	en-joy-a-ble
s-tar-ship	star-ship
or-nithol-o-gy	or-ni-thol-o-gy
im-pinge-men-t	im-pinge-ment
specu-lum	spec-u-lum
stetho-scope	steth-o-scope
s-ingly	sin-gly
af-ter-ward-s	af-ter-wards
zealot	zeal-ot
diox-in	di-ox-in
roast-ed	roasted
co-pro-lite	cop-ro-lite
syl-lo-gis-m	syl-lo-gism
syl-labary	syl-la-bar-y
c-ity	cit-y
con-stituen-t	con-stit-u-ent
anteater	ant-eat-er
quadrupole	quad-ru-pole
moi-ety	moi-e-ty
apothe-cary	a-poth-e-car-y
up-silon	up-si-lon
vis-i-ta-tion	vis-it-a-tion
ra-bid	rab-id
i-nan-i-mate	in-an-i-mate
puis-san-t	pu-is-sant
scintig-ra-phy	scin-tig-ra-phy
d-warfed	dwarfed
whiten	whit-en
in-ces-t	in-cest
peep-s	peeps
over-ac-tive	o-ver-ac-tive
zenith	ze-nith
electable	e-lect-a-ble
apo-lit-i-cal	a-po-lit-i-cal
pro-pri-ety	pro-pri-e-ty
ev-ery-thing	eve-ry-thing
lemon-ade	lem-on-ade
l-itany	lit-a-ny
book-stal-l	book-stall
de-tach-able	de-tach-a-ble
gaslight	gas-light
para-sol	par-a-sol
trel-lised	trellised
dereg-u-late	de-reg-u-late
speedome-ter	speed-om-e-ter
silken	silk-en
g-nat	gnat
ethol-o-gy	e-thol-o-gy
tawny	taw-ny
kine-mat-ic-s	kin-e-mat-ics
s-to-ry	sto-ry
su-per-in-ten-dence	su-per-in-tend-ence
hero-in	her-o-in
dis-cor-dance	dis-cord-ance
s-pan-gle	span-gle
co-eval	co-e-val
pro-tect-ed	protected
odor-ous	o-dor-ous
transat-lantic	trans-at-lan-tic
ex-pen-di-ture	ex-pend-i-ture
gib-ber-ing	gibbering
s-tud	stud
coro-nal	cor-o-nal
any-place	an-y-place
d-inghy	din-ghy
trans-portable	trans-port-a-ble
barefaced	bare-faced
s-meg-ma	smeg-ma
gen-uine-ness	gen-u-ine-ness
chan-t	chant
gar-b	garb
some-body	some-bod-y
pullover	pull-o-ver
de-sir-abil-i-a	de-si-ra-bi-li-a
an-cien-t	an-cient
tightrope	tight-rope
loafer	loaf-er
u-n-al-loyed	un-al-loyed
s-tat-uesque	stat-u-esque
dis-penser	dis-pens-er
con-ceiv-able	con-ceiv-a-ble
archdea-con	arch-dea-con
hypocrisy	hy-poc-ri-sy
read-abil-i-ty	read-a-bil-i-ty
evening	eve-ning
achieve	a-chieve
bio-chem-istry	bi-o-chem-is-try
weighty	weight-y
repar-tee	rep-ar-tee
con-flict-ed	conflicted
bar-bar-ian	bar-bar-i-an
arid	ar-id
over-lay	o-ver-lay
in-ces-san-t	in-ces-sant
loca-tive	loc-a-tive
tiling	til-ing
fizzy	fizz-y
s-tand-point	stand-point
sorghum	sor-ghum
d-win-dling	dwindling
lachry-mal	lach-ry-mal
undis-tort-ed	un-dis-tort-ed
viril-i-ty	vi-ril-i-ty
cra-nial	cra-ni-al
le-nien-t	le-ni-ent
non-cha-lan-t	non-cha-lant
gravi-ton	grav-i-ton
awhile	a-while
pro-trac-t	pro-tract
rein-ter-pre-ta-tion	re-in-ter-pre-ta-tion
ra-tio-nale	ra-tion-ale
hye-na	hy-e-na
sus-tain-able	sus-tain-a-ble
sideshow	side-show
marathon	mar-a-thon
d-if-fu-siv-i-ty	dif-fu-siv-i-ty
van-dal-is-m	van-dal-ism
tri-den-t	tri-dent
barter	bar-ter
any-how	an-y-how
de-brief-in-g	debriefing
rewind	re-wind
de-vel-op-men-t	de-vel-op-ment
broadsword	broad-sword
parox-ys-m	par-ox-ysm
in-dic-t	in-dict
toupee	tou-pee
pro-tec-tion-is-m	pro-tec-tion-ism
an-te-dilu-vian	an-te-di-lu-vi-an
droopy	droop-y
perquisite	per-qui-site
het-ero-gene-ity	het-er-o-ge-ne-i-ty
un-know-able	un-know-a-ble
laager	laa-ger
dis-heart-ened	dis-hear-tened
genoa	gen-o-a
in-flic-t	in-flict
d-u-al-is-m	du-al-ism
nice-ty	ni-ce-ty
in-sipid	in-sip-id
min-i-mal-is-m	min-i-mal-ism
e-van-ge-lis-m	e-van-ge-lism
as-ceti-cis-m	as-cet-i-cism
rein-ter-pret	re-in-ter-pret
d-enizen	den-i-zen
o-r-a-to-ry	or-a-to-ry
pleas-antry	pleas-ant-ry
car-cino-gen	car-cin-o-gen
lazy	la-zy
mantrap	man-trap
cut-lery	cut-ler-y
con-temptible	con-tempt-i-ble
foghorn	fog-horn
be-witch-ing	bewitching
hia-tus	hi-a-tus
cleaver	cleav-er
ruler	rul-er
in-vari-ably	in-var-i-a-bly
arise	a-rise
me-te-o-rol-o-gy	me-te-or-ol-o-gy
o-r-ange	or-ange
mazur-ka	ma-zur-ka
s-tarter	start-er
in-di-gestible	in-di-gest-i-ble
timer	tim-er
more-over	more-o-ver
charge-able	charge-a-ble
heady	head-y
over-write	o-ver-write
eeri-ly	ee-ri-ly
un-abashed-ly	un-a-bash-ed-ly
know-able	know-a-ble
eleven	e-lev-en
in-gre-di-en-t	in-gre-di-ent
colum-nar	co-lum-nar
fig-u-ra-tive	fig-ur-a-tive
oakum	oa-kum
u-nas-so-ci-at-ed	un-as-so-ci-at-ed
solem-n	sol-emn
op-er-a-tional-ly	op-er-a-tion-al-ly
non-con-for-mi-ty	non-con-form-i-ty
bradawl	brad-awl
re-liance	re-li-ance
n-im-ble-ness	nim-ble-ness
asym-met-ri-cal	a-sym-met-ri-cal
prepar-a-tive	pre-par-a-tive
culi-nary	cu-li-nar-y
y-ore	yore
do-lerite	dol-er-ite
soapy	soap-y
lib-er-al-is-m	lib-er-al-ism
over-e-mo-tion-al	o-ver-e-mo-tion-al
tat-ter-s	tat-ters
archery	ar-cher-y
casi-no	ca-si-no
elec-tro	e-lec-tro
detox-i-fi-ca-tion	de-tox-i-fi-ca-tion
method-olog-i-cal	meth-od-o-log-i-cal
es-capist	es-cap-ist
mono-rail	mon-o-rail
s-mirk	smirk
minute-ly	mi-nute-ly
easy-go-ing	eas-y-go-ing
gawky	gawk-y
con-ser-va-to-ry	con-serv-a-to-ry
demo-crat-ic	dem-o-crat-ic
tru-an-t	tru-ant
bistable	bi-sta-ble
u-nim-pres-sive	un-im-pres-sive
shoelace	shoe-lace
strudel	stru-del
rheuma-tism	rheu-ma-tism
im-paction	im-pac-tion
bi-l-abi-al	bi-la-bi-al
ni-troge-nous	ni-trog-e-nous
ap-por-tion-men-t	ap-por-tion-ment
dis-turbing-ly	dis-turb-ing-ly
duchess	duch-ess
in-tu-itive-ly	in-tu-i-tive-ly
s-ling	sling
s-lip-stream	slip-stream
spi-dery	spi-der-y
pro-boscis	pro-bos-cis
drainage	drain-age
causative	caus-a-tive
e-s-o-ter-i-ca	es-o-ter-i-ca
sooty	soot-y
squeegee	squee-gee
ar-chi-tec-t	ar-chi-tect
math-s	maths
astig-ma-tism	a-stig-ma-tism
s-noop-ing	snooping
s-pat	spat
asep-tic	a-sep-tic
hereto-fore	here-to-fore
un-pro-nounce-able	un-pro-nounce-a-ble
mi-cro-cos-m	mi-cro-cosm
polic-ing	policing
feal-ty	fe-al-ty
panacea	pan-a-ce-a
un-con-scionable	un-con-scion-a-ble
re-vam-p	re-vamp
antler	ant-ler
supreme-ly	su-preme-ly
black-ened	blackened
semi-fi-nal	sem-i-fi-nal
grouper	group-er
balmy	balm-y
col-lo-qui-al-is-m	col-lo-qui-al-ism
es-capis-m	es-cap-ism
whim-per-ing	whimpering
lan-guorous	lan-guor-ous
s-tarlight	star-light
s-corch-ing	scorch-ing
panties	pant-ies
o-r-a-tor	or-a-tor
m-nemon-ic	mne-mon-ic
d-u-al	du-al
mul-ti-plica-tive	mul-ti-pli-ca-tive
per-fec-tion-is-m	per-fec-tion-ism
s-noek	snoek
squalid	squal-id
holdup	hold-up
archetype	ar-che-type
s-teeple-jack	stee-ple-jack
quintessen-tial-ly	quin-tes-sen-tial-ly
un-for-get-table	un-for-get-ta-ble
merid-i-an	me-rid-i-an
astray	a-stray
ir-re-triev-ably	ir-re-triev-a-bly
temp-t	tempt
pheas-an-t	pheas-ant
broody	brood-y
cur-ran-t	cur-rant
very	ver-y
un-nec-es-sary	un-nec-es-sar-y
fu-ner-ary	fu-ner-ar-y
out-cal-l	out-call
de-base-men-t	de-base-ment
clover	clo-ver
macroe-co-nom-ic	mac-ro-ec-o-nom-ic
bene-fac-tress	ben-e-fac-tress
whizkid-s	whizkids
w-hole-saler	whole-sal-er
re-plan-t	re-plant
askance	a-skance
sed-i-men-t	sed-i-ment
pre-dict-ed	predicted
ro-tary	ro-ta-ry
obe-di-ent-ly	o-be-di-ent-ly
fuzzy	fuzz-y
iso-tope	i-so-tope
lovelorn	love-lorn
cir-cum-ven-t	cir-cum-vent
epis-to-lary	e-pis-to-lar-y
strug-gling	struggling
semi-colon	sem-i-co-lon
mul-ti-pro-ces-sor	mul-ti-proc-es-sor
balus-ter	bal-us-ter
gal-lan-t	gal-lant
sauna	sau-na
p-re-sen-ti-men-t	pre-sen-ti-ment
s-tim-u-lan-t	stim-u-lant
heather	heath-er
de-posi-tary	de-pos-i-tar-y
trans-ceiver	trans-ceiv-er
ready	read-y
metic-u-lous	me-tic-u-lous
silli-ness	sil-li-ness
ex-e-cutable	ex-e-cut-a-ble
ex-pan-sion-ary	ex-pan-sion-ar-y
stroller	stroll-er
watch-able	watch-a-ble
lin-ear	lin-e-ar
floozy	floo-zy
ure-a	u-re-a
head-scar-f	head-scarf
de-ni-able	de-ni-a-ble
pa-pyrus	pa-py-rus
ca-cao	ca-ca-o
rib-aldry	rib-ald-ry
y-oung-ster	young-ster
u-nas-sist-ed	un-as-sist-ed
ben-der	bend-er
dahli-a	dahl-ia
racial	ra-cial
un-com-fort-able	un-com-fort-a-ble
ge-net-ic-s	ge-net-ics
nymp-holep-sy	nym-pho-lep-sy
gro-cery	gro-cer-y
paragon	par-a-gon
over-due	o-ver-due
jaun-t	jaunt
pogo	po-go
ob-scu-ran-tist	ob-scu-rant-ist
zoo-plank-ton	zo-o-plank-ton
malaise	ma-laise
el-ven	elv-en
bi-sec-t	bi-sect
rein-sert	re-in-sert
racist	rac-ist
s-ta-tion	sta-tion
han-dover	hand-o-ver
cur-d	curd
over-ly	o-ver-ly
shal-l	shall
durable	du-ra-ble
pre-or-dained	preordained
re-spectable	re-spect-a-ble
s-lur-p	slurp
bari-tone	bar-i-tone
e-q-ui-table	eq-ui-ta-ble
porno-graph-ic	por-no-graph-ic
con-vivial	con-viv-i-al
ringer	ring-er
struc-tural-ly	struc-tur-al-ly
psy-chother-a-pist	psy-cho-ther-a-pist
pu-tres-cen-t	pu-tres-cent
weapon	weap-on
chapel	chap-el
cordage	cord-age
dra-mat-ic-s	dra-mat-ics
de-moun-t	de-mount
prodi-gy	prod-i-gy
over-feed	o-ver-feed
smithy	smith-y
nightlife	night-life
wor-m	worm
glow-wor-m	glow-worm
dance-able	dance-a-ble
borstal	bor-stal
s-tates-man-ship	states-man-ship
se-ca-teurs	sec-a-teurs
armistice	ar-mi-stice
tran-scen-dence	tran-scend-ence
voyeur	vo-yeur
malev-o-len-t	ma-lev-o-lent
s-mudge	smudge
o-r-a-to-ri-o	or-a-to-ri-o
builder	build-er
lauda-to-ry	laud-a-to-ry
apron	a-pron
dila-tor	di-la-tor
con-veyanc-ing	con-vey-anc-ing
vi-able	vi-a-ble
omis-sion	o-mis-sion
fuz-z	fuzz
im-munol-o-gy	im-mu-nol-o-gy
hu-man-is-m	hu-man-ism
imag-in-able	im-ag-i-na-ble
at-tain-men-t	at-tain-ment
nobly	no-bly
ede-ma	e-de-ma
risot-to	ri-sot-to
mono-logue	mon-o-logue
my-opic	my-op-ic
dic-tio-n	dic-tion
e-cono-met-ric-s	e-con-o-met-rics
pouter	pout-er
com-forter	com-fort-er
odor-if-er-ous	o-dor-if-er-ous
respite	res-pite
fur-rowed	furrowed
over-sup-ply	o-ver-sup-ply
in-de-clin-able	in-de-clin-a-ble
white-washed	whitewashed
peanut	pea-nut
punch-able	punch-a-ble
coleslaw	cole-slaw
mauler	maul-er
ema-ci-at-ed	e-ma-ci-at-ed
moraine	mo-raine
mu-tan-t	mu-tant
paunchy	paunch-y
g-luti-nous	glu-ti-nous
ped-a-gogy	ped-a-go-gy
eroge-nous	e-rog-e-nous
reify	re-i-fy
s-tub-born-ness	stub-born-ness
het-erol-o-gous	het-er-ol-o-gous
rigid-i-ty	ri-gid-i-ty
s-moother	smooth-er
litho-graph	lith-o-graph
e-u-pho-ny	eu-pho-ny
whaler	whal-er
pathol-o-gy	pa-thol-o-gy
ex-tend-ing	extending
resid-u-al	re-sid-u-al
lino	li-no
raga-muf-fin	rag-a-muf-fin
h-es-i-tan-cy	hes-i-tan-cy
edit-ed	edited
s-lick-er	slick-er
over-writ-ing	overwriting
gra-tu-itous	gra-tu-i-tous
fit-men-t	fit-ment
beg-gary	beg-gar-y
chasti-ty	chas-ti-ty
sky-scraper	sky-scrap-er
over-re-act-s	o-ver-re-acts
s-tu-dious-ly	stu-di-ous-ly
asyn-chro-nous	a-syn-chro-nous
re-main-s	re-mains
nosy	nos-y
cuprous	cu-prous
ac-coun-t	ac-count
retic-ule	ret-i-cule
id-i-olec-t	id-i-o-lect
geosyn-chronous	ge-o-syn-chro-nous
ex-pec-tant-ly	ex-pect-ant-ly
il-l	ill
polemi-cist	po-lem-i-cist
mono-gram	mon-o-gram
hangar	hang-ar
as-sen-t	as-sent
rigid-i-fy	ri-gid-i-fy
lega-tion	le-ga-tion
nor-m	norm
paramour	par-a-mour
de-sirous	de-sir-ous
left-over	left-o-ver
phos-pho-r	phos-phor
l-o-gis-tic	lo-gis-tic
damnable	dam-na-ble
hearti-ly	heart-i-ly
de-flec-t	de-flect
sun-tanned	suntanned
saucepan	sauce-pan
ridicule	rid-i-cule
topo-graph-i-cal	top-o-graph-i-cal
over-ac-t	o-ver-act
s-lop-ing	slop-ing
sup-plan-t	sup-plant
dic-tio-nary	dic-tion-ar-y
ar-range-men-t	ar-range-ment
turn-around	turn-a-round
decor	de-cor
peri-na-tal	per-i-na-tal
s-cald-ing	scald-ing
s-core-card	score-card
rem-nan-t	rem-nant
s-ce-nari-o	sce-nar-i-o
cylin-dri-cal	cy-lin-dri-cal
mil-l	mill
s-cent-ed	scent-ed
chancery	chan-cer-y
duo-de-num	du-o-de-num
voyeuris-tic	voy-eur-is-tic
gaiter	gait-er
share-able	share-a-ble
pho-to-genic	pho-to-gen-ic
salmon	salm-on
hy-drome-chan-ic-s	hy-dro-me-chan-ics
no-tice-able	no-tice-a-ble
flat-tery	flat-ter-y
biki-ni	bi-ki-ni
s-hear-wa-ter	shear-wa-ter
dis-ar-m	dis-arm
sun-burned	sunburned
s-coot-er	scoot-er
dauphin	dau-phin
flip-pan-t	flip-pant
har-m	harm
oviduc-t	o-vi-duct
wim-p	wimp
ex-oti-cis-m	ex-ot-i-cism
u-n-ap-pre-cia-tive	un-ap-pre-ci-a-tive
sali-vate	sal-i-vate
work-able	work-a-ble
in-ep-t	in-ept
con-vert-ible	con-vert-i-ble
pornog-ra-phy	por-nog-ra-phy
egress	e-gress
i-n-escapably	in-es-cap-a-bly
stinker	stink-er
skele-tal	skel-e-tal
lovesick	love-sick
pro-po-nen-t	pro-po-nent
s-teep	steep
cousin	cous-in
melo-dra-mat-ic	mel-o-dra-mat-ic
scrol-l	scroll
gan-g-ly	gan-gly
cu-rios-i-ty	cu-ri-os-i-ty
out-lawed	outlawed
dis-obe-di-ence	dis-o-be-di-ence
vine-gar	vin-e-gar
bel-liger-en-t	bel-lig-er-ent
sole-cis-m	sol-e-cism
vi-bran-t	vi-brant
messy	mess-y
tor-men-t	tor-ment
eroti-cis-m	e-rot-i-cism
foundling	found-ling
p-saltery	psal-ter-y
d-is-fig-ure-men-t	dis-fig-ure-ment
u-nion-i-sa-tion	un-ion-i-sa-tion
mirac-u-lous	mi-rac-u-lous
dis-mis-s	dis-miss
shril-l	shrill
ri-boflavin	ri-bo-fla-vin
un-der-e-d-u-cat-ed	un-der-ed-u-cat-ed
ser-f	serf
fleshy	flesh-y
down-fal-l	down-fall
drink-able	drink-a-ble
sain-t	saint
trencher	trench-er
con-stric-t	con-strict
ha-cien-da	ha-ci-en-da
palmy	palm-y
u-n-af-fil-i-at-ed	un-af-fil-i-at-ed
quaf-f	quaff
saver	sav-er
colour	co-lour
pathol-o-gist	pa-thol-o-gist
dioce-san	di-oc-e-san
bom-bard-men-t	bom-bard-ment
war-ran-t	war-rant
sandy	sand-y
s-tair	stair
in-den-t	in-dent
over-re-ac-t	o-ver-re-act
tremo-lo	trem-o-lo
lega-to	le-ga-to
in-tac-t	in-tact
s-cud	scud
quadri-lat-er-al	quad-ri-lat-er-al
de-co	dec-o
s-tu-dious	stu-di-ous
over-ween-ing	o-ver-ween-ing
over-win-ter	o-ver-win-ter
vari-able	var-i-a-ble
hideous	hid-e-ous
s-ludge	sludge
l-o-gof-f	log-off
lin-t	lint
bal-moral	bal-mor-al
tapas	ta-pas
lyric	lyr-ic
ni-hilis-m	ni-hil-ism
b-lis-s	bliss
sibyl	sib-yl
over-weight	o-ver-weight
bonobo	bo-no-bo
aper-i-tif	a-pe-ri-tif
s-neaky	sneak-y
ple-b	pleb
bi-car-b	bi-carb
delir-i-um	de-lir-i-um
ar-rival	ar-ri-val
crum-b	crumb
timid-i-ty	ti-mid-i-ty
dispir-it-ing	dis-pir-it-ing
flamin-go	fla-min-go
ex-i-gen-t	ex-i-gent
tru-is-m	tru-ism
lin-gerie	lin-ge-rie
event-ing	e-vent-ing
k-ing-fish-er	king-fish-er
poly-styrene	pol-y-sty-rene
macaque	ma-caque
cyn-i-cis-m	cyn-i-cism
artis-tic	ar-tis-tic
mar-quetry	mar-que-try
medi-ocre	me-di-o-cre
rooi-bos	roo-i-bos
u-n-aes-thet-ic	un-aes-thet-ic
s-mashed	smashed
ovoid	o-void
un-bear-ably	un-bear-a-bly
l-o-gis-ti-cal	lo-gis-ti-cal
tripoli	trip-o-li
fi-nale	fi-na-le
un-drink-able	un-drink-a-ble
re-place-able	re-place-a-ble
tiger-ish	ti-ger-ish
li-brary	li-brar-y
s-ten-cil	sten-cil
gestalt	ge-stalt
pres-i-den-t	pres-i-dent
mendele-vi-um	men-de-le-vi-um
bromine	bro-mine
trib-al-is-m	trib-al-ism
leapfrog	leap-frog
big-otry	big-ot-ry
s-lime	slime
nega-tion	ne-ga-tion
su-perbly	su-perb-ly
u-nattain-able	un-at-tain-a-ble
elec-trode	e-lec-trode
s-tand-ing	stand-ing
brief-s	briefs
samu-rai	sam-u-rai
urol-o-gist	u-rol-o-gist
medicine	med-i-cine
s-cone	scone
u-nadul-ter-at-ed	un-a-dul-ter-at-ed
re-mov-able	re-mov-a-ble
tele-pho-ny	te-leph-o-ny
dis-putable	dis-put-a-ble
per-man-ganate	per-man-ga-nate
monothe-is-m	mon-o-the-ism
con-tretemp-s	con-tre-temps
i-n-ad-ver-ten-t	in-ad-vert-ent
re-lax-an-t	re-lax-ant
liv-able	liv-a-ble
qui-eten	qui-et-en
net-bal-l	net-ball
con-ven-t	con-vent
un-al-ter-able	un-al-ter-a-ble
pen-sion-able	pen-sion-a-ble
pan-creas	pan-cre-as
neonate	ne-o-nate
top-i-ary	to-pi-ar-y
sen-hor	se-nhor
s-to-ry-telling	sto-ry-tell-ing
shifter	shift-er
gullible	gul-li-ble
ternary	ter-na-ry
parochial-is-m	pa-ro-chi-al-ism
d-welling	dwell-ing
coast-ing	coasting
ir-recov-er-able	ir-re-cov-er-a-ble
il-lu-mi-nan-t	il-lu-mi-nant
speechi-fy-ing	speechifying
crafty	craft-y
taunt-ing	taunting
over-spend	o-ver-spend
cel-l	cell
stinky	stink-y
usurp	u-surp
emit-ter	e-mit-ter
gourmet	gour-met
ma-chete	ma-chet-e
elec-tric	e-lec-tric
forte	for-te
mi-di	mid-i
in-vol-un-tary	in-vol-un-tar-y
om-nipresen-t	om-ni-pres-ent
teeter	tee-ter
in-ter-men-t	in-ter-ment
mis-align-men-t	mis-a-lign-ment
molten	mol-ten
her-mitage	her-mit-age
nonessen-tial	non-es-sen-tial
por-ous	po-rous
re-new-able	re-new-a-ble
incog-ni-to	in-cog-ni-to
s-pacey	spac-ey
o-ver-seer	o-ver-se-er
s-tove	stove
steadi-ly	stead-i-ly
za-p	zap
glassy	glass-y
afraid	a-fraid
sub-ter-ranean	sub-ter-ra-ne-an
ev-ery-one	eve-ry-one
stylist	styl-ist
arabesque	ar-a-besque
s-porty	sport-y
va-sec-to-my	vas-ec-to-my
diplo-mat-ic	dip-lo-mat-ic
s-ports-man	sports-man
bullish	bull-ish
neuter	neu-ter
el-e-men-tary	el-e-men-ta-ry
s-nub	snub
rif-f	riff
transna-tion-al	trans-na-tion-al
s-lip-per	slip-per
ceilid-h	cei-lidh
con-se-quen-t	con-se-quent
treach-ery	treach-er-y
brassy	brass-y
un-quench-able	un-quench-a-ble
pam-phle-teer	pam-phlet-eer
un-break-able	un-break-a-ble
ev-ery-day	eve-ry-day
pen-tame-ter	pen-tam-e-ter
s-neak-ing	sneak-ing
apolo-gia	ap-o-lo-gi-a
zona-tion	zo-na-tion
tetrox-ide	te-trox-ide
s-caf-fold	scaf-fold
swar-m	swarm
pu-ri-tanis-m	pu-ri-tan-ism
salver	sal-ver
cafe-te-ri-a	caf-e-te-ri-a
forgery	for-ger-y
lot-tery	lot-ter-y
loopy	loop-y
tal-c	talc
mayfly	may-fly
es-capee	es-cap-ee
undiplo-mat-ic	un-dip-lo-mat-ic
lack-adaisi-cal	lack-a-dai-si-cal
cigar	ci-gar
defam-a-to-ry	de-fam-a-to-ry
potash	pot-ash
drifter	drift-er
gusty	gust-y
sur-moun-t	sur-mount
bilin-gual	bi-lin-gual
ef-flu-en-t	ef-flu-ent
em-ploy-men-t	em-ploy-ment
ap-palling-ly	ap-pall-ing-ly
mi-crocode	mi-cro-code
berserk	ber-serk
s-in-cer-i-ty	sin-cer-i-ty
as-cetic	as-cet-ic
ragged	rag-ged
dis-ci-plinar-i-an	dis-ci-pli-nar-i-an
lit-toral	lit-to-ral
able	a-ble
clemen-cy	clem-en-cy
s-cu-ba	scu-ba
finick-y	fin-ick-y
cowslip	cow-slip
pro-pa-gan-da	prop-a-gan-da
flinch-ing	flin-ching
co-mestible	co-mes-ti-ble
neon	ne-on
vi-o-len-t	vi-o-lent
s-tu-por	stu-por
any-ways	an-y-ways
book-able	book-a-ble
hayloft	hay-loft
cos-set-ed	cosseted
on-slaugh-t	on-slaught
s-apling	sap-ling
leghorn	leg-horn
in-com-pe-ten-t	in-com-pe-tent
s-linky	slink-y
roller	roll-er
pe-trel	pet-rel
s-lushy	slush-y
bauble	bau-ble
rein-ven-t	re-in-vent
asleep	a-sleep
crim-p	crimp
ir-re-proach-able	ir-re-proach-a-ble
over-stress	o-ver-stress
tidy	ti-dy
fly-away	fly-a-way
beachy	beach-y
spencer	spen-cer
apoc-a-lyp-tic	a-poc-a-lyp-tic
mono-lay-er	mon-o-lay-er
cres-cen-t	cres-cent
ar-ranger	ar-rang-er
hypochon-dri-ac	hy-po-chon-dri-ac
nir-vana	nir-va-na
sys-temic	sys-tem-ic
coura-geous	cou-ra-geous
mis-di-rec-t	mis-di-rect
py-rotech-nic-s	py-ro-tech-nics
eigen-state	ei-gen-state
s-trag-gle	strag-gle
porta-bil-i-ty	port-a-bil-i-ty
cognoscen-ti	co-gno-scen-ti
un-con-quer-able	un-con-quer-a-ble
artiste	ar-tiste
satir-ic	sa-tir-ic
the-atri-cal-i-ty	the-at-ri-cal-i-ty
nar-cis-sis-m	nar-cis-sism
s-lit	slit
gua-camole	gua-ca-mo-le
abroad	a-broad
dimer	di-mer
in-sid-e	in-side
pasty	past-y
treat-able	treat-a-ble
sunken	sunk-en
pi-laster	pi-las-ter
en-dear-men-t	en-dear-ment
s-culp-tor	sculp-tor
e-mer-ald	em-er-ald
ex-oskele-ton	ex-o-skel-e-ton
flu-en-t	flu-ent
the-atri-cal-s	the-at-ri-cals
com-mis-sari-at	com-mis-sar-i-at
base-bal-l	base-ball
in-vig-o-rate	in-vig-or-ate
pul-l	pull
trade-marked	trademarked
melanin	mel-a-nin
windswep-t	wind-swept
judg-men-t	judg-ment
ex-pend-able	ex-pend-a-ble
s-nob-bish	snob-bish
bomber	bomb-er
pre-ven-t	pre-vent
piti-less	pit-i-less
fuch-si-a	fuch-sia
con-scrip-t	con-script
ban-knote	bank-note
laud-s	lauds
com-press-ibil-i-ty	com-pres-si-bil-i-ty
elec-tro-dy-nam-ic-s	e-lec-tro-dy-nam-ics
func-tionary	func-tion-ar-y
spinach	spin-ach
tyran-t	ty-rant
pen-i-ten-t	pen-i-tent
taxi-cab	tax-i-cab
a-tone-men-t	a-tone-ment
k-itchen-ware	kitch-en-ware
sala-man-der	sal-a-man-der
hideous-ly	hid-e-ous-ly
tele-vi-sion	tel-e-vi-sion
re-assert	re-as-sert
loosen	loos-en
pas-toral	pas-to-ral
k-ilo-byte	kil-o-byte
s-lalom	sla-lom
s-now-stor-m	snow-storm
en-ter-tain-men-t	en-ter-tain-ment
s-tac-ca-to	stac-ca-to
s-core-less	score-less
duchy	duch-y
tele-vise	tel-e-vise
dis-mem-bered	dismembered
fa-ther-ing	fathering
blue-bel-l	blue-bell
radish	rad-ish
hefty	heft-y
trol-l	troll
in-ter-cep-t	in-ter-cept
apro-pos	ap-ro-pos
de-liv-ery	de-liv-er-y
elec-troen-cephalo-gram	e-lec-tro-en-ceph-a-lo-gram
som-no-len-t	som-no-lent
sweater	sweat-er
over-head	o-ver-head
proph-esy	proph-e-sy
epis-tle	e-pis-tle
per-tur-b	per-turb
kinky	kink-y
dactylic	dac-tyl-ic
cycli-cal	cy-cli-cal
cir-cling	circling
im-muno-sup-pres-sive	im-mu-no-sup-pres-sive
vig-i-lan-t	vig-i-lant
tarot	ta-rot
elu-ci-da-tion	e-lu-ci-da-tion
k-er-chief	ker-chief
er-bium	er-bi-um
phys-io-ther-a-py	phys-i-o-ther-a-py
beryl-li-um	be-ryl-li-um
wave-for-m	wave-form
hab-er-dash-ery	hab-er-dash-er-y
aquar-i-um	a-quar-i-um
catch-men-t	catch-ment
tetchy	tetch-y
az-imuth	az-i-muth
naive	na-ive
s-trait	strait
sav-agery	sav-age-ry
in-tu-itive	in-tu-i-tive
c-etacean	ce-ta-cean
retsi-na	ret-si-na
hear-ken	heark-en
hearty	heart-y
valise	va-lise
s-moth-ered	smothered
down-load-ed	downloaded
s-cout-ing	scout-ing
aphro-disi-ac	aph-ro-dis-i-ac
febrile	fe-brile
as-s	ass
napoleon	na-po-le-on
screwy	screw-y
s-ta-sis	sta-sis
thau-maturge	thau-ma-turge
Words with errors: 2250
Words with incorrect number of syllables: 2044
Total evluated: 6500
Perfect accuracy: 0.65
Number of syllables accuracy: 0.69
Average Levenshtein Distance(across incorrect words): 1.21
