Attempt	Real
fla-gel-la-tion	flag-el-la-tion
de-cile	dec-ile
dis-sen-ter	dis-sent-er
ele-phant	el-e-phant
garn-ish	gar-nish
lea-gue	league
pro-duct	prod-uct
brunette	bru-nette
sushi	su-shi
ob-ser-ver	ob-serv-er
con-den-ser	con-dens-er
bi-got	big-ot
er-a-ser	e-ras-er
un-der-priv-ileged	un-der-priv-i-leged
con-tour-ing	con-touring
hein-ous	hei-nous
a-wes-truck	awe-struck
su-per-posed	superposed
hed-ger-ow	hedge-row
prostra-tion	pros-tra-tion
chee-ri-o	cheer-i-o
bonded	bond-ed
car-ri-age-way	car-riage-way
de-fines	def-ines
hireling	hire-ling
not-i-fy	no-ti-fy
de-lim-it-ed	delimited
o-ther-wise	oth-er-wise
gyro-scope	gy-ro-scope
co-pra	cop-ra
heat-wave	heatwave
as-tray	a-stray
to-p-o-graph-ic	top-o-graph-ic
ve-nue	ven-ue
throa-ty	throat-y
me-nu	men-u
un-priv-ileged	un-priv-i-leged
fa-th-om	fath-om
haberd-ash-er	hab-er-dash-er
stringy	string-y
lib-i-do	li-bi-do
port-age	por-tage
hy-po-c-ri-sy	hy-poc-ri-sy
au-g-er	au-ger
de-caf-feinate	de-caf-fein-ate
pre-sence	pres-ence
disem-bark	dis-em-bark
bet-ween	be-tween
ori-fice	or-i-fice
me-g-a-ton	meg-a-ton
in-ex-or-a-bly	in-ex-o-ra-bly
re-per-toire	rep-er-toire
doc-toring	doctoring
scream-ing	screaming
sy-non-y-my	syn-on-y-my
di-su-nion	dis-un-ion
prop-y-lene	pro-pyl-ene
nit-ro-gen	ni-tro-gen
whee-lie	wheel-ie
courte-san	cour-te-san
is-o-lat-ed	i-so-lat-ed
un-in-tel-ligi-ble	un-in-tel-li-gi-ble
swimming-ly	swim-ming-ly
hoard-ed	hoarded
stab-le-mate	sta-ble-mate
network-ing	networking
des-pite	de-spite
flu-tist	flut-ist
ou-tra-geous-ly	out-ra-geous-ly
rese-lect	re-se-lect
dis-tur-bing-ly	dis-turb-ing-ly
e-phem-e-r-a	e-phem-er-a
smokestack	smoke-stack
as-tir	a-stir
ma-lod-o-rous	mal-o-dor-ous
ben-e-fi-ciar-y	ben-e-fi-ci-ar-y
dis-cotheque	dis-co-theque
out-spo-k-en	out-spo-ken
syca-more	syc-a-more
budg-e-tar-y	budg-et-ar-y
fra-tric-i-dal	frat-ri-cid-al
flounder	floun-der
so-me-one	some-one
o-blate	ob-late
cat-er-er	ca-ter-er
san-i-ta-ry	san-i-tar-y
pri-est	priest
mo-vie	mov-ie
eas-ter-ly	east-er-ly
vi-s-or	vi-sor
furn-ished	fur-nished
med-dling	meddling
bleat-ing	bleating
anx-i-ous-ly	anx-ious-ly
molester	mo-lest-er
ow-ner-ship	own-er-ship
now-here	no-where
os-tra-c-ism	os-tra-cism
fran-gi-pa-ni	fran-gi-pan-i
ve-ter-i-nar-y	vet-er-i-nar-y
syl-la-ba-ry	syl-la-bar-y
mid-wif-er-y	mid-wife-ry
wes-tern-most	west-ern-most
dais-y	dai-sy
howling	howl-ing
o-ve-re-at	o-ver-eat
con-strict-ed	constricted
ep-ige-net-ic	ep-i-ge-net-ic
e-lec-tro-en-ce-phal-o-gram	e-lec-tro-en-ceph-a-lo-gram
i-deal-ly	i-de-al-ly
de-le-te-ri-ous	del-e-te-ri-ous
vig-o-rous	vig-or-ous
cour-teous	cour-te-ous
sa-v-age-ly	sav-age-ly
dura-ble	du-ra-ble
wa-gon	wag-on
ba-loney	ba-lo-ney
ini-tia-tor	in-i-ti-a-tor
cov-a-lent	co-va-lent
la-wy-er	law-yer
bi-g-ot-ry	big-ot-ry
fis-ti-cuffs	fist-i-cuffs
com-par-a-ble	com-pa-ra-ble
e-lec-to-rate	e-lec-tor-ate
ini-ti-a-tion	in-i-ti-a-tion
cre-nel-la-tions	cren-el-la-tions
u-n-o-rig-i-nal	un-o-rig-i-nal
maso-chist	mas-och-ist
roguish	ro-guish
dan-de-lion	dan-de-li-on
skiing	ski-ing
pi-ca-r-esque	pic-a-resque
do-pey	dope-y
he-roism	her-o-ism
an-ta-go-nism	an-tag-o-nism
me-lon	mel-on
e-phor	eph-or
de-vil-ment	dev-il-ment
prompting	prompt-ing
o-th-er-ness	oth-er-ness
tel-e-vised	televised
mes-senger	mes-sen-ger
re-in-vig-o-rate	re-in-vig-or-ate
gangling	gan-gling
un-pro-ven	un-prov-en
gi-blets	gib-lets
de-f-er-en-tial	def-er-en-tial
ba-l-ance	bal-ance
u-reth-ra	u-re-thra
tele-thon	tel-e-thon
macker-el	mack-er-el
twinkling	twin-kling
cata-comb	cat-a-comb
sil-age	si-lage
meas-ly	mea-sly
pre-mi-ere	pre-miere
eid-er	ei-der
ple-bis-cite	pleb-i-scite
mishan-dle	mis-han-dle
re-ceiver-ship	re-ceiv-er-ship
buz-zer	buzz-er
ting-ly	tin-gly
ca-mel	cam-el
arach-nid	a-rach-nid
ev-o-ca-tive	e-voc-a-tive
ba-sil	bas-il
nu-dist	nud-ist
re-devel-op-ment	re-de-vel-op-ment
sy-co-phan-tic	syc-o-phan-tic
wash-er-wo-man	wash-er-wom-an
dis-am-bi-gu-ate	dis-am-big-u-ate
her-me-ne-u-t-ics	her-me-neu-tics
is-o-mor-phic	i-so-mor-phic
las-er	la-ser
mus-ke-teer	mus-ket-eer
val-ise	va-lise
as-tro-nau-t-ics	as-tro-nau-tics
in-debted	in-debt-ed
nad-ir	na-dir
me-teor	me-te-or
mut-ter-ing	muttering
cerise	ce-rise
prompti-tude	promp-ti-tude
sy-nod-ic	syn-od-ic
spi-rit-u-al-ist	spir-it-u-al-ist
gir-der	gird-er
hy-draul-ic	hy-drau-lic
in-te-rim	in-ter-im
un-ique-ly	u-nique-ly
domi-neer	dom-i-neer
pe-ril	per-il
run-n-er	run-ner
haph-a-zard	hap-haz-ard
twinning	twin-ning
out-lier	out-li-er
pe-rine-um	per-i-ne-um
ci-trate	cit-rate
mem-ora-ble	mem-o-ra-ble
res-tate-ment	re-state-ment
sup-por-tive	sup-port-ive
me-te-o-rite	me-te-or-ite
e-ver-last-ing	ev-er-last-ing
pa-ren-ter-al	par-en-ter-al
ban-krupt-cy	bank-rupt-cy
ar-chene-my	arch-en-e-my
clash-ing	clashing
sine-wy	sin-ew-y
tran-s-lu-cen-cy	trans-lu-cen-cy
flow-ering	flow-er-ing
mole-cule	mol-e-cule
vig-orous-ly	vig-or-ous-ly
me-gal-o-ma-ni-a	meg-a-lo-ma-ni-a
prefer	pre-fer
con-scien-tious-ness	con-sci-en-tious-ness
cafe	ca-fe
quav-er	qua-ver
chi-val-ry	chiv-al-ry
grasshop-per	grass-hop-per
shat-tering	shat-ter-ing
en-riched	enriched
dis-em-bodied	dis-em-bod-ied
re-mar-ri-age	re-mar-riage
spid-er	spi-der
pre-da-to-ry	pred-a-to-ry
im-mo-ral	im-mor-al
oper-a-tive	op-er-a-tive
il-li-quid	il-liq-uid
coupling	cou-pling
pun-y	pu-ny
po-l-yga-mous	po-lyg-a-mous
e-di-fi-ca-tion	ed-i-fi-ca-tion
gig-gling	giggling
space-su-it	space-suit
black-ened	blackened
de-luge	del-uge
re-ad-i-ly	read-i-ly
ty-pist	typ-ist
roun-dup	round-up
ap-pal-ling-ly	ap-pall-ing-ly
ir-o-ny	i-ro-ny
bootleg	boot-leg
mousy	mous-y
logoff	log-off
seren-dip-i-ty	ser-en-dip-i-ty
was-trel	wast-rel
shar-pe-ner	shar-pen-er
re-fugee	ref-u-gee
flesh-ing	fleshing
i-co-no-clasm	i-con-o-clasm
realign	re-a-lign
dorm-er	dor-mer
con-sis-ten-cy	con-sist-en-cy
firma-ment	fir-ma-ment
car-cino-gen	car-cin-o-gen
spa-ni-el	span-iel
de-ri-va-tive	de-riv-a-tive
hails-torm	hail-storm
sof-tie	soft-ie
re-t-roac-tive-ly	ret-ro-ac-tive-ly
mar-gi-nal-i-a	mar-gi-na-li-a
ti-a-ra	ti-ar-a
pi-l-as-ter	pi-las-ter
mel-liflu-ous	mel-lif-lu-ous
bal-loon-ist	balloonist
lec-tu-re-ship	lec-ture-ship
hed-on-ist	he-don-ist
dis-courag-ing	dis-cour-ag-ing
ro-sin	ros-in
ca-me-o	cam-e-o
tra-chea	tra-che-a
gra-ter	grat-er
dis-pirit-ing	dis-pir-it-ing
re-routes	re-routes
dul-lard	dull-ard
om-ni-po-tence	om-nip-o-tence
un-cor-robo-rat-ed	un-cor-rob-o-rat-ed
hy-per-bole	hy-per-bo-le
re-so-na-tor	res-o-na-tor
i-mag-er-y	im-age-ry
fri-gate	frig-ate
sac-risty	sac-ris-ty
a-pro-pos	ap-ro-pos
im-palp-a-ble	im-pal-pa-ble
re-cid-iv-ist	re-cid-i-vist
ca-val-ry	cav-al-ry
la-cy	lac-y
te-n-an-try	ten-ant-ry
crink-ly	crin-kly
de-sul-to-ry	des-ul-to-ry
testy	tes-ty
ve-ris-i-mil-i-tude	ver-i-si-mil-i-tude
par-li-a-ment	par-lia-ment
di-a-co-nal	di-ac-o-nal
dis-fi-gure-ment	dis-fig-ure-ment
pregnan-cy	preg-nan-cy
diverge	di-verge
glut-to-n-ous	glut-ton-ous
ta-blet	tab-let
o-ver-crowding	o-ver-crow-ding
a-s-cribe	as-cribe
bal-a-laika	bal-a-lai-ka
in-cluded	in-clud-ed
bailiff	bail-iff
mag-netism	mag-net-ism
stoi-cism	sto-i-cism
cyan	cy-an
pre-dic-t-a-bil-i-ty	pre-dict-a-bil-i-ty
un-fa-shion-a-ble	un-fash-ion-a-ble
in-ge-ni-ous-ly	in-gen-ious-ly
re-as-sur-ing	reassuring
re-son-ance	res-o-nance
as-pi-rant	as-pir-ant
pas-sa-bly	pass-a-bly
shib-boleth	shib-bo-leth
vi-de-o	vid-e-o
tig-er-ish	ti-ger-ish
e-pis-tem-o-log-i-cal	e-pis-te-mo-log-i-cal
silv-er	sil-ver
cutler	cut-ler
so-l-icit	so-lic-it
au-topi-lot	au-to-pi-lot
mol-ybde-num	mo-lyb-de-num
un-bek-nown	un-be-known
new-sreel	news-reel
lam-b-da	lamb-da
how-it-zer	how-itz-er
pre-lude	prel-ude
ground-wa-t-er	ground-wa-ter
lurk-ing	lurking
flat-tering	flat-ter-ing
pa-tro-ness	pa-tron-ess
mis-spell-ings	mis-spel-lings
duik-er	dui-ker
blasphe-my	blas-phe-my
treas-u-ry	treas-ur-y
dra-gon-fly	drag-on-fly
as-tride	a-stride
wrestler	wres-tler
glor-i-fy	glo-ri-fy
trea-so-nous	trea-son-ous
chee-s-y	chees-y
mi-dair	mid-air
her-bi-cide	herb-i-cide
non-ex-is-tence	non-ex-ist-ence
de-nim	den-im
ir-repar-a-ble	ir-rep-a-ra-ble
edgy	edg-y
le-mon	lem-on
vide-o-taped	videotaped
scien-tist	sci-en-tist
con-ti-nue	con-tin-ue
both-ered	bothered
prem-a-ture	pre-ma-ture
flyov-er	fly-o-ver
con-su-mer-ism	con-sum-er-ism
ra-c-ist	rac-ist
ju-nip-er	ju-ni-per
po-ly-a-tom-ic	pol-y-a-tom-ic
fing-er	fin-ger
ele-venth	e-lev-enth
ni-co-tine	nic-o-tine
dro-pout	drop-out
o-do-rous	o-dor-ous
feasi-ble	fea-si-ble
neu-ro-nes	neu-rones
marked-ly	mark-ed-ly
shun-ter	shunt-er
an-tic-li-max	an-ti-cli-max
main-stre-am	main-stream
de-cay-ing	decaying
sole-cism	sol-e-cism
erase	e-rase
un-pre-ju-diced	un-prej-u-diced
mar-ke-teer	mar-ket-eer
smug-gling	smuggling
la-no-lin	lan-o-lin
ou-ter-most	out-er-most
u-ne-quiv-o-cal-ly	un-e-quiv-o-cal-ly
in-ter-ro-ga-to-ry	in-ter-rog-a-to-ry
create	cre-ate
out-going	out-go-ing
pu-rist	pur-ist
sterling	ster-ling
fal-len	fall-en
te-nant	ten-ant
blood-stre-am	blood-stream
mi-ra-cle	mir-a-cle
co-ron-er	cor-o-ner
un-plea-sant	un-pleas-ant
tran-sa-tlan-tic	trans-at-lan-tic
ety-mol-o-gy	et-y-mol-o-gy
mo-nomo-lec-u-lar	mon-o-mo-lec-u-lar
tri-bune	trib-une
church-war-d-en	church-ward-en
fer-al	fe-ral
jin-gois-tic	jin-go-is-tic
su-pre-m-a-cist	su-prem-a-cist
minke	min-ke
e-goism	e-go-ism
eth-y-lene	eth-yl-ene
in-choate	in-cho-ate
loc-o-mo-tion	lo-co-mo-tion
plea-sur-a-ble	pleas-ur-a-ble
se-v-en-ty	sev-en-ty
de-c-a-dence	dec-a-dence
de-ma-gogue	dem-a-gogue
lifes-tyle	life-style
pro-li-f-er-ate	pro-lif-er-ate
drunken-ly	drunk-en-ly
go-v-ern	gov-ern
shar-ply	sharp-ly
en-chant-ed	enchanted
cup-rous	cu-prous
read-just	re-ad-just
gopher	go-pher
phony	pho-ny
ma-rin-er	mar-i-ner
di-arr-hea	di-ar-rhe-a
ma-dam	mad-am
a-w-ash	a-wash
com-par-a-bly	com-pa-ra-bly
stabling	sta-bling
pa-pule	pap-ule
in-trepid	in-trep-id
ne-ther-most	neth-er-most
ci-vil-i-an	ci-vil-ian
talent-ed	tal-ent-ed
a-ny-bod-y	an-y-bod-y
smelt-ing	smelting
moth-er-stobe	mo-ther-stobe
mea-sure-less	meas-ure-less
clas-sroom	class-room
dis-po-sal	dis-pos-al
cus-to-ma-ry	cus-tom-ar-y
foghorn	fog-horn
en-gineer	en-gi-neer
fig-u-ra-tive	fig-ur-a-tive
fore-ver	for-ev-er
re-cog-nize	rec-og-nize
bil-lionaire	bil-lion-aire
oilc-loth	oil-cloth
dum-found-ing	dumf-ound-ing
springy	spring-y
pro-voking	pro-vok-ing
pre-suma-bly	pre-sum-a-bly
bota-nist	bot-a-nist
whiz-kids	whizkids
py-ram-id	pyr-a-mid
prole-tar-i-an	pro-le-tar-i-an
iso-top-ic	i-so-top-ic
wi-dow	wid-ow
cli-to-ral	clit-o-ral
in-dented	in-dent-ed
re-tri-ev-al	re-triev-al
jaz-zy	jazz-y
in-ge-ni-ous	in-gen-ious
dis-so-n-ant	dis-so-nant
dogged	dog-ged
depict	de-pict
hung-er	hun-ger
tho-rough-fare	thor-ough-fare
crispy	crisp-y
com-pa-nion-a-ble	com-pan-ion-a-ble
up-stre-am	up-stream
en-gineer-ing	en-gi-neer-ing
de-ca-pod	dec-a-pod
green-groc-er	green-gro-cer
dis-ap-pro-val	dis-ap-prov-al
col-la-b-o-ra-tive	col-lab-o-ra-tive
de-sir-a-bil-i-a	de-si-ra-bi-li-a
prolonged	pro-longed
hi-e-rat-ic	hi-er-at-ic
ho-me-ow-ner	home-own-er
zool-o-gist	zo-ol-o-gist
ava-lanche	av-a-lanche
ta-chy-on	tach-y-on
sal-ty	salt-y
dra-gon	drag-on
mush-room-ing	mushrooming
stag-e-coach	stage-coach
pa-p-ist	pa-pist
xer-og-ra-phy	xe-rog-ra-phy
cadet	ca-det
dam-pen	damp-en
sprinkling	sprin-kling
journa-lese	jour-nal-ese
her-ita-bil-i-ty	her-it-a-bil-i-ty
pseu-dopod	pseu-do-pod
feas-i-bil-i-ty	fea-si-bil-i-ty
cur-v-y	curv-y
pa-ge-ant	pag-eant
se-m-an-tic	se-man-tic
drubbing	drub-bing
burn-ings	bur-nings
seg-ment-ed	seg-men-ted
rain-fo-rest	rain-for-est
el-ven	elv-en
sturd-y	stur-dy
changeling	change-ling
twil-it	twi-lit
plenty	plen-ty
va-c-u-um	vac-u-um
pro-v-o-ca-tive-ly	pro-voc-a-tive-ly
feudist	feud-ist
mas-ca-ra	mas-car-a
nor-ther-ner	north-ern-er
ca-thol-ic	cath-o-lic
con-sor-tium	con-sor-ti-um
di-a-bol-ism	di-ab-o-lism
re-for-ma-tion	ref-or-ma-tion
solicit-ing	soliciting
le-ga-tee	leg-a-tee
me-tho-do-log-i-cal	meth-od-o-log-i-cal
bu-si-ly	bus-i-ly
crum-by	crumb-y
febrile	fe-brile
un-der-stu-dy	un-der-stud-y
de-boned	deboned
lob-byist	lob-by-ist
lemur	le-mur
aw-ry	a-wry
per-i-lous-ly	per-il-ous-ly
grasping	grasp-ing
chan-geov-er	change-o-ver
pe-remp-to-ry	per-emp-to-ry
ex-a-cer-bate	ex-ac-er-bate
cau-sal-ly	caus-al-ly
o-pe-ner	o-pen-er
doing	do-ing
toothy	tooth-y
trust-ed	trusted
ar-mis-tice	ar-mi-stice
phe-no-men-o-log-i-cal	phe-nom-e-no-log-i-cal
six-tieth	six-ti-eth
con-sider-a-bly	con-sid-er-a-bly
co-ral	cor-al
o-ni-on	on-ion
nic-e-ty	ni-ce-ty
re-la-tivis-tic	rel-a-tiv-is-tic
e-pis-cop-a-cy	e-pis-co-pa-cy
mi-le-stone	mile-stone
pil-grimage	pil-grim-age
mar-ke-ter	mar-ket-er
cyc-lic	cy-clic
lisping	lis-ping
pilf-er	pil-fer
un-ea-s-i-ly	un-eas-i-ly
ca-shi-er	cash-ier
pol-t-roon	pol-troon
un-con-ge-ni-al	un-con-gen-ial
rare-fied	rar-e-fied
pa-ro-chial-ism	pa-ro-chi-al-ism
ve-n-ous	ve-nous
grou-pie	group-ie
nea-t-en	neat-en
te-leph-o-n-ist	te-leph-o-nist
naive	na-ive
un-dim-in-ished	un-di-min-ished
carou-sel	car-ou-sel
sub-stan-dard	sub-stand-ard
pol-y-cry-stal-line	pol-y-crys-tal-line
my-ri-ad	myr-i-ad
cau-sal	caus-al
neph-ri-tis	ne-phri-tis
psy-choth-er-a-py	psy-cho-ther-a-py
gha-na	ghana
du-ode-num	du-o-de-num
cos-tar	co-star
roo-k-er-y	rook-er-y
pro-state	pros-tate
re-gis-tra-ble	reg-is-tra-ble
cor-n-er	cor-ner
cle-men-cy	clem-en-cy
loit-er	loi-ter
tru-cu-lent	truc-u-lent
sys-te-mat-i-cal-ly	sys-tem-at-i-cal-ly
in-sa-ti-a-ble	in-sa-tia-ble
priv-ileged	priv-i-leged
canc-er	can-cer
prison	pris-on
clov-en	clo-ven
tricy-cle	tri-cy-cle
sport-swear	sports-wear
dying	dy-ing
titil-late	tit-il-late
chame-le-on	cha-me-le-on
re-strain-ing	restraining
dis-cerning	dis-cern-ing
lof-t-y	loft-y
es-ca-pist	es-cap-ist
de-pos-i-tary	de-pos-i-tar-y
e-so-ter-ic	es-o-ter-ic
malev-o-lent	ma-lev-o-lent
blender	blend-er
co-ra-cle	cor-a-cle
ther-mos-tat	ther-mo-stat
son-ar	so-nar
rolling	roll-ing
fril-lier	fril-li-er
ti-me-piece	time-piece
bio-morph	bi-o-morph
grassroots	grass-roots
bes-tir	be-stir
prop-o-nent	pro-po-nent
per-sis-tent-ly	per-sist-ent-ly
mo-ral-ism	mor-al-ism
al-arm-ing	a-larm-ing
te-lex	tel-ex
ca-rat	car-at
pal-ata-ble	pal-at-a-ble
con-san-guine-ous	con-san-guin-e-ous
scler-o-sis	scle-ro-sis
el-i-tism	e-lit-ism
com-pa-ra-tive-ly	com-par-a-tive-ly
in-di-ca-tive	in-dic-a-tive
prim-o-gen-i-ture	pri-mo-gen-i-ture
un-so-ci-a-ble	un-so-cia-ble
hearten-ing	heartening
rev-i-val-ism	re-viv-al-ism
a-r-is-to-crat	a-ris-to-crat
tid-i-ness	ti-di-ness
char-is-ma	cha-ris-ma
ka-le-i-do-s-cop-ic	ka-lei-do-scop-ic
e-schew	es-chew
ex-cla-ma-to-ry	ex-clam-a-to-ry
de-reg-u-la-tion	de-reg-u-lation
leg-a-lese	le-gal-ese
re-phrases	re-phra-ses
a-toll	at-oll
per-mit-ting	permitting
pe-dant	ped-ant
serene-ly	se-rene-ly
whole-wheat	wholewheat
ev-ict	e-vict
in-san-i-tary	in-san-i-tar-y
plea-san-try	pleas-ant-ry
re-pre-hensi-ble	rep-re-hen-si-ble
re-tro-spec-tion	ret-ro-spec-tion
lan-y-ard	lan-yard
te-net	ten-et
de-fa-ma-to-ry	de-fam-a-to-ry
quiet-ness	qui-et-ness
foreign	for-eign
ele-ment	el-e-ment
culp-a-ble	cul-pa-ble
do-tage	dot-age
in-cle-ment	in-clem-ent
fin-ance	fi-nance
stra-pless	strap-less
pho-to-co-pi-er	pho-to-cop-i-er
comp-troll-er	comp-trol-ler
hairy	hair-y
trackbed	track-bed
dom-i-cil-i-a-r-y	dom-i-cil-i-ar-y
un-plea-sant-ness	un-pleas-ant-ness
flooz-y	floo-zy
pol-e-cat	pole-cat
nob-o-dy	no-bod-y
glasses	glass-es
ner-vous	nerv-ous
a-tav-ism	at-a-vism
gla-di-a-to-ri-al	glad-i-a-to-ri-al
sophis-ti-ca-tion	so-phis-ti-ca-tion
mis-er-li-ness	mi-ser-li-ness
grumbling	grum-bling
pol-y-prop-y-lene	pol-y-pro-pyl-ene
ple-nar-y	ple-na-ry
forest-ed	forested
covet	cov-et
phi-lo-soph-i-cal-ly	phil-o-soph-i-cal-ly
va-cu-ole	vac-u-ole
gof-er	go-fer
quart-zite	quartz-ite
ma-lad-just-ment	mal-ad-just-ment
pin-e-ap-ple	pine-ap-ple
poignan-cy	poign-an-cy
con-ver-t-er	con-vert-er
cor-po-ra-tist	cor-po-rat-ist
credit	cred-it
grand-fath-er	grand-fa-ther
scan-d-a-lous	scan-dal-ous
un-asham-ed-ly	un-a-sham-ed-ly
pear-ly	pearl-y
re-fo-res-ta-tion	re-for-est-a-tion
slender	slen-der
or-thor-hom-bic	or-tho-rhom-bic
in-du-bita-ble	in-du-bi-ta-ble
in-su-p-er-a-ble	in-su-per-a-ble
steve-dore	ste-ve-dore
ho-min-id	hom-i-nid
sickbed	sick-bed
re-fer-eeing	re-fe-ree-ing
ca-ra-mel	car-a-mel
char-wo-man	char-wom-an
fril-ly	frill-y
thousand	thou-sand
ex-em-p-lar	ex-em-plar
con-si-dering	con-sid-er-ing
whir-lig-ig	whirl-i-gig
sty-l-is-tics	sty-lis-tics
si-des-tep	side-step
leth-al	le-thal
ou-trid-er	out-rid-er
in-ver-ter	in-vert-er
ep-is-tem-ic	ep-i-ste-mic
in-es-ca-p-a-ble	in-es-cap-a-ble
cand-les-tick	can-dle-stick
the-reu-pon	there-up-on
pro-vo-ca-tive	pro-voc-a-tive
re-spec-t-a-bil-i-ty	re-spect-a-bil-i-ty
un-derfed	un-der-fed
ap-pro-val	ap-prov-al
ma-ca-roon	mac-a-roon
cable-way	ca-ble-way
re-col-lec-tion	rec-ol-lec-tion
pe-ram-bu-la-tor	per-am-bu-la-tor
sub-sis-tence	sub-sist-ence
re-t-i-na	ret-i-na
gen-tri-fied	gentrified
bou-gain-vil-lea	bou-gain-vil-le-a
floa-ty	float-y
in-ter-dis-cip-li-nar-y	in-ter-dis-ci-pli-nar-y
darling	dar-ling
lo-des-tar	lode-star
cli-to-ris	clit-o-ris
sapling	sap-ling
ne-cropo-lis	ne-crop-o-lis
cher-u-b-ic	che-ru-bic
har-den	hard-en
val-i-ant-ly	val-iant-ly
modesty	mod-es-ty
ringlead-er	ring-lead-er
prime-val	pri-me-val
down-load-ed	downloaded
me-t-ro	met-ro
scor-pion	scor-pi-on
fo-res-tall	fore-stall
phra-sal	phras-al
dis-pensa-ble	dis-pen-sa-ble
bi-mo-dal	bi-mod-al
fi-n-an-cial	fi-nan-cial
nai-vete	naivete
mi-r-age	mi-rage
casket	cas-ket
skew-ered	skewered
su-bur-ban	sub-ur-ban
prop-a-gand-ist	prop-a-gan-dist
te-nured	tenured
town-speo-ple	towns-peo-ple
mag-ne-sium	mag-ne-si-um
trea-sur-er	treas-ur-er
cunning	cun-ning
re-no-vate	ren-o-vate
gloat-ing	gloating
ca-cao	ca-ca-o
dog-matism	dog-ma-tism
snow-s-torm	snow-storm
une-lect-ed	un-e-lect-ed
tre-mo-lo	trem-o-lo
ep-ine-phrine	ep-i-neph-rine
cal-cium	cal-ci-um
in-her-i-tance	in-her-it-ance
ta-lent-less	tal-ent-less
ex-hila-r-at-ing	ex-hil-a-rat-ing
col-li-ne-ar	col-lin-e-ar
un-feas-i-ble	un-fea-si-ble
bulg-ing	bulging
slander	slan-der
dar-ken	dark-en
story-tell-er	sto-ry-tell-er
stoi-cal	sto-i-cal
ev-er-ything	eve-ry-thing
fri-a-r-y	fri-ar-y
hang-glid-ed	hang-gli-ded
de-lect-a-ble	de-lec-ta-ble
ex-tram-u-ral	ex-tra-mu-ral
cricket-ing	crick-et-ing
de-vas-ta-tion	dev-as-ta-tion
un-an-i-mous	u-nan-i-mous
de-cla-ma-to-ry	de-clam-a-to-ry
nor-thern-most	north-ern-most
un-varnished	un-var-nished
dim-i-nu-tive	di-min-u-tive
i-le-um	il-e-um
uni-den-ti-fied	un-i-den-ti-fied
ma-lad-min-is-tra-tion	mal-ad-min-is-tra-tion
ditch-ing	ditching
e-n-ig-mat-ic	en-ig-mat-ic
o-ver-flow-ing	o-ver-flo-wing
scra-pyard	scrap-yard
re-v-is-it	re-vis-it
re-gis-trar	reg-is-trar
con-duc-tance	con-duct-ance
shepherd-ing	shepherding
re-vel-ry	rev-el-ry
in-ad-ver-tent	in-ad-vert-ent
po-ver-ty	pov-er-ty
mes-o-s-phere	mes-o-sphere
mis-creant	mis-cre-ant
cha-mois	cham-ois
ca-v-ern	cav-ern
dis-gusting	dis-gust-ing
me-tro-nome	met-ro-nome
pro-ject-ing	projecting
mal-ig-nan-cy	ma-lig-nan-cy
fas-tener	fas-ten-er
scare-mon-gering	scare-mon-ger-ing
polyun-sat-u-rat-ed	pol-y-un-sat-u-rat-ed
slip-ping	slipping
at-mosphere	at-mos-phere
dam-ning	damn-ing
courthouse	court-house
in-effa-ble	in-ef-fa-ble
em-bedda-ble	em-bed-da-ble
ex-port-a-bil-i-ty	ex-por-ta-bi-li-ty
pol-y-ga-my	po-lyg-a-my
clergy	cler-gy
le-gend	leg-end
hu-morous-ly	hu-mor-ous-ly
un-im-port-ance	un-im-por-tance
in-sis-tence	in-sist-ence
seas-cape	sea-scape
in-tel-li-gent-sia	in-tel-li-gent-si-a
of-fhand	off-hand
ter-ro-rism	ter-ror-ism
i-m-a-go	i-ma-go
chroni-cler	chron-i-cler
bab-y-sit-ter	ba-by-sit-ter
ceil-idh	cei-lidh
sa-tur-day	sat-ur-day
cra-tered	cratered
bri-ef-case	brief-case
o-pa-les-cent	o-pal-es-cent
trigo-nom-e-try	trig-o-nom-e-try
coax-i-al	co-ax-i-al
be-de-vil	be-dev-il
pho-n-o-log-i-cal	pho-no-log-i-cal
privet	priv-et
un-coordi-nat-ed	un-co-or-di-nat-ed
stoi-cal-ly	sto-i-cal-ly
pro-pell-er	pro-pel-ler
slal-om	sla-lom
dis-credit-ed	discredited
fluf-fy	fluff-y
posting	post-ing
a-ve-nue	av-e-nue
wicketkeep-er	wick-et-keep-er
ca-na-r-y	ca-nar-y
con-flict-ed	conflicted
de-vil	dev-il
gut-sy	guts-y
new-lywed	new-ly-wed
nau-seat-ing	nau-se-at-ing
in-val-id	in-va-lid
in-deco-rous	in-dec-o-rous
pro-tect-ed	protected
hook-ing	hooking
pe-des-tal	ped-es-tal
a-s-crip-tion	as-crip-tion
ir-rel-ev-ance	ir-rel-e-vance
defi-nite-ly	def-i-nite-ly
wear-i-ly	wea-ri-ly
dis-tri-bute	dis-trib-ute
der-anged	de-ranged
with-dra-wal	with-draw-al
pre-mises	prem-is-es
al-toge-ther	al-to-geth-er
te-le-kine-sis	tel-e-ki-ne-sis
per-sev-er-ance	per-se-ver-ance
sailc-loth	sail-cloth
so-cie-tal	so-ci-e-tal
cam-a-ra-de-rie	ca-ma-ra-de-rie
foot-s-tool	foot-stool
ev-er-y-where	eve-ry-where
tog-ether	to-geth-er
or-i-ga-mi	o-ri-ga-mi
foam-ing	foaming
sprinkler	sprin-kler
ini-ti-ate	in-i-ti-ate
bri-gand	brig-and
spin-al	spi-nal
gri-my	grim-y
re-pub-li-ca-n-ism	re-pub-li-can-ism
signers	sign-ers
tasty	tast-y
swarm-ing	swarming
mil-lin-er	mil-li-ner
el-fin	elf-in
mil-i-ta-ry	mil-i-tar-y
per-e-s-troi-ka	pe-re-stroi-ka
full-ing	fulling
strangle-hold	stran-gle-hold
cand-lel-it	can-dle-lit
de-ve-lop-men-tal	de-vel-op-men-tal
ex-ult-ing	exulting
arr-hyth-mi-a	ar-rhyth-mi-a
dairy-ing	dair-y-ing
li-zard	liz-ard
ca-val-cade	cav-al-cade
un-doing	un-do-ing
dan-ce-a-ble	dance-a-ble
lady-like	la-dy-like
frau-d-u-lent	fraud-u-lent
re-trofit	ret-ro-fit
restroom	rest-room
chandler	chan-dler
pi-e-ce-me-al	piece-meal
pi-ty	pit-y
gun-me-tal	gun-met-al
freewheel-ing	free-wheel-ing
pre-fa-to-ry	pref-a-to-ry
mis-er	mi-ser
es-ca-pism	es-cap-ism
man-i-cured	ma-ni-cured
fe-lon	fel-on
pre-ju-dice	prej-u-dice
bu-si-nes-slike	busi-ness-like
ene-my	en-e-my
pro-se-c-u-tor	pros-e-cu-tor
mi-en	mien
u-n-i-verse	u-ni-verse
deci-sive-ness	de-ci-sive-ness
a-venger	a-veng-er
seas-o-nal-i-ty	sea-son-al-i-ty
fi-nale	fi-na-le
per-so-ni-fi-ca-tion	per-son-i-fi-ca-tion
sob-ri-quet	so-bri-quet
fealt-y	fe-al-ty
un-dis-covered	un-dis-cov-ered
te-le-o-log-i-cal	tel-e-o-log-i-cal
a-v-er	a-ver
chivv-y	chiv-vy
pap-a-cy	pa-pa-cy
for-sy-thi-a	for-syth-i-a
chro-moso-mal	chro-mo-so-mal
o-ra-to-ry	or-a-to-ry
stripling	strip-ling
ham-mering	ham-mer-ing
pos-ter	post-er
severe-ly	se-vere-ly
at-tri-bute	at-trib-ute
in-di-ges-t-i-ble	in-di-gest-i-ble
basket	bas-ket
frica-tive	fric-a-tive
fig-u-ra-tive-ly	fig-ur-a-tive-ly
re-sis-tant	re-sist-ant
shar-pen	sharp-en
hon-o-rar-y	hon-or-ar-y
ta-bloid	tab-loid
chutzpah	chutz-pah
hide-ous	hid-e-ous
mo-der-nist	mod-ern-ist
re-no-va-tion	ren-o-va-tion
punish-a-ble	pun-ish-a-ble
cowling	cowl-ing
laz-i-ness	la-zi-ness
ges-talt	ge-stalt
spok-en	spo-ken
con-que-ror	con-quer-or
an-o-ma-ly	a-nom-a-ly
om-ni-pre-sence	om-ni-pres-ence
thre-at-en	threat-en
in-deli-ble	in-del-i-ble
mis-chie-v-ous	mis-chie-vous
spider-y	spi-der-y
lemming	lem-ming
knuck-le-dus-ter	knuck-le-dust-er
tab-le-ware	ta-ble-ware
profit-less	prof-it-less
phy-si-o-log-i-cal	phys-i-o-log-i-cal
re-s-cind	re-scind
zool-o-gy	zo-ol-o-gy
ir-rel-e-v-ant	ir-rel-e-vant
min-ce-me-at	mince-meat
sug-ges-ti-ble	sug-gest-i-ble
dau-ber	daub-er
se-b-a-ceous	se-ba-ceous
com-plain-ing	complaining
so-ci-a-bil-i-ty	so-cia-bil-i-ty
tit-ter-ing	tittering
mo-men-ta-ry	mo-men-tar-y
wes-ter-ly	west-er-ly
gree-nie	green-ie
ex-a-min-er	ex-am-in-er
gi-go-lo	gig-o-lo
veg-et-a-tive	veg-e-ta-tive
con-trac-ti-ble	con-tract-i-ble
ou-tra-geous	out-ra-geous
i-mag-ina-ble	im-ag-i-na-ble
ap-pren-ti-ce-ship	ap-pren-tice-ship
bat-ter-ing	battering
starf-ish	star-fish
bould-er	boul-der
gnom-ic	gno-mic
sprawl-ing	sprawling
fi-n-an-cial-ly	fi-nan-cial-ly
pro-per-ty	prop-er-ty
be-wildered	bewildered
slant-ed	slanted
pom-pous	pomp-ous
e-q-ui-noc-tial	e-qui-noc-tial
down-stre-am	down-stream
dis-trac-t-ing	dis-tract-ing
vag-ue-ness	vague-ness
re-v-e-la-tion	rev-e-la-tion
dee-ply	deep-ly
ti-dal	tid-al
pro-gressed	progressed
bril-li-ance	bril-liance
vel-o-drome	ve-lo-drome
me-moir	mem-oir
mo-nolo-gue	mon-o-logue
ga-my	gam-y
gal-lan-try	gal-lant-ry
blanket-ing	blan-ket-ing
gon-ad	go-nad
cre-dit-wor-thy	cred-it-worth-y
the-re-in	there-in
sat-i-ny	sat-in-y
ma-jo-l-i-ca	ma-jol-i-ca
eg-o-cen-tric	e-go-cen-tric
cha-te-au	cha-teau
nestling	nest-ling
gud-geon	gudg-eon
lo-ve-li-ness	love-li-ness
is-o-ther-mal	i-so-ther-mal
re-gis-ter	reg-is-ter
wither-ing	with-er-ing
pap-y-rus	pa-py-rus
ba-d-inage	bad-i-nage
splut-ter-ing	spluttering
proph-e-tess	proph-et-ess
liber-tar-i-an	lib-er-tar-i-an
pro-to-zoan	pro-to-zo-an
hyph-e-nate	hy-phen-ate
pi-er	pier
ga-mut	gam-ut
tel-es-cop-ic	tel-e-scop-ic
pese-ta	pe-se-ta
furn-ish-ing	fur-nish-ing
laz-i-ly	la-zi-ly
task-master	task-mas-ter
cursed	curs-ed
sal-es-man	sales-man
bi-o-che-m-ist	bi-o-chem-ist
lives-tock	live-stock
simp-er	sim-per
bes-tiar-y	bes-ti-ar-y
hairstyle	hair-style
sacred	sa-cred
i-ni-tial-ly	in-i-tial-ly
courte-sy	cour-te-sy
phy-si-o-log-i-cal-ly	phys-i-o-log-i-cal-ly
res-tora-tive	re-stor-a-tive
during	dur-ing
cabri-o-let	cab-ri-o-let
ir-re-con-cila-ble	ir-rec-on-cil-a-ble
mouth-water-ing	mouth-wa-ter-ing
in-de-ter-min-a-ble	in-de-ter-mi-na-ble
bon-an-za	bo-nan-za
cloa-ca	clo-a-ca
su-per-cil-ious	su-per-cil-i-ous
vi-t-a-min	vi-ta-min
chair-wo-man	chair-wom-an
pyr-o-ma-ni-ac	py-ro-ma-ni-ac
an-ti-qua-r-y	an-ti-quar-y
groc-er-y	gro-cer-y
spoils-port	spoil-sport
se-questered	se-ques-tered
reu-ni-on	re-un-ion
phi-late-ly	phi-lat-e-ly
u-pend-ed	upended
shant-y	shan-ty
galling	gall-ing
kayak	kay-ak
ar-chan-gel	arch-an-gel
e-le-giac	el-e-gi-ac
tying	ty-ing
e-quer-ry	eq-uer-ry
vide-o-tape	vid-e-o-tape
ti-me-li-ness	time-li-ness
ju-bilee	ju-bi-lee
li-brari-an	li-brar-i-an
de-cayed	decayed
pikestaff	pike-staff
diphthong	diph-thong
waf-er	wa-fer
promp-ter	prompt-er
cocka-too	cock-a-too
den-o-ta-tion	de-no-ta-tion
arche-type	ar-che-type
or-tho-go-nal	or-thog-o-nal
co-py-ist	cop-y-ist
o-ver-crowd-ed	o-ver-crow-ded
po-lit-ic	pol-i-tic
brand-y	bran-dy
en-tre-at	en-treat
a-tom	at-om
con-scien-tious	con-sci-en-tious
vap-o-rous	va-por-ous
me-nace	men-ace
ra-pine	rap-ine
story-book	sto-ry-book
prair-ie	prai-rie
swelling	swell-ing
pre-late	prel-ate
prosthe-sis	pros-the-sis
grati-fi-ca-tion	grat-i-fi-ca-tion
un-ex-a-mined	un-ex-am-ined
se-con-da-ry	sec-ond-ar-y
vig-i-lante	vig-i-lan-te
was-ter	wast-er
re-com-pense	rec-om-pense
faul-ty	fault-y
lun-cheon	lunch-eon
cro-co-dile	croc-o-dile
sep-ar-a-ble	sep-a-ra-ble
ex-tra-g-a-lac-tic	ex-tra-ga-lac-tic
in-capa-ble	in-ca-pa-ble
ol-die	old-ie
wrang-ler	wran-gler
kindling	kin-dling
prolapsed	pro-lapsed
de-ter-min-a-ble	de-ter-mi-na-ble
o-v-er-anx-i-ous	o-ver-anx-ious
vo-la-tile	vol-a-tile
foreknowledge	fore-knowl-edge
in-tru-der	in-trud-er
a-symp-tote	as-ymp-tote
mic-ro-grav-i-ty	mi-cro-grav-i-ty
dis-in-fec-tant	dis-in-fect-ant
pre-sen-ta-tion	pres-en-ta-tion
a-za-le-a	a-zal-ea
gin-gham	ging-ham
coac-tion	co-ac-tion
ig-no-r-ance	ig-no-rance
re-p-ut-a-ble	rep-u-ta-ble
tri-gly-ce-ride	tri-glyc-er-ide
going	go-ing
ti-mes-cale	time-scale
phooe-y	phoo-ey
swea-t-y	sweat-y
o-ver-re-ach	o-ver-reach
sil-vered	silvered
spelling	spell-ing
eon	e-on
gase-ous	gas-e-ous
chiseled	chis-eled
ar-gua-bly	ar-gu-a-bly
te-le-ol-o-gy	tel-e-ol-o-gy
hon-esty	hon-es-ty
mi-nu-tiae	mi-nu-ti-ae
u-ni-mag-ina-bly	un-im-ag-i-na-bly
rivet-ing	riv-et-ing
pla-cen-tae	pla-cen-tae
shadow	shad-ow
un-ea-sy	un-eas-y
re-ve-rie	rev-er-ie
ni-ece	niece
i-m-age	im-age
ca-ter-waul	cat-er-waul
go-v-ern-men-tal	gov-ern-men-tal
flossy	floss-y
im-porter	im-port-er
do-de-cahe-dron	do-dec-a-he-dron
savvy	sav-vy
dol-o-rous	dol-or-ous
parser	pars-er
cris-per	crisp-er
in-ter-min-a-ble	in-ter-mi-na-ble
a-qualung	aq-ua-lung
sa-v-a-g-er-y	sav-age-ry
un-willing-ness	un-will-ing-ness
pi-rat-ed	pirated
back-pe-dal	back-ped-al
ar-chiv-ist	ar-chi-vist
crum-bling	crumbling
dus-ty	dust-y
tourn-a-ment	tour-na-ment
re-col-lect	rec-ol-lect
bir-die	bird-ie
ba-ron	bar-on
e-r-upt	e-rupt
legged	leg-ged
cap-er	ca-per
con-duct-ed	conducted
lin-es-man	lines-man
un-e-a-t-en	un-eat-en
pus-sy-cat	pussycat
weari-ness	wea-ri-ness
he-reu-pon	here-up-on
lus-ty	lust-y
com-mis-sioned	commissioned
con-scien-tious-ly	con-sci-en-tious-ly
frown-ing	frowning
novel-ist	nov-el-ist
is-os-tat-ic	i-so-stat-ic
com-po-ser	com-pos-er
pu-r-ee	pu-ree
tum-bled	tumbled
biweek-ly	bi-week-ly
ex-hila-rate	ex-hil-a-rate
in-ade-quate-ly	in-ad-e-quate-ly
an-throp-o-gen-ic	an-thro-po-gen-ic
ir-rit-a-bil-i-ty	ir-ri-ta-bil-i-ty
bra-dawl	brad-awl
cool-ing	cooling
finder	find-er
pu-mice	pum-ice
pleat-ed	pleated
sim-plem-ind-ed	sim-ple-mind-ed
fu-tu-ris-tic	fu-tur-is-tic
mon-e-tar-ism	mon-e-ta-rism
ar-rival	ar-ri-val
sa-wy-er	saw-yer
reb-u-ry	re-bur-y
re-cre-a-tion	rec-re-a-tion
li-totes	li-to-tes
gla-di-a-tor	glad-i-a-tor
te-non	ten-on
ex-plo-ra-to-ry	ex-plor-a-to-ry
cata-clys-mic	cat-a-clys-mic
com-pa-n-i-on-ship	com-pan-ion-ship
clum-py	clump-y
ar-tist	art-ist
in-com-pres-si-ble	in-com-press-i-ble
smar-ten	smart-en
cyc-li-cal	cy-cli-cal
numbskull	numb-skull
pa-ral-lax	par-al-lax
ga-l-ax-y	gal-ax-y
ca-r-ess	ca-ress
pa-l-a-tal	pal-a-tal
glim-mering	glim-mer-ing
measured	meas-ured
re-com-men-da-tion	rec-om-men-da-tion
scrolling	scroll-ing
pan-ache	pa-nache
em-bo-som	em-bos-om
kill-er	kil-ler
southern-most	south-ern-most
pho-to-mul-ti-plier	pho-to-mul-ti-pli-er
de-mo	dem-o
fran-chisee	fran-chi-see
gon-do-li-er	gon-do-lier
gleam-ing	gleaming
im-po-lit-ic	im-pol-i-tic
tran-s-pire	tran-spire
rec-ti-li-near	rec-ti-lin-e-ar
spee-dom-e-ter	speed-om-e-ter
golfer	golf-er
ma-jes-ty	maj-es-ty
ey-e-let	eye-let
o-ver-writ-ing	overwriting
sole-noid	so-le-noid
drunkard	drunk-ard
erased	e-rased
a-ba-lone	ab-a-lo-ne
re-gis-tra-tion	reg-is-tra-tion
con-fi-gure	con-fig-ure
i-nim-i-cal	in-im-i-cal
e-tymo-log-i-cal	et-y-mo-log-i-cal
en-dang-er	en-dan-ger
fru-it-ful	fruit-ful
tor-tu-r-ous	tor-tur-ous
mai-so-nette	mai-son-ette
he-roine	her-o-ine
ly-rist	lyr-ist
gang-p-lank	gang-plank
psy-ch-o-so-cial	psy-cho-so-cial
pa-ral-lel-ism	par-al-lel-ism
ci-tron	cit-ron
dosage	dos-age
the-o-do-lite	the-od-o-lite
burg-lar	bur-glar
pi-ece	piece
cate-chist	cat-e-chist
riv-e-rine	riv-er-ine
lan-gu-ish	lan-guish
steal-thi-ly	stealth-i-ly
mag-ne-tite	mag-net-ite
con-cil-iar	con-cil-i-ar
loft-ed	lofted
men-swear	mens-wear
pho-tos-tat	pho-to-stat
un-ob-ser-vant	un-ob-serv-ant
dis-e-qui-li-bri-um	dis-e-qui-lib-ri-um
Words with errors: 1287
Words with incorrect number of syllables: 660
Total evluated: 6500
Perfect accuracy: 0.80
Number of syllables accuracy: 0.90
Average Levenshtein Distance(across incorrect words): 1.17
