Attempt	Real
yel-lowed	yellowed
eid-er	ei-der
sober-ly	so-ber-ly
tach-yon	tach-y-on
stard-ust	star-dust
dand-y	dan-dy
pubes-cent	pu-bes-cent
hor-rend-ous	hor-ren-dous
dis-cer-ni-ble	dis-cern-i-ble
in-teg-ra-tive	in-te-gra-tive
eu-phem-is-ti-cal-ly	eu-phe-mis-ti-cal-ly
test-ing	testing
in-ter-ci-ty	in-ter-cit-y
pre-si-d-i-um	pre-sid-i-um
dum-found-ing	dumf-ound-ing
struc-tu-r-al-ism	struc-tur-al-ism
un-ob-ser-vant	un-ob-serv-ant
un-provoked	un-pro-voked
pout-ing	pouting
an-tis-tat-ic	an-ti-stat-ic
flan-ne-lette	flan-nel-ette
u-ne-mo-tion-al	un-e-mo-tion-al
hero	he-ro
pag-ean-try	pag-eant-ry
curtsy	curt-sy
gas-k-et	gas-ket
wa-ter-me-lon	wa-ter-mel-on
in-dub-it-a-ble	in-du-bi-ta-ble
fil-i-bust-er	fil-i-bus-ter
fron-ti-er	fron-tier
mi-d-riff	mid-riff
hawt-horn	haw-thorn
rock-et-ing	rocketing
brok-er	bro-ker
in-ter-pol-a-t-a-ble	in-ter-po-la-ta-ble
mu-t-a-ble	mu-ta-ble
chid-ing	chiding
co-pi-er	cop-i-er
com-mand-ant	com-man-dant
ka-ra-kul	kar-a-kul
fa-cile	fac-ile
sampling	sam-pling
subrou-tine	sub-rou-tine
ma-tri-ar-ch-y	ma-tri-ar-chy
herald	her-ald
twinn-ing	twin-ning
en-cy-clo-ped-ic	en-cy-clo-pe-dic
tena-cious	te-na-cious
cas-so-w-ar-y	cas-so-war-y
tur-na-bout	turn-a-bout
spin-n-ing	spin-ning
buz-z-er	buzz-er
in-qui-ry	in-quir-y
in-ci-pient	in-cip-i-ent
ra-cy	rac-y
dro-pout	drop-out
ne-on-a-tal	ne-o-na-tal
an-x-ious-ly	anx-ious-ly
e-ver-y-one	eve-ry-one
spi-rit-u-al	spir-it-u-al
fiddly	fid-dly
tre-mendous-ly	tre-men-dous-ly
ir-re-con-cil-a-ble	ir-rec-on-cil-a-ble
so-lace	sol-ace
sine-cure	si-ne-cure
mea-s-ure	meas-ure
te-n-et	ten-et
cal-der-a	cal-de-ra
foreknowledge	fore-knowl-edge
in-ter-nu-clear	in-ter-nu-cle-ar
churchyard	church-yard
de-prec-a-to-ry	dep-re-ca-to-ry
di-o-ce-san	di-oc-e-san
fan-cier	fan-ci-er
wom-ankind	wom-an-kind
re-s-cale	re-scale
a-b-an-don-ment	a-ban-don-ment
in-tract-a-ble	in-trac-ta-ble
iso-lat-ed	i-so-lat-ed
bumbling	bum-bling
au-d-i-to-ry	au-di-to-ry
re-freshed	refreshed
sil-vers-mith	sil-ver-smith
de-fi-nes	def-ines
un-imped-ed	un-im-ped-ed
a-l-oud	a-loud
worsted	wor-sted
de-stined	des-tined
di-so-ri-en-ta-tion	dis-o-ri-en-ta-tion
lim-erick	lim-er-ick
di-m-in-u-en-do	di-min-u-en-do
ve-ter-i-nar-y	vet-er-i-nar-y
vir-gi-nal	vir-gin-al
sal-u-ta-r-y	sal-u-tar-y
ro-s-y	ros-y
syn-a-go-gue	syn-a-gogue
e-lec-to-ral	e-lec-tor-al
sex-tup-let	sex-tu-plet
com-pli-c-it	com-plic-it
knuck-ledus-ter	knuck-le-dust-er
me-g-al-o-ma-ni-ac	meg-a-lo-ma-ni-ac
breast-feed-ing	breastfeeding
dai-r-y	dair-y
de-co	dec-o
baleen	ba-leen
cin-em-a-tog-ra-pher	cin-e-ma-tog-ra-pher
re-as-sur-ing	reassuring
hear-ti-ly	heart-i-ly
dim-er	di-mer
yod-el	yo-del
bo-ta-nist	bot-a-nist
er-a-s-er	e-ras-er
sinew-y	sin-ew-y
sub-si-dence	sub-sid-ence
sen-sual	sen-su-al
roy-alty	roy-al-ty
nai-vete	naivete
e-quid-is-tant	e-qui-dis-tant
er-stwhile	erst-while
wor-th-i-ness	wor-thi-ness
isom-er	i-so-mer
buck-min-ster-ful-ler-e-ne	buck-min-ster-ful-ler-ene
gra-n-ite	gran-ite
pol-yeth-y-lene	pol-y-eth-yl-ene
et-h-i-cal	eth-i-cal
lich-en	li-chen
vis-i-ta-tion	vis-it-a-tion
un-prece-dent-ed	un-prec-e-dent-ed
spon-sored	sponsored
for-get-t-a-ble	for-get-ta-ble
ex-istence	ex-ist-ence
cro-ch-et	cro-chet
kal-e-i-dos-cop-ic	ka-lei-do-scop-ic
her-m-i-tage	her-mit-age
mila-d-y	mi-la-dy
grie-v-ous-ly	griev-ous-ly
dal-liance	dal-li-ance
bun-galow	bun-ga-low
cred-it-wor-th-y	cred-it-worth-y
pro-mul-gate	prom-ul-gate
tapes-try	tap-es-try
in-trau-terine	in-tra-u-ter-ine
pos-thu-mous	post-hu-mous
le-gume	leg-ume
un-molest-ed	un-mo-lest-ed
ex-cer-pt	ex-cerpt
u-ni-que-ness	u-nique-ness
gen-i-tal-i-a	gen-i-ta-li-a
metemp-sy-cho-sis	me-tem-psy-cho-sis
iro-ny	i-ro-ny
na-n-o-tech-nol-o-gy	nan-o-tech-nol-o-gy
proce-dure	pro-ce-dure
steam-roller	steam-roll-er
bi-shop-ric	bish-op-ric
dar-t-er	dart-er
cow-ar-dice	cow-ard-ice
hy-per-bole	hy-per-bo-le
frown-ing	frowning
em-o-tive	e-mo-tive
pro-ject-ed	projected
lib-er-o	li-be-ro
astound-ing	as-tound-ing
rost-er	ros-ter
lul-la-by	lull-a-by
di-vot	div-ot
van-il-la	va-nil-la
ci-trate	cit-rate
western	west-ern
cad-et	ca-det
el-ven	elv-en
in-com-par-a-bly	in-com-pa-ra-bly
iso-top-ic	i-so-top-ic
slob-ber-ing	slobbering
in-ad-ver-tent-ly	in-ad-vert-ent-ly
mul-tid-i-men-sion-al	mul-ti-di-men-sion-al
mileage	mile-age
ge-ri-at-ric	ger-i-at-ric
chemist	chem-ist
freel-anc-er	free-lanc-er
demount-a-ble	de-mount-a-ble
sa-pient	sa-pi-ent
wear-i-ness	wea-ri-ness
fin-gering	fin-ger-ing
my-th-o-log-i-cal	myth-o-log-i-cal
voc-a-l-ist	vo-cal-ist
u-n-i-ver-sal-i-ty	u-ni-ver-sal-i-ty
blaster	blast-er
tom-foo-l-er-y	tom-fool-er-y
lad-y-like	la-dy-like
a-n-oint	a-noint
se-ni-or-i-ty	sen-ior-i-ty
ne-th-er-most	neth-er-most
rep-o-si-tion	re-po-si-tion
pres-byter-y	pres-by-ter-y
con-su-mer-ism	con-sum-er-ism
pha-r-a-oh	phar-aoh
misspell-ings	mis-spel-lings
lych-ee	ly-chee
neo-phyte	ne-o-phyte
re-fer-en-dum	ref-er-en-dum
ward-en	war-den
prob-i-ty	pro-bi-ty
pleb-is-cite	pleb-i-scite
bu-si-ness-wom-an	busi-ness-wom-an
for-mu-laic	for-mu-la-ic
paraf-fin	par-af-fin
un-herald-ed	un-her-ald-ed
re-sin	res-in
here-sy	her-e-sy
trans-du-c-er	trans-duc-er
mischief	mis-chief
brand-ed	bran-ded
ey-e-let	eye-let
vehi-cle	ve-hi-cle
el-vish	elv-ish
ma-ny	man-y
sav-ager-y	sav-age-ry
bud-ger-i-gar	budg-er-i-gar
de-duc-ti-ble	de-duct-i-ble
u-n-i-mag-i-na-tive	un-im-ag-i-na-tive
motel	mo-tel
pa-pule	pap-ule
sau-ce-pan	sauce-pan
mai-s-o-nette	mai-son-ette
chal-et	cha-let
decom-pose	de-com-pose
pa-pri-ka	pap-ri-ka
vap-o-rous	va-por-ous
gub-er-na-to-ri-al	gu-ber-na-to-ri-al
u-ni-den-ti-fi-a-ble	un-i-den-ti-fi-a-ble
sal-ient	sa-li-ent
turnt-a-ble	turn-ta-ble
con-val-es-cent	con-va-les-cent
seventh	sev-enth
cu-nei-form	cu-ne-i-form
glis-ten-ing	gli-ste-ning
shand-y	shan-dy
mo-m-en-tous	mo-men-tous
frag-men-ta-ry	frag-men-tar-y
ni-t-rous	ni-trous
e-pine-phrine	ep-i-neph-rine
gar-age	ga-rage
thrus-t-er	thrust-er
no-t-i-fi-ca-tion	no-ti-fi-ca-tion
o-ver-react	o-ver-re-act
bee-feat-er	beef-eat-er
po-lit-ics	pol-i-tics
ow-ner-ship	own-er-ship
a-node	an-ode
pago-da	pa-go-da
ar-ch-er	arch-er
in-feas-i-ble	in-fea-si-ble
dis-son-ance	dis-so-nance
sterl-ing	ster-ling
mag-ni-f-i-cent-ly	mag-nif-i-cent-ly
bo-log-na	bo-lo-gna
gyr-o-mag-net-ic	gy-ro-mag-net-ic
hoth-ouse	hot-house
bom-bar-di-er	bom-bar-dier
ca-r-at	car-at
e-n-er-get-ic	en-er-get-ic
in-sal-u-bri-ous	in-sa-lu-bri-ous
swimm-ing	swim-ming
ren-e-go-ti-ate	re-ne-go-ti-ate
path-o-gene-sis	path-o-gen-e-sis
dis-respect-ful	dis-re-spect-ful
thau-m-a-turge	thau-ma-turge
seas-cape	sea-scape
con-ge-ni-al	con-gen-ial
seclud-ed	se-clud-ed
je-j-u-num	je-ju-num
moorh-en	moor-hen
de-scant	des-cant
sty-list	styl-ist
o-ver-writ-ing	overwriting
sy-no-vi-al	syn-o-vi-al
lob-o-to-my	lo-bot-o-my
an-x-i-e-ty	anx-i-e-ty
cas-ter	cast-er
chev-al-i-er	chev-a-lier
deb-at-a-ble	de-bat-a-ble
sev-en-tieth	sev-en-ti-eth
ar-chan-gel	arch-an-gel
dei-ty	de-i-ty
des-truc-tion	de-struc-tion
tamp-er	tam-per
in-ex-plica-ble	in-ex-pli-ca-ble
per-i-ph-er-y	pe-riph-er-y
le-gate	leg-ate
so-lemn	sol-emn
vide-o-taped	videotaped
pro-mis-cu-i-ty	prom-is-cu-i-ty
tel-e-com-mut-ing	te-le-com-mu-ting
an-te-r-oom	an-te-room
con-tri-v-ance	con-triv-ance
er-ad-i-ca-tion	e-rad-i-ca-tion
eth-er	e-ther
pro-pa-ga-tor	prop-a-ga-tor
psy-choan-a-lyst	psy-cho-an-a-lyst
un-dim-in-ished	un-di-min-ished
trous-ers	trou-sers
must-ang	mus-tang
law-y-er	law-yer
re-qui-em	req-ui-em
dec-lam-a-to-ry	de-clam-a-to-ry
lump-en	lum-pen
reap-ply	re-ap-ply
wolfhound	wolf-hound
an-ni-ver-sar-y	an-ni-ver-sa-ry
as-y-lum	a-sy-lum
cand-y	can-dy
mistype	mis-type
cack-ling	cackling
met-er	me-ter
scal-ar	sca-lar
o-ni-on	on-ion
mar-ginal	mar-gin-al
den-o-ta-tion	de-no-ta-tion
un-feas-i-ble	un-fea-si-ble
prer-og-a-tive	pre-rog-a-tive
hearthrug	hearth-rug
in-fi-d-el	in-fi-del
lac-u-na	la-cu-na
sta-tue	stat-ue
miss-pell	mis-spell
naked	na-ked
ru-de-ness	rude-ness
flinch-ing	flin-ching
may-or-alty	may-or-al-ty
per-i-ph-er-al	pe-riph-er-al
shepherd-ess	shep-herd-ess
pos-thu-mous-ly	post-hu-mous-ly
non-ex-istence	non-ex-ist-ence
tail-or-ing	tai-lor-ing
e-lec-tro-phore-sis	e-lec-tro-pho-re-sis
de-hu-mi-d-i-fier	de-hu-mid-i-fi-er
em-bo-som	em-bos-om
peas-an-try	peas-ant-ry
steve-dore	ste-ve-dore
pro-po-si-tion-al	prop-o-si-tion-al
son-o-rous	so-no-rous
laun-dered	laundered
de-bau-ch-er-y	de-bauch-er-y
re-hear-sal	re-hears-al
trel-lised	trellised
per-fec-ti-bil-i-ty	per-fect-i-bil-i-ty
te-l-e-o-log-i-cal	tel-e-o-log-i-cal
sal-mon	salm-on
i-d-i-ot	id-i-ot
be-fud-dling	befuddling
duplic-i-ty	du-plic-i-ty
cu-te-ness	cute-ness
fath-er-hood	fa-ther-hood
us-her-ette	ush-er-ette
ki-lo-ton	kil-o-ton
gladi-a-tor	glad-i-a-tor
ex-cel-sior	ex-cel-si-or
pantheon	pan-the-on
pur-ee	pu-ree
grape-fru-it	grape-fruit
dun-ghill	dung-hill
gang-ly	gan-gly
pur-po-sive	pur-pos-ive
por-ta-bil-i-ty	port-a-bil-i-ty
heret-i-cal	he-ret-i-cal
ther-e-un-der	there-un-der
di-a-na	di-an-a
co-ev-al	co-e-val
mi-cros-co-p-y	mi-cros-co-py
bang-ing	banging
cen-tur-y	cen-tu-ry
prec-on-ceived	pre-con-ceived
cru-ci-fix-i-on	cru-ci-fix-ion
per-su-a-sive-ly	per-sua-sive-ly
mel-an-cho-ly	mel-an-chol-y
henpeck	hen-peck
destroy	de-stroy
grizz-ly	griz-zly
pac-i-fier	pac-i-fi-er
seb-a-ceous	se-ba-ceous
dis-ad-vant-aged	dis-ad-van-taged
ne-glig-i-ble	neg-li-gi-ble
me-tha-nol	meth-a-nol
hom-e-ow-n-er	home-own-er
con-fi-d-ent-ly	con-fi-dent-ly
eg-o-tism	e-go-tism
re-pentance	re-pent-ance
in-dex-ing	indexing
stun-n-ing-ly	stun-ning-ly
pres-et	pre-set
ga-l-ore	ga-lore
none-vent	non-e-vent
skirm-ish	skir-mish
cine	cin-e
ent-wine	en-twine
ca-rous-el	car-ou-sel
ex-pect-ed	expected
ba-ron-et	bar-on-et
un-set-tling	unsettling
der-i-sory	de-ri-so-ry
prem-a-ture	pre-ma-ture
vi-rile	vir-ile
car-e-tak-er	care-tak-er
hor-mon-al	hor-mo-nal
paper-work	pa-per-work
twent-y	twen-ty
obe-di-ent	o-be-di-ent
im-ple-m-en-ta-tion	im-ple-men-ta-tion
priv-a-cy	pri-va-cy
ir-repar-a-ble	ir-rep-a-ra-ble
is-o-ton-ic	i-so-ton-ic
leth-arg-y	leth-ar-gy
par-a-no-i-a	par-a-noi-a
tril-b-y	tril-by
au-th-o-ress	au-thor-ess
con-ser-va-to-ry	con-serv-a-to-ry
ca-ra-v-el	car-a-vel
hiber-nal	hi-ber-nal
husk-y	hus-ky
milk-shake	milkshake
un-an-i-mous	u-nan-i-mous
rubric	ru-bric
iv-y	i-vy
au-tom-o-tive	au-to-mo-tive
tute-lage	tu-te-lage
ser-vant	serv-ant
ven-o-mous	ven-om-ous
pivo-tal	piv-ot-al
iso-lat-ing	i-so-lat-ing
dec-i-sive-ly	de-ci-sive-ly
fool-hard-y	fool-har-dy
wheed-ling	wheedling
coch-lea	coch-le-a
math-em-a-ti-cian	math-e-ma-ti-cian
feas-i-bil-i-ty	fea-si-bil-i-ty
pre-ju-di-cial	prej-u-di-cial
wides-creen	wide-screen
steep-le-chase	stee-ple-chase
voyeu-ris-tic	voy-eur-is-tic
re-maind-er	re-main-der
haph-a-zard-ly	hap-haz-ard-ly
devil-ish	dev-il-ish
voyeur-ism	vo-yeur-ism
dan-de-lion	dan-de-li-on
my-ri-ad	myr-i-ad
motet	mo-tet
minute-ly	mi-nute-ly
mal-ad-justed	mal-ad-just-ed
dode-cahe-dron	do-dec-a-he-dron
nav-y	na-vy
drow-s-i-ness	drow-si-ness
prop-el	pro-pel
trifl-ing	tri-fling
o-ver-shadow	o-ver-shad-ow
transcend	tran-scend
car-ci-no-gen-e-sis	car-cin-o-gen-e-sis
dog-sbod-y	dogs-bod-y
tri-mar-an	tri-ma-ran
dar-kroom	dark-room
rhod-od-en-d-ron	rho-do-den-dron
fluid	flu-id
pri-mar-i-ly	pri-ma-ri-ly
si-mile	sim-i-le
o-ra-tor	or-a-tor
u-n-u-su-al	un-u-su-al
spenc-er	spen-cer
lin-k-up	link-up
un-a-dapted	un-a-dapt-ed
sy-rup	syr-up
re-tri-ev-al	re-triev-al
un-ac-com-pan-ied	un-ac-com-pa-nied
ju-nior	jun-ior
bawl-ing	baw-ling
in-viol-a-ble	in-vi-o-la-ble
leftist	left-ist
pla-t-en	plat-en
chart-er	char-ter
is-o-la-tion-ism	i-so-la-tion-ism
pej-or-a-tive	pe-jo-ra-tive
hom-o-sex-u-al-i-ty	ho-mo-sex-u-al-i-ty
feud-al	feu-dal
mo-t-i-vate	mo-ti-vate
pronounce-ment	pro-nounce-ment
au-gur-y	au-gu-ry
as-sist-ant	as-sis-tant
dis-kette	disk-ette
stifl-ing	sti-fling
look-ing	looking
rene-wal	re-new-al
ap-o-lit-i-cal	a-po-lit-i-cal
frui-t-y	fruit-y
i-n-i-ti-a-tion	in-i-ti-a-tion
sol-di-er-y	sol-dier-y
tract-a-ble	trac-ta-ble
ar-chaism	ar-cha-ism
non-con-for-m-i-ty	non-con-form-i-ty
clums-y	clum-sy
caval-i-er	cav-a-lier
strang-les	stran-gles
rubi-cund	ru-bi-cund
chagrin	cha-grin
di-ges-t-i-ble	di-gest-i-ble
bar-nyard	barn-yard
mel-od-ra-ma	mel-o-dra-ma
coup-let	cou-plet
gooey	goo-ey
ant-werp	antwerp
feas-i-bly	fea-si-bly
cris-is	cri-sis
beach-com-ber	beach-comb-er
cen-tri-f-u-gal	cen-trif-u-gal
smelt-ing	smelting
stere-o-typ-i-cal	ster-e-o-typ-i-cal
cath-e-t-er	cath-e-ter
stop-o-v-er	stop-o-ver
para-sol	par-a-sol
prob-a-tive	pro-ba-tive
doom-s-day	dooms-day
slouch-ing	slouching
ba-ron	bar-on
pam-phle-teer	pam-phlet-eer
spi-rit-u-al-ist	spir-it-u-al-ist
ex-po-n-ent	ex-po-nent
sacro-sanct	sac-ro-sanct
stiffly	stiff-ly
pro-per-ty	prop-er-ty
bu-si-ness	busi-ness
ro-oi-bos	roo-i-bos
mer-cur-y	mer-cu-ry
ga-lax-y	gal-ax-y
cyc-lic	cy-clic
se-c-ond-ly	sec-ond-ly
sacri-le-gious	sac-ri-le-gious
fedo-ra	fe-do-ra
swimming-ly	swim-ming-ly
lei-s-ure	lei-sure
bur-gund-y	bur-gun-dy
et-u-i	e-tui
hi-erat-ic	hi-er-at-ic
mishap	mis-hap
lab-yrin-thine	lab-y-rin-thine
pro-test-ing	protesting
pol-y-car-bo-nate	pol-y-car-bon-ate
cop-i-lot	co-pi-lot
e-n-ig-mat-ic	en-ig-mat-ic
devel-op	de-vel-op
un-in-tel-lig-i-ble	un-in-tel-li-gi-ble
poet-ry	po-et-ry
cru-s-ad-er	cru-sad-er
be-whis-kered	be-whisk-ered
so-n-a-ta	so-na-ta
nephew	neph-ew
fer-mion	fer-mi-on
fiendish	fiend-ish
phy-s-i-ol-o-gy	phys-i-ol-o-gy
seg-ment-ed	seg-men-ted
prosthe-sis	pros-the-sis
gaf-fe	gaffe
vin-yl	vi-nyl
cour-tier	cour-ti-er
u-p-ro-ar-i-ous	up-roar-i-ous
words-mith	word-smith
in-ter-pret-a-tive	in-ter-pre-ta-tive
haws-er	haw-ser
dom-i-cil-iar-y	dom-i-cil-i-ar-y
man-a-ger-ess	man-ag-er-ess
trespas-s-er	tres-pass-er
a-r-ith-met-ic	a-rith-me-tic
e-lig-i-ble	el-i-gi-ble
une-vent-ful	un-e-vent-ful
pri-est	priest
men-agerie	me-nag-er-ie
guac-a-mole	gua-ca-mo-le
boozer	booz-er
her-oism	her-o-ism
un-shap-ed	un-shaped
un-du-lat-ing	un-du-la-ting
prim-a-cy	pri-ma-cy
scor-pion	scor-pi-on
sea-w-a-ter	sea-wa-ter
mer-chandis-ing	mer-chan-dis-ing
new-t-on	new-ton
boast-ing	boas-ting
palat-i-nate	pa-lat-i-nate
ther-mos-tat	ther-mo-stat
te-nor	ten-or
in-a-l-ien-a-ble	in-al-ien-a-ble
awe-som-e-ness	awe-some-ness
in-trave-nous-ly	in-tra-ve-nous-ly
am-us-ing	a-mus-ing
rec-a-pit-u-late	re-ca-pit-u-late
pros-od-y	pros-o-dy
her-oi-cal-ly	he-ro-i-cal-ly
dif-fer-ing	differing
mild-ew	mil-dew
cres-cen-do	cre-scen-do
to-ke-nism	to-ken-ism
swarm-ing	swarming
wor-ksta-tion	work-sta-tion
cir-cu-it	cir-cuit
snig-ger-ing	sniggering
ca-n-ard	ca-nard
wov-en	wo-ven
ap-pro-v-ing-ly	ap-prov-ing-ly
em-physe-ma	em-phy-se-ma
sinew	sin-ew
fust-y	fus-ty
ca-val-cade	cav-al-cade
ben-e-fi-ciar-y	ben-e-fi-ci-ar-y
blus-ter-ing	blustering
chie-fly	chief-ly
bo-dy-guard	bod-y-guard
dis-ord-er	dis-or-der
pal-u-dal	pa-lu-dal
cas-u-alty	cas-u-al-ty
cere-bel-lum	cer-e-bel-lum
koa-la	ko-a-la
haz-y	ha-zy
whimp-er	whim-per
ar-chene-my	arch-en-e-my
bu-si-ness-like	busi-ness-like
val-en-cy	va-len-cy
jam-boree	jam-bo-ree
chas-t-i-ty	chas-ti-ty
bu-si-ness-man	busi-ness-man
pina-fore	pin-a-fore
char-wo-man	char-wom-an
lemm-ing	lem-ming
thi-ev-ish	thiev-ish
renew-a-ble	re-new-a-ble
kwa-ch-a	kwa-cha
or-i-ga-mi	o-ri-ga-mi
pain-stak-ing-ly	pains-tak-ing-ly
ax-e-man	axe-man
do-pey	dope-y
hori-zon-tal-ly	hor-i-zon-tal-ly
dul-lard	dull-ard
moiety	moi-e-ty
tena-cious-ly	te-na-cious-ly
per-ci-pient	per-cip-i-ent
vel-ve-teen	vel-vet-een
ca-bri-o-let	cab-ri-o-let
fa-cul-ty	fac-ul-ty
ma-lod-or-ous	mal-o-dor-ous
a-voir-du-pois	av-oir-du-pois
ging-er	gin-ger
sal-ience	sa-li-ence
owlish	owl-ish
hy-po-ch-on-dri-a-cal	hy-po-chon-dri-a-cal
de-vil	dev-il
gudgeon	gudg-eon
scler-o-sis	scle-ro-sis
bou-le-vard	boul-e-vard
sil-vering	sil-ver-ing
vitri-ol	vit-ri-ol
mar-chio-ness	mar-chion-ess
wadi	wa-di
changeling	change-ling
de-boned	deboned
pri-est-hood	priest-hood
ba-th-os	ba-thos
dyn-a-mite	dy-na-mite
e-n-act-ment	en-act-ment
re-for-es-ta-tion	re-for-est-a-tion
in-vert-ed	inverted
princi-pled	prin-ci-pled
phle-boto-my	phle-bot-o-my
mas-er	ma-ser
ves-ti-gial	ves-tig-i-al
teet-er	tee-ter
hered-i-ty	he-red-i-ty
im-pre-sar-i-o	im-pre-sa-ri-o
o-v-i-duct	o-vi-duct
handled	han-dled
gun-me-tal	gun-met-al
wind-sur-fer	wind-surf-er
dy-n-a-mism	dy-na-mism
dis-ord-er-ly	dis-or-der-ly
de-cade	dec-ade
hib-er-na-tion	hi-ber-na-tion
re-com-pense	rec-om-pense
random-ness	ran-dom-ness
crump-et	crum-pet
ri-ver-side	riv-er-side
re-tro-fit	ret-ro-fit
fe-t-lock	fet-lock
gla-di-o-lus	glad-i-o-lus
predict	pre-dict
phi-loso-pher	phi-los-o-pher
re-g-is-trar	reg-is-trar
bas-k-et-ry	bas-ket-ry
smoth-ered	smothered
maul-ing	mauling
fun-drais-er	fund-rais-er
gal-e-na	ga-le-na
gran-ar-y	gra-na-ry
in-sou-ciant	in-sou-ci-ant
stor-y	sto-ry
clank-ing	clan-king
ner-ve-less	nerve-less
devo-tee	dev-o-tee
wry-l-y	wry-ly
un-real	un-re-al
conger	con-ger
un-sold-er	un-sol-der
scream-ing	screaming
profli-ga-cy	prof-li-ga-cy
ge-n-er-ic	ge-ner-ic
roun-dup	round-up
mas-ca-ra	mas-car-a
pri-estess	priest-ess
rani	ra-ni
bob-bed	bobbed
sol-di-er	sol-dier
gut-ter-s-nipe	gut-ter-snipe
scare-mon-gering	scare-mon-ger-ing
snift-er	snif-ter
para-bo-loid	pa-rab-o-loid
in-sa-ti-a-ble	in-sa-tia-ble
mordant	mor-dant
coy-ote	coy-o-te
con-tempti-ble	con-tempt-i-ble
phi-lan-throp-ic	phil-an-throp-ic
forester	for-est-er
chro-moso-mal	chro-mo-so-mal
coral-line	cor-al-line
prese-lect	pre-se-lect
reverie	rev-er-ie
iv-o-ry	i-vo-ry
dis-e-ase	dis-ease
theat-ri-cals	the-at-ri-cals
pur-suant	pur-su-ant
bire-frin-gent	bi-re-frin-gent
pho-n-y	pho-ny
pen-et-ra-ble	pen-e-tra-ble
order	or-der
trimm-ing	trim-ming
sneer-ing	sneering
whatev-er	what-ev-er
be-drock	bed-rock
dim-in-ished	di-min-ished
ru-i-na-tion	ru-in-a-tion
pas-s-port	pass-port
sis-al	si-sal
turna-r-ound	turn-a-round
ex-tram-u-r-al	ex-tra-mu-ral
de-mon-strate	dem-on-strate
wrink-ly	wrin-kly
prestige	pres-tige
def-e-n-es-tra-tion	de-fen-es-tra-tion
bludgeon	bludg-eon
ti-bi-a	tib-i-a
u-n-i-ver-sal	u-ni-ver-sal
gha-na	ghana
res-tor-a-tive	re-stor-a-tive
ev-en	e-ven
church-war-d-en	church-ward-en
bases	ba-ses
tra-verse	trav-erse
dairy-man	dair-y-man
clov-en	clo-ven
cran-n-y	cran-ny
ten-an-try	ten-ant-ry
eg-o-ma-ni-ac	e-go-ma-ni-ac
in-de-struc-ti-ble	in-de-struct-i-ble
e-cho	ech-o
re-in-car-nat-ed	reincarnated
reg-elate	re-ge-late
pho-to-c-o-py	pho-to-cop-y
crea-tor	cre-a-tor
com-mis-sioned	commissioned
bullish	bull-ish
tur-no-v-er	turn-o-ver
stee-p-ly	steep-ly
cam-pa-n-ile	cam-pa-ni-le
flooz-y	floo-zy
char-la-d-y	char-la-dy
val-ise	va-lise
se-t-up	set-up
teen-a-ger	teen-ag-er
us-u-al-ly	u-su-al-ly
aud-i-ble	au-di-ble
de-press-ing	de-pres-sing
homo-mor-phism	ho-mo-mor-phism
pro-vo-ca-tion	prov-o-ca-tion
manom-e-ter	ma-nom-e-ter
pi-a-n-o-la	pi-a-no-la
ga-my	gam-y
tail-ored	tai-lored
rhea	rhe-a
quer-y	que-ry
strug-gling	struggling
bi-noc-u-lar	bin-oc-u-lar
doc-to-rate	doc-tor-ate
ey-e-lash	eye-lash
i-n-ept	in-ept
chill-ing	chilling
bene-fac-tress	ben-e-fac-tress
zool-o-gist	zo-ol-o-gist
ca-bin	cab-in
ting-ly	tin-gly
se-mi-co-lon	sem-i-co-lon
by-pro-duct	by-prod-uct
cine-ma	cin-e-ma
pap-yrus	pa-py-rus
at-tack-ing	attacking
pro-b-os-cis	pro-bos-cis
rog-uish	ro-guish
nift-y	nif-ty
vant-age	van-tage
rent-ed	rented
del-u-sive	de-lu-sive
ic-o-nog-ra-phy	i-co-nog-ra-phy
manes	ma-nes
gal-leon	gal-le-on
con-son-ance	con-so-nance
de-sig-n-er	de-sign-er
tel-e-s-cop-ic	tel-e-scop-ic
del-i-mit	de-lim-it
lin-e-up	line-up
ge-os-ta-tion-ar-y	ge-o-sta-tion-ar-y
whodu-n-it	who-dun-it
chaplain	chap-lain
slant-ed	slanted
tur-bo-charged	turbocharged
em-bossed	embossed
comf-y	com-fy
un-fet-tered	unfettered
ny-a-la	nya-la
garn-ish	gar-nish
ca-ba-ret	cab-a-ret
penul-ti-mate	pe-nul-ti-mate
in-choate	in-cho-ate
com-plex-i-on	com-plex-ion
arc-ing	arcing
dau-ber	daub-er
sub-ur-ban-i-sa-tion	su-bur-ba-ni-sa-tion
tree-l-ess	tree-less
pas-tor-al	pas-to-ral
pa-ren-ter-al	par-en-ter-al
ar-ro-w-root	ar-row-root
blasted	blast-ed
mouth-wa-tering	mouth-wa-ter-ing
fat-i-gue	fa-tigue
ple-nar-y	ple-na-ry
di-p-lo-ma	di-plo-ma
is-os-tat-ic	i-so-stat-ic
su-per-a-bund-ant	su-per-a-bun-dant
coupling	cou-pling
trade-marked	trademarked
te-l-ex	tel-ex
pill-age	pil-lage
sugar	sug-ar
esp-y	es-py
in-val-id	in-va-lid
o-per-et-ta	op-er-et-ta
cra-z-y	cra-zy
out-gu-ess	out-guess
e-ma-ciat-ed	e-ma-ci-at-ed
should-er	shoul-der
col-le-gial	col-le-gi-al
mi-dair	mid-air
su-per-posed	superposed
ba-sil	bas-il
re-cessed	recessed
jaz-z-y	jazz-y
o-cean-ic	o-ce-an-ic
saintli-ness	saint-li-ness
im-ple-men-ter	im-ple-ment-er
con-sor-tium	con-sor-ti-um
a-sympto-mat-ic	a-symp-to-mat-ic
dis-content-ed	dis-con-tent-ed
pho-n-on	pho-non
ton-gue	tongue
co-co-a	co-coa
prol-e-tar-i-at	pro-le-tar-i-at
fill-y	fil-ly
ever-y-where	eve-ry-where
ig-nom-i-ny	ig-no-min-y
sec-to-ral	sec-tor-al
gene-al-o-gy	ge-ne-al-o-gy
co-ron-er	cor-o-ner
pro-sec-u-to-ri-al	pros-e-cu-to-ri-al
ra-di-on-u-clide	ra-di-o-nu-clide
in-fect-ed	in-fec-ted
per-se-c-u-tor	per-se-cu-tor
i-d-e-o-log-i-cal-ly	i-de-o-log-i-cal-ly
strate-gy	strat-e-gy
glim-mering	glim-mer-ing
em-ployed	employed
mo-n-as-tic	mo-nas-tic
dis-cre-pan-cy	dis-crep-an-cy
recede	re-cede
fo-reig-n-er	for-eign-er
rese-lect	re-se-lect
welt-er	wel-ter
co-lan-der	col-an-der
un-fa-thomed	un-fath-omed
so-ci-a-bil-i-ty	so-cia-bil-i-ty
reab-sorb	re-ab-sorb
final-ly	fi-nal-ly
her-oine	her-o-ine
proph-y-lac-tic	pro-phy-lac-tic
di-a-bol-ism	di-ab-o-lism
coi-tus	co-i-tus
ar-tis-try	art-ist-ry
win-n-ing	win-ning
thunder	thun-der
bene-fit	ben-e-fit
cough-ing	coughing
ri-v-al-ry	ri-val-ry
to-p-less	top-less
bi-b-li-o-graph-ic	bib-li-o-graph-ic
com-ba-tant	com-bat-ant
fi-g-ure	fig-ure
pi-ti-a-ble	pit-i-a-ble
chem-ist-ry	chem-is-try
see-s-aw	see-saw
cool-ing	cooling
hye-na	hy-e-na
prosp-er	pros-per
theat-ri-cal	the-at-ri-cal
ir-re-fut-a-ble	ir-ref-u-ta-ble
ar-chival	ar-chi-val
o-var-y	o-va-ry
furnish-ing	fur-nish-ing
highlight	high-light
plen-teous	plen-te-ous
eer-i-ly	ee-ri-ly
scab-bed	scabbed
de-sider-a-tum	de-sid-er-a-tum
rel-o-cate	re-lo-cate
un-bridled	un-bri-dled
un-aligned	un-a-ligned
tri-po-li	trip-o-li
bi-or-hythm	bi-o-rhythm
gass-y	gas-sy
en-gin-eer	en-gi-neer
re-col-lect	rec-ol-lect
dam-n-ing	damn-ing
ge-noc-i-dal	gen-o-cid-al
cur-tained	curtained
chaot-ic	cha-ot-ic
ca-ter-pil-lar	cat-er-pil-lar
sul-ta-na	sul-tan-a
thre-shold	thresh-old
cus-to-mar-y	cus-tom-ar-y
re-lict	rel-ict
lack-a-dais-i-cal	lack-a-dai-si-cal
waf-er	wa-fer
deli-m-it-ed	delimited
chim-er-a	chi-me-ra
mandi-ble	man-di-ble
un-an-i-mous-ly	u-nan-i-mous-ly
in-sou-ciance	in-sou-ci-ance
ru-na-way	run-a-way
fath-er-ing	fathering
u-p-riv-er	up-riv-er
equa-ble	eq-ua-ble
her-biv-or-ous	her-biv-o-rous
val-i-ant-ly	val-iant-ly
pen-thouse	pent-house
at-mosphere	at-mos-phere
pred-i-lec-tion	pre-di-lec-tion
varied	var-ied
boatswain	boat-swain
sub-ser-vience	sub-ser-vi-ence
pas-seng-er	pas-sen-ger
en-tour-age	en-tou-rage
hit-t-a-ble	hit-ta-ble
cor-ti-cos-ter-oid	cor-ti-co-ster-oid
gyr-o-scope	gy-ro-scope
rack-e-teer-ing	rack-et-eer-ing
span-n-er	span-ner
stam-m-er	stam-mer
tri-b-al-ism	trib-al-ism
cau-s-al	caus-al
e-lig-i-bil-i-ty	el-i-gi-bil-i-ty
jour-nalese	jour-nal-ese
com-pell-ing-ly	com-pel-ling-ly
ne-crop-sy	nec-rop-sy
des-pite	de-spite
wreck-ing	wrecking
par-then-o-gene-sis	par-the-no-gen-e-sis
col-lap-si-ble	col-laps-i-ble
con-cord-at	con-cor-dat
ma-lad-mi-n-is-tra-tion	mal-ad-min-is-tra-tion
pro-phet	proph-et
ta-pi-o-ca	tap-i-o-ca
man-us-cript	man-u-script
highlight-er	high-ligh-ter
rem-in-is-cent	rem-i-nis-cent
barter	bar-ter
quest-ing	questing
vil-lai-ny	vil-lain-y
trea-s-o-n-ous	trea-son-ous
gi-an-tess	gi-ant-ess
bi-odeg-rad-a-ble	bi-o-de-grad-a-ble
zaire	za-ire
sur-fer	surf-er
mar-ke-teer	mar-ket-eer
cet-a-cean	ce-ta-cean
ca-pri-ole	cap-ri-ole
im-pish	imp-ish
veg-eta-tive	veg-e-ta-tive
grie-v-ous	griev-ous
tin-d-er	tin-der
ou-tride	out-ride
leis-ured	lei-sured
table-land	ta-ble-land
mac-a-roni	mac-a-ro-ni
theism	the-ism
hon-o-rif-ic	hon-or-if-ic
di-ar-y	di-a-ry
brog-ue	brogue
char-i-t-a-bly	char-i-ta-bly
cou-sin	cous-in
dim-pled	dimpled
min-or	mi-nor
clai-mant	claim-ant
wear-y-ing	wea-ry-ing
hard-i-ness	har-di-ness
xyl-o-phone	xy-lo-phone
pre-bend	preb-end
mas-o-chist	mas-och-ist
glor-y	glo-ry
in-tel-lig-i-bil-i-ty	in-tel-li-gi-bil-i-ty
ask-ew	a-skew
con-cil-iar	con-cil-i-ar
span-gled	spangled
an-g-er	an-ger
caliph	ca-liph
mor-pho-gene-sis	mor-pho-gen-e-sis
ta-l-on	tal-on
test-y	tes-ty
un-lad-y-like	un-la-dy-like
stap-ler	sta-pler
mankind	man-kind
des-pise	de-spise
our-sel-ves	our-selves
over-in-flat-ed	o-ver-in-flat-ed
stoi-cal	sto-i-cal
pacif-ic	pa-cif-ic
ji-u-jit-su	jiu-jit-su
hyp-no-th-er-a-py	hyp-no-ther-a-py
un-cre-dit-ed	un-cred-it-ed
re-ser-voir	res-er-voir
ca-cao	ca-ca-o
pa-ten	pat-en
di-a-ph-a-nous	di-aph-a-nous
anx-i-ous	anx-ious
nuis-ance	nui-sance
ca-rol	car-ol
ig-nor-a-mus	ig-no-ra-mus
story-tell-ing	sto-ry-tell-ing
mon-e-tar-ism	mon-e-ta-rism
silt-ing	silting
hool-i-gan	hoo-li-gan
au-tom-o-bile	au-to-mo-bile
du-ode-num	du-o-de-num
bluish	blu-ish
ban-ter-ing	bantering
widow-hood	wid-ow-hood
shim-mering	shimmering
stratig-ra-phy	stra-tig-ra-phy
sed-an	se-dan
prol-onged	pro-longed
tick-et-ed	ticketed
ma-cro	mac-ro
pan-ache	pa-nache
bi-o-che-mist	bi-o-chem-ist
her-bal-ist	herb-al-ist
con-sen-sual	con-sen-su-al
nast-y	nas-ty
is-o-la-tion-ist	i-so-la-tion-ist
zoop-lank-ton	zo-o-plank-ton
ep-i-tome	e-pit-o-me
cour-teous	cour-te-ous
re-furb-ish-ment	re-fur-bish-ment
ob-lige	o-blige
ex-a-mine	ex-am-ine
guin-e-a	guin-ea
pol-y-cy-c-lic	pol-y-cy-clic
arch-bishop	arch-bish-op
chan-cy	chanc-y
e-pi-ge-net-ic	ep-i-ge-net-ic
un-mis-s-a-ble	un-miss-a-ble
pro-l-ong	pro-long
burg-lar	bur-glar
punc-til-ious	punc-til-i-ous
in-com-bust-i-ble	in-com-bus-ti-ble
un-sub-stan-tiat-ed	un-sub-stan-ti-at-ed
re-al-ign	re-a-lign
char-i-o-teer	char-i-ot-eer
stron-groom	strong-room
pois-o-n-ous	poi-son-ous
vex-ing	vexing
mom-en-ta-ry	mo-men-tar-y
re-dev-el-op-ment	re-de-vel-op-ment
lac-teal	lac-te-al
li-b-id-i-nous	li-bid-i-nous
starl-ing	star-ling
newly	new-ly
per-en-nial-ly	per-en-ni-al-ly
es-ca-pism	es-cap-ism
re-s-cu-er	res-cu-er
fes-t-er	fes-ter
ge-no-a	gen-o-a
frailt-y	frail-ty
o-ver-pro-duced	overproduced
prena-tal	pre-na-tal
flee-c-y	fleec-y
ha-zard	haz-ard
hier-arch-y	hi-er-ar-chy
gadge-t-ry	gadg-et-ry
de-bit	deb-it
sa-tire	sat-ire
con-des-cen-sion	con-de-scen-sion
kal-e-i-dos-cope	ka-lei-do-scope
nine-tieth	nine-ti-eth
ped-a-go-gue	ped-a-gogue
moss-y	mos-sy
om-ni-d-i-rec-tion-al	om-ni-di-rec-tion-al
stripling	strip-ling
une-dit-ed	un-ed-it-ed
clim-ber	climb-er
cursed	curs-ed
whiz-kids	whizkids
hori-zon-tal	hor-i-zon-tal
brigade	bri-gade
pi-a-n-is-si-mo	pi-a-nis-si-mo
dis-con-ti-nue	dis-con-tin-ue
re-routes	re-routes
re-c-og-ni-tion	rec-og-ni-tion
thirsty	thirst-y
grand-daugh-t-er	grand-daugh-ter
gof-er	go-fer
fath-er	fa-ther
elon-gat-ed	e-lon-gat-ed
dish-wa-t-er	dish-wa-ter
hy-dros-tat-ic	hy-dro-stat-ic
pred-is-pose	pre-dis-pose
newlywed	new-ly-wed
cop-ro-ces-sor	co-proc-es-sor
sem-i-conduct-ing	sem-i-con-duct-ing
et-h-i-cal-ly	eth-i-cal-ly
pro-tec-to-rate	pro-tec-tor-ate
ene-my	en-e-my
di-a-co-nal	di-ac-o-nal
un-nerving	unnerving
li-q-uor-ish	liq-uor-ish
po-tash	pot-ash
be-ginning	be-gin-ning
me-teor	me-te-or
ap-par-a-tus	ap-pa-rat-us
re-com-mend	rec-om-mend
sa-do-ma-so-chis-tic	sa-do-mas-o-chis-tic
prec-on-di-tion	pre-con-di-tion
re-tain-ing	retaining
u-n-i-mag-i-na-ble	un-im-ag-i-na-ble
bas-sist	bass-ist
o-beis-ance	o-bei-sance
balder-dash	bal-der-dash
som-e-one	some-one
un-reg-istered	un-reg-is-tered
ca-n-on-ic	ca-non-ic
dowry	dow-ry
mil-lin-er	mil-li-ner
ge-opo-lit-i-cal	ge-o-po-lit-i-cal
heartache	heart-ache
mus-ke-teer	mus-ket-eer
un-ac-cep-ta-bly	un-ac-cept-a-bly
re-gret-t-a-ble	re-gret-ta-ble
eer-ie	ee-rie
savage-ly	sav-age-ly
di-ges-ter	di-gest-er
suici-dal	su-i-cid-al
pos-y	po-sy
brie-fly	brief-ly
squee-g-ee	squee-gee
dem-ol-ish	de-mol-ish
ion	i-on
dis-abling	disabling
con-tri-b-u-tor	con-trib-u-tor
fa-c-er	fac-er
u-t-er-us	u-ter-us
trans-pi-ra-tion	tran-spi-ra-tion
ha-p-less	hap-less
li-q-uid	liq-uid
pold-er	pol-der
lil-ac	li-lac
bi-t-u-men	bi-tu-men
com-ra-de-ship	com-rade-ship
cag-oule	ca-goule
wes-tern-most	west-ern-most
how-soev-er	how-so-ev-er
redhead	red-head
hol-i-ness	ho-li-ness
town-speo-ple	towns-peo-ple
sug-ges-t-i-ble	sug-gest-i-ble
lam-plight	lamp-light
pre-mise	prem-ise
parox-ysm	par-ox-ysm
mel-od-y	mel-o-dy
con-flict-ed	conflicted
eag-er	ea-ger
de-cayed	decayed
de-cile	dec-ile
Words with errors: 1208
Words with incorrect number of syllables: 654
Total evluated: 6500
Perfect accuracy: 0.81
Number of syllables accuracy: 0.90
Average Levenshtein Distance(across incorrect words): 1.15
