Attempt	Real
or-pha-n-age	or-phan-age
ta-r-ot	ta-rot
is-o-top-ic	i-so-top-ic
ep-i-tome	e-pit-o-me
aph-ro-di-si-ac	aph-ro-dis-i-ac
com-ra-de-ship	com-rade-ship
re-lict	rel-ict
cre-dit-wor-thi-ness	cred-it-wor-thi-ness
brazen-ly	bra-zen-ly
bask-et-ry	bas-ket-ry
sei-z-ure	sei-zure
var-ie-gat-ed	var-i-e-gat-ed
gan-glion	gan-gli-on
lurk-ing	lurking
man-a-ger-ess	man-ag-er-ess
mach-in-ist	ma-chin-ist
poli-cewo-man	po-lice-wom-an
ca-vi-ar	cav-i-ar
im-pish	imp-ish
pen-i-ten-tiar-y	pen-i-ten-tia-ry
rem-it	re-mit
wel-com-ing	wel-co-ming
re-volt-ed	revolted
i-d-ol-a-try	i-dol-a-try
prede-ter-mine	pre-de-ter-mine
cle-ment	clem-ent
author-ing	au-thor-ing
se-lec-tee	se-lect-ee
re-con-cil-i-a-tion	rec-on-cil-i-a-tion
guar-di-an	guard-i-an
smold-er	smol-der
nove-lette	nov-el-ette
in-vol-ve-ment	in-volve-ment
coun-ter-balance	coun-ter-bal-ance
tu-n-ic	tu-nic
ca-py-ba-ra	cap-y-ba-ra
i-d-ol-a-trous	i-dol-a-trous
trig-ram	tri-gram
malad-justed	mal-ad-just-ed
melt-ed	melted
non-chal-ant-ly	non-cha-lant-ly
per-pet-ra-tor	per-pe-tra-tor
brand-ed	bran-ded
ren-e-wal	re-new-al
ben-ign	be-nign
tig-er	ti-ger
pred-i-lec-tion	pre-di-lec-tion
in-tert-wine	in-ter-twine
cover-ing	cov-er-ing
sole-cism	sol-e-cism
meth-y-lene	meth-yl-ene
covet-ed	coveted
fors-wear	for-swear
dais-y	dai-sy
o-ther-wise	oth-er-wise
pre-bend-ar-y	preb-en-dar-y
sa-mo-var	sam-o-var
sus-ten-ance	sus-te-nance
ey-e-brow	eye-brow
gener-ic	ge-ner-ic
chin-oiser-ie	chi-noi-se-rie
puf-fer	puff-er
feud-al	feu-dal
su-b-or-di-nate	sub-or-di-nate
hap-pygo-luck-y	hap-py-go-luck-y
sil-vers-mith	sil-ver-smith
no-vel	nov-el
a-var-ice	av-a-rice
con-son-ance	con-so-nance
sur-real-ist	sur-re-al-ist
un-crow-d-ed	un-crowd-ed
awes-truck	awe-struck
pi-rat-ed	pirated
rare-fied	rar-e-fied
vo-lun-tar-y	vol-un-tar-y
ex-ag-ge-ra-tion	ex-ag-ger-a-tion
spaniel	span-iel
tarn-ish	tar-nish
tran-s-pi-ra-tion	tran-spi-ra-tion
re-quiem	req-ui-em
sav-ant	sa-vant
moped	mo-ped
betrothed	be-trothed
moun-taineer-ing	moun-tain-eer-ing
cor-on-al	cor-o-nal
foreign	for-eign
eg-o-ma-ni-ac	e-go-ma-ni-ac
go-ver-nor	gov-er-nor
an-ted-i-lu-vi-an	an-te-di-lu-vi-an
om-nid-i-rec-tion-al	om-ni-di-rec-tion-al
sep-a-ratism	sep-a-ra-tism
res-on-ance	res-o-nance
div-ers	di-vers
reu-nite	re-u-nite
si-n-us	si-nus
stoi-c-ism	sto-i-cism
coin-cide	co-in-cide
thumbprint	thumb-print
paraf-fin	par-af-fin
notice	no-tice
nin-e-teen	nine-teen
ico-nog-ra-phy	i-co-nog-ra-phy
sari	sa-ri
win-n-ing-ly	win-ning-ly
hal-ibut	hal-i-but
con-strict-ed	constricted
in-ter-mina-ble	in-ter-mi-na-ble
se-c-u-ri-ty	se-cu-ri-ty
dach-shund	dachs-hund
ma-croec-o-nom-ic	mac-ro-ec-o-nom-ic
mimick-er	mim-ick-er
streng-th-en	strength-en
loo-phole	loop-hole
is-o-la-tion-ist	i-so-la-tion-ist
mea-sure	meas-ure
gon-ad	go-nad
mem-or-a-bili-a	mem-o-ra-bil-i-a
a-qua	aq-ua
clum-s-y	clum-sy
pain-stak-ing	pains-tak-ing
stunn-ing	stun-ning
test-y	tes-ty
ig-nor-ance	ig-no-rance
re-cessed	recessed
pyri-dine	pyr-i-dine
ar-chan-gel	arch-an-gel
vi-o-l-a-tor	vi-o-la-tor
in-fect-ed	in-fec-ted
plast-er	plas-ter
rel-a-tor	re-la-tor
pres-ti-gious	pres-tig-ious
mi-cro-sur-g-er-y	mi-cro-sur-ger-y
lait-y	la-i-ty
ig-nor-a-mus	ig-no-ra-mus
ba-by-sit-ting	babysitting
tur-f-y	turf-y
pos-thu-mous	post-hu-mous
flaut-ist	flau-tist
peren-ni-al	per-en-ni-al
hier-arch-y	hi-er-ar-chy
ex-hil-arate	ex-hil-a-rate
trea-t-ise	trea-tise
bree-z-y	breez-y
erec-tion	e-rec-tion
furth-er	fur-ther
seduc-er	se-duc-er
crotch-e-ty	crotch-et-y
vo-ter	vot-er
tilde	til-de
forest-ed	forested
ma-ti-nee	mat-i-nee
friday	fri-day
ge-noc-i-dal	gen-o-cid-al
strug-gling	struggling
xen-o-phob-ic	xen-o-pho-bic
an-ti-podes	an-tip-o-des
pat-ro-ness	pa-tron-ess
sturd-y	stur-dy
lin-o-le-um	li-no-le-um
dan-de-lion	dan-de-li-on
sed-uce	se-duce
u-prise	up-rise
mil-lise-cond	mil-li-sec-ond
cus-hioned	cush-ioned
stif-fen-ing	stiff-en-ing
un-com-prom-is-ing	un-com-pro-mis-ing
ma-nik-in	man-i-kin
pi-les	piles
e-so-ter-ic	es-o-ter-ic
co-te-r-ie	co-te-rie
en-a-mel	e-nam-el
brand-y	bran-dy
hom-o-ge-ne-ous	ho-mo-ge-ne-ous
chor-al	cho-ral
guitar-ist	gui-tar-ist
startling-ly	star-tling-ly
cour-tier	cour-ti-er
re-com-pense	rec-om-pense
sacri-lege	sac-ri-lege
phy-s-i-o-log-i-cal-ly	phys-i-o-log-i-cal-ly
en-dang-er	en-dan-ger
claret	clar-et
ge-o-desic	ge-o-des-ic
bu-re-au	bu-reau
fra-tric-i-dal	frat-ri-cid-al
pout-ing	pouting
kam-i-kaze	ka-mi-ka-ze
com-plet-e-ness	com-plete-ness
eag-let	ea-glet
skiing	ski-ing
earthling	earth-ling
busi-nes-slike	busi-ness-like
flesh-ing	fleshing
re-sur-rec-tion	res-ur-rec-tion
transcrip-tion	tran-scrip-tion
co-py-ist	cop-y-ist
res-is-tiv-i-ty	re-sis-tiv-i-ty
oldie	old-ie
pro-saic	pro-sa-ic
cate-chist	cat-e-chist
know-ledge	knowl-edge
co-pra	cop-ra
dem-o-nol-o-gy	de-mon-ol-o-gy
sine-wy	sin-ew-y
tempting	tempt-ing
e-l-on-ga-tion	e-lon-ga-tion
con-vales-cence	con-va-les-cence
ped-an-try	ped-ant-ry
zool-o-gist	zo-ol-o-gist
meg-al-o-ma-ni-a	meg-a-lo-ma-ni-a
dis-e-ase	dis-ease
grand-daugh-t-er	grand-daugh-ter
e-lec-tro-phore-sis	e-lec-tro-pho-re-sis
slal-om	sla-lom
re-cy-cling	recycling
fid-g-et	fidg-et
ep-is-cop-a-cy	e-pis-co-pa-cy
rav-en	ra-ven
renew-a-ble	re-new-a-ble
glor-i-fy	glo-ri-fy
heaven-ly	heav-en-ly
su-bur-ban	sub-ur-ban
di-su-nion	dis-un-ion
vir-tuos-i-ty	vir-tu-os-i-ty
mes-os-phere	mes-o-sphere
pekan	pek-an
sain-t-li-ness	saint-li-ness
suf-fra-g-ist	suf-fra-gist
pro-mon-to-ry	prom-on-to-ry
sed-i-men-ta-r-y	sed-i-men-ta-ry
her-al-dic	he-ral-dic
cli-to-ris	clit-o-ris
scan-ti-ness	scant-i-ness
pej-or-a-tive	pe-jo-ra-tive
red-is-cov-er-y	re-dis-cov-er-y
hear-ti-ly	heart-i-ly
sir-en	si-ren
prof-ita-bly	prof-it-a-bly
challenged	chal-lenged
pet-er	pe-ter
con-des-cen-sion	con-de-scen-sion
goalkeep-ing	goal-keep-ing
un-prompted	un-prompt-ed
con-su-mer-ist	con-sum-er-ist
cra-v-at	cra-vat
cafe	ca-fe
com-pell-ing	com-pel-ling
pha-r-aoh	phar-aoh
wor-k-horse	work-horse
se-cond-ly	sec-ond-ly
so-meti-mes	some-times
mel-od-ra-mat-ic	mel-o-dra-mat-ic
con-ge-ni-al	con-gen-ial
fluid-i-ty	flu-id-i-ty
mal-adroit	mal-a-droit
mete-o-r-o-log-i-cal	me-te-or-o-log-i-cal
in-ad-ver-tent	in-ad-vert-ent
pre-sence	pres-ence
su-bop-ti-mal	sub-op-ti-mal
mis-chie-v-ous	mis-chie-vous
pro-ph-y-lax-is	pro-phy-lax-is
tel-e-pa-thy	te-lep-a-thy
con-ni-vance	con-niv-ance
gen-i-tal-i-a	gen-i-ta-li-a
whir-lig-ig	whirl-i-gig
tel-e-kin-e-sis	tel-e-ki-ne-sis
chant-ry	chan-try
gem-sbok	gems-bok
men-swear	mens-wear
buzz-ing	buzzing
friz-z-y	friz-zy
weev-il	wee-vil
pro-ced-ur-al-ly	pro-ce-dur-al-ly
char-it-a-ble	char-i-ta-ble
im-pas-sa-ble	im-pass-a-ble
car-ri-age-way	car-riage-way
is-o-la-tion	i-so-la-tion
chair-wo-m-an	chair-wom-an
clai-m-ant	claim-ant
tre-spass	tres-pass
in-teg-ra-tive	in-te-gra-tive
scho-lar	schol-ar
de-to-na-tor	det-o-na-tor
pro-secu-tor	pros-e-cu-tor
pred-i-ca-ment	pre-dic-a-ment
sa-c-ri-le-gious	sac-ri-le-gious
dis-rep-ut-a-ble	dis-rep-u-ta-ble
ti-ara	ti-ar-a
fal-len	fall-en
shind-ig	shin-dig
butler	but-ler
crink-ly	crin-kly
strate-gy	strat-e-gy
ref-i-nance	re-fi-nance
ir-refut-a-ble	ir-ref-u-ta-ble
in-deb-t-ed-ness	in-debt-ed-ness
drys-tone	dry-stone
heavi-ness	heav-i-ness
si-len-cer	si-lenc-er
sch-wa	schwa
ir-rita-ble	ir-ri-ta-ble
gamete	gam-ete
au-top-i-lot	au-to-pi-lot
star-ga-zer	star-gaz-er
nar-cissism	nar-cis-sism
grie-v-ous	griev-ous
au-to-ma-ton	au-tom-a-ton
trip-od	tri-pod
ye-oman-ry	yeo-man-ry
scream-ing	screaming
di-a-ph-a-n-ous	di-aph-a-nous
bes-mirch	be-smirch
cam-per	camp-er
twent-y	twen-ty
fer-mion	fer-mi-on
oa-sis	o-a-sis
dis-sent-ing	dissenting
un-char-it-a-ble	un-char-i-ta-ble
lar-yn-geal	la-ryn-ge-al
copy-right	cop-y-right
primor-di-al	pri-mor-di-al
frau-du-lent	fraud-u-lent
pean-ut	pea-nut
mis-ma-n-age	mis-man-age
tran-sac-tion-al	trans-ac-tion-al
da-m-age	dam-age
sa-wy-er	saw-yer
pat-terned	patterned
ti-me-li-ness	time-li-ness
primar-i-ly	pri-ma-ri-ly
ser-vant	serv-ant
haver-ing	ha-ve-ring
re-fores-ta-tion	re-for-est-a-tion
syr-inge	sy-ringe
me-tal	met-al
u-pon	up-on
ga-l-ax-y	gal-ax-y
su-b-u-nit	sub-u-nit
sus-pend-ed	sus-pen-ded
ab-a-lone	ab-a-lo-ne
hor-n-y	horn-y
ex-pira-to-ry	ex-pir-a-to-ry
cor-ny	corn-y
fev-er	fe-ver
placat-ing	pla-cat-ing
sphyg-mom-a-nom-e-ter	sphyg-mo-ma-nom-e-ter
squire-arch-y	squire-ar-chy
sach-et	sa-chet
hier-o-glyph	hi-er-o-glyph
re-con-fi-gure	re-con-fig-ure
su-per-mo-del	su-per-mod-el
pig-eon	pi-geon
cat-al-y-sis	ca-tal-y-sis
pa-r-en-ter-al	par-en-ter-al
to-bac-con-ist	to-bac-co-nist
pream-ble	pre-am-ble
un-pron-oun-ce-a-ble	un-pro-nounce-a-ble
masthead	mast-head
lus-ti-ly	lust-i-ly
fril-lier	fril-li-er
met-er	me-ter
theist	the-ist
arc-ing	arcing
derange	de-range
full-ing	fulling
col-on-ist	col-o-nist
ven-al	ve-nal
o-ver-staffed	overstaffed
protes-ter	pro-test-er
quea-s-y	quea-sy
prestige	pres-tige
th-wart	thwart
outride	out-ride
satur-day	sat-ur-day
table-cloth	ta-ble-cloth
li-quor	liq-uor
gang-ly	gan-gly
plann-ing	plan-ning
triplet	tri-plet
mi-ra-cle	mir-a-cle
blush-ing	blushing
iron-stone	i-ron-stone
vide-o-phone	vid-e-o-phone
chore-o-graph-ic	cho-re-o-graph-ic
o-ver-load-ed	overloaded
ure-ter	u-re-ter
cour-teous	cour-te-ous
an-thro-p-o-log-i-cal	an-thro-po-log-i-cal
gen-uine	gen-u-ine
nec-ro-man-c-er	nec-ro-man-cer
com-pul-so-r-y	com-pul-so-ry
ci-ta-del	cit-a-del
ba-bes	babes
co-met	com-et
vestige	ves-tige
grill-ing	grilling
phy-s-i-ol-o-gy	phys-i-ol-o-gy
taunt-ing	taunting
dwin-dling	dwindling
tapes-try	tap-es-try
harp-ist	har-pist
ap-pa-rent	ap-par-ent
typ-o-graph-i-cal	ty-po-graph-i-cal
cog-nac	co-gnac
shepherd	shep-herd
ta-proom	tap-room
cuir-ass	cui-rass
re-t-i-na	ret-i-na
oi-ly	oil-y
spid-er-y	spi-der-y
blat-ant-ly	bla-tant-ly
re-cipro-cal	re-cip-ro-cal
salvage	sal-vage
hom-o-sex-u-al-i-ty	ho-mo-sex-u-al-i-ty
in-com-par-a-bly	in-com-pa-ra-bly
jurist	ju-rist
learned	learn-ed
vide-o-tape	vid-e-o-tape
de-mo	dem-o
starl-ing	star-ling
tricy-cle	tri-cy-cle
pen-ile	pe-nile
bad-tempered	bad-tem-pered
as-tro-no-m-er	as-tron-o-mer
is-o-la-tion-ism	i-so-la-tion-ism
chiseled	chis-eled
e-quer-ry	eq-uer-ry
cra-tered	cratered
cret-i-nous	cre-tin-ous
prime-val	pri-me-val
trib-u-nal	tri-bu-nal
rel-o-cate	re-lo-cate
gnom-ic	gno-mic
nur-ser-y	nurs-er-y
in-trave-nous-ly	in-tra-ve-nous-ly
de-ter-minist	de-ter-min-ist
speech-i-fy-ing	speechifying
lu-nat-ic	lu-na-tic
liar	li-ar
cor-dil-ler-a	cor-dil-le-ra
gro-vel	grov-el
beat-i-fi-ca-tion	be-at-i-fi-ca-tion
whos-oev-er	who-so-ev-er
lambing	lamb-ing
so-lemn-ly	sol-emn-ly
om-ni-pre-sence	om-ni-pres-ence
de-vil-ish	dev-il-ish
lib-id-i-nous	li-bid-i-nous
er-ased	e-rased
pil-gri-mage	pil-grim-age
chili	chil-i
transport-a-ble	trans-port-a-ble
cad-et	ca-det
pre-face	pref-ace
re-s-cale	re-scale
dis-co-v-er-er	dis-cov-er-er
re-al-ign-ment	re-a-lign-ment
di-a-gon-al-ly	di-ag-o-nal-ly
ig-ua-na	i-gua-na
rep-ro-gram	re-pro-gram
ca-ch-et	ca-chet
sto-kes	stokes
rave-nous	rav-en-ous
brog-ue	brogue
moto-cross	mo-to-cross
transcend	tran-scend
ma-cro-bi-ot-ic	mac-ro-bi-ot-ic
ap-pro-val	ap-prov-al
temp-tress	tempt-ress
twis-t-er	twist-er
hy-drome-chan-ics	hy-dro-me-chan-ics
moth-er-stobe	mo-ther-stobe
in-dec-i-sive	in-de-ci-sive
em-broid-er	em-broi-der
dan-ce-a-ble	dance-a-ble
diplo-mat	dip-lo-mat
ro-sar-y	ro-sa-ry
mar-ri-age-a-ble	mar-riage-a-ble
ma-dam	mad-am
leng-then-ing	lengthening
ty-pe-set	type-set
courte-sy	cour-te-sy
ex-eunt	ex-e-unt
de-can-t-er	de-cant-er
im-pin-ge-ment	im-pinge-ment
nic-e-ty	ni-ce-ty
kar-ak-ul	kar-a-kul
laud-ed	lauded
sterl-ing	ster-ling
ye-as-ty	yeast-y
rel-o-ca-tion	re-lo-ca-tion
re-al-ness	real-ness
make-o-v-er	make-o-ver
dod-g-y	dodg-y
gloat-ing	gloating
helm-s-man	helms-man
bi-od-i-ver-si-ty	bi-o-di-ver-si-ty
cat-er	ca-ter
fri-en-dli-ly	friend-li-ly
deranged	de-ranged
un-set-tling	unsettling
in-tract-a-ble	in-trac-ta-ble
re-cord-ed	re-cor-ded
fos-t-er	fos-ter
twin-k-le	twin-kle
co-ver-let	cov-er-let
vig-nette	vi-gnette
ex-pla-n-a-to-ry	ex-plan-a-to-ry
qua-ter-nion	qua-ter-ni-on
blist-er	blis-ter
an-oint	a-noint
ruler	rul-er
re-com-men-da-tion	rec-om-men-da-tion
pho-to-vol-taic	pho-to-vol-ta-ic
ha-cien-da	ha-ci-en-da
in-tegra-tor	in-te-gra-tor
slander	slan-der
mul-ti-p-li-ca-tive	mul-ti-pli-ca-tive
click-ing	clicking
man-a-ger	man-ag-er
phra-s-al	phras-al
po-lit-ic	pol-i-tic
o-vere-at	o-ver-eat
fat-al-is-tic	fa-tal-is-tic
re-par-tee	rep-ar-tee
doom-s-day	dooms-day
photo-ty-pe-set-ter	pho-to-type-set-ter
coin-ci-den-tal-ly	co-in-ci-den-tal-ly
in-es-capa-bly	in-es-cap-a-bly
fis-h-er-man	fish-er-man
mer-cury	mer-cu-ry
cal-dera	cal-de-ra
di-arr-hea	di-ar-rhe-a
e-ty-mo-log-i-cal	et-y-mo-log-i-cal
cau-sal	caus-al
bi-noc-u-lar	bin-oc-u-lar
py-ram-id	pyr-a-mid
breast-feed	breastfeed
brow-nie	brown-ie
goalkeep-er	goal-keep-er
strang-er	stran-ger
a-nom-a-l-ous	a-nom-a-lous
fa-c-ile	fac-ile
ent-wine	en-twine
ar-ro-whead	ar-row-head
se-con-dar-y	sec-ond-ar-y
si-byl	sib-yl
rel-e-v-ant	rel-e-vant
un-linked	unlinked
blessed	bless-ed
plane-tar-y	plan-e-tar-y
rach-is	ra-chis
sol-di-er	sol-dier
pa-p-er	pa-per
i-vory	i-vo-ry
scruf-f-y	scruff-y
pro-t-ru-sive	pro-tru-sive
eav-es	eaves
cop-la-nar	co-pla-nar
lau-d-a-ble	laud-a-ble
re-vol-ver	re-volv-er
cus-to-mar-y	cus-tom-ar-y
dat-a-base	da-ta-base
un-ea-s-y	un-eas-y
in-def-in-a-ble	in-de-fin-a-ble
en-fee-bled	enfeebled
can-nib-alis-tic	can-ni-bal-is-tic
bit-u-men	bi-tu-men
twen-tieth	twen-ti-eth
capri-ole	cap-ri-ole
there-und-er	there-un-der
pol-yure-thane	pol-y-u-re-thane
me-ch-an-ist	mech-a-nist
quiet-ness	qui-et-ness
un-challenged	un-chal-lenged
ten-ured	tenured
drows-y	drow-sy
out-stretched	outstretched
pas-seng-er	pas-sen-ger
fal-lout	fall-out
em-bol-ism	em-bo-lism
teap-ot	tea-pot
pas-sa-ble	pass-a-ble
majo-rette	ma-jor-ette
e-ver-green	ev-er-green
re-newed	renewed
pro-duct	prod-uct
om-ni-po-tent	om-nip-o-tent
as-tride	a-stride
in-ter-changea-bly	in-ter-change-a-bly
ar-t-is-try	art-ist-ry
na-v-al	na-val
ko-ala	ko-a-la
is-o-ton-ic	i-so-ton-ic
pray-er-ful	prayer-ful
news-paper	news-pa-per
e-cu-men-ism	ec-u-me-nism
aright	a-right
di-a-t-ribe	di-a-tribe
un-dis-covered	un-dis-cov-ered
per-fu-mer-y	per-fum-er-y
spec-tro-ph-o-tom-e-ter	spec-tro-pho-tom-e-ter
hor-ser-ad-ish	horse-rad-ish
micro-cosm	mi-cro-cosm
water-logged	wa-ter-logged
plastered	plas-tered
hye-na	hy-e-na
bison	bi-son
chan-cy	chanc-y
cam-pa-nile	cam-pa-ni-le
ri-ot-ing	ri-o-ting
ex-cla-m-a-to-ry	ex-clam-a-to-ry
re-lat-ivis-tic	rel-a-tiv-is-tic
pig-ment-ed	pig-men-ted
coop-er-a-tive-ly	co-op-er-a-tive-ly
o-ver-sampling	o-ver-sam-pling
om-ni-pre-sent	om-ni-pres-ent
bul-letin	bul-le-tin
rack-e-teer-ing	rack-et-eer-ing
un-learned	un-learn-ed
er-upt	e-rupt
ex-cru-ciat-ing	ex-cru-ci-at-ing
las-er	la-ser
im-pie-ty	im-pi-e-ty
lion	li-on
he-roin	her-o-in
in-com-bust-i-ble	in-com-bus-ti-ble
tod-ay	to-day
per-so-nal-i-ty	per-son-al-i-ty
ne-ph-ri-tis	ne-phri-tis
ver-d-ant	ver-dant
toup-ee	tou-pee
dis-ord-er	dis-or-der
steep-le-chase	stee-ple-chase
fas-ti-d-i-ous	fas-tid-i-ous
whisk-ey	whis-key
de-for-m-i-ty	de-form-i-ty
darkened	dar-kened
neu-ro-surg-er-y	neu-ro-sur-ger-y
se-questered	se-ques-tered
pen-et-ra-ble	pen-e-tra-ble
pan-th-er	pan-ther
tend-er	ten-der
cheer-ing	cheering
val-i-ant-ly	val-iant-ly
re-strain-ing	restraining
ze-phyr	zeph-yr
do-pey	dope-y
sta-phy-lo-coc-cus	staph-y-lo-coc-cus
poet-ess	po-et-ess
pro-fli-gate	prof-li-gate
deb-a-cle	de-ba-cle
dra-g-on-f-ly	drag-on-fly
sym-pa-th-y	sym-pa-thy
re-sid-ue	res-i-due
tuxe-do	tux-e-do
bar-ba-ri-an	bar-bar-i-an
po-ver-ty	pov-er-ty
strato-spher-ic	strat-o-spher-ic
dun-gar-ees	dun-ga-rees
par-tic-i-ple	par-ti-ci-ple
bond-ing	bonding
ti-mes	times
feathered	feath-ered
caba-ret	cab-a-ret
ci-ty	cit-y
whirl-ing	whirling
tem-por-al	tem-po-ral
im-peri-al-is-tic	im-pe-ri-al-is-tic
pro-te-in	pro-tein
ar-chaic	ar-cha-ic
unfed	un-fed
de-co	dec-o
mar-quet-ry	mar-que-try
ir-re-medi-a-ble	ir-re-me-di-a-ble
blasted	blast-ed
transport-er	trans-port-er
un-fa-shion-a-ble	un-fash-ion-a-ble
sal-mon	salm-on
stable-mate	sta-ble-mate
un-pro-b-le-mat-ic	un-prob-lem-at-ic
post-mo-dern-ism	post-mod-ern-ism
ir-o-ny	i-ro-ny
ca-n-on-ic	ca-non-ic
diur-nal	di-ur-nal
blit-zkrieg	blitz-krieg
lib-i-do	li-bi-do
fal-ter-ing	fal-te-ring
as-pirin	as-pi-rin
com-ba-tant	com-bat-ant
bask-et	bas-ket
od-di-ty	odd-i-ty
go-vernance	gov-ern-ance
de-b-o-nair	deb-o-nair
ide-o-log-i-cal	i-de-o-log-i-cal
ge-nom-ic	ge-no-mic
clog-ged	clogged
de-od-or-ant	de-o-dor-ant
hu-mankind	hu-man-kind
chry-sal-is	chrys-a-lis
un-dim-in-ished	un-di-min-ished
glam-o-r-ous	glam-or-ous
mid-dlew-eight	mid-dle-weight
har-v-est	har-vest
cryp-ta-n-al-y-sis	crypt-a-nal-y-sis
re-medi-a-ble	re-me-di-a-ble
tard-y	tar-dy
priv-a-teer	pri-va-teer
un-dis-tribut-ed	un-dis-trib-ut-ed
com-par-a-bil-i-ty	com-pa-ra-bil-i-ty
ti-d-y	ti-dy
sen-ile	se-nile
une-lect-a-ble	un-e-lect-a-ble
an-throp-ic	an-thro-pic
ex-cita-ble	ex-cit-a-ble
ex-cru-ciat-ing-ly	ex-cru-ci-at-ing-ly
grand-pa-r-ent	grand-par-ent
grotesque-ly	gro-tesque-ly
de-faul-t-er	de-fault-er
lisp-ing	lis-ping
fealt-y	fe-al-ty
swin-g-y	swing-y
ve-l-um	ve-lum
ret-re-at	re-treat
dis-pen-sar-y	dis-pen-sa-ry
husk-y	hus-ky
ton-gue	tongue
u-ne-mo-tion-al	un-e-mo-tion-al
out-lier	out-li-er
strangle-hold	stran-gle-hold
cere-al	ce-re-al
nak-ed-ness	na-ked-ness
cur-tained	curtained
twilight	twi-light
lin-eage	lin-e-age
un-cre-dit-ed	un-cred-it-ed
sea-sonal-i-ty	sea-son-al-i-ty
hor-sewhip	horse-whip
prompting	prompt-ing
de-r-iv-a-tive	de-riv-a-tive
fur-th-er-ance	fur-ther-ance
un-coop-er-a-tive	un-co-op-er-a-tive
sa-les-man	sales-man
fin-an-cial-ly	fi-nan-cial-ly
un-i-on-i-sa-tion	un-ion-i-sa-tion
hy-dro-phob-ic	hy-dro-pho-bic
moti-va-tor	mo-ti-va-tor
pec-tor-al	pec-to-ral
test-ing	testing
swam-pland	swamp-land
whisp-er	whis-per
tub-er	tu-ber
leg-a-lis-tic	le-gal-is-tic
ca-cao	ca-ca-o
dam-pen	damp-en
o-ven	ov-en
aro-ma	a-ro-ma
toil-e-tries	toi-let-ries
bount-y	boun-ty
vis-ion	vi-sion
ther-moe-lec-tric	ther-mo-e-lec-tric
phy-s-i-o-ther-a-py	phys-i-o-ther-a-py
re-freshed	refreshed
privet	priv-et
cos-set-ed	cosseted
pho-nem-ic	pho-ne-mic
nearby	near-by
phob-ic	pho-bic
spon-sored	sponsored
poin-t-y	point-y
cove-tous	cov-et-ous
hol-d-all	hold-all
co-py	cop-y
dis-in-fec-tant	dis-in-fect-ant
grid-ded	gridded
pro-peller	pro-pel-ler
lander	land-er
caressing	ca-res-sing
pa-ten	pat-en
napk-in	nap-kin
men-arche	men-ar-che
proce-dure	pro-ce-dure
bi-or-hythm	bi-o-rhythm
thre-shold	thresh-old
squalor	squal-or
flus-tered	flustered
u-pro-ar-i-ous	up-roar-i-ous
dep-o-nent	de-po-nent
dis-son-ance	dis-so-nance
trait-o-rous	trai-tor-ous
fre-quent-ed	frequented
twinn-ing	twin-ning
col-ogne	co-logne
worldli-ness	world-li-ness
poet-ry	po-et-ry
yacht-sman	yachts-man
hered-i-ty	he-red-i-ty
cor-dite	cord-ite
par-a-bo-loid	pa-rab-o-loid
back-pe-d-al	back-ped-al
pol-y-cry-stal-line	pol-y-crys-tal-line
un-derling	un-der-ling
ma-nor	man-or
ge-r-on-toc-ra-cy	ger-on-toc-ra-cy
pa-ra-bo-la	pa-rab-o-la
pick-pock-et-ing	pickpocketing
lid-o	li-do
re-per-toire	rep-er-toire
tail-ored	tai-lored
dis-cred-ita-ble	dis-cred-it-a-ble
ex-cel-sior	ex-cel-si-or
homes-pun	home-spun
nur-ser-y-men	nurs-er-y-men
a-r-id	ar-id
glo-r-i-fi-ca-tion	glo-ri-fi-ca-tion
mot-i-vate	mo-ti-vate
re-tro	ret-ro
cour-tyard	court-yard
watershed	wa-ter-shed
bonan-za	bo-nan-za
wicked	wick-ed
prefer	pre-fer
cut-th-roat	cut-throat
jes-ter	jest-er
pod-g-y	podg-y
un-bek-nown	un-be-known
phi-l-an-thro-p-ist	phi-lan-thro-pist
gob-bledy-gook	gob-ble-dy-gook
chee-s-y	chees-y
ir-rel-e-v-ant	ir-rel-e-vant
malad-mi-nis-tra-tion	mal-ad-min-is-tra-tion
nuis-ance	nui-sance
strid-ent-ly	stri-dent-ly
mi-croe-lec-tron-ics	mi-cro-e-lec-tron-ics
rain-fo-rest	rain-for-est
purb-lind	pur-blind
steward	stew-ard
po-tash	pot-ash
dar-ter	dart-er
rep-ri-sal	re-pris-al
com-pa-ni-on-ship	com-pan-ion-ship
re-a-son-a-ble	rea-son-a-ble
ca-me-o	cam-e-o
se-cond-hand	sec-ond-hand
o-ver-flow-ing	o-ver-flo-wing
can-y-on	can-yon
sauc-y	sau-cy
con-sul-tant	con-sult-ant
con-su-mer-ism	con-sum-er-ism
wel-l-y	wel-ly
cal-cium	cal-ci-um
eu-phe-m-ism	eu-phe-mism
il-lu-so-r-y	il-lu-so-ry
e-s-prit	es-prit
sen-sual-i-ty	sen-su-al-i-ty
com-men-ta-r-y	com-men-tar-y
man-icured	ma-ni-cured
for-g-er-y	for-ger-y
di-ar-y	di-a-ry
de-fi-nes	def-ines
blun-der-ing	blundering
con-i-fer	co-ni-fer
blanket-ing	blan-ket-ing
in-sep-a-r-a-ble	in-sep-a-ra-ble
portend	por-tend
im-por-t-er	im-port-er
ta-pi-o-ca	tap-i-o-ca
in-sec-tiv-or-ous	in-sec-tiv-o-rous
wherev-er	wher-ev-er
mar-ke-teer	mar-ket-eer
fin-ite	fi-nite
wick-etk-eep-er	wick-et-keep-er
para-no-i-a	par-a-noi-a
in-kling	ink-ling
so-l-ace	sol-ace
prol-e-tar-i-at	pro-le-tar-i-at
re-cru-it-er	re-cruit-er
ju-di-ciar-y	ju-di-ci-ar-y
e-lec-tro-ne-ga-tive	e-lec-tro-neg-a-tive
blank-et	blan-ket
burn-ings	bur-nings
freck-led	freckled
iron-work	i-ron-work
teen-a-ger	teen-ag-er
li-ber-ty	lib-er-ty
mol-ester	mo-lest-er
scanty	scant-y
gun-me-tal	gun-met-al
vantage	van-tage
whim-per-ing	whimpering
sad-om-a-so-chis-tic	sa-do-mas-o-chis-tic
jux-ta-p-o-si-tion	jux-ta-po-si-tion
in-fras-truc-tur-al	in-fra-struc-tur-al
a-per-y	ap-er-y
in-ci-pi-ent	in-cip-i-ent
mon-e-tar-ism	mon-e-ta-rism
glor-y	glo-ry
e-phe-mer-is	e-phem-er-is
rat-a-touille	ra-ta-touille
con-tume-ly	con-tu-me-ly
col-lec-tiv-i-sa-tion	col-lec-ti-vi-sa-tion
hide-ous-ly	hid-e-ous-ly
un-lac-ing	un-lacing
un-noticed	un-no-ticed
clank-ing	clan-king
un-der-s-tudy	un-der-stud-y
ca-b-in	cab-in
fus-s-y	fuss-y
tran-s-cend-ence	tran-scend-ence
leak-ing	leaking
toughie	tough-ie
out-lawed	outlawed
vo-yeu-ris-tic	voy-eur-is-tic
dec-or-a-tive	dec-o-ra-tive
cog-no-scen-ti	co-gno-scen-ti
mach-is-mo	ma-chis-mo
tail-or	tai-lor
grie-vous-ly	griev-ous-ly
loess	lo-ess
de-vo-tee	dev-o-tee
trans-for-m-a-tive	trans-form-a-tive
friv-ol-ous	friv-o-lous
con-gealed	congealed
brack-et-ed	bracketed
res-pira-tor	res-pi-ra-tor
pal-m-ist	palm-ist
pe-r-i-a-s-tron	per-i-as-tron
cris-is	cri-sis
can-dles-tick	can-dle-stick
fo-ghorn	fog-horn
prem-a-ture	pre-ma-ture
sun-glas-ses	sun-glass-es
forester	for-est-er
trea-sure	treas-ure
col-lab-or-a-tor	col-lab-o-ra-tor
re-spite	res-pite
bun-dling	bundling
pul-lov-er	pull-o-ver
prede-fined	pre-de-fined
au-tar-ch-y	au-tar-chy
ha-berd-ash-er	hab-er-dash-er
in-ge-ni-ous-ly	in-gen-ious-ly
en-tre-p-re-neur	en-tre-pre-neur
para-sol	par-a-sol
dis-pen-ser	dis-pens-er
ar-ound	a-round
lam-plit	lamp-lit
de-sig-ned-ly	de-sign-ed-ly
grand-fa-th-er	grand-fa-ther
more-ov-er	more-o-ver
per-mit-ting	permitting
coi-tus	co-i-tus
ar-ch-er	arch-er
un-pal-a-ta-ble	un-pal-at-a-ble
di-su-ni-ty	dis-u-ni-ty
trin-k-et	trin-ket
crum-b-y	crumb-y
pro-spec-tive-ly	prospectively
hy-droe-lec-tric	hy-dro-e-lec-tric
in-ter-go-vern-men-tal	in-ter-gov-ern-men-tal
e-qui-ta-ble	eq-ui-ta-ble
im-per-vious	im-per-vi-ous
sneer-ing	sneering
hyp-no-th-er-a-py	hyp-no-ther-a-py
sup-er	su-per
con-tour-ing	con-touring
fore-fing-er	fore-fin-ger
prem-a-ture-ly	pre-ma-ture-ly
hon-orar-y	hon-or-ar-y
pain-ter	paint-er
pold-er	pol-der
hand-picked	handpicked
sub-mer-si-ble	sub-mers-i-ble
o-b-lo-quy	ob-lo-quy
tel-e-prin-ter	tel-e-print-er
ge-n-i-al-i-ty	ge-ni-al-i-ty
fe-lon	fel-on
a-toll	at-oll
cath-e-dral	ca-the-dral
mon-o-c-lo-nal	mon-o-clo-nal
in-com-par-a-ble	in-com-pa-ra-ble
ru-di-men-tar-y	ru-di-men-ta-ry
alarm-ing	a-larm-ing
step-daugh-t-er	step-daugh-ter
fin-al-ly	fi-nal-ly
spir-al	spi-ral
pas-tor-al	pas-to-ral
quad-ruply	quad-ru-ply
mis-er	mi-ser
scra-pyard	scrap-yard
lau-da-to-ry	laud-a-to-ry
thank-sgiv-ing	thanks-giv-ing
weanl-ing	wean-ling
show-jum-p-ers	show-jum-pers
re-im-ple-ment-ed	reimplemented
phar-ma-c-o-log-i-cal	phar-ma-co-log-i-cal
me-tro	met-ro
sauc-er	sau-cer
ob-soles-cence	ob-so-les-cence
cal-la-ble	call-a-ble
an-ni-ver-sar-y	an-ni-ver-sa-ry
domi-no	dom-i-no
defer	de-fer
iso-ther-mal	i-so-ther-mal
in-vo-lun-tar-y	in-vol-un-tar-y
bulg-ing	bulging
ex-hil-arat-ing	ex-hil-a-rat-ing
mo-no	mon-o
high-land-er	high-lan-der
pre-bend	preb-end
es-ta-blish	es-tab-lish
teac-up	tea-cup
pro-tec-to-rate	pro-tec-tor-ate
proff-er	prof-fer
vide-o-con-fer-enc-ing	vid-e-o-con-fer-enc-ing
pio-neer-ing	pi-o-neer-ing
growl-ing	growling
fa-sh-ion	fash-ion
demer-it	de-mer-it
dis-a-bling	disabling
outrank	out-rank
strat-ig-ra-phy	stra-tig-ra-phy
de-gauss-ing	degaussing
par-li-a-ment	par-lia-ment
frag-men-ta-r-y	frag-men-tar-y
credit	cred-it
har-an-gue	ha-rangue
co-lon-nade	col-on-nade
un-plug-ged	un-plugged
spy-g-lass	spy-glass
at-mo-spher-ics	at-mos-pher-ics
buck-min-ster-ful-ler-e-ne	buck-min-ster-ful-ler-ene
oft-en	of-ten
re-tro-ac-tive	ret-ro-ac-tive
ex-trag-a-lac-tic	ex-tra-ga-lac-tic
til-lage	till-age
tourni-quet	tour-ni-quet
meand-er	me-an-der
ci-tron	cit-ron
jo-key	jok-ey
cac-o-ph-o-ny	ca-coph-o-ny
prom-is-so-r-y	prom-is-so-ry
iv-y	i-vy
in-su-b-or-di-nate	in-sub-or-di-nate
de-ar-ie	dear-ie
bet-ray-al	be-tray-al
theism	the-ism
per-u-s-al	pe-rus-al
mar-gi-nal-ly	mar-gin-al-ly
cere-mo-ny	cer-e-mo-ny
zaire	za-ire
im-mo-dest	im-mod-est
en-vi-s-age	en-vis-age
hu-ma-nis-tic	hu-man-is-tic
tow-ard	to-ward
vic-er-oy	vice-roy
ta-lent	tal-ent
de-scend-ing	descending
neu-ro-nes	neu-rones
mul-tid-i-men-sion-al	mul-ti-di-men-sion-al
a-qualung	aq-ua-lung
so-po-rif-ic	sop-o-rif-ic
dent-is-try	den-tis-try
dun-ghill	dung-hill
sci-ent-ist	sci-en-tist
in-com-men-sur-a-ble	in-com-men-su-ra-ble
ty-pog-ra-phers	ty-po-gra-phers
gar-dener	gar-den-er
hon-orar-i-um	hon-o-rar-i-um
cof-fer-d-am	cof-fer-dam
dis-mem-bered	dismembered
re-p-ro-duce	re-pro-duce
fid-d-ly	fid-dly
gin-gham	ging-ham
tro-ph-y	tro-phy
rhea	rhe-a
a-v-id	av-id
in-ter-col-le-gi-ate	in-ter-col-le-giate
dis-cour-teous	dis-cour-te-ous
mer-i-no	me-ri-no
dyad	dy-ad
signer	sign-er
saki	sa-ki
re-scue	res-cue
dif-fer-ing	differing
un-con-si-dered	un-con-sid-ered
burg-lar-y	bur-gla-ry
meg-as-tar	meg-a-star
tea-r-oom	tea-room
dang-er	dan-ger
lu-ke-warm	luke-warm
gal-leon	gal-le-on
pho-to-co-pi-er	pho-to-cop-i-er
gen-e-al-o-gy	ge-ne-al-o-gy
oc-tog-e-nar-i-an	oc-to-ge-nar-i-an
cor-por-al	cor-po-ral
di-ar-ist	di-a-rist
in-fir-mar-y	in-fir-ma-ry
cudd-ly	cud-dly
re-voca-ble	rev-o-ca-ble
trel-lised	trellised
li-nes-man	lines-man
de-por-t-ee	de-por-tee
o-per-et-ta	op-er-et-ta
coin-ci-dence	co-in-ci-dence
an-tib-i-ot-ic	an-ti-bi-ot-ic
per-is-cope	per-i-scope
net-work-ing	networking
seg-ment-ed	seg-men-ted
psy-chopa-thol-o-gy	psy-cho-pa-thol-o-gy
be-ginn-ing	be-gin-ning
lit-er-a-ti	lit-e-ra-ti
tran-s-cen-den-tal	tran-scen-den-tal
re-vel	rev-el
dis-cre-dit-ed	discredited
lis-t-en	lis-ten
ju-gu-lar	jug-u-lar
oak-um	oa-kum
pa-lette	pal-ette
prop-y-lene	pro-pyl-ene
re-ad-apt	re-a-dapt
a-n-y-bod-y	an-y-bod-y
ner-vous	nerv-ous
se-rai	se-ra-i
temp-ter	tempt-er
dis-quiet-ing	dis-qui-et-ing
quiver-ing	quivering
or-al	o-ral
nomi-nee	nom-i-nee
rib-o-flav-in	ri-bo-fla-vin
pesk-y	pes-ky
ge-noa	gen-o-a
pol-yethy-lene	pol-y-eth-yl-ene
quav-er	qua-ver
troika	troi-ka
prede-ter-mined	predetermined
pi-o-n-eer	pi-o-neer
flor-al	flo-ral
la-teco-mer	late-com-er
e-lec-to-rate	e-lec-tor-ate
un-a-dapted	un-a-dapt-ed
bumpkin	bump-kin
cud-g-el	cudg-el
tra-des-man	trades-man
gig-gling	giggling
being	be-ing
fath-er-land	fa-ther-land
word-s-mith	word-smith
of-fend-ing	of-fen-ding
ge-o-chem-istry	ge-o-chem-is-try
has-ti-ly	hast-i-ly
chromo-some	chro-mo-some
un-ta-lent-ed	un-tal-ent-ed
ool-o-gy	o-ol-o-gy
e-so-ter-i-ca	es-o-ter-i-ca
a-n-y	an-y
chi-c-o-ry	chic-o-ry
em-bedd-a-ble	em-bed-da-ble
pub-li-c-ist	pub-li-cist
mo-no-to-nous	mo-not-o-nous
for-t-ress	for-tress
o-b-lique	o-blique
mil-lin-er	mil-li-ner
par-ap-sy-chol-o-gy	par-a-psy-chol-o-gy
ile-um	il-e-um
re-tin-ue	ret-i-nue
quad-ruped	quad-ru-ped
dec-i-sive	de-ci-sive
me-lon	mel-on
cro-ch-et	cro-chet
eid-er	ei-der
leg-a-tor	le-ga-tor
mar-ri-age	mar-riage
per-cep-t-i-ble	per-cep-ti-ble
meth-o-dol-o-gy	meth-od-ol-o-gy
ce-lebri-ty	ce-leb-ri-ty
hy-drochlo-ride	hy-dro-chlo-ride
grav-y	gra-vy
ey-e-l-in-er	eye-lin-er
su-per-posed	superposed
con-troll-er	con-trol-ler
cub-oid	cu-boid
pin-cu-shion	pin-cush-ion
ref-o-cus	re-fo-cus
con-sul-tan-cy	con-sult-an-cy
black-ened	blackened
ure-thane	u-re-thane
Words with errors: 1187
Words with incorrect number of syllables: 625
Total evluated: 6500
Perfect accuracy: 0.82
Number of syllables accuracy: 0.90
Average Levenshtein Distance(across incorrect words): 1.15
