Attempt	Real
bar-o-n-age	bar-on-age
ho-wit-zer	how-itz-er
de-cay-ing	decaying
se-n-a-to-ri-al	sen-a-to-ri-al
di-ges-ti-ble	di-gest-i-ble
o-th-er-wise	oth-er-wise
test-ing	testing
thriller	thrill-er
hide-ous	hid-e-ous
astound-ing	as-tound-ing
mil-d-ew	mil-dew
our-sel-ves	our-selves
a-chi-eve-ment	a-chieve-ment
un-prob-le-mat-ic	un-prob-lem-at-ic
slum-b-er	slum-ber
pu-r-i-ty	pu-ri-ty
un-beaten	un-beat-en
re-fer-ee	ref-er-ee
gol-fer	golf-er
huck-leber-ry	huck-le-ber-ry
screenp-lay	screen-play
pa-lette	pal-ette
pep-pered	peppered
gal-e-na	ga-le-na
du-ke-dom	duke-dom
slant-ed	slanted
han-go-v-er	hang-o-ver
wat-er	wa-ter
there-aft-er	there-af-ter
pres-ti-gious	pres-tig-ious
chee-s-y	chees-y
re-tro-ac-tive-ly	ret-ro-ac-tive-ly
is-o-la-tion-ism	i-so-la-tion-ism
cough-ing	coughing
pe-n-al	pe-nal
cal-o-rime-ter	cal-o-rim-e-ter
hor-rend-ous	hor-ren-dous
un-satis-fac-to-ry	un-sat-is-fac-to-ry
cre-dit-wor-thy	cred-it-worth-y
fas-tidi-ous	fas-tid-i-ous
day-dre-am	day-dream
me-ch-an-ic	me-chan-ic
con-ti-nue	con-tin-ue
cour-tyard	court-yard
cet-a-cean	ce-ta-cean
coerce	co-erce
resis-tance	re-sist-ance
trans-pa-r-en-cy	trans-par-en-cy
medal	med-al
redi-rec-tion	re-di-rec-tion
hand-mai-den	hand-maid-en
succeed-ing	suc-ceed-ing
con-cussed	concussed
nor-thern-most	north-ern-most
fat-al-ism	fa-tal-ism
cor-on-er	cor-o-ner
fi-nis	fin-is
tour-is-ty	tour-ist-y
ben-e-fi-ciar-y	ben-e-fi-ci-ar-y
se-ven-teenth	sev-en-teenth
phy-si-og-no-my	phys-i-og-no-my
de-scant	des-cant
at-tempt-ed	at-temp-ted
con-sul-tant	con-sult-ant
nin-e-teen	nine-teen
cur-vy	curv-y
piglet	pig-let
in-se-cu-r-i-ty	in-se-cu-ri-ty
le-ger-de-main	leg-er-de-main
mu-es-li	mues-li
se-r-o-to-nin	ser-o-to-nin
cu-tler	cut-ler
an-te-n-a-tal	an-te-na-tal
mi-c-ro-wave	mi-cro-wave
vel-ve-teen	vel-vet-een
back-pe-dal	back-ped-al
re-l-a-tiv-i-ty	rel-a-tiv-i-ty
fore-fath-er	fore-fa-ther
in-a-d-e-qua-cy	in-ad-e-qua-cy
joy-r-id-ing	joy-rid-ing
kit-che-nette	kitch-en-ette
sol-di-er-ly	sol-dier-ly
stran-g-les	stran-gles
a-sympto-mat-ic	a-symp-to-mat-ic
mir-ror-ing	mirroring
sa-lad	sal-ad
ra-pine	rap-ine
mil-de-wy	mil-dew-y
cas-ta-way	cast-a-way
e-nact	en-act
col-le-gial	col-le-gi-al
sizzling	siz-zling
thrus-t-er	thrust-er
un-lad-y-like	un-la-dy-like
bask-et	bas-ket
ra-v-en	ra-ven
ge-o-syn-chro-n-ous	ge-o-syn-chro-nous
in-hab-i-ta-ble	in-hab-it-a-ble
pol-d-er	pol-der
char-i-o-teer	char-i-ot-eer
go-ver-nance	gov-ern-ance
un-e-lec-t-a-ble	un-e-lect-a-ble
ven-ge-ful	venge-ful
en-a-bled	e-na-bled
dev-astat-ing-ly	dev-as-tat-ing-ly
stra-to-s-pher-ic	strat-o-spher-ic
hein-ous	hei-nous
re-cipi-ent	re-cip-i-ent
pal-my	palm-y
repro-duc-i-bil-i-ty	re-pro-duc-i-bil-i-ty
de-f-a-ma-tion	def-a-ma-tion
py-r-i-dine	pyr-i-dine
ba-lus-trade	bal-us-trade
napo-le-on	na-po-le-on
jiff-y	jif-fy
per-iphra-sis	pe-riph-ra-sis
re-a-son-a-ble-ness	rea-son-a-ble-ness
wi-ly	wil-y
con-nect-ing	con-nec-ting
fri-end-li-ly	friend-li-ly
ton-ight	to-night
pleni-po-ten-tiar-y	plen-i-po-ten-ti-ar-y
be-loved	be-lov-ed
im-mo-ral	im-mor-al
goalk-eep-ing	goal-keep-ing
im-pe-dance	im-ped-ance
gha-na	ghana
mu-shroom	mush-room
ev-er-y-where	eve-ry-where
break-water	break-wa-ter
man-a-ger-ess	man-ag-er-ess
ar-chan-gel	arch-an-gel
be-witch-ing	bewitching
un-fa-th-om-a-ble	un-fath-om-a-ble
dingh-y	din-ghy
mot-i-vate	mo-ti-vate
trea-sur-er	treas-ur-er
ex-pect-ed	expected
ba-bys-it	ba-by-sit
lim-i-ter	lim-it-er
in-trav-e-nous	in-tra-ve-nous
re-n-o-vate	ren-o-vate
un-ba-lance	un-bal-ance
prol-ong	pro-long
in-dec-i-sive	in-de-ci-sive
sa-r-i	sa-ri
desig-na-tion	des-ig-na-tion
un-fru-it-ful	un-fruit-ful
vil-lainy	vil-lain-y
re-com-mend-ed	recommended
hed-on-ist	he-don-ist
or-ga-nized	or-gan-ized
ma-l-ign	ma-lign
in-sis-tent	in-sist-ent
dress-age	dres-sage
based	based
is-o-met-ric	i-so-met-ric
im-pas-sa-ble	im-pass-a-ble
jin-gois-tic	jin-go-is-tic
nep-h-ri-tis	ne-phri-tis
su-per-n-a-tant	su-per-na-tant
clergy-man	cler-gy-man
prolonged	pro-longed
tel-l-er	tell-er
in-for-mant	in-form-ant
scur-ri-lous	scur-ril-ous
fath-er-ing	fathering
a-ro-ma-th-er-a-py	a-ro-ma-ther-a-py
in-ter-ci-ty	in-ter-cit-y
pre-cooked	precooked
en-count-er	en-coun-ter
pa-late	pal-ate
las-civi-ous	las-civ-i-ous
feas-i-ble	fea-si-ble
thous-and	thou-sand
se-cu-r-i-ty	se-cu-ri-ty
hear-ti-ly	heart-i-ly
eq-ui-dis-tant	e-qui-dis-tant
be-vel	bev-el
lager	la-ger
hor-se-whip	horse-whip
me-l-a-to-nin	mel-a-to-nin
mid-wi-fer-y	mid-wife-ry
re-p-re-hend	rep-re-hend
mel-ee	me-lee
stoa	sto-a
is-o-late	i-so-late
ta-l-on	tal-on
ro-bin	rob-in
canon-ic	ca-non-ic
rei-fy	re-i-fy
chloro-phyll	chlo-ro-phyll
mo-re-o-v-er	more-o-ver
hy-drome-chan-ics	hy-dro-me-chan-ics
im-pressed	impressed
e-s-pres-so	es-pres-so
mim-i-cry	mim-ic-ry
wond-er	won-der
for-sy-thi-a	for-syth-i-a
dis-satis-fac-tion	dis-sat-is-fac-tion
cys-teine	cys-te-ine
un-in-hab-i-ta-ble	un-in-hab-it-a-ble
de-sig-ner	de-sign-er
fi-erce	fierce
hap-pyg-o-luck-y	hap-py-go-luck-y
crotchet	crotch-et
a-s-leep	a-sleep
un-bek-nown	un-be-known
mour-ner	mourn-er
dis-a-bling	disabling
tram-li-nes	tram-lines
lymph-o-cyte	lym-pho-cyte
chan-ge-o-v-er	change-o-ver
rati-fi-ca-tion	rat-i-fi-ca-tion
par-li-a-men-tar-i-an	par-lia-men-tar-i-an
fer-mion	fer-mi-on
bea-n-ie	bean-ie
in-de-ciph-er-a-ble	in-de-ci-pher-a-ble
lef-to-v-er	left-o-ver
dish-on-est-ly	dis-hon-est-ly
re-fer-en-dum	ref-er-en-dum
bal-o-ney	ba-lo-ney
var-i-e-tal	va-ri-e-tal
doc-u-men-tar-y	doc-u-men-ta-ry
ma-cro-eco-nom-ic	mac-ro-ec-o-nom-ic
blo-w-up	blow-up
eg-o-tis-ti-cal	e-go-tis-ti-cal
epis-cop-a-cy	e-pis-co-pa-cy
blust-er	blus-ter
whomev-er	whom-ev-er
budget	budg-et
rat-tles-nake	rat-tle-snake
dim-in-ish	di-min-ish
cha-mo-mile	cham-o-mile
ir-re-con-ci-la-ble	ir-rec-on-cil-a-ble
gen-e-a-log-i-cal	ge-ne-a-log-i-cal
un-pre-judiced	un-prej-u-diced
eer-i-ly	ee-ri-ly
et-u-i	e-tui
ex-tram-u-ral	ex-tra-mu-ral
wis-p-y	wisp-y
si-mile	sim-i-le
dra-gon	drag-on
bleat-ing	bleating
a-n-y-bo-d-y	an-y-bod-y
best-selling	best-sell-ing
nif-t-y	nif-ty
re-tro	ret-ro
blit-zkrieg	blitz-krieg
gask-et	gas-ket
sympto-mat-ic	symp-to-mat-ic
lisping	lis-ping
joey	jo-ey
ro-man-cer	ro-manc-er
beat-i-tude	be-at-i-tude
in-her-ita-ble	in-her-it-a-ble
gent-ly	gen-tly
lo-de-s-tar	lode-star
so-ci-al-ite	so-cial-ite
heli-o-trope	he-li-o-trope
de-scend-ing	descending
new-scast	news-cast
fac-si-mile	fac-sim-i-le
doomsday	dooms-day
wicketkeep-er	wick-et-keep-er
gon-do-li-er	gon-do-lier
foun-d-ry	found-ry
con-temp-t-i-ble	con-tempt-i-ble
com-men-sur-ate	com-men-su-rate
ca-rat	car-at
swimm-ing-ly	swim-ming-ly
trel-lised	trellised
lo-de-stone	lode-stone
sy-ca-more	syc-a-more
res-is-tiv-i-ty	re-sis-tiv-i-ty
coag-u-late	co-ag-u-late
wiz-ar-dry	wiz-ard-ry
le-th-al	le-thal
coi-tus	co-i-tus
shepherd	shep-herd
sep-a-r-a-tism	sep-a-ra-tism
a-po-state	a-pos-tate
cou-r-a-geous	cou-ra-geous
pal-u-dal	pa-lu-dal
fus-s-y	fuss-y
ig-u-a-na	i-gua-na
au-d-i-to-ry	au-di-to-ry
ob-stetri-cian	ob-ste-tri-cian
pu-e-rile	pu-er-ile
dis-fi-gure	dis-fig-ure
a-larmed	alarmed
spind-rift	spin-drift
oc-tog-e-nar-i-an	oc-to-ge-nar-i-an
razzma-tazz	razz-ma-tazz
slo-ven-ly	slov-en-ly
clam-o-rous	clam-or-ous
cyc-lic	cy-clic
tech-no-pho-bi-a	tech-no-pho-bia
port-age	por-tage
bys-tander	by-stand-er
ti-dal	tid-al
cya-nide	cy-a-nide
pre-ser-va-tion	pres-er-va-tion
succeed	suc-ceed
wher-e-v-er	wher-ev-er
stag-ger-ing	staggering
lai-ty	la-i-ty
a-ven-ger	a-veng-er
cheetah	chee-tah
ele-venth	e-lev-enth
gaun-tlet	gaunt-let
son-gwrit-er	song-writ-er
staphylo-coc-cus	staph-y-lo-coc-cus
creak-ing	creaking
o-blit-er-a-tion	ob-lit-er-a-tion
fra-gile	frag-ile
down-s-wing	down-swing
daily	dai-ly
si-r-en	si-ren
div-ider	di-vid-er
decla-ma-tion	dec-la-ma-tion
hier-arch	hi-er-arch
in-frared	in-fra-red
dauber	daub-er
res-is-tant	re-sist-ant
lit-er-a-ti	lit-e-ra-ti
convinc-ing	con-vinc-ing
un-credit-ed	un-cred-it-ed
di-arrhea	di-ar-rhe-a
cer-ise	ce-rise
in-ge-nious	in-gen-ious
man-a-ger	man-ag-er
lymphoid	lym-phoid
donor	do-nor
wainscot-ing	wain-scot-ing
dis-con-ti-nue	dis-con-tin-ue
o-ver-seer	o-ver-se-er
se-cond-ly	sec-ond-ly
char-ade	cha-rade
du-o-mo	duo-mo
quiv-er-ing	quivering
od-di-ty	odd-i-ty
un-repre-sent-ed	un-rep-re-sent-ed
du-o-lo-gue	du-o-logue
o-blate	ob-late
thor-ny	thorn-y
re-sin	res-in
ba-lance	bal-ance
per-use	pe-ruse
spoke-swom-an	spokes-wom-an
e-ch-id-na	e-chid-na
so-cie-tal	so-ci-e-tal
fril-ly	frill-y
car-ouse	ca-rouse
stapler	sta-pler
dis-hearten-ing	dis-hear-te-ning
so-ci-a-ble	so-cia-ble
sweeten-er	sweet-en-er
craf-ty	craft-y
trac-t-a-ble	trac-ta-ble
de-ser-ti-fi-ca-tion	de-sert-i-fi-ca-tion
li-tur-gy	lit-ur-gy
meand-er	me-an-der
un-co-vered	un-cov-ered
ea-sy	eas-y
re-cord-ed	re-cor-ded
won-d-rous	won-drous
hy-gien-ic	hy-gi-en-ic
eid-er	ei-der
pitu-i-tar-y	pi-tu-i-tar-y
hyph-e-nate	hy-phen-ate
shorten-ing	short-en-ing
prol-e-tar-i-an	pro-le-tar-i-an
ped-an-try	ped-ant-ry
crat-er	cra-ter
peri-o-dic-i-ty	pe-ri-o-dic-i-ty
de-reg-u-la-tion	de-reg-u-lation
in-de-struc-t-i-ble	in-de-struct-i-ble
lu-ke-warm	luke-warm
sym-bo-lism	sym-bol-ism
pea-sant	peas-ant
lit-to-r-al	lit-to-ral
ge-rund	ger-und
scler-o-sis	scle-ro-sis
col-on-ist	col-o-nist
spongy	spon-gy
cor-ti-cos-ter-oid	cor-ti-co-ster-oid
in-ter-lo-p-er	in-ter-lop-er
ge-n-ie	ge-nie
haph-a-zard-ly	hap-haz-ard-ly
ma-cro-bi-ot-ic	mac-ro-bi-ot-ic
si-de-track	side-track
e-ver-more	ev-er-more
spher-oid	sphe-roid
aw-hile	a-while
hol-ism	ho-lism
burg-lar	bur-glar
pa-r-a-dox	par-a-dox
re-cru-it-er	re-cruit-er
ru-i-na-tion	ru-in-a-tion
fin-der	find-er
da-hli-a	dahl-ia
pi-ti-a-ble	pit-i-a-ble
hy-droch-lo-ride	hy-dro-chlo-ride
reti-nue	ret-i-nue
sur-f-er	surf-er
scra-pie	scrap-ie
del-u-sive	de-lu-sive
repro-duc-tion	re-pro-duc-tion
ex-ult-ing	exulting
om-it	o-mit
waf-er	wa-fer
the-ocra-cy	the-oc-ra-cy
pre-sent-ly	pres-ent-ly
a-nyth-ing	an-y-thing
in-tert-wine	in-ter-twine
gen-d-er	gen-der
can-di-datu-res	can-di-da-tures
fro-lic-some	frol-ic-some
im-per-so-nate	im-per-son-ate
easter-ly	east-er-ly
pout-ing	pouting
un-plea-sant	un-pleas-ant
un-sweetened	un-sweet-ened
post-pon-e-ment	post-pone-ment
lun-cheon	lunch-eon
her-bi-cide	herb-i-cide
re-vol-ver	re-volv-er
gan-gland	gang-land
fuz-zy	fuzz-y
mo-les-ter	mo-lest-er
crema-to-ri-um	cre-ma-to-ri-um
fo-re-arm	fore-arm
plu-my	plum-y
lac-u-na	la-cu-na
fre-sh-en-er	fresh-en-er
stu-died	stud-ied
el-ic-it	e-lic-it
ir-ri-t-a-ble	ir-ri-ta-ble
oyster	oys-ter
the-or-ist	the-o-rist
steril-i-ty	ste-ril-i-ty
leg-al-ism	le-gal-ism
or-ga-nize	or-gan-ize
tap-er-ing	ta-pe-ring
sig-ners	sign-ers
betro-thal	be-troth-al
u-n-i-on-i-sa-tion	un-ion-i-sa-tion
tel-ep-a-thy	te-lep-a-thy
mak-e-up	make-up
vo-lume	vol-ume
mul-tip-li-ca-tive	mul-ti-pli-ca-tive
dis-con-ti-nued	dis-con-tin-ued
cere-al	ce-re-al
cad-av-er	ca-dav-er
man-i-cured	ma-ni-cured
ow-let	owl-et
to-bac-con-ist	to-bac-co-nist
sca-r-ab	scar-ab
spin-al	spi-nal
sa-le-s-per-son	sales-per-son
fol-d-er	fold-er
cle-ment	clem-ent
hel-p-er	help-er
warthog	wart-hog
howd-y	how-dy
re-ser-voir	res-er-voir
im-mo-dest	im-mod-est
i-mag-i-na-tion	im-ag-i-na-tion
pap-y-rus	pa-py-rus
en-gi-neered	engineered
head-pho-nes	head-phones
howev-er	how-ev-er
o-be-lisk	ob-e-lisk
crazi-ly	cra-zi-ly
ex-eunt	ex-e-unt
giblets	gib-lets
in-su-p-er-a-ble	in-su-per-a-ble
pin-e-ap-ple	pine-ap-ple
he-roine	her-o-ine
go-ver-nor	gov-er-nor
cask-et	cas-ket
pir-a-cy	pi-ra-cy
pro-blem	prob-lem
ap-pa-rent	ap-par-ent
mo-no-mo-lec-u-lar	mon-o-mo-lec-u-lar
veg-et-a-tive	veg-e-ta-tive
slouch-ing	slouching
dan-de-lion	dan-de-li-on
vig-i-lante	vig-i-lan-te
in-hab-i-tant	in-hab-it-ant
prol-o-gue	pro-logue
per-u-sal	pe-rus-al
re-ven-ge-ful	re-venge-ful
roun-dup	round-up
ca-l-iph	ca-liph
en-liven	en-liv-en
sea-going	sea-go-ing
dangling	dan-gling
theat-ri-cal-ly	the-at-ri-cal-ly
ma-l-ig-nant	ma-lig-nant
li-eu	lieu
noi-sy	nois-y
pean-ut	pea-nut
shar-p-en	sharp-en
can-y-on	can-yon
sa-les-girl	sales-girl
vi-de-o-tape	vid-e-o-tape
e-l-o-cu-tion	el-o-cu-tion
ex-pec-tant-ly	ex-pect-ant-ly
ri-fled	rifled
wreck-ing	wrecking
el-e-v-a-tor	el-e-va-tor
bar-ge-pole	barge-pole
beat-i-fy	be-at-i-fy
ood-les	oo-dles
pu-blic	pub-lic
scraw-ny	scrawn-y
dish-water	dish-wa-ter
sep-ar-a-ble	sep-a-ra-ble
weary-ing	wea-ry-ing
ex-cav-a-tor	ex-ca-va-tor
gir-der	gird-er
mac-a-bre	ma-ca-bre
de-caf-fei-nate	de-caf-fein-ate
nos-tal-gi-a	nos-tal-gia
quer-y	que-ry
li-mo	lim-o
weasel	wea-sel
cate-go-ry	cat-e-go-ry
ho-o-l-i-gan-ism	hoo-li-gan-ism
swampland	swamp-land
en-tre-p-re-neu-ri-al	en-tre-pre-neur-i-al
flutist	flut-ist
neu-ro-nal	neu-ron-al
prim-a-cy	pri-ma-cy
hav-en	ha-ven
ev-er-y	eve-ry
cor-dil-ler-a	cor-dil-le-ra
or-al-ly	o-ral-ly
leak-ing	leaking
blin-k-ered	blink-ered
ask-ew	a-skew
in-ter-regnum	in-ter-reg-num
de-prec-a-to-ry	dep-re-ca-to-ry
prov-ok-ing	pro-vok-ing
iron-ing	i-ron-ing
fa-cul-ty	fac-ul-ty
su-per-in-ten-dence	su-per-in-tend-ence
a-re-a	ar-e-a
bu-tler	but-ler
der-iva-tive	de-riv-a-tive
cos-set-ed	cosseted
tran-sac-tion	trans-ac-tion
o-ver-pro-duced	overproduced
blasphemy	blas-phe-my
se-ven-ty	sev-en-ty
com-po-ser	com-pos-er
hil-ly	hill-y
re-cover-y	re-cov-er-y
doub-t-er	doubt-er
i-de-o-lo-gue	i-de-o-logue
com-par-a-bil-i-ty	com-pa-ra-bil-i-ty
flood-ing	flooding
mi-n-or	mi-nor
fis-ti-cuffs	fist-i-cuffs
fa-cile	fac-ile
chal-et	cha-let
in-fante	in-fan-te
punch-line	punchline
pro-te-in	pro-tein
coev-al	co-e-val
e-lec-to-r-al	e-lec-tor-al
cha-mois	cham-ois
ru-ler	rul-er
pro-sec-u-to-ri-al	pros-e-cu-to-ri-al
prim-e-val	pri-me-val
mul-ti-cul-tu-ral	mul-ti-cul-tur-al
lin-k-up	link-up
re-publish	re-pub-lish
in-scrut-a-ble	in-scru-ta-ble
gui-d-ance	guid-ance
un-re-ser-v-ed-ly	un-re-serv-ed-ly
ki-lo-ton	kil-o-ton
ey-e-l-et	eye-let
em-bo-som	em-bos-om
ly-r-ist	lyr-ist
un-fo-c-used	un-fo-cused
lif-toff	lift-off
pres-e-lect	pre-se-lect
bai-lout	bail-out
re-pro-cess	re-proc-ess
anx-i-ous	anx-ious
ditch-ing	ditching
po-ver-ty	pov-er-ty
re-trof-it	ret-ro-fit
puzzling	puz-zling
ci-trate	cit-rate
chal-len-g-er	chal-leng-er
chaos	cha-os
trous-ers	trou-sers
mis-er	mi-ser
sa-les-man	sales-man
sig-ning	sign-ing
boun-d-ar-y	bound-a-ry
smold-er	smol-der
co-vert-ly	cov-ert-ly
ven-geance	venge-ance
ge-lig-nite	gel-ig-nite
bel-liger-ent	bel-lig-er-ent
dogged	dog-ged
fevered	fe-vered
an-ti-po-des	an-tip-o-des
nai-vete	naivete
ob-lig-ing	o-blig-ing
wicked	wick-ed
va-cil-la-tion	vac-il-la-tion
o-le-and-er	o-le-an-der
win-n-a-ble	win-na-ble
son-gwrit-ing	song-writ-ing
micro-graph	mi-cro-graph
new-spap-er	news-pa-per
fri-eze	frieze
tran-sves-tite	trans-ves-tite
re-no-va-tion	ren-o-va-tion
ped-a-go-gue	ped-a-gogue
sal-mon	salm-on
cop-i-lot	co-pi-lot
ste-r-ile	ster-ile
wand-er	wan-der
re-sur-rec-tion	res-ur-rec-tion
in-aud-i-ble	in-au-di-ble
un-du-lat-ing	un-du-la-ting
o-ver-crowd-ed	o-ver-crow-ded
sed-i-men-tar-y	sed-i-men-ta-ry
softheart-ed	soft-heart-ed
ap-o-lit-i-cal	a-po-lit-i-cal
big-o-try	big-ot-ry
pi-rou-ette	pir-ou-ette
re-s-cue	res-cue
vin-ey-ard	vine-yard
prose-cu-tion	pros-e-cu-tion
pro-tean	pro-te-an
per-ime-ter	pe-rim-e-ter
re-cid-i-v-ist	re-cid-i-vist
sty-l-ist	styl-ist
me-ch-an-ics	me-chan-ics
mul-ti-me-ter	mul-tim-e-ter
aphid	a-phid
monas-tic	mo-nas-tic
lack-a-dais-i-cal	lack-a-dai-si-cal
ool-o-gy	o-ol-o-gy
be-li-ev-a-bil-i-ty	be-liev-a-bil-i-ty
e-goism	e-go-ism
un-derling	un-der-ling
pros-ce-ni-um	pro-sce-ni-um
rep-o-si-tion	re-po-si-tion
prob-i-ty	pro-bi-ty
strang-er	stran-ger
her-bal	herb-al
brie-fly	brief-ly
rev-i-v-al	re-viv-al
no-b-ly	no-bly
ba-lus-ter	bal-us-ter
va-l-en-tine	val-en-tine
kai-s-er	kai-ser
napk-in	nap-kin
cle-men-cy	clem-en-cy
fore-shadow	fore-shad-ow
raven-ing	rav-en-ing
se-ven-tieth	sev-en-ti-eth
chau-vi-n-ism	chau-vin-ism
blis-tered	blistered
meth-y-lene	meth-yl-ene
toge-th-er-ness	to-geth-er-ness
se-r-on-e-ga-tive	se-ro-neg-a-tive
sou-ve-n-ir	sou-ve-nir
cid-er	ci-der
boul-d-er	boul-der
se-r-ene	se-rene
grand-pa-rent	grand-par-ent
de-sig-ned-ly	de-sign-ed-ly
ma-r-oon	ma-roon
cor-po-ra-tism	cor-po-rat-ism
re-devel-op	re-de-vel-op
new-sroom	news-room
me-lon	mel-on
sur-rend-er	sur-ren-der
coupling	cou-pling
pesk-y	pes-ky
so-vereign-ty	sov-er-eign-ty
sou-ther-n-er	south-ern-er
con-tume-ly	con-tu-me-ly
sta-tute	stat-ute
tran-s-pi-ra-tion	tran-spi-ra-tion
mil-i-tar-ism	mil-i-ta-rism
bif-o-cal	bi-fo-cal
o-ran-gu-tan	o-rang-u-tan
sil-age	si-lage
pain-stak-ing-ly	pains-tak-ing-ly
emis-sa-r-y	em-is-sar-y
ap-t-ly	apt-ly
blaspheme	blas-pheme
par-al-lelep-iped	par-al-lel-e-pi-ped
ma-r-ine	ma-rine
seal-ing	sealing
pho-nem-ic	pho-ne-mic
new-sprint	news-print
ex-is-tent	ex-ist-ent
ca-lum-ny	cal-um-ny
wea-th-er-vane	weath-er-vane
per-i-lous-ly	per-il-ous-ly
con-for-m-i-ty	con-form-i-ty
paup-er	pau-per
schemat-ic	sche-mat-ic
rifling	ri-fling
me-ga	meg-a
cat-er	ca-ter
boast-ing	boas-ting
is-o-la-tion	i-so-la-tion
pen-i-ten-tiar-y	pen-i-ten-tia-ry
dam-per	damp-er
pael-la	pa-el-la
o-cean-ic	o-ce-an-ic
pro-tect-ed	protected
u-n-i-ty	u-ni-ty
cere-mo-ny	cer-e-mo-ny
quick-silv-er	quick-sil-ver
mar-gi-nal	mar-gin-al
ne-ces-sar-i-ly	nec-es-sar-i-ly
pre-ju-dice	prej-u-dice
un-fet-tered	unfettered
tok-a-mak	to-ka-mak
ver-is-i-mil-i-tude	ver-i-si-mil-i-tude
re-mo-val	re-mov-al
e-c-on-om-ist	e-con-o-mist
mazy	ma-zy
rock-e-try	rock-et-ry
righteous-ness	right-eous-ness
pros-ta-glandin	pros-ta-glan-din
gladi-a-tor	glad-i-a-tor
u-pend-ed	upended
fi-ef-dom	fief-dom
pris-s-y	pris-sy
her-bage	herb-age
hor-sey	hors-ey
cham-pa-gne	cham-pagne
feas-i-bly	fea-si-bly
hy-po-x-i-a	hy-pox-i-a
mores	mo-res
son-o-r-ous	so-no-rous
trivi-a	triv-i-a
pet-ro-leum	pe-tro-le-um
se-ven-teen	sev-en-teen
dy-n-as-ty	dy-nas-ty
ob-stin-a-cy	ob-sti-na-cy
armpit	arm-pit
con-troll-er	con-trol-ler
wine-sk-in	wine-skin
up-lift-ed	uplifted
per-meate	per-me-ate
re-c-o-v-er	re-cov-er
o-pa-les-cent	o-pal-es-cent
stifling	sti-fling
neith-er	nei-ther
louv-er	lou-ver
de-vil-ish	dev-il-ish
scaffold-ing	scaf-fold-ing
plea-sure	pleas-ure
tid-y	ti-dy
re-l-a-tive-ly	rel-a-tive-ly
fo-rest	for-est
poem	po-em
pam-phle-teer	pam-phlet-eer
an-tler	ant-ler
lam-bda	lamb-da
steep-le-chase	stee-ple-chase
pi-rat-ed	pirated
wea-th-er-proof	weath-er-proof
of-fhand	off-hand
ou-t-house	out-house
im-prison-ment	im-pris-on-ment
ep-o-chal	ep-och-al
by-pro-duct	by-prod-uct
bond-ing	bonding
pro-po-si-tion-al	prop-o-si-tion-al
in-cor-rig-i-ble	in-cor-ri-gi-ble
pla-cen-tae	pla-cen-tae
bibli-o-graph-ic	bib-li-o-graph-ic
frail-t-y	frail-ty
pro-ced-u-r-al-ly	pro-ce-dur-al-ly
o-ver-act-ing	overacting
pe-jor-a-tive	pe-jo-ra-tive
im-pro-v-is-a-to-ry	im-pro-vi-sa-to-ry
de-s-ir-a-bil-i-ty	de-sir-a-bil-i-ty
o-ver-load-ed	overloaded
un-bo-som	un-bos-om
de-sic-ca-tor	des-ic-ca-tor
per-ipa-tet-ic	per-i-pa-tet-ic
pri-son	pris-on
e-ma-ciat-ed	e-ma-ci-at-ed
pro-l-if-ic	pro-lif-ic
pes-simist	pes-si-mist
god-fath-er	god-fa-ther
im-port-ed	imported
stoi-cal-ly	sto-i-cal-ly
me-ri-di-on-al	me-rid-i-o-nal
tele-vised	televised
pho-toc-o-py	pho-to-cop-y
re-lat-iv-ism	rel-a-tiv-ism
in-er-ti-a	in-er-tia
in-ver-ter	in-vert-er
bu-r-y	bur-y
ko-o-ka-bur-ra	kook-a-bur-ra
u-n-u-s-a-ble	un-us-a-ble
clever-ly	clev-er-ly
startling	star-tling
host-age	hos-tage
melt-ed	melted
bey-ond	be-yond
ha-ber-dash-er-y	hab-er-dash-er-y
man-i-ac	ma-ni-ac
com-man-der	com-mand-er
sub-sis-tence	sub-sist-ence
re-ser-va-tion	res-er-va-tion
heavy-weight	heav-y-weight
bom-ber	bomb-er
re-sil-i-ence	re-sil-ience
de-v-al-ue	de-val-ue
fes-t-er	fes-ter
deu-te-r-i-um	deu-te-ri-um
ma-lo-do-r-ous	mal-o-dor-ous
braw-ny	brawn-y
ti-bi-a	tib-i-a
ar-mrest	arm-rest
liber-tar-i-an-ism	lib-er-tar-i-an-ism
bab-y-sit-ter	ba-by-sit-ter
pro-to-zoan	pro-to-zo-an
men-d-i-cant	men-di-cant
ru-ined	ruined
sob-er	so-ber
con-den-ser	con-dens-er
fi-nale	fi-na-le
do-pey	dope-y
sto-p-o-ver	stop-o-ver
ther-eu-pon	there-up-on
beati-fi-ca-tion	be-at-i-fi-ca-tion
cour-thouse	court-house
aud-i-ble	au-di-ble
re-con-ci-la-ble	rec-on-cil-a-ble
pream-ble	pre-am-ble
cros-so-ver	cross-o-ver
pol-y-car-bo-nate	pol-y-car-bon-ate
re-ga-l-i-a	re-ga-li-a
bi-or-hythm	bi-o-rhythm
se-rai	se-ra-i
rant-ing	ranting
mar-ke-teer	mar-ket-eer
ra-c-ism	rac-ism
seven	sev-en
te-le-ol-o-gy	tel-e-ol-o-gy
ton-gue	tongue
monkfish	monk-fish
ha-voc	hav-oc
hip-po-pota-mus	hip-po-pot-a-mus
phy-si-ol-o-gist	phys-i-ol-o-gist
dul-lard	dull-ard
ween-y	wee-ny
so-lace	sol-ace
im-pla-ca-ble	im-plac-a-ble
glos-sa-r-y	glos-sa-ry
is-suance	is-su-ance
mea-sure-ment	meas-ure-ment
gau-cher-ie	gau-che-rie
burg-la-r-y	bur-gla-ry
im-pro-per-ly	im-prop-er-ly
fluid-ly	flu-id-ly
doc-to-rate	doc-tor-ate
boo-kie	book-ie
ex-a-cer-bate	ex-ac-er-bate
ras-per	rasp-er
bread-fru-it	bread-fruit
moth-er-stobe	mo-ther-stobe
de-po-sit	de-pos-it
mis-chiev-ous-ly	mis-chie-vous-ly
grasshop-per	grass-hop-per
car-cino-gen-ic	car-cin-o-gen-ic
lady-bug	la-dy-bug
un-con-tro-ver-si-al	un-con-tro-ver-sial
ital-ic	i-tal-ic
mi-mick-er	mim-ick-er
promis-so-ry	prom-is-so-ry
un-ta-l-ent-ed	un-tal-ent-ed
ba-bes	babes
re-ad-er-ship	read-er-ship
ope-nhand-ed	o-pen-hand-ed
grou-pie	group-ie
spil-lage	spill-age
su-gar	sug-ar
el-e-ven	e-lev-en
o-ver-sampling	o-ver-sam-pling
un-der-priv-ileged	un-der-priv-i-leged
mu-ti-ne-er	mu-ti-neer
bril-li-ance	bril-liance
hol-i-ness	ho-li-ness
precess	pre-cess
buz-zer	buzz-er
stron-groom	strong-room
mo-nau-ral	mon-au-ral
ent-wine	en-twine
me-di-ev-al	me-di-e-val
de-vas-ta-tion	dev-as-ta-tion
u-n-i-on-ism	un-ion-ism
sec-to-r-al	sec-tor-al
ti-ta-n-i-um	ti-ta-ni-um
un-spec-if-ic	un-spe-cif-ic
dish-on-es-ty	dis-hon-es-ty
a-po-stol-ic	ap-os-tol-ic
dis-cip-li-nar-y	dis-ci-pli-nar-y
recess	re-cess
hun-t-er	hunt-er
cap-er	ca-per
e-phor	eph-or
con-for-m-ance	con-form-ance
go-vern-ment	gov-ern-ment
re-devel-op-ment	re-de-vel-op-ment
cas-ter	cast-er
reu-ni-fy	re-u-ni-fy
su-prem-a-c-ist	su-prem-a-cist
milk-shake	milkshake
va-gue	vague
de-for-mi-ty	de-form-i-ty
scrib-bling	scribbling
el-dest	eld-est
pre-dict-ed	predicted
kin-s-wo-m-an	kins-wom-an
pee-phole	peep-hole
lo-w-er-case	low-er-case
per-su-a-sive	per-sua-sive
un-re-a-son-a-ble	un-rea-son-a-ble
mar-i-na	ma-ri-na
pain-kill-er	pain-kil-ler
proffer	prof-fer
di-vot	div-ot
breast-feed	breastfeed
hiber-nal	hi-ber-nal
earth-quak-es	earth-quakes
fac-e-plate	face-plate
fif-t-y	fif-ty
tracer-y	trac-er-y
dis-til-ler-y	dis-till-er-y
steve-dore	ste-ve-dore
ty-pew-ri-ter	type-writ-er
hege-mon-ic	heg-e-mon-ic
re-versed	reversed
vig-nette	vi-gnette
chan-cy	chanc-y
eye-shadow	eye-shad-ow
dairy-ing	dair-y-ing
hor-mon-al	hor-mo-nal
es-tablish-ment	es-tab-lish-ment
groom-ing	grooming
bee-swax	bees-wax
wav-er	wa-ver
a-node	an-ode
ber-et	be-ret
dau-ph-in	dau-phin
pu-mice	pum-ice
se-tup	set-up
va-sec-to-my	vas-ec-to-my
res-troom	rest-room
vel-ve-ty	vel-vet-y
troubling	trou-bling
spind-ly	spin-dly
coy-ote	coy-o-te
car-afe	ca-rafe
char-cu-ter-ie	char-cu-te-rie
clan-de-stine	clan-des-tine
a-po-the-o-sis	a-poth-e-o-sis
dee-pen-ing	deepening
wander-ing	wan-der-ing
farth-ing	far-thing
vex-ing	vexing
co-lander	col-an-der
honest	hon-est
in-feas-i-ble	in-fea-si-ble
tel-l-ing-ly	tell-ing-ly
im-pre-sar-i-o	im-pre-sa-ri-o
a-symptote	as-ymp-tote
cre-dul-i-ty	cre-du-li-ty
far-myard	farm-yard
fra-tric-i-dal	frat-ri-cid-al
pain-t-er	paint-er
e-qui-li-bri-um	e-qui-lib-ri-um
di-ar-y	di-a-ry
po-l-ite-ness	po-lite-ness
me-temp-sy-ch-o-sis	me-tem-psy-cho-sis
hiber-nate	hi-ber-nate
in-tel-ligi-ble	in-tel-li-gi-ble
re-word-ings	re-word-ings
mes-seng-er	mes-sen-ger
sob-er-ing	sobering
ta-ber-na-cle	tab-er-nac-le
un-convinc-ing	un-con-vinc-ing
di-e-sel	die-sel
y-ore	yore
stoic	sto-ic
coin-cide	co-in-cide
fedo-ra	fe-do-ra
mar-aud-ing	ma-raud-ing
e-ver-last-ing	ev-er-last-ing
fum-bling	fumbling
car-ess	ca-ress
ci-vil-i-an	ci-vil-ian
a-vo-ca-do	av-o-ca-do
quadrat-ic	quad-rat-ic
be-v-y	bev-y
matins	mat-ins
he-roi-cal-ly	he-ro-i-cal-ly
phi-lo-so-ph-er	phi-los-o-pher
un-bothered	un-both-ered
sim-per-ing	simpering
renew-a-ble	re-new-a-ble
fla-gel-la-tion	flag-el-la-tion
rin-glet	ring-let
an-tag-o-n-ist	an-tag-o-nist
ir-re-sis-ti-ble	ir-re-sist-i-ble
corn-er	cor-ner
pag-a-n-ism	pa-gan-ism
mi-l-a-dy	mi-la-dy
tru-c-u-lent	truc-u-lent
chil-l-ing-ly	chill-ing-ly
par-i-e-tal	pa-ri-e-tal
hou-ser-oom	house-room
panth-er	pan-ther
ap-pli-c-a-bil-i-ty	ap-pli-ca-bil-i-ty
gen-i-al-i-ty	ge-ni-al-i-ty
meander-ing	me-an-der-ing
har-b-ing-er	har-bin-ger
trans-cend-ent	tran-scend-ent
un-hy-gien-ic	un-hy-gi-en-ic
tra-verse	trav-erse
fla-gon	flag-on
dow-sing	dows-ing
over-ac-tive	o-ver-ac-tive
guar-di-an-ship	guard-i-an-ship
il-me-nite	il-men-ite
a-p-er-y	ap-er-y
be-wild-er-ing	bewildering
flam-e-proof	flame-proof
whir-lig-ig	whirl-i-gig
cramm-ing	cram-ming
ru-na-way	run-a-way
em-broid-er	em-broi-der
ora-cle	or-a-cle
thum-bprint	thumb-print
transcend	tran-scend
doer	do-er
bo-som	bos-om
gar-de-n-er	gar-den-er
fa-thom	fath-om
ex-is-tence	ex-ist-ence
coun-ter-ba-lance	coun-ter-bal-ance
peas-an-try	peas-ant-ry
crick-eter	crick-et-er
voltage	volt-age
aphro-di-siac	aph-ro-dis-i-ac
sol-di-er-y	sol-dier-y
pro-sod-y	pros-o-dy
offer	of-fer
wheelw-right	wheel-wright
bo-ther-some	both-er-some
sou-thern-most	south-ern-most
peri-od	pe-ri-od
bu-si-ness-man	busi-ness-man
bo-he-mian	bo-he-mi-an
li-mou-sine	lim-ou-sine
pen-thouse	pent-house
embed	em-bed
hy-po-crite	hyp-o-crite
new-sy	news-y
for-est-ed	forested
pri-mar-i-ly	pri-ma-ri-ly
ciph-er	ci-pher
glut-to-n-ous	glut-ton-ous
chir-p-y	chirp-y
la-r-ynx	lar-ynx
au-tho-ress	au-thor-ess
sup-ple-men-tar-y	sup-ple-men-ta-ry
om-nipre-sence	om-ni-pres-ence
shoplifter	shop-lift-er
wag-er	wa-ger
stoic-ism	sto-i-cism
i-som-er	i-so-mer
bristling	bris-tling
ha-ber-dash-er	hab-er-dash-er
someth-ing	some-thing
mon-om-er	mon-o-mer
hon-o-rif-ic	hon-or-if-ic
re-fur-b-ish	re-fur-bish
gooey	goo-ey
sub-standard	sub-stand-ard
time-s-cale	time-scale
au-to-ma-ton	au-tom-a-ton
tempta-tion	temp-ta-tion
dyad	dy-ad
ling-er	lin-ger
sa-wy-er	saw-yer
ga-lax-y	gal-ax-y
rec-a-pit-u-late	re-ca-pit-u-late
na-v-al	na-val
in-com-par-a-bly	in-com-pa-ra-bly
create	cre-ate
po-l-it-ic	pol-i-tic
con-vict-ed	convicted
sa-lar-y	sal-a-ry
re-col-lect	rec-ol-lect
man-dar-in	man-da-rin
co-pra	cop-ra
im-pregnate	im-preg-nate
li-quor	liq-uor
in-e-ligi-ble	in-el-i-gi-ble
pro-ject-ing	projecting
dei-fy	de-i-fy
psal-mist	psalm-ist
ye-a	yea
hi-jack-ing	hi-jac-king
stu-pend-ous	stu-pen-dous
bri-de-groom	bride-groom
phon-o-graph	pho-no-graph
is-o-la-tion-ist	i-so-la-tion-ist
bol-stered	bolstered
cau-sa-tive	caus-a-tive
tur-f-y	turf-y
earwig	ear-wig
re-fur-b-ish-ment	re-fur-bish-ment
me-galo-ma-ni-a	meg-a-lo-ma-ni-a
sec-re-tive	se-cre-tive
in-trau-ter-ine	in-tra-u-ter-ine
so-me-one	some-one
pos-itiv-ist	pos-i-tiv-ist
em-bell-ish-ment	em-bel-lish-ment
re-al-ness	real-ness
def-ic-it	def-i-cit
con-duc-tance	con-duct-ance
e-ru-dite	er-u-dite
pig-st-y	pig-sty
re-staur-ant	res-tau-rant
a-r-ight	a-right
as-tir	a-stir
ser-aph-ic	se-raph-ic
cap-a-bil-i-ty	ca-pa-bil-i-ty
starling	star-ling
proo-f-read-er	proof-read-er
tre-spass	tres-pass
mois-t-en	mois-ten
se-cond-hand	sec-ond-hand
pream-pli-fi-er	pre-am-pli-fi-er
pup-pe-teer	pup-pet-eer
turn-t-a-ble	turn-ta-ble
re-sul-tant	re-sult-ant
e-vo-c-a-tive	e-voc-a-tive
rho-do-dend-ron	rho-do-den-dron
cath-e-dral	ca-the-dral
lazi-ness	la-zi-ness
ar-i-a	a-ri-a
a-waken	a-wak-en
un-wear-ied	un-wea-ried
prem-o-ni-tion	pre-mo-ni-tion
oa-sis	o-a-sis
guar-di-an	guard-i-an
starf-ish	star-fish
can-al	ca-nal
legged	leg-ged
caress-ing	ca-res-sing
ele-ment	el-e-ment
for-t-ress	for-tress
ty-pe-set-ter	type-set-ter
per-i	pe-ri
poul-t-ry	poul-try
em-i-rate	e-mir-ate
lin-e-up	line-up
pol-lard-ed	pollarded
re-per-toire	rep-er-toire
nor-th-ern	north-ern
boa	bo-a
shand-y	shan-dy
a-p-ril	a-pril
hat-ch-et	hatch-et
per-sis-t-ent-ly	per-sist-ent-ly
non-ex-is-tence	non-ex-ist-ence
tute-lar-y	tu-te-lar-y
om-nid-i-rec-tion-al	om-ni-di-rec-tion-al
hed-on-ism	he-don-ism
un-pro-v-en	un-prov-en
wear-i-ly	wea-ri-ly
sacris-ty	sac-ris-ty
epis-te-mol-o-gy	e-pis-te-mol-o-gy
cris-py	crisp-y
man-d-i-ble	man-di-ble
shell-f-ish	shell-fish
el-fin	elf-in
re-a-son	rea-son
mis-ty	mist-y
sewage	sew-age
bridal	brid-al
ham-p-er	ham-per
un-com-prom-is-ing	un-com-pro-mis-ing
nigh-t-ie	night-ie
gir-lish	girl-ish
fid-get	fidg-et
ob-scu-ran-tism	ob-scu-rant-ism
be-drock	bed-rock
pro-ph-e-tess	proph-et-ess
id-ly	i-dly
o-per-a	o-pe-ra
ma-ta-dor	mat-a-dor
hourg-lass	hour-glass
cudd-ly	cud-dly
pat-terned	patterned
re-joind-er	re-join-der
de-cade	dec-ade
re-quiem	req-ui-em
ex-per-i-men-ter	ex-per-i-ment-er
scrip-twrit-er	script-writ-er
play-w-right	play-wright
height-ened	heightened
wretched	wretch-ed
in-ex-or-a-ble	in-ex-o-ra-ble
dis-pen-sa-r-y	dis-pen-sa-ry
ge-o-me-ter	ge-om-e-ter
ve-l-o-cipede	ve-loc-i-pede
der-e-l-ict	der-e-lict
plau-s-i-bly	plau-si-bly
new-lywed	new-ly-wed
Words with errors: 1235
Words with incorrect number of syllables: 635
Total evluated: 6500
Perfect accuracy: 0.81
Number of syllables accuracy: 0.90
Average Levenshtein Distance(across incorrect words): 1.15
