Attempt	Real
son-ar	so-nar
cli-t-oral	clit-o-ral
be-devil	be-dev-il
rusty	rust-y
go-v-er-nance	gov-ern-ance
gus-ty	gust-y
stalac-tite	sta-lac-tite
un-chartered	un-char-tered
pre-late	prel-ate
wig-e-on	wig-eon
mis-er	mi-ser
de-r-e-lic-tion	der-e-lic-tion
bu-si-ness	busi-ness
bart-er	bar-ter
e-n-er-get-ic	en-er-get-ic
cudd-ly	cud-dly
cat-er	ca-ter
re-ser-va-tion	res-er-va-tion
con-duct-ed	conducted
ge-os-ta-tion-ar-y	ge-o-sta-tion-ar-y
martyred	mar-tyred
i-s-o-ton-ic	i-so-ton-ic
for-mid-a-ble	for-mi-da-ble
dis-com-fort-ing	discomforting
scam-per	scamp-er
tran-s-lu-cen-cy	trans-lu-cen-cy
tran-s-pi-ra-tion	tran-spi-ra-tion
is-o-la-tion-ist	i-so-la-tion-ist
squa-lor	squal-or
di-s-own	dis-own
hy-gien-ic	hy-gi-en-ic
in-ge-ni-ous	in-gen-ious
warthog	wart-hog
fuse-lage	fu-se-lage
cat-ac-lysm	cat-a-clysm
hol-i-ness	ho-li-ness
in-ex-pres-si-ble	in-ex-press-i-ble
sum-mar-y	sum-ma-ry
zool-o-gy	zo-ol-o-gy
rat-tles-nake	rat-tle-snake
sus-ten-ance	sus-te-nance
starter	start-er
ban-g-er	bang-er
in-e-b-ri-a-tion	in-e-bri-a-tion
di-vot	div-ot
granule	gran-ule
mas-que-rade	mas-quer-ade
dorm-er	dor-mer
bra-dawl	brad-awl
dy-nam-ism	dy-na-mism
down-load-ed	downloaded
e-lec-tro-phore-sis	e-lec-tro-pho-re-sis
chid-ing	chiding
high-n-ess	high-ness
col-lec-tiv-i-sa-tion	col-lec-ti-vi-sa-tion
rebury	re-bur-y
em-broid-er-y	em-broi-der-y
pep-pered	peppered
spid-er	spi-der
dis-may-ing	dismaying
e-s-pres-so	es-pres-so
coc-o-nut	co-co-nut
a-v-ar-ice	av-a-rice
un-i-on-ist	un-ion-ist
coe-v-al	co-e-val
li-tot-es	li-to-tes
bask-et	bas-ket
tap-er	ta-per
in-ter-min-a-ble	in-ter-mi-na-ble
teen-a-ger	teen-ag-er
pro-pell-er	pro-pel-ler
dim-in-ished	di-min-ished
pun-y	pu-ny
di-aphrag-mat-ic	di-a-phrag-mat-ic
der-iva-tive	de-riv-a-tive
naked	na-ked
un-glam-o-r-ous	un-glam-or-ous
mag-ne-sium	mag-ne-si-um
wafer	wa-fer
un-devel-oped	un-de-vel-oped
gal-e-na	ga-le-na
in-trav-e-nous-ly	in-tra-ve-nous-ly
cab-ar-et	cab-a-ret
tach-yon	tach-y-on
be-lon-g-ings	be-long-ings
hither-to	hith-er-to
sche-dule	sched-ule
hem-is-phere	hem-i-sphere
ir-rel-e-v-ance	ir-rel-e-vance
method	meth-od
click-ing	clicking
in-com-bust-i-ble	in-com-bus-ti-ble
la-vend-er	lav-en-der
ci-vil-i-an	ci-vil-ian
im-preg-n-a-ble	im-preg-na-ble
ig-no-r-ance	ig-no-rance
trink-et	trin-ket
brow-nie	brown-ie
rubbing	rub-bing
sin-ger	sing-er
gra-phol-o-gy	graph-ol-o-gy
dar-ter	dart-er
stupe-fy	stu-pe-fy
gun-pow-d-er	gun-pow-der
ex-per-i-men-ter	ex-per-i-ment-er
vented	vent-ed
pe-ri-he-lion	per-i-he-li-on
meg-as-tar	meg-a-star
dy-n-a-mite	dy-na-mite
in-ter-mar-ri-age	in-ter-mar-riage
beav-er	bea-ver
fore-sha-dow	fore-shad-ow
les-sen	less-en
un-scheduled	un-sched-uled
stable-mate	sta-ble-mate
co-p-ro-ces-sor	co-proc-es-sor
res-o-n-a-tor	res-o-na-tor
defa-ma-to-ry	de-fam-a-to-ry
roug-hage	rough-age
peri-as-tron	per-i-as-tron
de-ser-ti-fi-ca-tion	de-sert-i-fi-ca-tion
per-jury	per-ju-ry
cadence	ca-dence
ty-pe-w-rit-er	type-writ-er
proscribe	pro-scribe
mu-seum	mu-se-um
an-throp-o-gen-ic	an-thro-po-gen-ic
re-ap-prai-sal	re-ap-prais-al
bu-ry	bur-y
axle	ax-le
coex-ist	co-ex-ist
rum-m-y	rum-my
ped-an-try	ped-ant-ry
thereu-pon	there-up-on
fre-sco	fres-co
bu-re-au-crat	bu-reau-crat
or-bi-tal	or-bit-al
cramm-ing	cram-ming
larce-ny	lar-ce-ny
ban-k-rupt-cy	bank-rupt-cy
thunder	thun-der
face-tious	fa-ce-tious
le-prous	lep-rous
per-mit-ting	permitting
re-a-son	rea-son
co-pi-er	cop-i-er
go-r-y	gor-y
gi-go-lo	gig-o-lo
cham-pion-ship	cham-pi-on-ship
photo-chem-is-try	pho-to-chem-is-try
pewt-er	pew-ter
toaster	toast-er
cig-ar-ette	cig-a-rette
o-leand-er	o-le-an-der
om-ni-d-i-rec-tion-al	om-ni-di-rec-tion-al
new-s-read-er	news-read-er
kin-der-gart-en	kin-der-gar-ten
tran-s-late	trans-late
dunghill	dung-hill
distinct-ly	dis-tinct-ly
deafen-ing	deaf-en-ing
dim-in-u-en-do	di-min-u-en-do
scien-tist	sci-en-tist
pom-ade	po-made
o-r-a-to-ry	or-a-to-ry
wind-sur-f-er	wind-surf-er
par-a-bo-la	pa-rab-o-la
gas-troin-tes-ti-nal	gas-tro-in-tes-ti-nal
li-fes-tyle	life-style
ex-tram-u-ral	ex-tra-mu-ral
nov-e-list	nov-el-ist
ow-n-er-ship	own-er-ship
cha-mo-mi-le	cham-o-mile
platy-pus	plat-y-pus
rive-rine	riv-er-ine
pro-per-ty	prop-er-ty
se-ro-to-nin	ser-o-to-nin
har-bing-er	har-bin-ger
drunkard	drunk-ard
spec-troph-o-tom-e-ter	spec-tro-pho-tom-e-ter
hi-jack-ing	hi-jac-king
in-sis-tent	in-sist-ent
siren	si-ren
res-pi-r-a-tor	res-pi-ra-tor
de-fend-ing	defending
snork-el	snor-kel
wheelie	wheel-ie
pat-ri-line-al	pat-ri-lin-e-al
waistline	waist-line
fel-lowship	fel-low-ship
in-er-ad-i-ca-ble	in-e-rad-i-ca-ble
en-fee-bled	enfeebled
wherev-er	wher-ev-er
se-c-re-tive	se-cre-tive
her-al-d-ic	he-ral-dic
riv-al-ry	ri-val-ry
pothole	pot-hole
killing	kill-ing
de-con-struc-tive	deconstructive
ev-er-y-one	eve-ry-one
clim-ber	climb-er
i-ron-mong-er	i-ron-mon-ger
syn-o-n-ym	syn-o-nym
i-s-o-met-ric	i-so-met-ric
in-scrut-a-ble	in-scru-ta-ble
pro-fit-a-bly	prof-it-a-bly
stupid-ly	stu-pid-ly
fev-er-ish-ly	fe-ver-ish-ly
un-char-it-a-ble	un-char-i-ta-ble
grav-e-dig-ger	grave-dig-ger
pet-er	pe-ter
crav-en	cra-ven
cate-gor-i-cal-ly	cat-e-gor-i-cal-ly
going	go-ing
laund-ry	laun-dry
tint-ed	tinted
ir-re-pres-si-ble	ir-re-press-i-ble
lo-goff	log-off
va-len-tine	val-en-tine
de-brief-ing	debriefing
trous-ers	trou-sers
photo-sphere	pho-to-sphere
ma-cro-e-co-nom-ic	mac-ro-ec-o-nom-ic
youngish	young-ish
hos-t-el	hos-tel
in-fan-t-ry	in-fan-try
lec-t-ern	lec-tern
ref-i-nance	re-fi-nance
psyche	psy-che
spin-al	spi-nal
hip-po-po-ta-mus	hip-po-pot-a-mus
gem-s-bok	gems-bok
wreck-ing	wrecking
ob-stin-a-cy	ob-sti-na-cy
sa-l-ient	sa-li-ent
tur-nout	turn-out
bab-y-sit-ting	babysitting
pi-et-y	pi-e-ty
nin-e-teenth	nine-teenth
in-distinct	in-dis-tinct
ap-os-trophe	a-pos-tro-phe
plunder	plun-der
toas-ty	toast-y
in-te-r-im	in-ter-im
scholar	schol-ar
co-l-on-el	colo-nel
ti-mes-cale	time-scale
malo-dor-ous	mal-o-dor-ous
ri-ot-ing	ri-o-ting
fa-cet	fac-et
in-ho-m-o-ge-ne-ous	in-ho-mo-ge-ne-ous
reg-e-late	re-ge-late
re-ar	rear
hed-on-ist	he-don-ist
leg-al-ism	le-gal-ism
bows-prit	bow-sprit
cos-tar	co-star
ta-b-let	tab-let
mel-liflu-ous	mel-lif-lu-ous
shelt-er	shel-ter
can-d-y	can-dy
un-restrict-ed	un-re-strict-ed
gla-mour	glam-our
pen-et-ra-ble	pen-e-tra-ble
re-gal-i-a	re-ga-li-a
blush-ing	blushing
de-co	dec-o
brav-a-do	bra-va-do
pro-ject-ed	projected
e-q-ua-nim-i-ty	e-qua-nim-i-ty
mas-er	ma-ser
pro-ced-ur-al-ly	pro-ce-dur-al-ly
han-drail	hand-rail
heroine	her-o-ine
caress	ca-ress
i-mag-i-na-tion	im-ag-i-na-tion
dripping	drip-ping
ov-i-duct	o-vi-duct
pan-creas	pan-cre-as
gar-age	ga-rage
crad-ling	cra-dling
tel-epa-thy	te-lep-a-thy
an-te-n-a-tal	an-te-na-tal
solid	sol-id
cam-pa-nile	cam-pa-ni-le
hal-lel-u-jah	hal-le-lu-jah
pho-tos-tat	pho-to-stat
stam-mering	stammering
repli-ca-ble	rep-li-ca-ble
coex-istent	co-ex-ist-ent
me-te-o-rol-o-gy	me-te-or-ol-o-gy
mar-i-o-n-ette	mar-i-on-ette
o-ver-load-ed	overloaded
pro-fit	prof-it
a-vens	av-ens
re-in-deer	rein-deer
re-ad-a-bil-i-ty	read-a-bil-i-ty
ep-ig-e-net-ic	ep-i-ge-net-ic
nephew	neph-ew
spec-ta-c-les	spec-ta-cles
el-ic-it	e-lic-it
fur-rowed	furrowed
fig-ura-tive-ly	fig-ur-a-tive-ly
row-d-y	row-dy
tiger-ish	ti-ger-ish
ga-mut	gam-ut
mech-an-ist	mech-a-nist
re-furb-ish	re-fur-bish
un-talent-ed	un-tal-ent-ed
in-ex-trica-bly	in-ex-tri-ca-bly
bot-tled	bottled
dec-or-ous	dec-o-rous
i-n-oc-u-la-tion	in-oc-u-la-tion
con-scien-tious	con-sci-en-tious
ket-chup	ketch-up
pi-er	pier
per-sev-er-ance	per-se-ver-ance
cur-va-ce-ous	cur-va-ceous
bludgeon	bludg-eon
gen-uine	gen-u-ine
res-tor-a-tive	re-stor-a-tive
so-lemn	sol-emn
de-line-ate	de-lin-e-ate
brok-er-age	bro-ker-age
di-agon-al-ly	di-ag-o-nal-ly
mat-ri-line-al	mat-ri-lin-e-al
in-ex-or-a-ble	in-ex-o-ra-ble
hib-is-cus	hi-bis-cus
cachet	ca-chet
cet-a-cean	ce-ta-cean
breast-feed-ing	breastfeeding
so-b-er	so-ber
dram-at-ist	dram-a-tist
herring	her-ring
bu-si-ness-wom-an	busi-ness-wom-an
prop-o-nent	pro-po-nent
chee-ri-o	cheer-i-o
re-strain-ing	restraining
de-li	del-i
spi-cy	spic-y
o-ver-crowd-ed	o-ver-crow-ded
lar-ynxes	la-rynx-es
im-port-ed	imported
del-iq-ues-cent	del-i-ques-cent
re-stive	res-tive
pi-rou-ette	pir-ou-ette
sun-tanned	suntanned
eastern-most	east-ern-most
swam-pland	swamp-land
an-teroom	an-te-room
ho-ver-craft	hov-er-craft
knowledge	knowl-edge
par-li-a-m-en-tar-y	par-lia-men-ta-ry
pro-gressed	progressed
seabed	sea-bed
nor-thern	north-ern
bu-si-ly	bus-i-ly
e-co-n-o-met-rics	e-con-o-met-rics
ap-o-ca-lypse	a-poc-a-lypse
ge-r-on-toc-ra-cy	ger-on-toc-ra-cy
post-mod-er-nist	post-mod-ern-ist
cos-set-ed	cosseted
bur-g-lar	bur-glar
molester	mo-lest-er
beyond	be-yond
whipping	whip-ping
ed-gy	edg-y
news-worthy	news-wor-thy
paper-work	pa-per-work
le-gend	leg-end
eav-es-drop	eaves-drop
ge-op-o-lit-i-cal	ge-o-po-lit-i-cal
tele-kine-sis	tel-e-ki-ne-sis
un-bothered	un-both-ered
hom-o-phobic	ho-mo-pho-bic
ran-gy	rang-y
pro-create	pro-cre-ate
spil-lage	spill-age
be-r-eft	be-reft
sa-pient	sa-pi-ent
rata-touille	ra-ta-touille
ap-prai-sal	ap-prais-al
rav-e-nous	rav-en-ous
re-con-cile	rec-on-cile
im-ba-l-ance	im-bal-ance
asymp-tote	as-ymp-tote
as-pir-in	as-pi-rin
dis-play-a-ble	displayable
si-m-ul-ta-ne-ous-ly	si-mul-ta-ne-ous-ly
mis-chiev-ous	mis-chie-vous
un-in-hab-i-t-a-ble	un-in-hab-it-a-ble
doc-to-r-al	doc-tor-al
pa-pule	pap-ule
me-lan-cho-li-a	mel-an-cho-li-a
bunk-er	bun-ker
temp-tress	tempt-ress
chry-salis	chrys-a-lis
con-cussed	concussed
ma-n-i-a	ma-ni-a
proce-dure	pro-ce-dure
min-ute	mi-nute
co-py	cop-y
char-wo-m-an	char-wom-an
mut-ter-ing	muttering
cros-sov-er	cross-o-ver
fore-ver	for-ev-er
in-fir-mar-y	in-fir-ma-ry
bask-et-ry	bas-ket-ry
in-tel-ligi-bil-i-ty	in-tel-li-gi-bil-i-ty
com-par-a-ble	com-pa-ra-ble
lateco-mer	late-com-er
blaspheme	blas-pheme
sale-sper-son	sales-per-son
si-li-co-sis	sil-i-co-sis
flab-ber-gast-ed	flabbergasted
vo-lume	vol-ume
ecstasy	ec-sta-sy
stin-gray	sting-ray
nutmeg	nut-meg
ju-n-ior	jun-ior
gi-an-tism	gi-ant-ism
can-ar-y	ca-nar-y
deafen	deaf-en
e-sprit	es-prit
ber-et	be-ret
pre-ser-va-tion	pres-er-va-tion
ge-nom-ic	ge-no-mic
cris-is	cri-sis
suf-fragist	suf-fra-gist
cursed	curs-ed
mo-r-on	mo-ron
un-ack-nowledged	un-ac-knowl-edged
pu-mice	pum-ice
post-mo-der-nism	post-mod-ern-ism
her-bal	herb-al
sur-real-ist	sur-re-al-ist
re-ach	reach
fi-nale	fi-na-le
stra-teg-ic	stra-te-gic
fluid-ly	flu-id-ly
re-ci-pi-ent	re-cip-i-ent
min-der	mind-er
de-cay-ing	decaying
leg-i-s-late	leg-is-late
re-a-son-a-bly	rea-son-a-bly
un-furnished	un-fur-nished
full-ing	fulling
stoic-ism	sto-i-cism
an-nihi-late	an-ni-hi-late
earn-est-ly	ear-nest-ly
pag-o-da	pa-go-da
ap-par-a-tus	ap-pa-rat-us
o-range	or-ange
stolid	stol-id
is-os-tat-ic	i-so-stat-ic
u-p-roar	up-roar
speech-i-fy-ing	speechifying
non-ethe-less	none-the-less
sat-ir-ist	sat-i-rist
eye-sha-dow	eye-shad-ow
doing	do-ing
as-lant	a-slant
sa-d-o-ma-so-chis-tic	sa-do-mas-o-chis-tic
com-pli-men-tar-y	com-pli-men-ta-ry
va-let	val-et
wel-com-ing	wel-co-ming
di-ploid	dip-loid
be-fud-dled	befuddled
tuxe-do	tux-e-do
per-meate	per-me-ate
su-bur-bi-a	sub-ur-bi-a
im-per-so-n-a-tor	im-per-son-a-tor
li-zard	liz-ard
o-th-er-wise	oth-er-wise
re-fo-res-ta-tion	re-for-est-a-tion
com-pa-ni-on-a-ble	com-pan-ion-a-ble
vis-ion	vi-sion
com-ple-m-en-ta-r-y	com-ple-men-ta-ry
courte-sy	cour-te-sy
milk-shake	milkshake
mel-od-ra-ma	mel-o-dra-ma
tele-o-log-i-cal	tel-e-o-log-i-cal
lac-teal	lac-te-al
stron-groom	strong-room
ditch-ing	ditching
drap-er-y	dra-per-y
thous-and	thou-sand
claus-tro-phob-ic	claus-tro-pho-bic
twil-it	twi-lit
com-bus-t-i-ble	com-bus-ti-ble
bour-ge-o-i-sie	bour-geoi-sie
palimp-sest	pal-imp-sest
o-ver-e-at	o-ver-eat
stomach	stom-ach
hau-lage	haul-age
shoulder	shoul-der
clov-en	clo-ven
bishop-ric	bish-op-ric
prim-o-gen-i-ture	pri-mo-gen-i-ture
ven-ge-ful	venge-ful
ra-di-on-u-clide	ra-di-o-nu-clide
re-c-y-cle	re-cy-cle
weathered	weath-ered
mil-lin-er-y	mil-li-ner-y
con-nect-ing	con-nec-ting
tas-ty	tast-y
promp-ter	prompt-er
toothy	tooth-y
hor-se-hair	horse-hair
gal-ore	ga-lore
cus-to-mer	cus-tom-er
esteemed	e-steemed
o-live	ol-ive
brack-et-ed	bracketed
mincing	minc-ing
ex-pi-r-a-to-ry	ex-pir-a-to-ry
tsun-a-mi	tsu-na-mi
bar-o-net	bar-on-et
de-bo-nair	deb-o-nair
profi-t-a-bil-i-ty	prof-it-a-bil-i-ty
pro-pri-et-y	pro-pri-e-ty
bar-bit-u-rate	bar-bi-tu-rate
dis-son-ance	dis-so-nance
apoth-e-car-y	a-poth-e-car-y
hier-o-glyph	hi-er-o-glyph
cre-vice	crev-ice
un-plea-sant-ness	un-pleas-ant-ness
clank-ing	clan-king
ki-l-o-hertz	kil-o-hertz
trilby	tril-by
cru-elty	cru-el-ty
dem-o-nol-o-gy	de-mon-ol-o-gy
o-om-pah	oom-pah
phra-sal	phras-al
par-li-a-men-tar-i-an	par-lia-men-tar-i-an
dis-tri-bute	dis-trib-ute
coursing	cours-ing
tribute	trib-ute
mar-ri-age-a-ble	mar-riage-a-ble
dearie	dear-ie
ca-me-o	cam-e-o
stom-a-chache	stom-ach-ache
mea-sure	meas-ure
as-s-ist	as-sist
con-vict-ed	convicted
hav-en	ha-ven
draf-t-y	draft-y
com-pact-ed	compacted
di-s-ease	dis-ease
dis-til-ler-y	dis-till-er-y
chap-e-r-one	chap-er-one
prowess	prow-ess
cam-ouf-lage	cam-ou-flage
cas-i-no	ca-si-no
cat-er-er	ca-ter-er
lef-t-y	left-y
blank-et	blan-ket
holl-er	hol-ler
mi-dair	mid-air
im-pri-soned	im-pris-oned
si-len-cer	si-lenc-er
dyad	dy-ad
plu-my	plum-y
fid-d-ly	fid-dly
un-an-i-mous-ly	u-nan-i-mous-ly
rho-do-dendron	rho-do-den-dron
steep-le-chase	stee-ple-chase
vi-z-i-er	vi-zier
ther-mos-tat	ther-mo-stat
quies-cent	qui-es-cent
bu-si-nes-slike	busi-ness-like
mo-m-en-tar-i-ly	mo-men-tar-i-ly
co-met	com-et
genie	ge-nie
bull-do-zer	bull-doz-er
u-nu-s-u-al	un-u-su-al
im-ag-in-a-ble	im-ag-i-na-ble
dura-ble	du-ra-ble
chaot-ic	cha-ot-ic
met-a-l-an-guage	met-a-lan-guage
dumpling	dump-ling
thrilling	thrill-ing
lisping	lis-ping
co-d-ex	co-dex
pheasant	pheas-ant
em-bas-s-y	em-bas-sy
u-nim-ag-in-a-ble	un-im-ag-i-na-ble
wid-o-whood	wid-ow-hood
re-port-ed	reported
scan-da-lous	scan-dal-ous
bar-o-ness	bar-on-ess
cine	cin-e
gym-na-sium	gym-na-si-um
tran-sves-tite	trans-ves-tite
goer	go-er
splen-d-id-ly	splen-did-ly
ka-raoke	kar-a-o-ke
con-troll-er	con-trol-ler
the-or-ist	the-o-rist
vag-ue	vague
can-ard	ca-nard
re-rout-es	re-routes
host-age	hos-tage
sup-por-tive	sup-port-ive
jeer-ing	jeering
place-bo	pla-ce-bo
theist	the-ist
up-lift-ed	uplifted
id-yll	i-dyll
toughie	tough-ie
tincture	tinc-ture
pedes-tal	ped-es-tal
men-swear	mens-wear
im-po-lit-ic	im-pol-i-tic
an-throp-ic	an-thro-pic
sneer-ing	sneering
ined-i-ble	in-ed-i-ble
u-nim-a-gin-a-bly	un-im-ag-i-na-bly
hib-er-na-tion	hi-ber-na-tion
as-tray	a-stray
en-gi-n-eer	en-gi-neer
sov-ere-ign	sov-er-eign
jer-k-in	jer-kin
re-adapt	re-a-dapt
chos-en	cho-sen
ex-is-tent	ex-ist-ent
un-in-tel-lig-i-ble	un-in-tel-li-gi-ble
blos-som-ing	blossoming
ob-scu-ran-t-ism	ob-scu-rant-ism
di-agon-al	di-ag-o-nal
aq-ual-ung	aq-ua-lung
ha-cien-da	ha-ci-en-da
roas-ter	roast-er
sub-sis-tence	sub-sist-ence
how-it-zer	how-itz-er
vo-l-un-tar-y	vol-un-tar-y
en-riched	enriched
com-men-t-er	com-ment-er
cas-u-istry	cas-u-ist-ry
module	mod-ule
mis-nom-er	mis-no-mer
re-pen-t-ant	re-pent-ant
ge-o-m-ag-net-i-cal-ly	ge-o-mag-ne-ti-cal-ly
ex-tral-in-guis-tic	ex-tra-lin-guis-tic
cere-mo-ni-al	cer-e-mo-ni-al
nec-ro-sis	ne-cro-sis
un-sel-l-a-ble	un-sell-a-ble
mon-e-tar-ism	mon-e-ta-rism
pa-lace	pal-ace
leak-ing	leaking
easy-going	eas-y-go-ing
fruit-ing	fruiting
em-bit-tered	embittered
tok-a-mak	to-ka-mak
feas-i-bil-i-ty	fea-si-bil-i-ty
ob-stet-ri-cian	ob-ste-tri-cian
mi-l-i-eu	mi-lieu
tes-timo-ny	tes-ti-mo-ny
li-q-uor	liq-uor
te-lex	tel-ex
cheroot	che-root
per-use	pe-ruse
fer-rom-ag-net-ic	fer-ro-mag-net-ic
pout-ing	pouting
is-o-lat-ing	i-so-lat-ing
dow-d-y	dow-dy
ante	an-te
lym-ph-o-cyte	lym-pho-cyte
pro-ject	proj-ect
pi-q-uan-cy	pi-quan-cy
is-o-la-tion	i-so-la-tion
sheriff	sher-iff
cu-nei-form	cu-ne-i-form
a-rum	ar-um
cron-y	cro-ny
gir-lish	girl-ish
phy-l-og-e-net-ic	phy-lo-ge-net-ic
em-o-tive	e-mo-tive
hereund-er	here-un-der
stamen	sta-men
e-quer-ry	eq-uer-ry
fore-going	fore-go-ing
psychic	psy-chic
ty-pes-cript	type-script
an-tagon-ism	an-tag-o-nism
in-ter-lock-ing	in-ter-loc-king
un-sys-te-mat-ic	un-sys-tem-at-ic
dep-o-nent	de-po-nent
fort-y	for-ty
phys-ique	phy-sique
meadow	mead-ow
hor-i-zon	ho-ri-zon
skys-crap-er	sky-scrap-er
bril-li-ance	bril-liance
co-di-fi-ca-tion	cod-i-fi-ca-tion
whodunit	who-dun-it
di-a-bet-es	di-a-be-tes
ob-lique	o-blique
in-cre-dul-i-ty	in-cre-du-li-ty
pom-pous	pomp-ous
im-per-so-nate	im-per-son-ate
en-crust-ed	encrusted
lay-ering	lay-er-ing
ex-plo-ra-to-ry	ex-plor-a-to-ry
sem-i-con-ducting	sem-i-con-duct-ing
ep-is-tem-o-log-i-cal	e-pis-te-mo-log-i-cal
com-mu-nion	com-mun-ion
cui-r-ass	cui-rass
in-dig-e-n-ous	in-dig-e-nous
ey-e-piece	eye-piece
snows-torm	snow-storm
mat-er	ma-ter
cate-chist	cat-e-chist
con-stitu-en-cy	con-stit-u-en-cy
hom-o-sex-u-al-i-ty	ho-mo-sex-u-al-i-ty
rost-er	ros-ter
stif-fen	stiff-en
ir-rel-e-v-ant	ir-rel-e-vant
smirk-ing	smirking
ar-chan-gel	arch-an-gel
do-zen	doz-en
bab-y-ish	ba-by-ish
glut-to-ny	glut-ton-y
ma-tri-arch-y	ma-tri-ar-chy
de-vot-ee	dev-o-tee
trip-od	tri-pod
dis-cotheque	dis-co-theque
pan-ties	pant-ies
groc-er-y	gro-cer-y
quisling	quis-ling
lus-ty	lust-y
in-vol-ve-ment	in-volve-ment
ma-tins	mat-ins
startling	star-tling
wa-terbed	wa-ter-bed
au-tho-ress	au-thor-ess
homes-tead	home-stead
cre-nel-la-tions	cren-el-la-tions
con-vect-ed	convected
boun-dar-y	bound-a-ry
ma-nus-cript	man-u-script
un-der-rat-ed	underrated
melod-ra-mat-ic	mel-o-dra-mat-ic
be-r-yl-li-um	be-ryl-li-um
li-ve-li-hood	live-li-hood
in-im-i-t-a-ble	in-im-i-ta-ble
cam-per	camp-er
preamp	pre-amp
ska-t-er	skat-er
chroni-cler	chron-i-cler
dis-o-ri-en-tat-ed	disorientated
hard-y	har-dy
lo-vel-i-ness	love-li-ness
in-choate	in-cho-ate
chrom-a-tog-ra-phy	chro-ma-tog-ra-phy
sus-pend-ed	sus-pen-ded
ir-re-voc-a-bly	ir-rev-o-ca-bly
throug-hout	through-out
in-es-tim-a-ble	in-es-ti-ma-ble
pad-ded	padded
sul-ta-na	sul-tan-a
en-a-bled	e-na-bled
goatee	goat-ee
un-ac-com-pa-n-ied	un-ac-com-pa-nied
what-e-ver	what-ev-er
ranch-ing	ranching
re-spite	res-pite
em-bossed	embossed
panache	pa-nache
mis-aligned	mis-a-ligned
mot-i-vate	mo-ti-vate
pur-suance	pur-su-ance
cas-k-et	cas-ket
duik-er	dui-ker
re-tiree	re-tir-ee
clam-o-rous	clam-or-ous
ron-da-v-el	ron-da-vel
rac-e-track	race-track
un-ob-ser-vant	un-ob-serv-ant
loess	lo-ess
sav-ag-er-y	sav-age-ry
cate-go-ry	cat-e-go-ry
pre-face	pref-ace
hero	he-ro
steplad-der	step-lad-der
gud-geon	gudg-eon
chug-g-ing	chug-ging
has-t-en	has-ten
strat-ig-ra-phy	stra-tig-ra-phy
brazen	bra-zen
swimming-ly	swim-ming-ly
a-r-om-a-tic-i-ty	ar-o-ma-tic-i-ty
din-o-saur	di-no-saur
don-or	do-nor
bon-o-bo	bo-no-bo
un-molest-ed	un-mo-lest-ed
twil-ight	twi-light
un-for-gett-a-ble	un-for-get-ta-ble
kam-i-kaze	ka-mi-ka-ze
prol-ong	pro-long
vid-e-o-taped	videotaped
a-o-r-ist	a-o-rist
rivet-ing	riv-et-ing
scur-ri-lous	scur-ril-ous
lau-da-to-ry	laud-a-to-ry
pro-tect-ed	protected
in-teg-ra-tive	in-te-gra-tive
ye-ti	yet-i
ile-um	il-e-um
hor-monal	hor-mo-nal
han-gov-er	hang-o-ver
newlywed	new-ly-wed
seven-fold	sev-en-fold
forer-un-ner	fore-run-ner
tran-sac-tion-al	trans-ac-tion-al
reson-ance	res-o-nance
ob-durate	ob-du-rate
epilogue	ep-i-logue
cas-toff	cast-off
must-ang	mus-tang
por-thole	port-hole
un-processed	un-proc-essed
busk-ing	busking
theoso-phy	the-os-o-phy
un-com-prom-is-ing	un-com-pro-mis-ing
me-l-an-chol-ic	mel-an-chol-ic
da-mask	dam-ask
mer-i-no	me-ri-no
rep-ro-gram	re-pro-gram
se-ni-or	sen-ior
psalter	psal-ter
ra-pier	ra-pi-er
u-n-id-i-rec-tion-al	u-ni-di-rec-tion-al
re-la-tiv-ism	rel-a-tiv-ism
kin-swom-an	kins-wom-an
pe-ri-neum	per-i-ne-um
tute-lage	tu-te-lage
theat-ri-cal-ly	the-at-ri-cal-ly
glit-zy	glitz-y
in-sis-tence	in-sist-ence
cre-dit-wor-thi-ness	cred-it-wor-thi-ness
bar-bar-ism	bar-ba-rism
non-chal-ant-ly	non-cha-lant-ly
per-fi-d-y	per-fi-dy
re-in-vig-o-rate	re-in-vig-or-ate
craz-i-ly	cra-zi-ly
citys-cape	cit-y-scape
ox-alate	ox-a-late
net-work-ing	networking
re-tro-ac-tive-ly	ret-ro-ac-tive-ly
gathering	gath-er-ing
char-i-o-teer	char-i-ot-eer
dis-mem-bered	dismembered
re-q-ui-s-ite	req-ui-site
fir-k-in	fir-kin
me-di-ev-al	me-di-e-val
gal-leon	gal-le-on
def-en-es-trate	de-fen-es-trate
dynas-ty	dy-nas-ty
pur-suant	pur-su-ant
ri-s-ot-to	ri-sot-to
pries-tess	priest-ess
where-soev-er	where-so-ev-er
desir-a-ble	de-sir-a-ble
un-decid-a-ble	un-de-cid-a-ble
be-wild-ered	bewildered
con-que-r-or	con-quer-or
sof-tie	soft-ie
han-d-i-work	hand-i-work
aun-tie	aunt-ie
ob-lige	o-blige
sai-lor	sail-or
dem-er-it	de-mer-it
obe-lisk	ob-e-lisk
o-ver-pow-ering	o-ver-pow-er-ing
coax-ial	co-ax-i-al
ham-mering	ham-mer-ing
ke-s-trel	kes-trel
prem-i-ses	prem-is-es
flick-er-ing	flickering
pro-sec-u-to-ri-al	pros-e-cu-to-ri-al
snig-ger-ing	sniggering
con-scien-tious-ness	con-sci-en-tious-ness
ap-o-stol-ic	ap-os-tol-ic
zeal-o-try	zeal-ot-ry
re-m-iss	re-miss
sopping	sop-ping
ar-tis-try	art-ist-ry
tur-nov-er	turn-o-ver
un-coordi-nat-ed	un-co-or-di-nat-ed
coloured	co-loured
ov-er-anx-ious	o-ver-anx-ious
ex-ul-tant	ex-ult-ant
ver-is-i-mil-i-tude	ver-i-si-mil-i-tude
co-r-on-er	cor-o-ner
re-stroom	rest-room
tre-atise	trea-tise
bar-rac-u-da	bar-ra-cu-da
cris-ply	crisp-ly
rain-fo-rest	rain-for-est
ic-i-cle	i-ci-cle
mi-n-i	min-i
theod-o-lite	the-od-o-lite
me-n-arche	men-ar-che
tapping	tap-ping
bin-der-y	bind-er-y
su-prem-acist	su-prem-a-cist
scrib-bling	scribbling
clov-er	clo-ver
dro-plet	drop-let
ten-an-try	ten-ant-ry
xerog-ra-phy	xe-rog-ra-phy
hy-dro-phob-ic	hy-dro-pho-bic
wrink-ly	wrin-kly
purser	purs-er
ester	es-ter
col-ogne	co-logne
pa-tri-mo-ny	pat-ri-mo-ny
teet-er	tee-ter
feathering	feath-er-ing
ob-lig-ing-ly	o-blig-ing-ly
ba-s-il	bas-il
sturd-y	stur-dy
drubbing	drub-bing
gau-ch-erie	gau-che-rie
fath-er-less	fa-ther-less
cau-sal	caus-al
front-ed	fronted
hos-t-ess	host-ess
in-au-gu-r-al	in-au-gu-ral
bog-ey-man	bo-gey-man
lit-to-r-al	lit-to-ral
easting	east-ing
may-o-ral-ty	may-or-al-ty
par-ent-ing	parenting
may-oral	may-or-al
ne-crop-sy	nec-rop-sy
pol-y-ure-thane	pol-y-u-re-thane
voy-eu-ris-tic	voy-eur-is-tic
cat-a-l-ep-sy	cat-a-lep-sy
e-n-er-get-i-cal-ly	en-er-get-i-cal-ly
dar-k-room	dark-room
halo	ha-lo
fet-i-shis-tic	fet-ish-is-tic
rhinoc-eros	rhi-noc-er-os
tract-a-ble	trac-ta-ble
bo-dy-guard	bod-y-guard
meg-al-o-ma-ni-a	meg-a-lo-ma-ni-a
revue	re-vue
ti-mel-i-ness	time-li-ness
pi-ty	pit-y
ex-pec-tant-ly	ex-pect-ant-ly
cap-er	ca-per
re-cord-ed	re-cor-ded
id-e-o-log-i-cal	i-de-o-log-i-cal
smel-ly	smell-y
cloister	clois-ter
pre-m-a-ture	pre-ma-ture
com-ber	comb-er
gas-tropod	gas-tro-pod
bet-ro-thal	be-troth-al
are-na	a-re-na
prov-id-er	pro-vid-er
fo-re-arm	fore-arm
bord-er	bor-der
sur-rend-er	sur-ren-der
dau-ber	daub-er
pleb-is-cite	pleb-i-scite
ban-tering	bantering
gaze-bo	ga-ze-bo
ta-bles-poon	ta-ble-spoon
booster	boost-er
com-man-der	com-mand-er
hair-spray	hairspray
re-a-son-a-ble-ness	rea-son-a-ble-ness
un-buried	un-bur-ied
sa-les-girl	sales-girl
bee-feat-er	beef-eat-er
de-caf-fei-nate	de-caf-fein-ate
im-pri-son	im-pris-on
theis-tic	the-is-tic
sob-ri-et-y	so-bri-e-ty
flin-t-y	flint-y
leg-a-tor	le-ga-tor
bi-noc-u-lars	bin-oc-u-lars
tax-ono-my	tax-on-o-my
in-cor-rig-i-ble	in-cor-ri-gi-ble
sub-mer-si-ble	sub-mers-i-ble
eas-ter-ly	east-er-ly
rhe-tor-ic	rhet-o-ric
kosh-er	ko-sher
ven-geance	venge-ance
gent-ly	gen-tly
eb-o-ny	eb-on-y
feathered	feath-ered
for-gett-a-ble	for-get-ta-ble
dul-cim-er	dul-ci-mer
di-s-o-ri-en-ta-tion	dis-o-ri-en-ta-tion
an-tac-id	ant-ac-id
re-for-ma-tion	ref-or-ma-tion
us-ur-per	u-surp-er
dis-gust-ed	disgusted
col-lab-ora-tive	col-lab-o-ra-tive
tim-e-t-a-ble	time-ta-ble
steep-le-jack	stee-ple-jack
de-cile	dec-ile
bo-dy-build-ing	bod-y-build-ing
pros-t-a-glan-din	pros-ta-glan-din
some-w-hat	some-what
vil-la-g-er	vil-lag-er
u-te-rine	u-ter-ine
thread-ed	threaded
mole-cule	mol-e-cule
mar-gi-nal	mar-gin-al
pes-sim-ist	pes-si-mist
hom-o-mor-phism	ho-mo-mor-phism
mot-el	mo-tel
whoev-er	who-ev-er
con-serv-a-toire	con-ser-va-toire
pot-a-ble	po-ta-ble
di-a-th-er-my	di-a-ther-my
pur-suer	pur-su-er
pro-tagon-ist	pro-tag-o-nist
priv-a-cy	pri-va-cy
pre-sen-ta-tion	pres-en-ta-tion
sie-s-ta	si-es-ta
tran-sact	trans-act
dan-de-lion	dan-de-li-on
leng-thy	length-y
a-tonal	a-ton-al
un-pal-ata-ble	un-pal-at-a-ble
smelt-ing	smelting
poin-t-y	point-y
wall-a-by	wal-la-by
com-plet-e-ness	com-plete-ness
ex-acting	ex-act-ing
metho-do-log-i-cal	meth-od-o-log-i-cal
o-pin-i-on-at-ed	o-pin-ion-at-ed
gy-ro-m-ag-net-ic	gy-ro-mag-net-ic
ven-o-mous	ven-om-ous
pursue	pur-sue
eg-o-ma-ni-ac	e-go-ma-ni-ac
mon-o-clonal	mon-o-clo-nal
wherewi-thal	where-with-al
ves-ti-gial	ves-tig-i-al
ting-ly	tin-gly
posse	pos-se
phe-n-o-meno-log-i-cal	phe-nom-e-no-log-i-cal
fes-tiv-al	fes-ti-val
glas-ses	glass-es
out-lawed	outlawed
arc-ing	arcing
proac-tive	pro-ac-tive
haird-ress-ing	hair-dress-ing
pin-i-on	pin-ion
os-tracism	os-tra-cism
con-cord-at	con-cor-dat
cere-mo-ni-ous	cer-e-mo-ni-ous
bi-ochemist	bi-o-chem-ist
han-do-ver	hand-o-ver
con-descend	con-de-scend
in-tract-a-ble	in-trac-ta-ble
how-soev-er	how-so-ev-er
prol-e-tar-i-at	pro-le-tar-i-at
prem-o-lar	pre-mo-lar
en-tour-age	en-tou-rage
tou-r-is-tic	tour-is-tic
frow-ard	fro-ward
ion	i-on
cus-hioned	cush-ioned
hothouse	hot-house
an-tagon-ist	an-tag-o-nist
un-sol-v-a-ble	un-solv-a-ble
i-s-o-trop-ic	i-so-trop-ic
prevue	pre-vue
ki-w-i	ki-wi
ga-my	gam-y
mea-sure-ment	meas-ure-ment
ro-s-a-r-y	ro-sa-ry
cut-tlef-ish	cut-tle-fish
glos-s-y	gloss-y
sem-id-e-tached	sem-i-de-tached
a-zure	az-ure
doub-t-er	doubt-er
gib-ber-ing	gibbering
las-er	la-ser
di-aphragm	di-a-phragm
hy-acinth	hy-a-cinth
is-suance	is-su-ance
ex-pect-ed	expected
coax-ing	coaxing
bu-ri-al	bur-i-al
bur-gund-y	bur-gun-dy
crooked	crook-ed
un-derfed	un-der-fed
se-same	ses-a-me
ce-lan-dine	cel-an-dine
bulg-ing	bulging
dach-shund	dachs-hund
lo-des-tar	lode-star
talent-ed	tal-ent-ed
par-en-tal	pa-ren-tal
be-drid-den	bed-rid-den
stym-ie	sty-mie
com-par-a-bly	com-pa-ra-bly
ap-o-ca-lyp-tic	a-poc-a-lyp-tic
ref-o-cus	re-fo-cus
vine-gar	vin-e-gar
my-tho-log-i-cal	myth-o-log-i-cal
qua-ter-nion	qua-ter-ni-on
tri-maran	tri-ma-ran
re-tin-ue	ret-i-nue
laag-er	laa-ger
taver-na	ta-ver-na
eag-er	ea-ger
fo-re-ign-er	for-eign-er
wi-dow-er	wid-ow-er
brand-y	bran-dy
briefly	brief-ly
a-za-le-a	a-zal-ea
pu-e-rile	pu-er-ile
fon-d-ant	fon-dant
scented	scent-ed
la-zu-li	laz-u-li
pi-e-ce-me-al	piece-meal
ou-ter-most	out-er-most
yod-el	yo-del
fundrais-ing	fund-rais-ing
dis-qui-etude	dis-qui-e-tude
star-ga-zer	star-gaz-er
re-devel-op	re-de-vel-op
sis-al	si-sal
sal-ary	sal-a-ry
erstwhile	erst-while
par-sley	pars-ley
noble-man	no-ble-man
co-b-alt	co-balt
hoo-k-ah	hook-ah
chor-al	cho-ral
for-sy-thi-a	for-syth-i-a
re-word-ings	re-word-ings
aw-ry	a-wry
ey-e-lin-er	eye-lin-er
len-d-er	lend-er
con-demned	condemned
mason-ry	ma-son-ry
pester	pes-ter
an-noun-cer	an-nounc-er
a-ny	an-y
mo-noto-nous	mo-not-o-nous
bas-ic	ba-sic
gi-blets	gib-lets
to-m-or-row	to-mor-row
amaz-ing	a-maz-ing
so-ciol-o-gist	so-ci-ol-o-gist
prob-le-mat-i-cal	prob-lem-at-i-cal
do-cile	doc-ile
fluf-fy	fluff-y
fault-ing	faulting
di-s-o-ri-ent	dis-o-ri-ent
ca-r-ouse	ca-rouse
pa-geant	pag-eant
pean-ut	pea-nut
glor-i-fy	glo-ri-fy
coef-fi-cient	co-ef-fi-cient
ha-track	hat-rack
por-phyrit-ic	por-phy-rit-ic
sil-vered	silvered
in-trau-te-rine	in-tra-u-ter-ine
during	dur-ing
mi-li-ti-a	mi-li-tia
ev-ac-u-ee	e-vac-u-ee
ra-con-teur	rac-on-teur
joey	jo-ey
mar-gi-nal-ia	mar-gi-na-li-a
treat-y	trea-ty
Words with errors: 1176
Words with incorrect number of syllables: 624
Total evluated: 6500
Perfect accuracy: 0.82
Number of syllables accuracy: 0.90
Average Levenshtein Distance(across incorrect words): 1.17
