Attempt	Real
mil-i-tar-ist	mil-i-ta-rist
juve-nile	ju-ve-nile
ta-bloid	tab-loid
re-pro-cess	re-proc-ess
throughout	through-out
bal-loon-ist	balloonist
real-ism	re-al-ism
cac-o-ph-o-ny	ca-coph-o-ny
ulc-er	ul-cer
me-lan-cho-li-a	mel-an-cho-li-a
slip-pe-r-i-ness	slip-per-i-ness
lus-ti-ly	lust-i-ly
ob-scu-r-ant-ism	ob-scu-rant-ism
rip-pling	rippling
ra-con-teur	rac-on-teur
craz-y	cra-zy
nuclear	nu-cle-ar
fore-ign-er	for-eign-er
re-sidue	res-i-due
ao-r-ist	a-o-rist
ca-ver-nous	cav-ern-ous
min-ce-meat	mince-meat
cru-d-i-ty	cru-di-ty
go-v-er-nor-ship	gov-er-nor-ship
cam-e-ra	cam-er-a
ref-i-nance	re-fi-nance
id-ler	i-dler
herein-aft-er	here-in-af-ter
sleaz-y	slea-zy
cere-bel-lum	cer-e-bel-lum
triffid	trif-fid
the-re-in	there-in
ca-te-ch-ist	cat-e-chist
pon-d-er	pon-der
herr-ing-bone	her-ring-bone
nox-i-ous	nox-ious
pi-rou-ette	pir-ou-ette
ma-ho-ga-ny	ma-hog-a-ny
in-gra-tiat-ing	in-gra-ti-at-ing
ear-then-ware	earth-en-ware
in-dige-nous	in-dig-e-nous
du-ke-dom	duke-dom
suprem-a-c-ist	su-prem-a-cist
jour-na-l-is-tic	jour-nal-is-tic
e-very-one	eve-ry-one
is-o-trop-ic	i-so-trop-ic
un-beknown	un-be-known
kosh-er	ko-sher
although	al-though
ob-lige	o-blige
dis-a-vo-wal	dis-a-vow-al
hungry	hun-gry
ton-al-i-ty	to-nal-i-ty
ve-ri-fi-a-ble	ver-i-fi-a-ble
le-prous	lep-rous
grav-eyard	grave-yard
he-re-of	here-of
cha-plain	chap-lain
snow-s-torm	snow-storm
in-kling	ink-ling
gadget	gadg-et
news-worth-y	news-wor-thy
dup-lic-i-ty	du-plic-i-ty
cos-set-ed	cosseted
un-real-is-ti-cal-ly	un-re-al-is-ti-cal-ly
rem-i-n-isce	rem-i-nisce
bail-iw-ick	bail-i-wick
win-n-er	win-ner
pros-ta-gland-in	pros-ta-glan-din
dis-gruntled	dis-grun-tled
el-i-c-it	e-lic-it
proto-type	pro-to-type
ex-ult-ing	exulting
do-n-ate	do-nate
ignore	ig-nore
tick-et-ed	ticketed
gun-powder	gun-pow-der
ji-u-jit-su	jiu-jit-su
ty-ran-ny	tyr-an-ny
frui-ty	fruit-y
dis-pen-ser	dis-pens-er
pe-kan	pek-an
vir-gi-nal	vir-gin-al
ki-lo-watt	kil-o-watt
po-lice-wo-man	po-lice-wom-an
leak-ing	leaking
bel-liger-ent	bel-lig-er-ent
tempting	tempt-ing
feudal-ism	feu-dal-ism
bab-y-sit-ting	babysitting
met-a-mor-phosed	metamorphosed
mi-m-ick-er	mim-ick-er
ho-mi-nid	hom-i-nid
in-ci-pient	in-cip-i-ent
dis-quiet-ing	dis-qui-et-ing
scor-pion	scor-pi-on
foo-thill	foot-hill
bas-sist	bass-ist
ple-bei-an	ple-be-ian
car-pen-t-er	car-pen-ter
ran-co-rous	ran-cor-ous
fig-u-ra-tive	fig-ur-a-tive
wea-th-er-vane	weath-er-vane
tsun-a-mi	tsu-na-mi
cow-ar-d-ice	cow-ard-ice
med-dling	meddling
e-nor-m-i-ty	e-nor-mi-ty
un-trust-wor-th-y	un-trust-wor-thy
pet-er	pe-ter
mid--	mid-
in-sou-ciance	in-sou-ci-ance
as-sai-lant	as-sail-ant
son-or-i-ty	so-nor-i-ty
o-cean-ic	o-ce-an-ic
im-pas-s-a-ble	im-pass-a-ble
ver-it-a-ble	ver-i-ta-ble
rea-wak-en	re-a-wak-en
pla-ten	plat-en
con-strict-ed	constricted
su-per-fi-cial-i-ty	su-per-fi-ci-al-i-ty
dis-ad-vantaged	dis-ad-van-taged
tach-yon	tach-y-on
un-sys-te-mat-ic	un-sys-tem-at-ic
veget-a-tive	veg-e-ta-tive
mis-er-ly	mi-ser-ly
be-wild-ered	bewildered
con-ti-nue	con-tin-ue
in-es-tim-a-ble	in-es-ti-ma-ble
cand-lel-it	can-dle-lit
bol-stered	bolstered
or-tho-dontist	or-tho-don-tist
rhe-tor-ic	rhet-o-ric
rent-ed	rented
e-van-gel-ist	e-van-ge-list
scan-da-l-ous	scan-dal-ous
do-cile	doc-ile
bristling	bris-tling
aw-ry	a-wry
an-tece-dent	an-te-ced-ent
stumbling	stum-bling
cater-er	ca-ter-er
outride	out-ride
pre-oc-cup-y	pre-oc-cu-py
fev-er	fe-ver
en-vi-s-ion	en-vi-sion
sac-char-in	sac-cha-rin
pre-fabri-cat-ed	prefabricated
glori-ous-ly	glo-ri-ous-ly
fal-len	fall-en
pup-pe-teer	pup-pet-eer
em-o-tive	e-mo-tive
temp-tress	tempt-ress
pas-ch-al	pas-chal
su-per-vi-s-ion	su-per-vi-sion
farth-ing	far-thing
re-for-ma-tion	ref-or-ma-tion
rede-fine	re-de-fine
sys-te-mat-i-cal-ly	sys-tem-at-i-cal-ly
un-di-plo-mat-ic	un-dip-lo-mat-ic
e-s-carp-ment	es-carp-ment
phle-boto-my	phle-bot-o-my
re-al-pol-i-tik	re-al-po-li-tik
a-pro-pos	ap-ro-pos
pol-y-e-th-y-lene	pol-y-eth-yl-ene
nav-el	na-vel
laud-ed	lauded
pan-ache	pa-nache
pes-sim-ism	pes-si-mism
riv-al-ry	ri-val-ry
busi-nesslike	busi-ness-like
xer-og-ra-phy	xe-rog-ra-phy
ta-pi-o-ca	tap-i-o-ca
conger	con-ger
ra-di-on-u-clide	ra-di-o-nu-clide
im-plausi-ble	im-plau-si-ble
leisured	lei-sured
chi-li	chil-i
eastern-most	east-ern-most
dish-wat-er	dish-wa-ter
can-ni-ba-l-is-tic	can-ni-bal-is-tic
reab-sorb	re-ab-sorb
li-quor-ish	liq-uor-ish
de-sul-to-ry	des-ul-to-ry
fer-al	fe-ral
pseu-dopod	pseu-do-pod
un-hy-gien-ic	un-hy-gi-en-ic
preschool	pre-school
re-vi-val	re-viv-al
re-com-men-da-tion	rec-om-men-da-tion
me-lon	mel-on
reas-sur-ing-ly	re-as-sur-ing-ly
o-ver-crowd-ed	o-ver-crow-ded
in-trav-e-nous	in-tra-ve-nous
ga-te-au	ga-teau
e-phe-m-er-is	e-phem-er-is
pal-m-istry	palm-is-try
fath-er	fa-ther
sa-tin	sat-in
de-n-i-zen	den-i-zen
lac-teal	lac-te-al
basket-ball	bas-ket-ball
for-e-stry	for-est-ry
lau-da-to-ry	laud-a-to-ry
butler	but-ler
hostler	hos-tler
coast-ing	coasting
es-ti-m-a-ble	es-ti-ma-ble
con-nect-ing	con-nec-ting
an-ta-g-o-n-is-tic	an-tag-o-nis-tic
blun-dering	blundering
pol-y-propy-lene	pol-y-pro-pyl-ene
is-o-ther-mal	i-so-ther-mal
pael-la	pa-el-la
chrono-log-i-cal-ly	chron-o-log-i-cal-ly
ve-n-eer	ve-neer
vitri-ol	vit-ri-ol
mo-re-ov-er	more-o-ver
reg-e-late	re-ge-late
unt-wist	un-twist
wood-s-man	woods-man
in-de-feas-i-ble	in-de-fea-si-ble
thur-s-day	thurs-day
de-ter-mi-nis-tic	de-ter-min-is-tic
cyclist	cy-clist
un-wear-ied	un-wea-ried
daugh-t-er	daugh-ter
prot-a-gon-ist	pro-tag-o-nist
un-varn-ished	un-var-nished
ivo-ry	i-vo-ry
com-men-surate	com-men-su-rate
chi-ro-pod-ist	chi-rop-o-dist
pag-an-ism	pa-gan-ism
tri-bune	trib-une
de-m-o-graph-ics	dem-o-graph-ics
de-vel-o-per	de-vel-op-er
ef-fronter-y	ef-fron-ter-y
ent-wine	en-twine
en-gineer-ing	en-gi-neer-ing
toge-ther-ness	to-geth-er-ness
rut-t-ed	rut-ted
slob-bering	slobbering
sprinkler	sprin-kler
geol-o-gy	ge-ol-o-gy
bire-frin-gent	bi-re-frin-gent
pen-et-ra-tive	pen-e-tra-tive
veget-a-ble	veg-e-ta-ble
clif-fhang-er	cliff-hang-er
e-qui-libri-um	e-qui-lib-ri-um
laches	lach-es
endan-gered	en-dan-gered
cashi-er	cash-ier
ex-cla-ma-to-ry	ex-clam-a-to-ry
glor-i-fy	glo-ri-fy
nove-lette	nov-el-ette
freel-anc-er	free-lanc-er
ep-i-tome	e-pit-o-me
as-tron-aut	as-tro-naut
ca-l-en-dar	cal-en-dar
sea-so-nal-i-ty	sea-son-al-i-ty
ci-ty-s-cape	cit-y-scape
misspell-ings	mis-spel-lings
panth-er	pan-ther
se-nate	sen-ate
froward	fro-ward
ra-c-ist	rac-ist
tran-s-lit-er-ate	trans-lit-er-ate
quart-zite	quartz-ite
fealt-y	fe-al-ty
number	num-ber
being	be-ing
bridle	bri-dle
ra-pine	rap-ine
sa-tel-lite	sat-el-lite
e-l-u-ci-date	e-lu-ci-date
min-a-r-et	min-a-ret
ka-l-ei-do-scope	ka-lei-do-scope
ob-lig-ing	o-blig-ing
obe-lisk	ob-e-lisk
el-it-ist	e-lit-ist
bumbling	bum-bling
he-d-on-ism	he-don-ism
in-ex-pres-si-ble	in-ex-press-i-ble
hor-rendous-ly	hor-ren-dous-ly
cre-m-a-to-ri-um	cre-ma-to-ri-um
sy-n-apse	syn-apse
devas-tat-ing-ly	dev-as-tat-ing-ly
mid-wi-fer-y	mid-wife-ry
fi-du-ciar-y	fi-du-ci-ar-y
pro-per-ly	prop-er-ly
minke	min-ke
pronounced	pro-nounced
plenar-y	ple-na-ry
pol-lard-ed	pollarded
tech-no-pho-bi-a	tech-no-pho-bia
je-wel-ry	jew-el-ry
mer-in-gue	me-ringue
ta-lent	tal-ent
ti-a-ra	ti-ar-a
coun-ter-ba-l-ance	coun-ter-bal-ance
mean-dering	me-an-der-ing
pre-sent-ly	pres-ent-ly
as-tir	a-stir
coex-ist	co-ex-ist
sooty	soot-y
re-stau-r-ant	res-tau-rant
haph-a-zard	hap-haz-ard
twinning	twin-ning
an-tler	ant-ler
per-e-stroik-a	pe-re-stroi-ka
con-toured	contoured
in-solv-ent	in-sol-vent
ap-pa-rent	ap-par-ent
va-cil-late	vac-il-late
bur-bling	burbling
bar-ge-pole	barge-pole
a-nom-a-l-ous	a-nom-a-lous
per-meate	per-me-ate
pen-etra-ble	pen-e-tra-ble
regist-er	reg-is-ter
softheart-ed	soft-heart-ed
dis-con-ti-nue	dis-con-tin-ue
vic-er-oy	vice-roy
her-m-it	her-mit
in-e-qui-ta-ble	in-eq-ui-ta-ble
pro-mise	prom-ise
phy-si-o-log-i-cal	phys-i-o-log-i-cal
mot-i-vate	mo-ti-vate
anx-i-ous	anx-ious
per-mea-bil-i-ty	per-me-a-bil-i-ty
flus-tered	flustered
sine-wy	sin-ew-y
de-cay-ing	decaying
fes-tival	fes-ti-val
nons-mok-er	non-smok-er
sparkler	spar-kler
vel-o-drome	ve-lo-drome
au-tar-ch-y	au-tar-chy
piv-o-tal	piv-ot-al
geo-syn-chro-nous	ge-o-syn-chro-nous
troik-a	troi-ka
de-cayed	decayed
prep-a-ra-to-ry	pre-par-a-to-ry
shril-l-y	shril-ly
bri-gand	brig-and
thread-ed	threaded
pean-ut	pea-nut
outreach	out-reach
ele-phant	el-e-phant
per-sec-u-tor	per-se-cu-tor
pa-ten	pat-en
sy-nod-ic	syn-od-ic
dyad	dy-ad
e-lec-to-rate	e-lec-tor-ate
fis-ti-cuffs	fist-i-cuffs
spheroid	sphe-roid
eg-o-ma-n-i-ac	e-go-ma-ni-ac
mi-nu-tiae	mi-nu-ti-ae
stu-pen-d-ous	stu-pen-dous
un-tarn-ished	un-tar-nished
se-ven-teen	sev-en-teen
bour-ge-ois	bour-geois
cu-nei-form	cu-ne-i-form
ele-gant	el-e-gant
in-sis-t-ence	in-sist-ence
fa-sh-ion	fash-ion
e-s-cape	es-cape
sand-paper	sand-pa-per
re-oc-cup-y	re-oc-cu-py
grie-v-ous	griev-ous
au-to-m-o-tive	au-to-mo-tive
po-ly-chro-mat-ic	pol-y-chro-mat-ic
las-ci-v-ious	las-civ-i-ous
trans-for-ma-tive	trans-form-a-tive
ther-mostat	ther-mo-stat
den-o-ta-tion	de-no-ta-tion
octane	oc-tane
hy-droch-lo-ride	hy-dro-chlo-ride
chro-no-log-i-cal	chron-o-log-i-cal
neces-sar-y	nec-es-sar-y
ca-mouf-lage	cam-ou-flage
for-e-taste	fore-taste
tuesday	tues-day
vo-lun-tar-i-ly	vol-un-tar-i-ly
handov-er	hand-o-ver
provid-ing	pro-vid-ing
is-o-late	i-so-late
com-ba-tive	com-bat-ive
punch-line	punchline
miss-pell	mis-spell
plast-er	plas-ter
re-pri-eve	re-prieve
su-bur-bi-a	sub-ur-bi-a
groc-er-y	gro-cer-y
stal-e-mate	stale-mate
cur-tained	curtained
ade-quate-ly	ad-e-quate-ly
so-lace	sol-ace
coex-is-tent	co-ex-ist-ent
ge-n-er-ic	ge-ner-ic
sa-l-ar-ied	sal-a-ried
pa-tri-mo-ny	pat-ri-mo-ny
dis-com-fort-ing	discomforting
ex-por-t-a-bil-i-ty	ex-por-ta-bi-li-ty
glis-t-en	glis-ten
kill-er	kil-ler
mais-o-nette	mai-son-ette
nomad	no-mad
prose-cute	pros-e-cute
lif-toff	lift-off
dow-n-y	down-y
tur-nov-er	turn-o-ver
slouch-ing	slouching
ginger	gin-ger
i-n-i-tial	in-i-tial
un-wel-coming	un-wel-com-ing
what-soev-er	what-so-ev-er
im-prov-i-sa-to-ry	im-pro-vi-sa-to-ry
di-plo-mat	dip-lo-mat
stiffening	stiff-en-ing
cal-care-ous	cal-car-e-ous
ar-se-n-al	ar-se-nal
fif-tieth	fif-ti-eth
ge-om-ag-net-i-cal-ly	ge-o-mag-ne-ti-cal-ly
chan-cy	chanc-y
ome-ga	o-me-ga
can-d-le-pow-er	can-dle-pow-er
lag-er	la-ger
pes-sim-ist	pes-si-mist
ta-lent-ed	tal-ent-ed
ye-ti	yet-i
eth-y-lene	eth-yl-ene
phi-lo-soph-i-cal-ly	phil-o-soph-i-cal-ly
volt-me-t-er	volt-me-ter
re-trofit	ret-ro-fit
une-ven-ly	un-e-ven-ly
rant-ing	ranting
startling-ly	star-tling-ly
u-n-i-den-ti-fied	un-i-den-ti-fied
im-pli-c-it	im-plic-it
eith-er	ei-ther
chaot-ic	cha-ot-ic
nin-e-teenth	nine-teenth
negligi-ble	neg-li-gi-ble
sum-mar-y	sum-ma-ry
glor-i-fied	glo-ri-fied
re-stau-ra-teur	res-tau-ra-teur
so-ci-a-bil-i-ty	so-cia-bil-i-ty
om-ni-po-tence	om-nip-o-tence
splint-er	splin-ter
cat-er	ca-ter
breast-feed-ing	breastfeeding
en-dura-ble	en-dur-a-ble
hairdress-ing	hair-dress-ing
un-neces-sar-y	un-nec-es-sar-y
crea-tor	cre-a-tor
dino-saur	di-no-saur
scalar	sca-lar
re-v-i-val-ism	re-viv-al-ism
elder-flow-er	el-der-flow-er
fal-lout	fall-out
hy-po-the-sis	hy-poth-e-sis
ver-an-da	ve-ran-da
pa-r-en-thet-i-cal	par-en-thet-i-cal
menac-ing-ly	men-ac-ing-ly
def-a-ma-to-ry	de-fam-a-to-ry
min-e-s-trone	min-e-stro-ne
u-pon	up-on
com-pa-r-a-tive-ly	com-par-a-tive-ly
grill-ing	grilling
ri-ot-ing	ri-o-ting
reas-sign	re-as-sign
ve-ter-i-nar-y	vet-er-i-nar-y
tre-mo-lo	trem-o-lo
ex-tra-g-a-lac-tic	ex-tra-ga-lac-tic
col-lec-tiv-i-sa-tion	col-lec-ti-vi-sa-tion
sul-ta-na	sul-tan-a
wicked	wick-ed
plummy	plum-my
ni-hilis-tic	ni-hil-is-tic
whe-re-on	where-on
phi-lan-throp-ic	phil-an-throp-ic
li-eute-nant	lieu-ten-ant
in-a-lien-a-ble	in-al-ien-a-ble
humid	hu-mid
hal-lel-u-jah	hal-le-lu-jah
pig-ment-ed	pig-men-ted
lul-la-by	lull-a-by
pla-ty-pus	plat-y-pus
a-po-lo-gi-a	ap-o-lo-gi-a
banking	bank-ing
fi-erce	fierce
hex-a-go-n-al	hex-ag-o-nal
sacri-lege	sac-ri-lege
ste-rile	ster-ile
mi-croor-g-an-ism	mi-cro-or-gan-ism
hi-er-ar-ch-i-cal	hi-er-ar-chi-cal
as-pi-r-in	as-pi-rin
arch-er-y	ar-cher-y
con-tri-v-ance	con-triv-ance
pi-erce	pierce
so-ciol-o-gy	so-ci-ol-o-gy
sa-l-a-mi	sa-la-mi
un-for-gett-a-ble	un-for-get-ta-ble
ta-ber-na-cle	tab-er-nac-le
crazi-ly	cra-zi-ly
shut-tering	shut-ter-ing
asi-nine	as-i-nine
dairy-ing	dair-y-ing
flow-ering	flow-er-ing
fe-s-tive	fes-tive
fresh-wa-t-er	fresh-wa-ter
un-re-pre-sent-ed	un-rep-re-sent-ed
pre-ju-dice	prej-u-dice
nutmeg	nut-meg
mo-no-to-ny	mo-not-o-ny
vi-a-d-uct	vi-a-duct
at-mo-sphere	at-mos-phere
a-symp-tote	as-ymp-tote
winn-ing-ly	win-ning-ly
taper	ta-per
prove-nance	prov-e-nance
rene-wal	re-new-al
om-it	o-mit
psy-cho-th-er-a-py	psy-cho-ther-a-py
nestling	nest-ling
pub-lished	published
fac-si-mile	fac-sim-i-le
bart-er	bar-ter
ketchup	ketch-up
sniff-ing	sniffing
dud-geon	dudg-eon
plural-ist	plu-ral-ist
ge-n-oa	gen-o-a
mal-ty	malt-y
a-qua	aq-ua
eva-sive	e-va-sive
red-i-rect	re-di-rect
runn-er	run-ner
body-build-ing	bod-y-build-ing
cut-th-roat	cut-throat
de-nim	den-im
in-sou-ciant	in-sou-ci-ant
mul-ti-process-ing	mul-ti-proc-ess-ing
tar-a-ma-sa-la-ta	ta-ra-ma-sa-la-ta
se-quen-cer	se-quenc-er
ap-proach-ing	approaching
dram-at-ist	dram-a-tist
un-ap-pre-ciat-ed	un-ap-pre-ci-at-ed
col-le-gial	col-le-gi-al
palp-a-bly	pal-pa-bly
pen-thouse	pent-house
bom-bar-di-er	bom-bar-dier
church-warden	church-ward-en
tropo-pause	trop-o-pause
suburb	sub-urb
chiefly	chief-ly
chival-ry	chiv-al-ry
sy-ca-more	syc-a-more
tri-bal	trib-al
pa-ra-si-t-ism	par-a-sit-ism
fe-lon	fel-on
pub-er-ty	pu-ber-ty
ki-lo-ton	kil-o-ton
rel-e-v-ance	rel-e-vance
manes	ma-nes
her-mi-tage	her-mit-age
in-ju-r-y	in-ju-ry
swin-gy	swing-y
heart-en-ing	heartening
alt-er	al-ter
fal-se-hood	false-hood
coo-lant	cool-ant
lob-byist	lob-by-ist
proac-tive	pro-ac-tive
reunite	re-u-nite
sob-ri-quet	so-bri-quet
pyro-ma-ni-ac	py-ro-ma-ni-ac
gathering	gath-er-ing
ven-ous	ve-nous
ves-ti-gial	ves-tig-i-al
harshen	harsh-en
di-ges-ti-ble	di-gest-i-ble
trans-pa-r-ent-ly	trans-par-ent-ly
height-ened	heightened
em-bedd-a-ble	em-bed-da-ble
joust-ing	jousting
there-aft-er	there-af-ter
su-brou-tine	sub-rou-tine
cutler-y	cut-ler-y
pa-r-ox-ysm	par-ox-ysm
jin-gois-tic	jin-go-is-tic
bey-ond	be-yond
cura-ble	cur-a-ble
in-ex-hausti-ble	in-ex-haust-i-ble
spirit-u-al-ist	spir-it-u-al-ist
cus-to-mar-i-ly	cus-tom-ar-i-ly
e-lec-trom-o-tive	e-lec-tro-mo-tive
a-wak-ening	a-wak-en-ing
re-ceiver-ship	re-ceiv-er-ship
ex-pen-di-ture	ex-pend-i-ture
pla-te-au	pla-teau
com-ber	comb-er
sur-real-ist	sur-re-al-ist
vesp-ers	ves-pers
floral	flo-ral
re-publi-can	re-pub-li-can
in-sol-v-en-cy	in-sol-ven-cy
strat-o-spher-i-cal-ly	stratospherically
e-ver-last-ing	ev-er-last-ing
tutelage	tu-te-lage
fond-ant	fon-dant
wad-i	wa-di
welt-er	wel-ter
kitchen-ware	kitch-en-ware
en-tour-age	en-tou-rage
pup-pe-try	pup-pet-ry
cher-oot	che-root
sist-er	sis-ter
pin-kie	pink-ie
pop-u-l-ism	pop-u-lism
anth-er	an-ther
vitre-ous	vit-re-ous
pos-top-er-a-tive	post-op-er-a-tive
dro-plet	drop-let
ver-is-i-mil-i-tude	ver-i-si-mil-i-tude
ma-ta-dor	mat-a-dor
jokey	jok-ey
sin-ist-er	sin-is-ter
hy-gien-ic	hy-gi-en-ic
ack-nowl-edge	ac-knowl-edge
deb-tor	debt-or
spid-er-y	spi-der-y
ma-jo-rette	ma-jor-ette
cen-tu-r-y	cen-tu-ry
good-night	goodnight
haik-u	hai-ku
rap-pro-che-ment	rap-proche-ment
cos-mon-aut	cos-mo-naut
mer-cur-y	mer-cu-ry
cat-ter-y	cat-te-ry
in-com-par-a-ble	in-com-pa-ra-ble
di-l-a-ta-tion	dil-a-ta-tion
ra-di-o-th-er-a-py	ra-di-o-ther-a-py
im-provised	im-pro-vised
facet	fac-et
an-ti-the-sis	an-tith-e-sis
fat-i-gue	fa-tigue
ask-ance	a-skance
kestrel	kes-trel
bur-geon-ing	burgeoning
col-ogne	co-logne
calum-ny	cal-um-ny
par-si-m-o-ny	par-si-mo-ny
thes-pian	thes-pi-an
copy-writ-er	cop-y-writ-er
loosen	loos-en
il-li-cit	il-lic-it
re-value	re-val-ue
count-y	coun-ty
dat-a-base	da-ta-base
ester	es-ter
haz-el	ha-zel
gha-na	ghana
dau-ber	daub-er
gun-me-tal	gun-met-al
diverse	di-verse
here-und-er	here-un-der
fidget	fidg-et
warthog	wart-hog
re-pro-bate	rep-ro-bate
at-mo-s-pher-ic	at-mos-pher-ic
en-ticing	en-tic-ing
take-ov-er	take-o-ver
sin-t-er	sin-ter
bi-mo-dal	bi-mod-al
ge-no-ci-dal	gen-o-cid-al
ap-er-i-tif	a-pe-ri-tif
ex-ci-ta-ble	ex-cit-a-ble
a-vion-ics	a-vi-on-ics
hamp-er	ham-per
sa-v-ant	sa-vant
flo-rin	flor-in
un-it	u-nit
bi-c-y-cle	bi-cy-cle
dis-pen-sa-r-y	dis-pen-sa-ry
proff-er	prof-fer
at-mospher-ics	at-mos-pher-ics
cath-et-er	cath-e-ter
foot-bal-l-er	foot-ball-er
mar-ri-age	mar-riage
cel-l-ist	cel-list
de-luge	del-uge
impish	imp-ish
pa-lette	pal-ette
eye-sha-dow	eye-shad-ow
ele-gance	el-e-gance
burn-ished	burnished
un-learned	un-learn-ed
sen-sual-i-ty	sen-su-al-i-ty
clo-set	clos-et
blund-er	blun-der
clann-ish	clan-nish
be-spect-acled	be-spec-ta-cled
in-ex-or-a-ble	in-ex-o-ra-ble
leis-ure-wear	lei-sure-wear
ty-pe-wri-t-er	type-writ-er
un-spok-en	un-spo-ken
stoic	sto-ic
may-a	ma-ya
mo-der-nism	mod-ern-ism
feather-weight	feath-er-weight
con-fi-gure	con-fig-ure
un-cer-taint-y	un-cer-tain-ty
salv-er	sal-ver
ar-ro-wroot	ar-row-root
tes-ta-men-tar-y	tes-ta-men-ta-ry
no-tar-y	no-ta-ry
lemm-ing	lem-ming
ca-bin	cab-in
ma-nor	man-or
busi-ly	bus-i-ly
is-o-la-tion	i-so-la-tion
po-l-y-ga-mous	po-lyg-a-mous
cud-d-ly	cud-dly
sun-burned	sunburned
stunner	stun-ner
tard-y	tar-dy
rig-o-r-ous	rig-or-ous
ca-r-ouse	ca-rouse
dol-o-mite	do-lo-mite
reassess-ment	re-as-sess-ment
e-pige-net-ic	ep-i-ge-net-ic
bour-geois-ie	bour-geoi-sie
me-lanch-o-ly	mel-an-chol-y
con-flict-ed	conflicted
lady-ship	la-dy-ship
ma-l-ev-o-lence	ma-lev-o-lence
e-clec-ti-cism	ec-lec-ti-cism
cus-hion	cush-ion
phy-siog-no-my	phys-i-og-no-my
righ-teous-ness	right-eous-ness
ovi-d-uct	o-vi-duct
un-ex-a-mined	un-ex-am-ined
sol-e-noid	so-le-noid
placa-to-ry	pla-ca-to-ry
pha-raoh	phar-aoh
tan-gy	tang-y
rummy	rum-my
thaw-ing	thawing
do-pey	dope-y
pic-tu-resque	pic-tur-esque
ro-strum	ros-trum
me-narche	men-ar-che
high-light-er	high-ligh-ter
e-lec-tro-phore-sis	e-lec-tro-pho-re-sis
a-p-ril	a-pril
pre-sen-ta-tion	pres-en-ta-tion
car-bo-n-a-ce-ous	car-bo-na-ceous
pa-late	pal-ate
bubon-ic	bu-bon-ic
re-im-ple-ment-ed	reimplemented
fleecy	fleec-y
fa-cile	fac-ile
profit	prof-it
con-son-ance	con-so-nance
mil-i-tar-ism	mil-i-ta-rism
re-routes	re-routes
man-i-cured	ma-ni-cured
diphthong	diph-thong
naked	na-ked
pro-pell-er	pro-pel-ler
per-is-cope	per-i-scope
fore-fath-er	fore-fa-ther
ciph-er	ci-pher
crotch-e-ty	crotch-et-y
sof-tie	soft-ie
nor-th-ern-most	north-ern-most
swimm-ing	swim-ming
homo-mor-phism	ho-mo-mor-phism
pred-i-lec-tion	pre-di-lec-tion
siss-y	sis-sy
tarn-ish	tar-nish
vin-yl	vi-nyl
ci-vil-i-an	ci-vil-ian
me-ri-di-on-al	me-rid-i-o-nal
cursed	curs-ed
re-ve-al	re-veal
ma-n-i-ac	ma-ni-ac
ca-ra-van	car-a-van
voy-eur-ism	vo-yeur-ism
cool-ing	cooling
ade-quate	ad-e-quate
ca-me-o	cam-e-o
un-er-ring	un-err-ing
ar-ch-e-type	ar-che-type
ne-ces-sar-i-ly	nec-es-sar-i-ly
in-ter-de-nom-i-na-tion-al-	in-ter-de-nom-i-na-tion-al
dam-per	damp-er
ap-a-th-y	ap-a-thy
ly-ch-ee	ly-chee
professed	pro-fessed
crat-er	cra-ter
dep-o-nent	de-po-nent
le-gate	leg-ate
di-a-go-n-al	di-ag-o-nal
per-pe-tui-ty	per-pe-tu-i-ty
a-per-ture	ap-er-ture
leer-ing	leering
differ	dif-fer
au-d-i-ble	au-di-ble
is-o-la-tion-ism	i-so-la-tion-ism
te-le-ol-o-gy	tel-e-ol-o-gy
han-gar	hang-ar
dy-s-pep-tic	dys-pep-tic
po-ten-tiom-e-ter	po-ten-ti-om-e-ter
glasshouse	glass-house
an-tide-pres-sant	an-ti-de-pres-sant
su-gar	sug-ar
bes-peak	be-speak
mi-ni	min-i
rectan-gle	rec-tan-gle
re-tain-ing	retaining
boa	bo-a
step-fath-er	step-fa-ther
ta-lent-less	tal-ent-less
bu-oy-an-cy	buoy-an-cy
sa-tur-nine	sat-ur-nine
rosa-r-y	ro-sa-ry
of-fend-ing	of-fen-ding
bu-ri-al	bur-i-al
fo-re-go	fore-go
ele-phan-tine	el-e-phan-tine
con-tin-u-i-ty	con-ti-nu-i-ty
fift-y	fif-ty
whe-re-of	where-of
bawdy	bawd-y
bunk-er	bun-ker
man-d-i-ble	man-di-ble
nai-vete	naivete
lump-en	lum-pen
pres-uma-bly	pre-sum-a-bly
chor-ist-er	chor-is-ter
longhand	long-hand
ask-ew	a-skew
predict-ed	predicted
ho-ri-zon-tal	hor-i-zon-tal
gol-liwog	gol-li-wog
but-tered	buttered
osten-ta-tious-ly	os-ten-ta-tious-ly
decla-ma-to-ry	de-clam-a-to-ry
mal-ig-nant	ma-lig-nant
psy-choan-al-y-sis	psy-cho-a-nal-y-sis
cal-der-a	cal-de-ra
tran-svestite	trans-ves-tite
dis-yl-lab-ic	di-syl-lab-ic
so-me-one	some-one
dim-er	di-mer
un-lady-like	un-la-dy-like
dim-pled	dimpled
tun-ic	tu-nic
bid-i-rec-tion-al	bi-di-rec-tion-al
wester-ly	west-er-ly
trimm-ing	trim-ming
gof-er	go-fer
newly	new-ly
beach-com-ber	beach-comb-er
muta-ble	mu-ta-ble
chev-a-l-i-er	chev-a-lier
coex-ten-sive	co-ex-ten-sive
fre-quent-ed	frequented
pol-ic-ing	policing
hon-est-y	hon-es-ty
ou-ter-most	out-er-most
is-o-bar	i-so-bar
li-eu	lieu
necro-manc-er	nec-ro-man-cer
palp-a-ble	pal-pa-ble
sold-er	sol-der
char-i-t-a-bly	char-i-ta-bly
geom-e-try	ge-om-e-try
nift-y	nif-ty
pad-ded	padded
an-te-n-a-tal	an-te-na-tal
sal-mon	salm-on
reb-ur-y	re-bur-y
com-man-d-ant	com-man-dant
scho-lar	schol-ar
ge-os-ta-tion-ar-y	ge-o-sta-tion-ar-y
syn-a-go-gue	syn-a-gogue
sen-sual	sen-su-al
workplace	work-place
scat-tered	scattered
a-rom-a-tic-i-ty	ar-o-ma-tic-i-ty
tou-r-is-tic	tour-is-tic
si-byl	sib-yl
cyan	cy-an
ga-ze-lle	ga-zelle
de-vil-ish	dev-il-ish
re-for-e-s-ta-tion	re-for-est-a-tion
fusi-ble	fu-si-ble
dim-in-ished	di-min-ished
col-la-bor-a-tive	col-lab-o-ra-tive
pi-ty	pit-y
far-myard	farm-yard
o-beis-ance	o-bei-sance
rogu-er-y	ro-guer-y
strang-er	stran-ger
succeed	suc-ceed
e-l-u-ci-da-tion	e-lu-ci-da-tion
pe-nin-su-la	pen-in-su-la
slim-m-er	slim-mer
sapling	sap-ling
of-fi-cial-d-om	of-fi-cial-dom
stager	stag-er
pa-th-os	pa-thos
kwach-a	kwa-cha
plastered	plas-tered
as-tride	a-stride
toil-e-tries	toi-let-ries
sprinkling	sprin-kling
in-vert-ed	inverted
ir-rel-e-v-ance	ir-rel-e-vance
trink-et	trin-ket
quiet-ness	qui-et-ness
naive-ly	na-ive-ly
lob-st-er	lob-ster
em-physe-ma	em-phy-se-ma
dis-po-sal	dis-pos-al
sec-to-r-al	sec-tor-al
her-bi-cide	herb-i-cide
ex-cepting	ex-cept-ing
ro-sy	ros-y
fore-sha-dow	fore-shad-ow
a-to-nal	a-ton-al
teet-er	tee-ter
un-sa-vo-ry	un-sa-vor-y
ru-p-ee	ru-pee
so-lemn	sol-emn
in-fantry	in-fan-try
cutler	cut-ler
un-am-bigu-ous-ly	un-am-big-u-ous-ly
cau-sa-tive	caus-a-tive
av-er	a-ver
la-cy	lac-y
ob-nox-i-ous	ob-nox-ious
winning	win-ning
di-sem-bow-el	dis-em-bow-el
plan-n-er	plan-ner
dis-cipli-nar-y	dis-ci-pli-nar-y
furth-er	fur-ther
her-biv-o-r-ous	her-biv-o-rous
necro-man-tic	nec-ro-man-tic
so-ciop-o-lit-i-cal	so-ci-o-po-lit-i-cal
spok-en	spo-ken
thous-and	thou-sand
pea-s-ant	peas-ant
ho-ver-craft	hov-er-craft
cach-et	ca-chet
cen-tri-fu-ga-tion	cen-trif-u-ga-tion
vacu-um	vac-u-um
naugh-t-y	naugh-ty
for-sy-thi-a	for-syth-i-a
co-v-ert-ly	cov-ert-ly
ma-cro-e-c-o-nom-ic	mac-ro-ec-o-nom-ic
de-signed-ly	de-sign-ed-ly
fai-lure	fail-ure
treat-ise	trea-tise
par-t-y	par-ty
port-age	por-tage
il-licit-ly	il-lic-it-ly
o-ver-sha-dow	o-ver-shad-ow
foothold	foot-hold
tint-ed	tinted
e-con-o-m-ist	e-con-o-mist
cheet-ah	chee-tah
sec-re-tive	se-cre-tive
vide-o-tape	vid-e-o-tape
vi-car-age	vic-ar-age
ele-gant-ly	el-e-gant-ly
ta-bleau	tab-leau
dis-heart-ened	dis-hear-tened
dough-t-y	dough-ty
mor-gue	morgue
nor-thern-er	north-ern-er
en-treaty	en-treat-y
seam-an	sea-man
in-tert-wine	in-ter-twine
ig-nor-ance	ig-no-rance
pan-o-p-ly	pan-o-ply
trans-pa-rent	trans-par-ent
con-vi-v-i-al	con-viv-i-al
un-lac-ing	un-lacing
wat-er	wa-ter
re-ga-l-i-a	re-ga-li-a
in-er-ad-i-ca-ble	in-e-rad-i-ca-ble
seap-lane	sea-plane
burg-lar	bur-glar
stupe-fy	stu-pe-fy
en-gin-eered	engineered
ra-cy	rac-y
bar-o-net	bar-on-et
em-po-wer-ment	em-pow-er-ment
quest-ing	questing
gra-tui-tous-ly	gra-tu-i-tous-ly
ex-a-cer-bate	ex-ac-er-bate
ye-o-man-ry	yeo-man-ry
bet-wixt	be-twixt
su-per-he-r-o	su-per-he-ro
quo-tidi-an	quo-tid-i-an
or-tho-go-nal	or-thog-o-nal
bet-ween	be-tween
wrink-ly	wrin-kly
car-ri-age	car-riage
dis-in-t-er	dis-in-ter
ragged	rag-ged
id-ly	i-dly
com-mu-ter	com-mut-er
statue	stat-ue
re-part-ee	rep-ar-tee
vestal	ves-tal
flan-ne-lette	flan-nel-ette
con-sen-sual	con-sen-su-al
ling-er	lin-ger
for-mi-d-a-ble	for-mi-da-ble
aud-it	au-dit
ra-re-bit	rare-bit
sat-is-fac-tor-i-ly	sat-is-fac-to-ri-ly
pho-o-ey	phoo-ey
re-ti-na	ret-i-na
u-n-ion	un-ion
ca-t-a-ma-ran	cat-a-ma-ran
pro-mis-cui-ty	prom-is-cu-i-ty
earthling	earth-ling
clust-er	clus-ter
tri-bes-pe-o-ple	tribes-peo-ple
me-th-o-do-log-i-cal	meth-od-o-log-i-cal
pro-phet	proph-et
blanket	blan-ket
un-thinking	un-think-ing
sil-age	si-lage
tele-phone	tel-e-phone
reg-istry	reg-is-try
fil-i-buster	fil-i-bus-ter
fluid-ly	flu-id-ly
ripen	rip-en
con-spi-ra-to-ri-al	con-spir-a-to-ri-al
de-scant	des-cant
idle-ness	i-dle-ness
needle-work	nee-dle-work
weari-ness	wea-ri-ness
pro-ject	proj-ect
mer-chandise	mer-chan-dise
thorough-go-ing	thor-ough-go-ing
hon-o-rar-y	hon-or-ar-y
vig-o-r-ous	vig-or-ous
with-ered	withered
dis-kette	disk-ette
lim-p-id	lim-pid
e-qui-ta-ble	eq-ui-ta-ble
ex-ecut-a-ble	ex-e-cut-a-ble
prolonged	pro-longed
con-sul-t-a-tive	con-sul-ta-tive
dumpling	dump-ling
spi-cy	spic-y
a-rith-met-ic	a-rith-me-tic
re-sin	res-in
in-dis-pensa-ble	in-dis-pen-sa-ble
in-cap-a-ble	in-ca-pa-ble
ex-is-t-ence	ex-ist-ence
lubri-cant	lu-bri-cant
genre	gen-re
re-furb-ish-ment	re-fur-bish-ment
swim-m-er	swim-mer
mo-nopo-ly	mo-nop-o-ly
me-te-o-rol-o-gy	me-te-or-ol-o-gy
chid-ing	chiding
trous-ers	trou-sers
a-voir-du-pois	av-oir-du-pois
doub-ly	dou-bly
postlude	post-lude
seaweed	sea-weed
un-der-wat-er	un-der-wa-ter
ma-chete	ma-chet-e
ten-antry	ten-ant-ry
minus-cule	mi-nus-cule
wrangler	wran-gler
as-tray	a-stray
bount-y	boun-ty
chi-ropo-d-y	chi-rop-o-dy
dam-pen	damp-en
col-o-n-ist	col-o-nist
dotage	dot-age
per-fidi-ous	per-fid-i-ous
sweltering	swel-ter-ing
client	cli-ent
kinase	ki-nase
coun-ter-in-tui-tive	coun-ter-in-tu-i-tive
cin-e-ma-togra-pher	cin-e-ma-tog-ra-pher
spac-e-craft	space-craft
pre-face	pref-ace
ar-chiv-ist	ar-chi-vist
sturd-y	stur-dy
pen-i-ten-tiar-y	pen-i-ten-tia-ry
sep-ar-a-ble	sep-a-ra-ble
de-p-o-si-tion	dep-o-si-tion
scen-ic	sce-nic
oc-tog-e-nar-i-an	oc-to-ge-nar-i-an
ety-mol-o-gy	et-y-mol-o-gy
re-pre-sent	rep-re-sent
e-pine-phrine	ep-i-neph-rine
cor-dite	cord-ite
qua-ter-nion	qua-ter-ni-on
di-cho-to-mous	di-chot-o-mous
mai-den-ly	maid-en-ly
sil-vered	silvered
im-pri-son	im-pris-on
pa-ra-dox	par-a-dox
nest-ing	nesting
a-tom	at-om
vestry	ves-try
re-joind-er	re-join-der
duik-er	dui-ker
he-li-osphere	he-li-o-sphere
moti-va-tor	mo-ti-va-tor
reu-ni-fy	re-u-ni-fy
mar-k-up	mark-up
widow-er	wid-ow-er
de-press-ing	de-pres-sing
ele-men-ta-r-y	el-e-men-ta-ry
se-lec-tee	se-lect-ee
con-ver-t-i-ble	con-vert-i-ble
wa-terbed	wa-ter-bed
re-phrases	re-phra-ses
fan-cier	fan-ci-er
un-sold-er	un-sol-der
a-ven-ger	a-veng-er
mouth-watering	mouth-wa-ter-ing
azi-muth	az-i-muth
un-con-ge-ni-al	un-con-gen-ial
tho-rough-fare	thor-ough-fare
cred-i-t-a-ble	cred-it-a-ble
reg-istra-ble	reg-is-tra-ble
dis-con-tin-u-i-ty	dis-con-ti-nu-i-ty
click-ing	clicking
summer	sum-mer
un-bridled	un-bri-dled
zea-l-ot	zeal-ot
ex-pi-ra-to-ry	ex-pir-a-to-ry
fur-rowed	furrowed
head-pho-nes	head-phones
i-s-osce-les	i-sos-ce-les
phosphate	phos-phate
vis-ion-ar-y	vi-sion-ar-y
trifling	tri-fling
cli-to-ris	clit-o-ris
bogey-man	bo-gey-man
od-dly	odd-ly
warden	war-den
dis-cer-ni-ble	dis-cern-i-ble
ju-n-ior	jun-ior
wal-l-a-by	wal-la-by
watershed	wa-ter-shed
prede-fined	pre-de-fined
un-an-i-mous	u-nan-i-mous
beat-i-fi-ca-tion	be-at-i-fi-ca-tion
enzyme	en-zyme
liber-tar-i-an	lib-er-tar-i-an
flut-tering	fluttering
rede-ploy	re-de-ploy
laby-rinth	lab-y-rinth
gin-gham	ging-ham
necro-man-cy	nec-ro-man-cy
i-a-tro-gen-ic	i-at-ro-gen-ic
hit-t-a-ble	hit-ta-ble
faul-ty	fault-y
subt-ly	sub-tly
weakling	weak-ling
perch-lo-rate	per-chlo-rate
guano	gua-no
ex-pla-na-to-ry	ex-plan-a-to-ry
da-mask	dam-ask
an-ti-pa-thy	an-tip-a-thy
re-cipe	rec-i-pe
jiff-y	jif-fy
scan-n-er	scan-ner
a-per-y	ap-er-y
geez-er	gee-zer
con-for-m-al	con-for-mal
cradling	cra-dling
pre-cooked	precooked
te-lex	tel-ex
inkwell	ink-well
dodgem	dodg-em
tyrant	ty-rant
geo-mor-phol-o-gy	ge-o-mor-phol-o-gy
un-easi-ness	un-eas-i-ness
guaca-mole	gua-ca-mo-le
re-mast-er	re-mas-ter
man-dar-in	man-da-rin
pru-d-ent	pru-dent
rare-fac-tion	rar-e-fac-tion
phi-lan-thro-p-ist	phi-lan-thro-pist
late-co-mer	late-com-er
se-ni-or-i-ty	sen-ior-i-ty
bao-b-ab	ba-o-bab
de-t-o-nate	det-o-nate
auger	au-ger
re-lict	rel-ict
re-tin-i-tis	ret-i-ni-tis
vo-lun-tar-y	vol-un-tar-y
ide-al	i-de-al
offend-ed	of-fend-ed
dev-o-t-ee	dev-o-tee
coff-er	cof-fer
de-lect-a-ble	de-lec-ta-ble
el-u-sive	e-lu-sive
rach-is	ra-chis
sub-mer-si-ble	sub-mers-i-ble
wid-o-whood	wid-ow-hood
pol-y-pho-ny	po-lyph-o-ny
blin-kered	blink-ered
war-drobe	ward-robe
un-wav-ering	un-wa-ver-ing
ar-is-to-crat-ic	a-ris-to-crat-ic
vin-ey-ard	vine-yard
coa-lesce	co-a-lesce
pa-tro-ness	pa-tron-ess
re-act-ant	re-ac-tant
koa-la	ko-a-la
miso-gy-n-ist	mi-sog-y-nist
lant-ern	lan-tern
ex-plicit-ly	ex-plic-it-ly
cle-ment	clem-ent
righ-teous	right-eous
wea-p-on	weap-on
con-trast-ing	contrasting
lisp-ing	lis-ping
fev-er-ish	fe-ver-ish
bould-er	boul-der
el-se-where	else-where
ca-ter-waul	cat-er-waul
dis-fi-gure	dis-fig-ure
cru-el-t-y	cru-el-ty
cra-v-at	cra-vat
jewel	jew-el
pie-z-oe-lec-tric	pi-e-zo-e-lec-tric
re-mar-ri-age	re-mar-riage
can-al	ca-nal
moto-r-ist	mo-tor-ist
hostel-ry	hos-tel-ry
com-pli-men-tar-y	com-pli-men-ta-ry
can-vas-s-er	can-vass-er
mon-as-tic	mo-nas-tic
ki-lo-volt	kil-o-volt
quad-rup-ly	quad-ru-ply
pout-ing	pouting
cate-go-ry	cat-e-go-ry
in-nov-a-tive	in-no-va-tive
beje-wel	be-jew-el
un-de-to-nat-ed	un-det-o-nat-ed
statu-ette	stat-u-ette
pho-nem-ic	pho-ne-mic
screwdriv-er	screw-driv-er
se-vent-y	sev-en-ty
seas-cape	sea-scape
en-durance	en-dur-ance
tid-i-ness	ti-di-ness
stinking	stink-ing
mag-ne-si-a	mag-ne-sia
in-di-ges-t-i-ble	in-di-gest-i-ble
dis-tas-te-ful	dis-taste-ful
ca-n-ar-y	ca-nar-y
e-lec-to-r-al	e-lec-tor-al
ide-o-log-i-cal	i-de-o-log-i-cal
moral	mor-al
tamp-er	tam-per
Words with errors: 1276
Words with incorrect number of syllables: 691
Total evluated: 6500
Perfect accuracy: 0.80
Number of syllables accuracy: 0.89
Average Levenshtein Distance(across incorrect words): 1.15
