Attempt	Real
de-mo	dem-o
school-mas-t-er	school-mas-ter
pri-m-al	pri-mal
sil-vered	silvered
how-it-zer	how-itz-er
green-gro-c-er	green-gro-cer
thirsty	thirst-y
ha-bi-t-u-a-tion	ha-bit-u-a-tion
un-der-devel-oped	un-der-de-vel-oped
sacred	sa-cred
sol-i-cit-ing	soliciting
un-doing	un-do-ing
chart-er	char-ter
im-per-vious	im-per-vi-ous
te-le-ol-o-gy	tel-e-ol-o-gy
craz-i-ness	cra-zi-ness
mi-n-a-r-et	min-a-ret
mi-cro-com-put-er	mi-cro-com-pu-ter
prin-tout	print-out
rains-wept	rain-swept
not-a-bly	no-ta-bly
meg-alith	meg-a-lith
brigand	brig-and
pla-giar-ism	pla-gia-rism
mar-ch-er	march-er
nit-rous	ni-trous
un-in-fluenced	un-in-flu-enced
pro-create	pro-cre-ate
nec-ro-manc-er	nec-ro-man-cer
oyster	oys-ter
laun-d-er	laun-der
nob-o-dy	no-bod-y
law-b-reak-er	law-break-er
bow-s-prit	bow-sprit
crooked	crook-ed
pu-mice	pum-ice
sub-stan-dard	sub-stand-ard
gaze-lle	ga-zelle
deb-tor	debt-or
non-chal-ant-ly	non-cha-lant-ly
darl-ing	dar-ling
pri-m-ar-y	pri-ma-ry
spi-rit-u-al-ist	spir-it-u-al-ist
chloro-form	chlo-ro-form
po-lym-er-ase	pol-y-mer-ase
rack-e-teer-ing	rack-et-eer-ing
neu-ro-nal	neu-ron-al
gol-f-er	golf-er
phy-t-o-plank-ton	phy-to-plank-ton
fru-it	fruit
scan-da-lous	scan-dal-ous
ca-sh-i-er	cash-ier
fore-ign	for-eign
fug-i-tive	fu-gi-tive
in-tert-wine	in-ter-twine
spon-sored	sponsored
der-i-so-ry	de-ri-so-ry
loun-g-er	loung-er
stu-died	stud-ied
de-spot	des-pot
re-deve-lop	re-de-vel-op
hu-mo-r-ous	hu-mor-ous
pier-c-er	pierc-er
geom-e-try	ge-om-e-try
bud-get	budg-et
pal-a-t-a-ble	pal-at-a-ble
coun-ter-ba-lance	coun-ter-bal-ance
in-frared	in-fra-red
det-ri-tus	de-tri-tus
in-ex-perienced	in-ex-pe-ri-enced
a-ba-cus	ab-a-cus
re-con-cile	rec-on-cile
ti-me-pi-ece	time-piece
pup-pe-teer	pup-pet-eer
car-pent-er	car-pen-ter
ap-para-tus	ap-pa-rat-us
com-pre-hen-s-i-ble	com-pre-hen-si-ble
or-bi-tal	or-bit-al
bir-die	bird-ie
can-dle-l-it	can-dle-lit
ca-v-er-nous	cav-ern-ous
ga-lop	gal-op
tel-e-vised	televised
pi-ece-me-al	piece-meal
ap-plic-a-bil-i-ty	ap-pli-ca-bil-i-ty
e-lec-to-r-al	e-lec-tor-al
mal-con-t-ent	mal-con-tent
blaspheme	blas-pheme
ref-it	re-fit
su-ba-tom-ic	sub-a-tom-ic
a-noth-er	an-oth-er
pep-pered	peppered
ri-bald	rib-ald
sur-real-ist	sur-re-al-ist
dow-ny	down-y
weakling	weak-ling
clo-s-et	clos-et
py-ra-mid	pyr-a-mid
sep-ul-chral	se-pul-chral
ov-er-act-ing	overacting
ly-ch-ee	ly-chee
lady-bug	la-dy-bug
throughout	through-out
bo-dy-guard	bod-y-guard
ty-pe-set-ter	type-set-ter
aor-ta	a-or-ta
snift-er	snif-ter
cu-tler	cut-ler
hear-th-rug	hearth-rug
eith-er	ei-ther
gal-e-na	ga-le-na
pro-ba-b-i-lis-tic	prob-a-bi-lis-tic
be-n-ign	be-nign
car-ci-no-gen-e-sis	car-cin-o-gen-e-sis
der-i-va-tive	de-riv-a-tive
limp-ing	limping
hor-se-pow-er	horse-pow-er
prev-a-l-ence	prev-a-lence
def-e-nes-tra-tion	de-fen-es-tra-tion
a-te-li-er	at-el-ier
un-ique	u-nique
is-o-th-er-mal	i-so-ther-mal
cloistered	clois-tered
slouch-ing	slouching
lon-g-ish	long-ish
haz-y	ha-zy
sig-ning	sign-ing
di-a-bol-ism	di-ab-o-lism
dais-y	dai-sy
as-tir	a-stir
sec-re-tive	se-cre-tive
with-ered	withered
re-per-toire	rep-er-toire
su-bur-bi-a	sub-ur-bi-a
com-mand-ant	com-man-dant
de-vil-ish-ly	dev-il-ish-ly
lamb-s-wool	lambs-wool
ves-ti-b-ule	ves-ti-bule
blust-er	blus-ter
par-a-ch-ut-ist	par-a-chut-ist
hor-n-y	horn-y
aro-math-er-a-py	a-ro-ma-ther-a-py
hau-lage	haul-age
ker-n-el	ker-nel
frizz-y	friz-zy
pad-ded	padded
har-shen	harsh-en
hau-li-er	haul-ier
lof-t-y	loft-y
mul-ti-pro-cess-ing	mul-ti-proc-ess-ing
lique-fy	liq-ue-fy
fer-mion	fer-mi-on
or-ga-nize	or-gan-ize
re-fu-sal	re-fus-al
so-loist	so-lo-ist
un-ea-s-i-ness	un-eas-i-ness
vil-lainy	vil-lain-y
gigg-ly	gig-gly
quad-ruped	quad-ru-ped
li-mou-sine	lim-ou-sine
geol-o-gy	ge-ol-o-gy
laun-dered	laundered
ir-re-par-a-ble	ir-rep-a-ra-ble
u-sury	u-su-ry
meg-as-tar	meg-a-star
slog-an	slo-gan
so-ci-a-bil-i-ty	so-cia-bil-i-ty
ma-n-y	man-y
i-o-n-o-sphere	i-on-o-sphere
bar-o-nage	bar-on-age
per-s-pi-cac-i-ty	per-spi-cac-i-ty
cros-stalk	cross-talk
sto-p-ov-er	stop-o-ver
co-ron-er	cor-o-ner
is-o-la-tion	i-so-la-tion
crystal	crys-tal
tempting	tempt-ing
pre-d-a-to-ry	pred-a-to-ry
re-cycl-a-ble	re-cy-cla-ble
pre-j-u-dice	prej-u-dice
fe-bru-ar-y	feb-ru-ar-y
ting-ly	tin-gly
head-master	head-mas-ter
nestling	nest-ling
dam-ning	damn-ing
burs-a-r-y	bur-sa-ry
pe-de-stri-an	pe-des-tri-an
in-de-ciph-er-a-ble	in-de-ci-pher-a-ble
en-count-er	en-coun-ter
ty-r-an-ny	tyr-an-ny
ou-ter-most	out-er-most
pre-mises	prem-is-es
me-l-od-ra-ma	mel-o-dra-ma
nav-y	na-vy
far-myard	farm-yard
hy-draul-ic	hy-drau-lic
cover-ing	cov-er-ing
e-p-is-tem-ic	ep-i-ste-mic
in-au-gur-ate	in-au-gu-rate
salad	sal-ad
trea-so-nous	trea-son-ous
ow-let	owl-et
pear-ly	pearl-y
un-creat-ed	un-cre-at-ed
tri-b-al	trib-al
re-ser-voir	res-er-voir
pro-spect	pros-pect
tech-no-pho-bi-a	tech-no-pho-bia
mod-esty	mod-es-ty
sin-g-er	sing-er
ov-er-anx-i-ous	o-ver-anx-ious
groom-ing	grooming
piv-ot-ed	pivoted
outly-ing	out-ly-ing
der-ange	de-range
fe-lon	fel-on
o-ra-tor-i-cal	or-a-tor-i-cal
em-bol-ism	em-bo-lism
ca-g-oule	ca-goule
bril-li-ant	bril-liant
pri-est-ess	priest-ess
vis-ion	vi-sion
ther-mod-y-nam-ics	ther-mo-dy-nam-ics
in-con-ve-ni-ent	in-con-ven-ient
coor-di-na-tion	co-or-di-na-tion
geisha	gei-sha
su-bun-it	sub-u-nit
no-tar-y	no-ta-ry
word-s-mith	word-smith
im-po-lit-ic	im-pol-i-tic
re-ci-div-ism	re-cid-i-vism
beat-i-tude	be-at-i-tude
im-per-so-na-tor	im-per-son-a-tor
waf-er	wa-fer
grotesque	gro-tesque
o-dys-sey	odyssey
aug-er	au-ger
ex-cru-ciat-ing	ex-cru-ci-at-ing
fin-al-ly	fi-nal-ly
re-cog-nize	rec-og-nize
em-bas-s-y	em-bas-sy
plum-ber	plumb-er
i-noc-u-la-tion	in-oc-u-la-tion
un-der-rat-ed	underrated
coef-fi-cient	co-ef-fi-cient
ob-lig-ing	o-blig-ing
pi-ran-ha	pi-ra-nha
pho-toc-o-py	pho-to-cop-y
be-r-eft	be-reft
re-ord-er	re-or-der
pol-y-and-ry	pol-y-an-dry
ne-o-n-a-tal	ne-o-na-tal
un-i-on	un-ion
swim-m-ing-ly	swim-ming-ly
stapes	sta-pes
dast-ard-ly	das-tard-ly
swind-ler	swin-dler
an-th-er	an-ther
an-tac-id	ant-ac-id
po-lit-ic	pol-i-tic
moor-h-en	moor-hen
dea-fen	deaf-en
bi-noc-u-lar	bin-oc-u-lar
hel-pline	help-line
ju-i-cy	juic-y
ven-al	ve-nal
ob-scur-i-ty	ob-scu-ri-ty
rem-it	re-mit
sub-ma-r-ine	sub-ma-rine
con-scien-tious-ness	con-sci-en-tious-ness
togeth-er-ness	to-geth-er-ness
twos-ome	two-some
stifl-ing	sti-fling
in-ve-i-gle	in-vei-gle
cred-i-t-a-ble	cred-it-a-ble
ge-no-cid-al	gen-o-cid-al
postlude	post-lude
pre-lude	prel-ude
ov-er-all	o-ver-all
in-de-ter-mi-n-a-ble	in-de-ter-mi-na-ble
vehe-ment	ve-he-ment
queas-y	quea-sy
trum-per-y	trump-er-y
tick-et-ed	ticketed
han-di-cap	hand-i-cap
upswing	up-swing
id-ly	i-dly
re-p-ri-mand	rep-ri-mand
wa-ter-me-lon	wa-ter-mel-on
smar-ten	smart-en
pol-lard-ed	pollarded
ante	an-te
rec-a-pit-u-late	re-ca-pit-u-late
glasses	glass-es
al-t-er	al-ter
whe-re-to	where-to
te-p-id	tep-id
mar-aud-ing	ma-raud-ing
lin-e-up	line-up
o-ver-crowd-ing	o-ver-crow-ding
mil-e-age	mile-age
so-ci-o-p-o-lit-i-cal	so-ci-o-po-lit-i-cal
cru-ise	cruise
her-biv-or-ous	her-biv-o-rous
con-duct-ed	conducted
im-pas-s-a-ble	im-pass-a-ble
ye-ti	yet-i
know-ledge-a-ble	knowl-edge-a-ble
pro-se-cu-tion	pros-e-cu-tion
con-fir-ma-to-ry	con-firm-a-to-ry
blus-ter-ing	blustering
ca-gey	cag-ey
di-p-lo-ma	di-plo-ma
pan-das	pan-das
brack-et-ed	bracketed
ho-me-com-ing	home-com-ing
gen-tri-fied	gentrified
gras-shop-per	grass-hop-per
armchair	arm-chair
de-bau-ch-er-y	de-bauch-er-y
rel-a-bel	re-la-bel
cys-teine	cys-te-ine
liquor-ish	liq-uor-ish
steep-le-chase	stee-ple-chase
clums-y	clum-sy
em-bit-tered	embittered
bar-b-er	bar-ber
sprawl-ing	sprawling
mer-chandise	mer-chan-dise
seg-ment-ed	seg-men-ted
mo-d-ern-ism	mod-ern-ism
pol-y-cry-s-tal-line	pol-y-crys-tal-line
en-ligh-t-en-ment	en-light-en-ment
glor-i-fied	glo-ri-fied
chi-val-rous	chiv-al-rous
fev-er-ish	fe-ver-ish
pres-ti-gious	pres-tig-ious
cam-a-ra-derie	ca-ma-ra-de-rie
dis-cred-it-ed	discredited
il-li-c-it-ly	il-lic-it-ly
poet	po-et
par-li-a-men-tar-i-an	par-lia-men-tar-i-an
glis-ten-ing	gli-ste-ning
maul-ing	mauling
ca-r-a-v-el	car-a-vel
ca-l-o-rie	cal-o-rie
sawy-er	saw-yer
shak-e-down	shake-down
par-i-ah	pa-ri-ah
con-toured	contoured
ig-nom-i-ny	ig-no-min-y
un-noticed	un-no-ticed
mas-t-er	mas-ter
e-s-prit	es-prit
crum-by	crumb-y
dis-grunt-led	dis-grun-tled
min-es-trone	min-e-stro-ne
bac-te-r-i-o-log-i-cal	bac-te-ri-o-log-i-cal
mi-li-ti-a-man	mi-li-tia-man
faul-ty	fault-y
nav-al	na-val
rivet-ing	riv-et-ing
re-joind-er	re-join-der
o-ver-worked	overworked
prop-el-lant	pro-pel-lant
in-ter-pret-a-tive	in-ter-pre-ta-tive
in-hab-i-tant	in-hab-it-ant
ar-chiv-ist	ar-chi-vist
vag-ue	vague
re-newed	renewed
psal-mist	psalm-ist
hyp-noth-er-a-py	hyp-no-ther-a-py
pay-master	pay-mas-ter
har-l-e-quin	har-le-quin
a-phe-lion	a-phe-li-on
gla-di-a-tor	glad-i-a-tor
mi-nu-tiae	mi-nu-ti-ae
sci-en-t-ist	sci-en-tist
spind-ly	spin-dly
mam-ma-l-i-an	mam-ma-li-an
ep-i-th-et	ep-i-thet
slend-er	slen-der
ge-lig-nite	gel-ig-nite
cor-ti-cos-ter-oid	cor-ti-co-ster-oid
real-ist	re-al-ist
pus-s-y	pus-sy
lag-g-ing	lag-ging
sec-on-d-ar-y	sec-ond-ar-y
mig-ra-to-ry	mi-gra-to-ry
brawny	brawn-y
bi-b-li-op-hile	bib-li-o-phile
ma-cro-bi-ot-ic	mac-ro-bi-ot-ic
eid-er	ei-der
ca-ter-pil-lar	cat-er-pil-lar
en-fran-ch-ise	en-fran-chise
su-bor-di-na-tion	sub-or-di-na-tion
us-urp-er	u-surp-er
pre-mise	prem-ise
eye-sha-dow	eye-shad-ow
di-sa-vow-al	dis-a-vow-al
locks-mith	lock-smith
sax-oph-o-n-ist	sax-o-phon-ist
dizzy	diz-zy
cog-nac	co-gnac
el-fin	elf-in
to-lu-ene	tol-u-ene
ta-v-ern	tav-ern
ty-pog-ra-phers	ty-po-gra-phers
bi-f-o-cal	bi-fo-cal
po-si-tiv-ism	pos-i-tiv-ism
dis-fi-gure	dis-fig-ure
sland-er	slan-der
bang-ing	banging
ge-r-on-tol-o-gy	ger-on-tol-o-gy
me-tal-lur-g-y	met-al-lur-gy
as-pi-rant	as-pir-ant
cop-i-lot	co-pi-lot
rel-o-cate	re-lo-cate
frow-ard	fro-ward
sa-tur-day	sat-ur-day
reg-e-late	re-ge-late
blun-der-ing	blundering
hor-mon-al	hor-mo-nal
con-spi-ra-tor	con-spir-a-tor
har-p-ists	har-pists
cat-er-er	ca-ter-er
lich-en	li-chen
glos-sa-r-y	glos-sa-ry
plu-m-age	plum-age
se-rai	se-ra-i
kind-ling	kin-dling
sea-going	sea-go-ing
joey	jo-ey
sold-er	sol-der
chint-zy	chintz-y
click-ing	clicking
ou-t-rank	out-rank
pec-car-y	pec-ca-ry
here-sy	her-e-sy
su-per-a-bund-ant	su-per-a-bun-dant
duckling	duck-ling
om-ni-pre-sence	om-ni-pres-ence
loc-o-mo-tion	lo-co-mo-tion
of-fend-ing	of-fen-ding
gar-t-er	gar-ter
pol-y-prop-y-lene	pol-y-pro-pyl-ene
sur-real-ism	sur-re-al-ism
note-pap-er	note-pa-per
un-trust-worth-y	un-trust-wor-thy
dec-i-ph-er	de-ci-pher
earth-quak-es	earth-quakes
en-chant-ed	enchanted
spec-tac-les	spec-ta-cles
pleat-ed	pleated
cu-b-it	cu-bit
u-n-o-rig-i-nal	un-o-rig-i-nal
rock-et-ing	rocketing
bril-li-ant-ly	bril-liant-ly
plen-teous	plen-te-ous
ga-lax-y	gal-ax-y
a-post-a-sy	a-pos-ta-sy
bride-s-maid	brides-maid
haird-ress-ing	hair-dress-ing
reu-nite	re-u-nite
e-num-er-ate	e-nu-mer-ate
ge-la-tin	gel-a-tin
cuddly	cud-dly
co-n-un-drum	co-nun-drum
scler-o-sis	scle-ro-sis
crem-a-to-ri-um	cre-ma-to-ri-um
crea-tor	cre-a-tor
ca-va-l-i-er	cav-a-lier
har-an-gue	ha-rangue
vig-o-r-ous	vig-or-ous
de-v-as-ta-tion	dev-as-ta-tion
con-fi-d-ant	con-fi-dant
un-in-for-ma-tive	un-in-form-a-tive
parabo-loid	pa-rab-o-loid
fes-tiv-al	fes-ti-val
un-der-car-ri-age	un-der-car-riage
a-s-i-nine	as-i-nine
vic-er-oy	vice-roy
col-o-nel	colo-nel
know-ledge	knowl-edge
par-al-le-lep-iped	par-al-lel-e-pi-ped
re-sidue	res-i-due
hon-e-y-comb	hon-ey-comb
boot-y	boo-ty
wail-ing	wailing
in-ver-ter	in-vert-er
ele-phant	el-e-phant
ho-m-o-pho-bi-a	ho-mo-pho-bi-a
mea-sure-ment	meas-ure-ment
clan-n-ish	clan-nish
mul-tip-li-ca-tion	mul-ti-pli-ca-tion
hy-per-bole	hy-per-bo-le
un-rep-re-sen-t-a-tive	un-rep-re-sent-a-tive
bar-ge-pole	barge-pole
ear-pi-ece	ear-piece
warthog	wart-hog
clash-ing	clashing
for-fe-it	for-feit
re-word-ings	re-word-ings
con-ge-ni-al	con-gen-ial
halo	ha-lo
humb-ly	hum-bly
raf-t-er	raft-er
cor-dil-lera	cor-dil-le-ra
val-ence	va-lence
tran-scon-ti-nen-tal	trans-con-ti-nen-tal
wal-k-ov-er	walk-o-ver
hyp-no-t-ism	hyp-no-tism
in-sa-ti-a-ble	in-sa-tia-ble
tri-bes-pe-o-ple	tribes-peo-ple
preamp	pre-amp
he-li-os-phere	he-li-o-sphere
po-licy-hold-er	pol-i-cy-hold-er
mon-og-a-my	mo-nog-a-my
im-a-gine	im-ag-ine
sphyg-mom-a-nom-e-ter	sphyg-mo-ma-nom-e-ter
sub-sid-y	sub-si-dy
lightheart-ed	light-heart-ed
leg-a-tor	le-ga-tor
cus-to-mar-y	cus-tom-ar-y
laz-i-ness	la-zi-ness
pap-a-cy	pa-pa-cy
in-ter-pol-at-a-ble	in-ter-po-la-ta-ble
charade	cha-rade
for-a-men	fo-ra-men
canter	can-ter
do-zen	doz-en
dem-o-nol-o-gy	de-mon-ol-o-gy
pi-ti-a-ble	pit-i-a-ble
smal-l-ish	small-ish
ir-re-voc-a-bly	ir-rev-o-ca-bly
ye-ast-y	yeast-y
bat-ter-ing	battering
ma-c-ro	mac-ro
in-ad-ver-tent-ly	in-ad-vert-ent-ly
ven-o-mous	ven-om-ous
mor-d-ant	mor-dant
qua-s-ar	qua-sar
chid-ing	chiding
om-ni-po-tence	om-nip-o-tence
chinoi-ser-ie	chi-noi-se-rie
fid-ge-ty	fidg-et-y
cham-pion	cham-pi-on
qui-n-ine	qui-nine
pos-thu-mous-ly	post-hu-mous-ly
trust-worth-y	trust-wor-thy
poet-ic	po-et-ic
nat-u-rist	na-tur-ist
lind-en	lin-den
hu-merus	hu-mer-us
a-n-y-one	an-y-one
tum-bled	tumbled
in-tract-a-ble	in-trac-ta-ble
per-sis-tent-ly	per-sist-ent-ly
be-d-rag-gled	be-drag-gled
de-r-ail-ment	de-rail-ment
di-ath-er-my	di-a-ther-my
in-ac-cu-r-a-cy	in-ac-cu-ra-cy
u-n-i-tar-y	u-ni-tar-y
de-vil-ment	dev-il-ment
un-e-dit-ed	un-ed-it-ed
un-con-trol-l-a-bly	un-con-trol-la-bly
re-con-cil-a-ble	rec-on-cil-a-ble
ar-is-to-crat-ic	a-ris-to-crat-ic
ly-rist	lyr-ist
sal-a-mi	sa-la-mi
re-con-fi-gure	re-con-fig-ure
ele-ment	el-e-ment
per-meate	per-me-ate
vitre-ous	vit-re-ous
proac-tive	pro-ac-tive
ne-o-l-o-gism	ne-ol-o-gism
earthling	earth-ling
in-sep-ar-a-ble	in-sep-a-ra-ble
in-au-g-u-ra-tion	in-au-gu-ra-tion
mo-d-est	mod-est
er-stwhile	erst-while
clien-tele	cli-en-tele
broken	bro-ken
ar-ch-er	arch-er
bar-bed	barbed
in-sis-tent	in-sist-ent
nif-t-y	nif-ty
wrestler	wres-tler
flut-ter-ing	fluttering
mi-l-i-eu	mi-lieu
wiz-ar-d-ry	wiz-ard-ry
news-pa-p-er	news-pa-per
gon-do-li-er	gon-do-lier
for-e-thought	fore-thought
pid-gin	pidg-in
li-ber-ty	lib-er-ty
thudding	thud-ding
ir-rel-e-v-ance	ir-rel-e-vance
pe-de-stal	ped-es-tal
ra-pine	rap-ine
ple-b-is-cite	pleb-i-scite
scan-ty	scant-y
cro-zi-er	cro-zier
real-ism	re-al-ism
gold-s-mith	gold-smith
in-con-sis-ten-cy	in-con-sist-en-cy
im-pe-net-ra-ble	im-pen-e-tra-ble
re-voc-a-ble	rev-o-ca-ble
un-sol-i-cit-ed	un-so-lic-it-ed
i-mag-i-nar-y	im-ag-i-nar-y
pol-y-car-bo-nate	pol-y-car-bon-ate
un-nerv-ing	unnerving
gre-n-ade	gre-nade
a-so-ci-al	a-so-cial
pro-tean	pro-te-an
vex-ing	vexing
sis-al	si-sal
con-va-lescence	con-va-les-cence
mil-d-ew-y	mil-dew-y
che-val-i-er	chev-a-lier
spi-rit-u-al-ism	spir-it-u-al-ism
ex-tra-galac-tic	ex-tra-ga-lac-tic
ar-t-istry	art-ist-ry
rho-do-dend-ron	rho-do-den-dron
bet-ro-thal	be-troth-al
stoa	sto-a
in-ter-nu-clear	in-ter-nu-cle-ar
com-pli-men-tar-y	com-pli-men-ta-ry
ta-lent	tal-ent
trim-m-er	trim-mer
glo-r-y	glo-ry
ty-r-an-ni-cide	ty-ran-ni-cide
wreck-ing	wrecking
sa-tin-wood	sat-in-wood
fruit-ing	fruiting
howd-y	how-dy
ey-e-pi-ece	eye-piece
pa-r-al-lel-ism	par-al-lel-ism
lab-y-rinthine	lab-y-rin-thine
boat-h-ouse	boat-house
ho-n-our	ho-nour
needle	nee-dle
sa-b-er	sa-ber
con-trast-ing	contrasting
chate-au	cha-teau
psy-ch-o-log-i-cal-ly	psy-cho-log-i-cal-ly
clim-ber	climb-er
ar-gua-bly	ar-gu-a-bly
bub-ble-g-um	bub-ble-gum
vide-o-con-fer-enc-ing	vid-e-o-con-fer-enc-ing
mild-ew	mil-dew
bastard	bas-tard
ex-tram-u-ral	ex-tra-mu-ral
truncheon	trun-cheon
im-pri-son	im-pris-on
gre-n-a-di-er	gren-a-dier
napk-in	nap-kin
in-e-luct-a-ble	in-e-luc-ta-ble
ca-mouf-lage	cam-ou-flage
se-ven-teenth	sev-en-teenth
ile-um	il-e-um
sat-i-ny	sat-in-y
de-r-og-a-to-ry	de-rog-a-to-ry
qua-ter-nion	qua-ter-ni-on
dec-i-sive-ly	de-ci-sive-ly
con-ser-va-tive	con-serv-a-tive
hy-g-ro-scop-ic	hy-gro-scop-ic
wal-l-a-by	wal-la-by
re-luc-t-ant-ly	re-luc-tant-ly
tho-rough-bred	thor-ough-bred
ca-v-ern	cav-ern
u-p-right	up-right
me-t-er	me-ter
col-lec-tiv-i-sa-tion	col-lec-ti-vi-sa-tion
per-so-n-al-ly	per-son-al-ly
paup-er	pau-per
tran-s-la-tion	trans-la-tion
mas-ca-ra	mas-car-a
be-lon-g-ings	be-long-ings
un-plea-s-ant	un-pleas-ant
phi-l-o-soph-i-cal-ly	phil-o-soph-i-cal-ly
mata-dor	mat-a-dor
me-r-i-no	me-ri-no
til-lage	till-age
vel-o-drome	ve-lo-drome
ring-mast-er	ring-mas-ter
in-vo-lun-tar-i-ly	in-vol-un-tar-i-ly
freck-led	freckled
scruf-f-y	scruff-y
we-d-lock	wed-lock
o-nyx	on-yx
pain-stak-ing-ly	pains-tak-ing-ly
g-nu	gnu
nu-clear	nu-cle-ar
tel-e-sa-les	tel-e-sales
bur-gun-d-y	bur-gun-dy
in-ter-go-vern-men-tal	in-ter-gov-ern-men-tal
blood-thirsty	blood-thirst-y
so-ci-al	so-cial
tra-verse	trav-erse
so-ci-al-ly	so-cial-ly
se-venth	sev-enth
cor-ny	corn-y
co-au-t-hor	co-au-thor
com-ba-tant	com-bat-ant
ne-verthe-less	nev-er-the-less
dorm-er	dor-mer
vo-lun-tar-i-ly	vol-un-tar-i-ly
sep-ar-a-ble	sep-a-ra-ble
trea-s-ur-er	treas-ur-er
isosce-les	i-sos-ce-les
mo-r-a-to-ri-um	mor-a-to-ri-um
cro-n-y	cro-ny
town-spe-o-ple	towns-peo-ple
grand-daught-er	grand-daugh-ter
vig-nette	vi-gnette
mut-ter-ing	muttering
ran-co-r-ous	ran-cor-ous
sui-ci-dal	su-i-cid-al
es-ta-blished	es-tab-lished
con-demned	condemned
nonsmok-ing	non-smok-ing
wav-er	wa-ver
moped	mo-ped
go-v-ern	gov-ern
ap-pli-c-a-tive	ap-pli-ca-tive
in-ex-or-a-ble	in-ex-o-ra-ble
anx-i-ous-ly	anx-ious-ly
no-neth-e-less	none-the-less
nove-list	nov-el-ist
dis-tri-bute	dis-trib-ute
tsu-n-a-mi	tsu-na-mi
sus-pend-ed	sus-pen-ded
un-dec-id-a-ble	un-de-cid-a-ble
mon-as-tic	mo-nas-tic
ba-l-a-laika	bal-a-lai-ka
glam-o-rous	glam-or-ous
ri-c-o-chet	ric-o-chet
od-d-ly	odd-ly
ru-i-n-ous	ru-in-ous
el-i-g-i-ble	el-i-gi-ble
di-he-d-ral	di-he-dral
sing-ly	sin-gly
di-ame-ter	di-am-e-ter
re-mast-er	re-mas-ter
roast-ed	roasted
syl-log-ism	syl-lo-gism
ci-ty	cit-y
an-teat-er	ant-eat-er
sex-tu-p-let	sex-tu-plet
vis-i-ta-tion	vis-it-a-tion
gir-der	gird-er
de-signing	de-sign-ing
me-chan-is-tic	mech-a-nis-tic
inan-i-mate	in-an-i-mate
unknow-ing	un-know-ing
sig-ner	sign-er
fro-lic-some	frol-ic-some
downswing	down-swing
mo-le-cule	mol-e-cule
sep-a-r-ate	sep-a-rate
ov-er-ac-tive	o-ver-ac-tive
ze-n-ith	ze-nith
priv-a-cy	pri-va-cy
nit-ro-gen	ni-tro-gen
ap-o-lit-i-cal	a-po-lit-i-cal
ev-er-ything	eve-ry-thing
lem-o-nade	lem-on-ade
trel-lised	trellised
sac-charin	sac-cha-rin
spee-dom-e-ter	speed-om-e-ter
bal-ler-i-na	bal-le-ri-na
shor-ten-ing	short-en-ing
her-oin	her-o-in
tas-te-ful-ly	taste-ful-ly
coev-al	co-e-val
pro-tect-ed	protected
hi-b-er-na-tion	hi-ber-na-tion
in-tel-lig-i-bil-i-ty	in-tel-li-gi-bil-i-ty
tran-sa-tlan-t-ic	trans-at-lan-tic
ex-pen-di-ture	ex-pend-i-ture
gib-ber-ing	gibbering
co-ro-nal	cor-o-nal
dinghy	din-ghy
sain-tli-ness	saint-li-ness
ge-nu-ine-ness	gen-u-ine-ness
some-bo-dy	some-bod-y
re-scue	res-cue
pul-lov-er	pull-o-ver
de-si-r-a-bil-i-a	de-si-ra-bi-li-a
pe-riod	pe-ri-od
an-ci-ent	an-cient
fru-it-ful	fruit-ful
tigh-trope	tight-rope
fac-e-plate	face-plate
un-furn-ished	un-fur-nished
dis-pen-s-er	dis-pens-er
arch-de-a-con	arch-dea-con
evening	eve-ning
freewheel-ing	free-wheel-ing
bi-ochem-is-try	bi-o-chem-is-try
re-par-tee	rep-ar-tee
con-flict-ed	conflicted
bar-ba-ri-an	bar-bar-i-an
a-rid	ar-id
cer-em-o-ny	cer-e-mo-ny
fizzy	fizz-y
car-ni-v-or-ous	car-niv-o-rous
hast-en	has-ten
dwind-ling	dwindling
poem	po-em
non-cha-l-ant	non-cha-lant
hye-na	hy-e-na
bes-tir	be-stir
whim-p-er	whim-per
bart-er	bar-ter
any-how	an-y-how
de-brief-ing	debriefing
broad-s-word	broad-sword
pa-rox-ysm	par-ox-ysm
char-it-a-bly	char-i-ta-bly
cutthroat	cut-throat
tailspin	tail-spin
an-te-d-i-lu-vi-an	an-te-di-lu-vi-an
per-qui-s-ite	per-qui-site
masthead	mast-head
het-er-o-ge-n-e-i-ty	het-er-o-ge-ne-i-ty
un-k-now-a-ble	un-know-a-ble
laag-er	laa-ger
disheart-ened	dis-hear-tened
cre-dit-worth-i-ness	cred-it-wor-thi-ness
ge-noa	gen-o-a
eg-o-t-ism	e-go-tism
nic-e-ty	ni-ce-ty
righ-teous-ness	right-eous-ness
fal-len	fall-en
gan-g-land	gang-land
caul-d-ron	caul-dron
be-r-ate	be-rate
o-ra-to-ry	or-a-to-ry
tend-er	ten-der
car-ci-n-o-gen	car-cin-o-gen
la-z-y	la-zy
cu-tler-y	cut-ler-y
de-vil-ry	dev-il-ry
con-temp-ti-ble	con-tempt-i-ble
foghorn	fog-horn
bew-itch-ing	bewitching
ru-l-er	rul-er
me-te-o-rol-o-gy	me-te-or-ol-o-gy
ex-a-mine	ex-am-ine
o-range	or-ange
i-s-om-er	i-so-mer
bet-i-mes	be-times
purblind	pur-blind
mo-re-ov-er	more-o-ver
gor-ge-ous-ly	gor-geous-ly
fe-cun-d-i-ty	fe-cun-di-ty
eer-i-ly	ee-ri-ly
e-le-v-en	e-lev-en
bull-do-z-er	bull-doz-er
oak-um	oa-kum
un-as-so-ciat-ed	un-as-so-ci-at-ed
re-f-er	re-fer
so-lemn	sol-emn
non-con-for-m-i-ty	non-con-form-i-ty
bra-dawl	brad-awl
bask-et	bas-ket
a-s-ym-met-ri-cal	a-sym-met-ri-cal
prep-ar-a-tive	pre-par-a-tive
pe-net-ra-ble	pen-e-tra-ble
ar-ch-er-y	ar-cher-y
cas-i-no	ca-si-no
meth-o-d-o-log-i-cal	meth-od-o-log-i-cal
es-ca-p-ist	es-cap-ist
ea-syg-oing	eas-y-go-ing
tu-n-ic	tu-nic
fidd-ly	fid-dly
con-ser-va-to-ry	con-serv-a-to-ry
pre-r-og-a-tive	pre-rog-a-tive
bis-t-a-ble	bi-sta-ble
strud-el	stru-del
rheu-mat-ism	rheu-ma-tism
ni-t-rog-e-nous	ni-trog-e-nous
clustered	clus-tered
spid-er-y	spi-der-y
as-so-n-ance	as-so-nance
cau-sa-tive	caus-a-tive
e-s-o-ter-i-ca	es-o-ter-i-ca
as-tig-mat-ism	a-stig-ma-tism
snoop-ing	snooping
here-t-o-fore	here-to-fore
un-pro-noun-ce-a-ble	un-pro-nounce-a-ble
ul-c-er	ul-cer
pol-ic-ing	policing
for-m-er-ly	for-mer-ly
feal-ty	fe-al-ty
pa-na-cea	pan-a-ce-a
head-pi-ece	head-piece
an-tler	ant-ler
black-ened	blackened
se-mi-f-i-nal	sem-i-fi-nal
bal-my	balm-y
whim-per-ing	whimpering
lan-guo-r-ous	lan-guor-ous
trans-pire	tran-spire
pan-ties	pant-ies
o-ra-tor	or-a-tor
li-ber-tine	lib-er-tine
tripod	tri-pod
mul-ti-p-li-ca-tive	mul-ti-pli-ca-tive
im-ba-lance	im-bal-ance
un-i-sex	u-ni-sex
holdup	hold-up
chartered	char-tered
me-ri-di-an	me-rid-i-an
astray	a-stray
phea-s-ant	pheas-ant
bit-ters-weet	bit-ter-sweet
un-nec-es-sa-r-y	un-nec-es-sar-y
fu-n-er-ar-y	fu-ner-ar-y
clov-er	clo-ver
ma-cro-ec-o-nom-ic	mac-ro-ec-o-nom-ic
bene-fac-tress	ben-e-fac-tress
ty-pist	typ-ist
whiz-kids	whizkids
ask-ance	a-skance
pre-dict-ed	predicted
pren-a-tal	pre-na-tal
ro-tar-y	ro-ta-ry
dam-pen	damp-en
pander	pan-der
ma-lad-mi-n-is-tra-tion	mal-ad-min-is-tra-tion
i-s-o-tope	i-so-tope
dec-i-sive	de-ci-sive
rost-er	ros-ter
strug-gling	struggling
se-mi-co-lon	sem-i-co-lon
mul-ti-pro-ces-sor	mul-ti-proc-es-sor
ba-lust-er	bal-us-ter
proph-y-lax-is	pro-phy-lax-is
per-sev-er-ance	per-se-ver-ance
fi-ef-dom	fief-dom
ca-ter-waul	cat-er-waul
tran-sceiv-er	trans-ceiv-er
be-lle	belle
ye-a	yea
ex-ec-u-t-a-ble	ex-e-cut-a-ble
flooz-y	floo-zy
pap-y-rus	pa-py-rus
ca-cao	ca-ca-o
ri-b-al-d-ry	rib-ald-ry
trink-et	trin-ket
dah-li-a	dahl-ia
imp-ly	im-ply
groc-er-y	gro-cer-y
ob-scur-ant-ist	ob-scu-rant-ist
man-a-ger	man-ag-er
pri-est-ly	priest-ly
zoop-lank-ton	zo-o-plank-ton
author-ship	au-thor-ship
prol-e-tar-i-an	pro-le-tar-i-an
em-bell-ish	em-bel-lish
bi-er	bier
el-ven	elv-en
ra-c-ist	rac-ist
han-dov-er	hand-o-ver
dur-a-ble	du-ra-ble
preor-dained	preordained
eq-uita-ble	eq-ui-ta-ble
psy-cho-th-er-a-pist	psy-cho-ther-a-pist
part-y	par-ty
pu-tre-scent	pu-tres-cent
wea-pon	weap-on
wretched	wretch-ed
rav-e-nous	rav-en-ous
town-s-folk	towns-folk
dan-ce-a-ble	dance-a-ble
ar-mis-tice	ar-mi-stice
tran-s-cend-ence	tran-scend-ence
voy-eur	vo-yeur
mal-ev-o-lent	ma-lev-o-lent
o-ra-to-ri-o	or-a-to-ri-o
lau-da-to-ry	laud-a-to-ry
sed-i-men-tar-y	sed-i-men-ta-ry
un-derf-loor	un-der-floor
imag-i-na-ble	im-ag-i-na-ble
nob-ly	no-bly
ede-ma	e-de-ma
sago	sa-go
dis-e-qui-li-bri-um	dis-e-qui-lib-ri-um
mon-o-l-o-gue	mon-o-logue
pos-thu-mous	post-hu-mous
e-c-on-o-met-rics	e-con-o-met-rics
o-do-rif-er-ous	o-dor-if-er-ous
re-spite	res-pite
fur-rowed	furrowed
man-s-laught-er	man-slaugh-ter
white-washed	whitewashed
pean-ut	pea-nut
cole-s-law	cole-slaw
mag-net-o-sphere	mag-ne-to-sphere
with-dra-wal	with-draw-al
ca-t-like	cat-like
e-ma-ciat-ed	e-ma-ci-at-ed
ped-ag-o-gy	ped-a-go-gy
bogey-man	bo-gey-man
rei-fy	re-i-fy
eu-ph-o-ny	eu-pho-ny
ex-tend-ing	extending
laugh-t-er	laugh-ter
ed-it-ed	edited
har-v-est	har-vest
booby	boo-by
o-ver-writ-ing	overwriting
skys-crap-er	sky-scrap-er
o-ver-reacts	o-ver-re-acts
un-de-livered	un-de-liv-ered
hi-th-er-to	hith-er-to
cup-rous	cu-prous
re-tic-ule	ret-i-cule
hy-p-o-thet-i-cal	hy-po-thet-i-cal
han-gar	hang-ar
lef-tov-er	left-o-ver
phosphor	phos-phor
hear-t-i-ly	heart-i-ly
harb-in-g-er	har-bin-ger
sun-tanned	suntanned
sau-ce-pan	sauce-pan
ri-di-cule	rid-i-cule
su-per-int-end	su-per-in-tend
ov-er-act	o-ver-act
tur-na-round	turn-a-round
trans-pi-ra-tion	tran-spi-ra-tion
la-rynx	lar-ynx
rac-e-track	race-track
ti-mes	times
pro-m-o-ter	pro-mot-er
com-mem-ora-tive	com-mem-o-ra-tive
voy-eu-ris-tic	voy-eur-is-tic
lan-gu-age	lan-guage
hatred	ha-tred
sal-mon	salm-on
hy-drome-chan-ics	hy-dro-me-chan-ics
org-y	or-gy
co-v-et	cov-et
biki-ni	bi-ki-ni
di-s-arm	dis-arm
sun-burned	sunburned
lighthead-ed	light-head-ed
work-s-ta-tion	work-sta-tion
rep-o-si-tion	re-po-si-tion
ovi-duct	o-vi-duct
ir-rit-a-ble	ir-ri-ta-ble
i-n-ept	in-ept
hob-go-blin	hob-gob-lin
beau-t-y	beau-ty
re-sig-na-tion	res-ig-na-tion
prop-o-nent	pro-po-nent
cou-sin	cous-in
me-lod-ra-mat-ic	mel-o-dra-mat-ic
gang-ly	gan-gly
out-lawed	outlawed
pas-s-age	pas-sage
diso-be-di-ence	dis-o-be-di-ence
cor-pse	corpse
mot-i-vate	mo-ti-vate
wick-etkeep-er	wick-et-keep-er
in-su-bor-di-na-tion	in-sub-or-di-na-tion
dis-fi-gure-ment	dis-fig-ure-ment
u-ni-on-i-sa-tion	un-ion-i-sa-tion
dis-ad-van-ta-ge-ous	dis-ad-van-ta-geous
rib-o-flav-in	ri-bo-fla-vin
un-dered-u-cat-ed	un-der-ed-u-cat-ed
ic-i-cle	i-ci-cle
pal-my	palm-y
pa-th-ol-o-gist	pa-thol-o-gist
tap-er	ta-per
di-oce-san	di-oc-e-san
o-ver-react	o-ver-re-act
re-con-cil-i-a-tion	rec-on-cil-i-a-tion
de-co	dec-o
pro-per-ty	prop-er-ty
mou-se-trap	mouse-trap
o-ver-wint-er	o-ver-win-ter
hide-ous	hid-e-ous
lo-goff	log-off
doc-to-rate	doc-tor-ate
si-byl	sib-yl
on-going	on-go-ing
gasket	gas-ket
re-gis-tra-ble	reg-is-tra-ble
aper-it-if	a-pe-ri-tif
lo-de-stone	lode-stone
ar-ri-v-al	ar-ri-val
con-tro-v-er-sy	con-tro-ver-sy
scrubland	scrub-land
dis-pirit-ing	dis-pir-it-ing
lad-y-bird	la-dy-bird
lin-ger-ie	lin-ge-rie
re-quis-ite	req-ui-site
po-lys-ty-rene	pol-y-sty-rene
ca-bin	cab-in
comp-troll-er	comp-trol-ler
mar-quet-ry	mar-que-try
ro-oi-bos	roo-i-bos
un-ae-sthet-ic	un-aes-thet-ic
tri-p-o-li	trip-o-li
fi-nale	fi-na-le
tig-er-ish	ti-ger-ish
va-c-il-la-tion	vac-il-la-tion
tri-bal-ism	trib-al-ism
big-o-try	big-ot-ry
sup-er-bly	su-perb-ly
dis-yl-la-ble	di-syl-la-ble
gar-n-er	gar-ner
e-n-er-vate	en-er-vate
dis-son-ance	dis-so-nance
mo-no-th-e-ism	mon-o-the-ism
in-ad-ver-tent	in-ad-vert-ent
qui-e-ten	qui-et-en
mishear	mis-hear
han-di-cap-ped	hand-i-capped
neo-nate	ne-o-nate
sen-hor	se-nhor
nov-em-ber	no-vem-ber
story-telling	sto-ry-tell-ing
coex-ten-sive	co-ex-ten-sive
cowshed	cow-shed
ter-na-r-y	ter-na-ry
godchild	god-child
paro-chi-al-ism	pa-ro-chi-al-ism
tran-s-verse	trans-verse
dar-e-devil	dare-dev-il
coast-ing	coasting
speech-i-fy-ing	speechifying
craf-t-y	craft-y
taunt-ing	taunting
daught-er	daugh-ter
us-urp	u-surp
ma-chete	ma-chet-e
forte	for-te
mi-di	mid-i
in-vo-lun-tar-y	in-vol-un-tar-y
om-ni-pre-sent	om-ni-pres-ent
teet-er	tee-ter
her-mi-tage	her-mit-age
tas-s-el	tas-sel
col-lab-o-r-a-tive	col-lab-o-ra-tive
hourg-lass	hour-glass
po-r-ous	po-rous
he-re-to	here-to
re-n-ew-a-ble	re-new-a-ble
spa-cey	spac-ey
o-ver-seer	o-ver-se-er
sub-ter-ra-nean	sub-ter-ra-ne-an
e-ver-y-one	eve-ry-one
va-sec-to-my	vas-ec-to-my
com-ba-tive	com-bat-ive
bullish	bull-ish
neut-er	neu-ter
ele-men-tary	el-e-men-ta-ry
yester-day	yes-ter-day
un-com-pli-men-tar-y	un-com-pli-men-ta-ry
la-tec-om-er	late-com-er
phant-a-sy	phan-ta-sy
su-bar-c-tic	sub-arc-tic
va-gue-ly	vague-ly
pam-ph-le-teer	pam-phlet-eer
feud-al	feu-dal
ev-er-y-day	eve-ry-day
sol-ic-it	so-lic-it
a-p-o-lo-gi-a	ap-o-lo-gi-a
whi-les	whiles
salv-er	sal-ver
cafe-te-ri-a	caf-e-te-ri-a
forger-y	for-ger-y
es-ca-pee	es-cap-ee
mi-le-stone	mile-stone
lack-a-da-is-i-cal	lack-a-dai-si-cal
ci-g-ar	ci-gar
def-a-ma-to-ry	de-fam-a-to-ry
po-tash	pot-ash
gus-ty	gust-y
mi-c-ro-code	mi-cro-code
ragged	rag-ged
dis-cip-li-nar-i-an	dis-ci-pli-nar-i-an
lit-to-r-al	lit-to-ral
cle-men-cy	clem-en-cy
cows-lip	cow-slip
flinch-ing	flin-ching
bet-ween	be-tween
co-mest-i-ble	co-mes-ti-ble
neon	ne-on
in-gra-tiat-ing	in-gra-ti-at-ing
dis-cre-pan-cy	dis-crep-an-cy
com-mo-nal-i-ty	com-mon-al-i-ty
cos-set-ed	cosseted
sapling	sap-ling
leghorn	leg-horn
pe-trel	pet-rel
as-leep	a-sleep
tid-y	ti-dy
louv-er	lou-ver
spen-c-er	spen-cer
a-po-calyp-tic	a-poc-a-lyp-tic
cre-scent	cres-cent
hyp-o-chon-dri-ac	hy-po-chon-dri-ac
cou-ra-ge-ous	cou-ra-geous
por-t-a-bil-i-ty	port-a-bil-i-ty
cog-no-scen-ti	co-gno-scen-ti
pron-ounced	pro-nounced
mech-an-ist	mech-a-nist
bount-y	boun-ty
mar-sh-land	marsh-land
guac-a-mole	gua-ca-mo-le
dim-er	di-mer
sun-ken	sunk-en
frenz-y	fren-zy
dea-fening	deaf-en-ing
in-vig-o-rate	in-vig-or-ate
da-m-age	dam-age
trade-marked	trademarked
bom-ber	bomb-er
fuch-si-a	fuch-sia
phos-pho-r-escence	phos-pho-res-cence
phot-o-syn-the-sis	pho-to-syn-the-sis
cap-a-bil-i-ty	ca-pa-bil-i-ty
e-lec-trod-y-nam-ics	e-lec-tro-dy-nam-ics
hide-ous-ly	hid-e-ous-ly
loo-sen	loos-en
pas-to-r-al	pas-to-ral
slal-om	sla-lom
com-par-a-bly	com-pa-ra-bly
de-b-a-cle	de-ba-cle
dis-mem-bered	dismembered
su-bop-ti-mal	sub-op-ti-mal
fath-er-ing	fathering
un-dif-fer-en-tiat-ed	un-dif-fer-en-ti-at-ed
te-n-an-cy	ten-an-cy
hef-t-y	heft-y
riv-al	ri-val
in-tegra-tive	in-te-gra-tive
a-pro-pos	ap-ro-pos
e-lec-troen-ce-phal-o-gram	e-lec-tro-en-ceph-a-lo-gram
proph-e-s-y	proph-e-sy
e-p-is-tle	e-pis-tle
idol-a-try	i-dol-a-try
cy-c-li-cal	cy-cli-cal
cir-cling	circling
tarot	ta-rot
bes-tow	be-stow
phys-i-oth-er-a-py	phys-i-o-ther-a-py
be-r-yl-li-um	be-ryl-li-um
ha-berd-ash-er-y	hab-er-dash-er-y
naive	na-ive
sav-ager-y	sav-age-ry
ce-t-a-cean	ce-ta-cean
val-ise	va-lise
smoth-ered	smothered
down-load-ed	downloaded
a-phro-di-si-ac	aph-ro-dis-i-ac
vehe-ment-ly	ve-he-ment-ly
na-po-leon	na-po-le-on
Words with errors: 1264
Words with incorrect number of syllables: 686
Total evluated: 6500
Perfect accuracy: 0.81
Number of syllables accuracy: 0.89
Average Levenshtein Distance(across incorrect words): 1.17
