Attempt	Real
as-tir	a-stir
surger-y	sur-ger-y
e-v-en-ly	e-ven-ly
dis-kette	disk-ette
mer-cur-ic	mer-cu-ric
de-scend-ing	descending
re-pro-duci-bly	re-pro-duc-i-bly
elvish	elv-ish
gad-get	gadg-et
phy-si-o-log-i-cal	phys-i-o-log-i-cal
heal-th-y	health-y
waspish	wasp-ish
se-r-o-to-nin	ser-o-to-nin
car-ri-age-way	car-riage-way
can-y-on	can-yon
there-un-d-er	there-un-der
in-cre-dul-i-ty	in-cre-du-li-ty
cud-gel	cudg-el
posse	pos-se
tel-e-sa-les	tel-e-sales
jux-tap-o-si-tion	jux-ta-po-si-tion
as-su-r-ance	as-sur-ance
im-port-ed	imported
an-yth-ing	an-y-thing
ti-til-la-tion	tit-il-la-tion
hered-i-tar-y	he-red-i-tar-y
ack-now-ledge	ac-knowl-edge
dach-shund	dachs-hund
hob-go-blin	hob-gob-lin
mar-kup	mark-up
in-tric-a-cy	in-tri-ca-cy
squa-lor	squal-or
the-ore-ti-cian	the-o-re-ti-cian
pan-th-er	pan-ther
pal-a-ta-ble	pal-at-a-ble
poem	po-em
tran-s-cen-den-tal	tran-scen-den-tal
flyov-er	fly-o-ver
can-al	ca-nal
cursed	curs-ed
pos-thu-mous-ly	post-hu-mous-ly
rhe-ostat	rhe-o-stat
louv-er	lou-ver
con-tin-u-i-ty	con-ti-nu-i-ty
ge-ogra-ph-er	ge-og-ra-pher
un-go-v-ern-a-ble	un-gov-ern-a-ble
de-crepit	de-crep-it
ga-se-ous	gas-e-ous
be-vel	bev-el
rede-ploy	re-de-ploy
grasshop-per	grass-hop-per
dei-ty	de-i-ty
wind-sur-fer	wind-surf-er
ig-nor-a-mus	ig-no-ra-mus
trans-plant-ed	transplanted
my-tho-log-i-cal	myth-o-log-i-cal
ther-mo-s-tat	ther-mo-stat
ci-t-y	cit-y
devel-o-per	de-vel-op-er
of-fhand	off-hand
myo-pi-a	my-o-pi-a
priss-y	pris-sy
glo-bal	glob-al
startling	star-tling
penk-nife	pen-knife
une-lect-a-ble	un-e-lect-a-ble
pro-spect	pros-pect
div-i-sive	di-vi-sive
bi-modal	bi-mod-al
de-lineate	de-lin-e-ate
bit-u-men	bi-tu-men
deca-pod	dec-a-pod
un-com-promis-ing	un-com-pro-mis-ing
nak-ed-ness	na-ked-ness
junk-er	jun-ker
bar-bar-ism	bar-ba-rism
cru-elty	cru-el-ty
bon-an-za	bo-nan-za
pro-tect-ed	protected
pri-s-on	pris-on
plac-a-to-ry	pla-ca-to-ry
globe-trotting	globe-trot-ting
con-tempti-ble	con-tempt-i-ble
el-fin	elf-in
vain-g-lo-ri-ous	vain-glo-ri-ous
con-vict-ed	convicted
swin-g-y	swing-y
mech-an-ist	mech-a-nist
poin-ty	point-y
dis-son-ant	dis-so-nant
su-p-ra-na-tion-al	su-pra-na-tion-al
mea-sure-ment	meas-ure-ment
drop-s-y	drop-sy
u-n-i-tar-y	u-ni-tar-y
gent-ly	gen-tly
cre-dul-i-ty	cre-du-li-ty
u-s-urp	u-surp
jal-o-py	ja-lop-y
spi-rit-u-al	spir-it-u-al
wa-gon	wag-on
ca-ter-waul	cat-er-waul
pome-lo	pom-e-lo
con-sul-tan-cy	con-sult-an-cy
smoth-ered	smothered
equita-bly	eq-ui-ta-bly
mic-ro-film	mi-cro-film
tre-mo-lo	trem-o-lo
govern-ing	governing
ma-ke-up	make-up
scan-da-lous	scan-dal-ous
cor-po-ra-tism	cor-po-rat-ism
rectan-gle	rec-tan-gle
ner-vy	nerv-y
ye-ti	yet-i
rearm	re-arm
cre-n-el-la-tions	cren-el-la-tions
sa-tur-nine	sat-ur-nine
phy-si-o-ther-a-pist	phys-i-o-ther-a-pist
bu-sy-bo-dy	bus-y-bod-y
treadle	trea-dle
her-bal-ist	herb-al-ist
rei-fy	re-i-fy
de-po-sit	de-pos-it
un-satis-fy-ing	un-sat-is-fy-ing
nove-lis-tic	nov-el-is-tic
god-for-sa-k-en	god-for-sak-en
cosset-ed	cosseted
frenz-y	fren-zy
proceed	pro-ceed
ca-n-oe	ca-noe
un-de-r-arm	un-der-arm
ween-y	wee-ny
sig-ners	sign-ers
bar-o-ness	bar-on-ess
a-waken-ing	a-wak-en-ing
dec-i-sive-ness	de-ci-sive-ness
un-devel-oped	un-de-vel-oped
pi-on-eer	pi-o-neer
pol-i-cewo-man	po-lice-wom-an
lemming	lem-ming
di-ploid	dip-loid
pon-y-tail	po-ny-tail
hys-te-r-ec-to-my	hys-ter-ec-to-my
bir-thright	birth-right
laund-er	laun-der
in-com-bust-i-ble	in-com-bus-ti-ble
met-er	me-ter
res-pir-a-tor	res-pi-ra-tor
burg-lar-y	bur-gla-ry
stripling	strip-ling
wor-m-y	worm-y
lit-er-a-ti	lit-e-ra-ti
de-ter-mi-nis-tic	de-ter-min-is-tic
el-sewh-ere	else-where
cap-rice	ca-price
in-er-ad-i-ca-ble	in-e-rad-i-ca-ble
ty-pog-ra-ph-ers	typographers
ste-th-o-scope	steth-o-scope
co-land-er	col-an-der
openhand-ed	o-pen-hand-ed
whee-lie	wheel-ie
phi-los-o-ph-er	phi-los-o-pher
duchess	duch-ess
bo-s-un	bo-sun
ic-i-cle	i-ci-cle
con-cussed	concussed
i-d-i-o-cy	id-i-o-cy
e-lec-to-rate	e-lec-tor-ate
a-to-mic-i-ty	at-o-mic-i-ty
pir-a-cy	pi-ra-cy
erup-tive	e-rup-tive
neu-t-er	neu-ter
re-sid-ue	res-i-due
bigot-ed	big-ot-ed
ca-vi-ar	cav-i-ar
in-ad-ver-tent	in-ad-vert-ent
nin-e-teen	nine-teen
at-tempt-ed	at-tempted
i-g-loo	ig-loo
bu-tler	but-ler
chartered	char-tered
platy-pus	plat-y-pus
whis-k-er	whisk-er
stiffly	stiff-ly
val-i-ant	val-iant
bi-vou-ac	biv-ou-ac
hatt-ed	hat-ted
word-s-mith	word-smith
not-i-fi-ca-tion	no-ti-fi-ca-tion
bar-bit-u-rate	bar-bi-tu-rate
tsetse	tset-se
pus-sy-cat	pussycat
scra-py-ard	scrap-yard
wes-ter-ly	west-er-ly
swin-geing	swinge-ing
non-chal-ant-ly	non-cha-lant-ly
gren-a-di-er	gren-a-dier
so-ci-o-p-o-lit-i-cal	so-ci-o-po-lit-i-cal
pael-la	pa-el-la
ex-tra-s-o-lar	ex-tra-so-lar
un-con-sidered	un-con-sid-ered
trans-finite	trans-fi-nite
uni-formed	u-ni-formed
bu-si-ness	busi-ness
foun-d-ry	found-ry
tur-na-r-ound	turn-a-round
breeches	breech-es
eag-er	ea-ger
sup-rem-a-cy	su-prem-a-cy
ragged	rag-ged
boathouse	boat-house
im-prov-ised	im-pro-vised
smelt-ing	smelting
nonsmok-ing	non-smok-ing
the-or-ist	the-o-rist
loo-s-en	loos-en
realign	re-a-lign
hol-i-ness	ho-li-ness
ka-t-y-did	ka-ty-did
be-drid-den	bed-rid-den
de-pen-den-cy	de-pend-en-cy
town-speo-ple	towns-peo-ple
zaire	za-ire
cig-arette	cig-a-rette
tech-no-pho-bi-a	tech-no-pho-bia
con-cate-na-tion	con-cat-e-na-tion
sugar-ing	sug-ar-ing
poet-i-cal-ly	po-et-i-cal-ly
wi-zened	wiz-ened
hege-mon-ic	heg-e-mon-ic
wor-d-y	word-y
jun-kyard	junk-yard
bour-ge-o-is	bour-geois
stalag-mite	sta-lag-mite
di-seq-ui-li-bri-um	dis-e-qui-lib-ri-um
in-es-capa-bly	in-es-cap-a-bly
wel-com-ing	welcoming
nove-list	nov-el-ist
e-so-ter-i-ca	es-o-ter-i-ca
i-nim-i-cal	in-im-i-cal
fore-cas-t-er	fore-cast-er
se-cond-hand	sec-ond-hand
fath-er	fa-ther
majest-y	maj-es-ty
e-v-en	e-ven
cu-p-rous	cu-prous
sier-ra	si-er-ra
final-ly	fi-nal-ly
sy-no-vi-al	syn-o-vi-al
fla-gon	flag-on
blo-w-up	blow-up
welt-er	wel-ter
me-ri-di-on-al	me-rid-i-o-nal
sa-la-am	sa-laam
sau-s-age	sau-sage
met-a-mor-phosed	metamorphosed
scan-ti-ly	scant-i-ly
le-gend	leg-end
pos-tal	post-al
par-a-chu-tist	par-a-chut-ist
crooked	crook-ed
de-si-rous	de-sir-ous
pro-lapsed	prolapsed
cap-a-ble	ca-pa-ble
micro-surger-y	mi-cro-sur-ger-y
swimming	swim-ming
cu-tout	cut-out
forte	for-te
cur-va-ce-ous	cur-va-ceous
shim-mer-ing	shimmering
me-l-o-dra-ma	mel-o-dra-ma
spa-cey	spac-ey
slant-ed	slanted
pro-mul-gate	prom-ul-gate
tele-pho-nist	te-leph-o-nist
prem-o-ni-tion	pre-mo-ni-tion
grou-pie	group-ie
ren-e-go-ti-a-tion	re-ne-go-ti-a-tion
smirk-ing	smirking
ac-cep-t-a-ble	ac-cept-a-ble
de-sir-a-bil-i-a	desirabilia
mis-creant	mis-cre-ant
twofaced	two-faced
re-con-fi-gure	re-con-fig-ure
fin-d-er	find-er
vi-tri-ol	vit-ri-ol
homo-pho-bi-a	ho-mo-pho-bi-a
wom-an-k-ind	wom-an-kind
tur-bocharged	turbocharged
con-fir-ma-to-ry	con-firm-a-to-ry
sere-nade	ser-e-nade
tran-sac-tion	trans-ac-tion
band-wa-gon	band-wag-on
in-fan-t-ry	in-fan-try
im-pro-p-er-ly	im-prop-er-ly
grie-v-ous-ly	griev-ous-ly
flin-tlock	flint-lock
lar-y-nx	lar-ynx
out-lawed	outlawed
im-po-lit-ic	im-pol-i-tic
un-de-r-es-ti-ma-tion	un-der-es-ti-ma-tion
me-te-o-r-o-log-i-cal	me-te-or-o-log-i-cal
or-bi-ter	or-bit-er
glo-b-al-ly	glob-al-ly
u-ni-p-o-lar	u-ni-po-lar
house-r-oom	house-room
cor-re-spon-d-ent	cor-re-spond-ent
stinger	sting-er
ca-va-li-er	cav-a-lier
lisp-ing	lisping
na-v-el	na-vel
lin-es-man	lines-man
arach-nid	a-rach-nid
par-then-o-gen-e-sis	par-the-no-gen-e-sis
mal-ig-nant	ma-lig-nant
vo-lun-tar-i-ly	vol-un-tar-i-ly
pro-p-er	prop-er
so-me-one	some-one
hip-podrome	hip-po-drome
cata-lep-sy	cat-a-lep-sy
par-en-tal	pa-ren-tal
whoev-er	who-ev-er
bi-s-on	bi-son
lef-tist	left-ist
dea-fen	deaf-en
con-sen-sual	con-sen-su-al
raf-t-er	raft-er
re-staur-a-teur	res-tau-ra-teur
u-phol-ster	up-hol-ster
blitzkrieg	blitz-krieg
re-a-son-a-bly	rea-son-a-bly
loess	lo-ess
syru-py	syr-up-y
pro-m-o-ter	pro-mot-er
a-po-s-tol-ic	ap-os-tol-ic
car-ess	ca-ress
naive	na-ive
vit-a-min	vi-ta-min
sober-ing	sobering
non-cha-l-ance	non-cha-lance
i-mag-i-nar-y	im-ag-i-nar-y
glis-t-en	glis-ten
ty-pist	typ-ist
un-super-vised	un-su-per-vised
sapling	sap-ling
un-sa-vo-ry	un-sa-vor-y
cop-ro-ces-sor	co-proc-es-sor
mimick-er	mim-ick-er
o-r-i-gami	o-ri-ga-mi
con-duct-ed	conducted
some-ti-mes	some-times
waterbed	wa-ter-bed
strid-ent	stri-dent
un-natu-ral	un-nat-u-ral
bi-noc-u-lars	bin-oc-u-lars
chalet	cha-let
cho-s-en	cho-sen
psy-choan-a-lyt-ic	psy-cho-an-a-lyt-ic
pol-y-e-ster	pol-y-es-ter
pam-ph-let	pam-phlet
pear-ly	pearl-y
chim-e-r-a	chi-me-ra
su-per-fi-cial-i-ty	su-per-fi-ci-al-i-ty
un-hindered	un-hin-dered
pari-e-tal	pa-ri-e-tal
re-r-un	re-run
stron-groom	strong-room
pen-et-ra-ble	pen-e-tra-ble
wol-fhound	wolf-hound
stif-fen-ing	stiff-en-ing
be-wild-er	be-wil-der
fan-cier	fan-ci-er
bas-ic	ba-sic
lumber-ing	lum-ber-ing
pros-th-e-sis	pros-the-sis
en-gineered	engineered
trunch-eon	trun-cheon
bire-frin-gent	bi-re-frin-gent
o-ran-gu-tan	o-rang-u-tan
an-ti-vi-r-al	an-ti-vi-ral
flee-cy	fleec-y
yearling	year-ling
gla-mour	glam-our
hau-lage	haul-age
shun-ter	shunt-er
tre-spass-er	tres-pass-er
aph-id	a-phid
tu-n-ic	tu-nic
bed-clo-thes	bed-clothes
pol-ys-ty-rene	pol-y-sty-rene
spher-oid	sphe-roid
waver-ing	wavering
fe-t-lock	fet-lock
elo-cu-tion	el-o-cu-tion
vil-la-ger	vil-lag-er
se-ni-or-i-ty	sen-ior-i-ty
axle	ax-le
coo-kie	cook-ie
predeter-mined	predetermined
but-tressed	buttressed
someth-ing	some-thing
tid-i-ness	ti-di-ness
bi-car-bon-ate	bi-car-bo-nate
di-a-ph-a-nous	di-aph-a-nous
ante	an-te
chemise	che-mise
con-ge-ni-al	con-gen-ial
o-leand-er	o-le-an-der
nit-rous	ni-trous
frigate	frig-ate
pere-grine	per-e-grine
su-p-reme	su-preme
de-spon-den-cy	de-spond-en-cy
dan-c-er	danc-er
li-brari-an	li-brar-i-an
pla-card	plac-ard
var-i-e-ty	va-ri-e-ty
ter-nar-y	ter-na-ry
re-du-ci-ble	re-duc-i-ble
voodoo	voo-doo
dis-mem-bered	dismembered
thousand	thou-sand
vehe-ment-ly	ve-he-ment-ly
scrib-bling	scribbling
ven-o-mous	ven-om-ous
com-pelling	com-pel-ling
burgun-dy	bur-gun-dy
ge-lig-nite	gel-ig-nite
sil-houette	sil-hou-ette
sel-f-ish	self-ish
drome-dar-y	drom-e-dar-y
pro-saic	pro-sa-ic
ex-ci-t-a-ble	ex-cit-a-ble
sa-v-ant	sa-vant
sten-o-sis	ste-no-sis
ood-les	oo-dles
co-r-o-na	co-ro-na
ar-chip-e-la-go	ar-chi-pel-a-go
un-pal-a-ta-ble	un-pal-at-a-ble
phos-pho-r-es-cence	phos-pho-res-cence
her-bal	herb-al
an-tiair-craft	an-ti-air-craft
re-gis-tra-ble	reg-is-tra-ble
vide-o-phone	vid-e-o-phone
during	dur-ing
qua-d-rat-ic	quad-rat-ic
col-lec-tiv-ely	col-lec-tive-ly
meow	me-ow
mea-s-ure	meas-ure
stron-ghold	strong-hold
une-ase	un-ease
cere-mo-ni-al	cer-e-mo-ni-al
scler-o-sis	scle-ro-sis
plu-my	plum-y
nov-em-ber	no-vem-ber
sys-te-mat-i-cal-ly	sys-tem-at-i-cal-ly
dumpling	dump-ling
re-fu-sal	re-fus-al
dis-gruntled	dis-grun-tled
as-pirin	as-pi-rin
skirmish-ing	skirmishing
huss-y	hus-sy
man-a-ger	man-ag-er
pi-per	pip-er
per-mit-ting	permitting
un-so-ci-a-ble	un-so-cia-ble
bar-becue	bar-be-cue
bron-chial	bron-chi-al
phen-o-type	phe-no-type
dow-d-y	dow-dy
fru-it-ful	fruit-ful
o-beis-ance	o-bei-sance
cud-d-ly	cud-dly
sup-rem-a-cist	su-prem-a-cist
hier-ar-ch-y	hi-er-ar-chy
phy-si-o-log-i-cal-ly	phys-i-o-log-i-cal-ly
laud-ed	lauded
ben-e-fi-ciar-y	ben-e-fi-ci-ar-y
de-cay-ing	decaying
ir-re-fut-a-ble	ir-ref-u-ta-ble
be-d-room	bed-room
ep-is-tle	e-pis-tle
in-ade-quate	in-ad-e-quate
un-ae-sthet-ic	un-aes-thet-ic
ou-tri-d-er	out-rid-er
in-vo-lun-tar-y	in-vol-un-tar-y
titled	ti-tled
i-n-ev-i-t-a-ble	in-ev-i-ta-ble
stu-died	stud-ied
per-ine-um	per-i-ne-um
sym-p-to-mat-ic	symp-to-mat-ic
dec-i-sive-ly	de-ci-sive-ly
for-er-un-ner	fore-run-ner
swee-tie	sweet-ie
boot-y	boo-ty
fil-th-y	filth-y
pho-to-co-pi-er	pho-to-cop-i-er
med-dling	meddling
tran-sceiv-er	trans-ceiv-er
rec-ti-lin-ear	rec-ti-lin-e-ar
be-si-des	be-sides
sy-rup	syr-up
ne-cro-po-lis	ne-crop-o-lis
pro-gressed	progressed
ste-plad-der	step-lad-der
tapestry	tap-es-try
test-y	tes-ty
vig-o-rous-ly	vig-or-ous-ly
in-te-r-op-er-a-bil-i-ty	in-ter-op-er-a-bil-i-ty
si-m-ile	sim-i-le
chir-o-prac-tor	chi-ro-prac-tor
coter-ie	co-te-rie
in-dec-o-r-ous	in-dec-o-rous
bin-ar-y	bi-na-ry
plas-t-er	plas-ter
sa-wy-er	saw-yer
farth-ing	far-thing
sa-t-yr	sa-tyr
cour-troom	court-room
pid-gin	pidg-in
dis-ord-er	dis-or-der
dea-fen-ing	deaf-en-ing
how-it-zer	how-itz-er
fi-nis	fin-is
i-di-o-s-yn-cra-sy	id-i-o-syn-cra-sy
un-secured	un-se-cured
church-war-den	church-ward-en
pold-er	pol-der
aor-tic	a-or-tic
chor-ist-er	chor-is-ter
me-t-a-b-o-lism	me-tab-o-lism
re-pe-al	re-peal
mar-in-er	mar-i-ner
horse-wh-ip	horse-whip
bar-barous	bar-ba-rous
cre-dit	cred-it
ev-er-y-where	eve-ry-where
hered-i-ty	he-red-i-ty
sum-ma-r-y	sum-ma-ry
over-bear-ing	o-ver-bear-ing
weanling	wean-ling
cool-ing	cooling
huf-f-y	huff-y
brie-fly	brief-ly
ro-s-ary	ro-sa-ry
ir-re-con-cila-ble	ir-rec-on-cil-a-ble
je-o-par-dy	jeop-ard-y
ig-u-a-na	i-gua-na
god-fath-er	god-fa-ther
wor-k-a-day	work-a-day
le-groom	leg-room
wo-man-ish	wom-an-ish
spirant	spi-rant
mi-cro-com-puter	mi-cro-com-pu-ter
glut-to-n-ous	glut-ton-ous
un-glam-o-r-ous	un-glam-or-ous
micro-fiche	mi-cro-fiche
mes-siah	mes-si-ah
te-nure	ten-ure
legged	leg-ged
re-ci-pi-ent	re-cip-i-ent
in-com-par-a-bly	in-com-pa-ra-bly
cog-nac	co-gnac
ta-hr	tahr
nutmeg	nut-meg
ner-vous	nerv-ous
seagull	sea-gull
sto-ny	ston-y
re-aw-ak-en	re-a-wak-en
coin-ci-dent	co-in-ci-dent
un-der-clo-thes	un-der-clothes
leg-a-lese	le-gal-ese
dis-con-tinue	dis-con-tin-ue
bub-bling	bubbling
wherew-i-th-al	where-with-al
con-tri-bu-tor	con-trib-u-tor
ven-al	ve-nal
so-b-er-ly	so-ber-ly
clat-ter-ing	cla-tter-ing
lib-e-ro	li-be-ro
chair-wo-man	chair-wom-an
ser-ene	se-rene
in-qui-s-i-to-ri-al	in-quis-i-to-ri-al
minke	min-ke
homo-pho-bic	ho-mo-pho-bic
lau-reate	lau-re-ate
em-body	em-bod-y
a-sym-me-t-ry	a-sym-me-try
un-a-l-ike	un-a-like
leav-ened	leavened
hast-en	has-ten
poignan-cy	poign-an-cy
ar-cha-e-op-ter-yx	ar-chae-op-ter-yx
sau-c-er	sau-cer
highlight	high-light
re-le-ase	re-lease
py-ram-id	pyr-a-mid
jun-kie	junk-ie
en-treat-ing	entreating
hier-o-glyph	hi-er-o-glyph
ma-ch-is-mo	ma-chis-mo
mus-ke-teer	mus-ket-eer
di-la-ta-tion	dil-a-ta-tion
di-v-er-gent	di-ver-gent
e-cho	ech-o
pup-pe-try	pup-pet-ry
com-men-ter	com-ment-er
o-ver-power-ing	o-ver-pow-er-ing
tran-slit-er-ate	trans-lit-er-ate
e-cu-me-nism	ec-u-me-nism
hamp-er	ham-per
rock-ing	rocking
la-cy	lac-y
min-der	mind-er
de-pen-d-a-bil-i-ty	de-pend-a-bil-i-ty
eith-er	ei-ther
tract-a-ble	trac-ta-ble
po-k-y	pok-y
chee-ri-o	cheer-i-o
pha-raoh	phar-aoh
hide-ous-ly	hid-e-ous-ly
cow-ar-dice	cow-ard-ice
mis-og-y-ny	mi-sog-y-ny
weav-ing	weaving
aor-ta	a-or-ta
be-ti-mes	be-times
ar-ti-fi-cial-i-ty	ar-ti-fi-ci-al-i-ty
pun-ter	punt-er
sec-to-ral	sec-tor-al
har-bing-er	har-bin-ger
doc-to-rate	doc-tor-ate
ca-tion	cat-i-on
number	num-ber
roo-m-y	room-y
e-m-er-gen-cy	e-mer-gen-cy
outra-geous-ly	out-ra-geous-ly
tro-ph-y	tro-phy
ap-proach-ing	approaching
rec-i-div-ism	re-cid-i-vism
gla-di-o-lus	glad-i-o-lus
a-pothe-car-y	a-poth-e-car-y
unk-now-a-ble	un-know-a-ble
man-i-ac	ma-ni-ac
de-tainee	de-tain-ee
vi-s-ion	vi-sion
ap-o-lit-i-cal	a-po-lit-i-cal
retro-spec-tive-ly	ret-ro-spec-tive-ly
in-dec-i-sive	in-de-ci-sive
for-mu-laic	for-mu-la-ic
lique-fy	liq-ue-fy
an-tide-pres-sant	an-ti-de-pres-sant
rollick-ing	rol-lick-ing
ou-t-rank	out-rank
prema-ture	pre-ma-ture
hiber-na-tion	hi-ber-na-tion
cor-ny	corn-y
e-qui-li-bri-um	e-qui-lib-ri-um
semidetached	sem-i-de-tached
in-com-par-a-ble	in-com-pa-ra-ble
un-noticed	un-no-ticed
hom-o-ge-ne-ous	ho-mo-ge-ne-ous
mar-ke-teer	mar-ket-eer
pray-er-ful	prayer-ful
wi-zard	wiz-ard
biped	bi-ped
dig-i-ta-lis	dig-i-tal-is
sheph-er-dess	shep-herd-ess
pro-b-le-mat-ic	prob-lem-at-ic
gi-an-tess	gi-ant-ess
lo-zenge	loz-enge
estranged	es-tranged
nin-e-tieth	nine-ti-eth
spil-lage	spill-age
ca-co-pho-nous	ca-coph-o-nous
tel-e-com-mut-ing	telecommuting
gloat-ing	gloating
em-ployed	employed
nec-ro-sis	ne-cro-sis
quest-ing	questing
throughout	through-out
ye-ster-day	yes-ter-day
dis-heart-ened	disheartened
un-a-dapted	un-a-dapt-ed
sing-ly	sin-gly
dairy-man	dair-y-man
man-g-er	man-ger
mag-net-o-sphere	mag-ne-to-sphere
im-pe-dance	im-ped-ance
paper-weight	pa-per-weight
brist-ly	bris-tly
pa-tri-o-tism	pa-tri-ot-ism
sem-est-er	se-mes-ter
sa-tel-lite	sat-el-lite
foolhardy	fool-har-dy
nor-thern-er	north-ern-er
res-is-tive	re-sis-tive
tre-spass	tres-pass
ey-elid	eye-lid
an-tedi-lu-vi-an	an-te-di-lu-vi-an
swam-pland	swamp-land
con-ver-ter	con-vert-er
renowned	re-nowned
lad-y-bug	la-dy-bug
fer-al	fe-ral
va-sec-to-my	vas-ec-to-my
se-same	ses-a-me
bal-ler-i-na	bal-le-ri-na
ar-chaic	ar-cha-ic
cate-ch-ism	cat-e-chism
in-de-fi-na-ble	in-de-fin-a-ble
nestling	nest-ling
un-rep-re-sen-ta-tive	un-rep-re-sent-a-tive
new-sread-er	news-read-er
cach-et	ca-chet
in-com-pres-s-i-ble	in-com-press-i-ble
trifl-ing	tri-fling
rifl-ing	ri-fling
tes-ta-men-tar-y	tes-ta-men-ta-ry
stabling	sta-bling
mo-l-est-er	mo-lest-er
beat-i-fy	be-at-i-fy
step-fath-er	step-fa-ther
di-sun-ion	dis-un-ion
trimming	trim-ming
la-ny-ard	lan-yard
pon-d-er	pon-der
im-mu-noas-say	im-mu-no-as-say
pla-giar-ism	pla-gia-rism
pean-ut	pea-nut
curling	curl-ing
der-i-sory	de-ri-so-ry
nu-cleus	nu-cle-us
pana-ma	pan-a-ma
pol-y-pho-ny	po-lyph-o-ny
is-o-la-tion-ist	i-so-la-tion-ist
bal-u-s-trade	bal-us-trade
en-gineer-ing	en-gi-neer-ing
lad-y-bird	la-dy-bird
po-l-ite-ness	po-lite-ness
war-m-er	warm-er
bee-f-y	beef-y
ep-is-tem-ic	ep-i-ste-mic
spec-trome-ter	spec-trom-e-ter
e-m-er-gence	e-mer-gence
gla-di-a-tor	glad-i-a-tor
turgid	tur-gid
mi-croor-gan-ism	mi-cro-or-gan-ism
her-oin	her-o-in
feas-i-bil-i-ty	fea-si-bil-i-ty
a-phor-ism	aph-o-rism
pur-port-ed	purported
cop-i-lot	co-pi-lot
wreck-ing	wrecking
pro-fi-ta-bil-i-ty	prof-it-a-bil-i-ty
darl-ing	dar-ling
wol-fish	wolf-ish
piti-a-ble	pit-i-a-ble
com-ber	comb-er
shoestring	shoe-string
boun-dar-y	bound-a-ry
re-v-el-ry	rev-el-ry
mi-ni	min-i
mes-seng-er	mes-sen-ger
hagi-og-ra-phy	hag-i-og-ra-phy
buzzard	buz-zard
em-broid-er-y	em-broi-der-y
sin-u-soid-al	si-nus-oi-dal
fu-ma-r-ole	fu-ma-role
micro-far-ad	mi-cro-far-ad
ex-per-i-men-t-er	ex-per-i-ment-er
hex-a-go-nal	hex-ag-o-nal
gazet-teer	gaz-et-teer
un-der-pinn-ing	un-der-pin-ning
col-lide	col-lide
im-per-so-nate	im-per-son-ate
te-tra	tet-ra
pre-face	pref-ace
tram-li-nes	tram-lines
cham-f-er	cham-fer
mari-on-ette	mar-i-on-ette
hier-arch	hi-er-arch
nast-y	nas-ty
hypno-ther-a-py	hyp-no-ther-a-py
bould-er	boul-der
re-for-m-ist	re-form-ist
sim-per-ing	simpering
coev-al	co-e-val
min-ce-me-at	mince-meat
glo-r-y	glo-ry
wherev-er	wher-ev-er
deplor-a-ble	de-plor-a-ble
e-very-one	eve-ry-one
ti-n-y	ti-ny
mye-lin	my-e-lin
at-tri-bute	at-trib-ute
hy-ph-e-nate	hy-phen-ate
bay-o-n-et	bay-o-net
ap-palling-ly	ap-pall-ing-ly
pred-i-ca-ment	pre-dic-a-ment
sine-w-y	sin-ew-y
grun-ter	grunt-er
pesk-y	pes-ky
for-sa-k-en	for-sak-en
ro-bin	rob-in
su-ba-tom-ic	sub-a-tom-ic
pre-da-tor	pred-a-tor
wil-d-er-ness	wil-der-ness
twen-tieth	twen-ti-eth
gib-bering	gibbering
mue-s-li	mues-li
mor-ass	mo-rass
ven-geance	venge-ance
chast-en-ing	chastening
com-ba-tant	com-bat-ant
in-habit	in-hab-it
col-lec-tive	col-lec-tive
ra-di-on-u-clide	ra-di-o-nu-clide
claimant	claim-ant
un-derfed	un-der-fed
bes-mirch	be-smirch
cour-tyard	court-yard
per-ci-pi-ent	per-cip-i-ent
sien-na	si-en-na
di-a-bo-l-ism	di-ab-o-lism
kin-et-ic	ki-net-ic
lico-rice	lic-o-rice
port-er	por-ter
gau-cherie	gau-che-rie
phy-si-og-no-my	phys-i-og-no-my
plastered	plas-tered
rel-o-ca-tion	re-lo-ca-tion
profli-ga-cy	prof-li-ga-cy
con-train-di-ca-tion	con-tra-in-di-ca-tion
twis-t-er	twist-er
lu-r-id	lu-rid
at-mo-s-pher-ics	at-mos-pher-ics
en-thalp-y	en-thal-py
flya-way	fly-a-way
clo-set	clos-et
now-here	no-where
re-la-ti-vis-tic	rel-a-tiv-is-tic
guanine	gua-nine
is-o-s-tat-ic	i-so-stat-ic
bath-wa-ter	bathwater
din-g-y	din-gy
un-ev-en-ly	un-e-ven-ly
nau-seate	nau-se-ate
ped-a-go-gic	ped-a-gog-ic
an-ti-bo-dy	an-ti-bod-y
par-li-a-men-ta-r-y	par-lia-men-ta-ry
stew-ar-dess	stew-ard-ess
mo-r-ose	mo-rose
deism	de-ism
wi-geon	wig-eon
sym-pa-th-y	sym-pa-thy
boatswain	boat-swain
coau-thor	co-au-thor
cat-as-troph-ic	cat-a-stroph-ic
feal-t-y	fe-al-ty
bey-ond	be-yond
shi-p-y-ard	ship-yard
laryn-geal	la-ryn-ge-al
sys-te-mat-ic	sys-tem-at-ic
hy-ph-en	hy-phen
valet	val-et
fast-en	fas-ten
sorghum	sor-ghum
wi-z-ar-d-ry	wiz-ard-ry
naiv-ete	naivete
fem-in-ism	fem-i-nism
splut-ter-ing	spluttering
pa-ten	pat-en
prem-i-ses	prem-is-es
wea-pon	weap-on
wear-i-ly	wea-ri-ly
polk-a	pol-ka
bun-gled	bungled
pre-late	prel-ate
rec-o-g-ni-tion	rec-og-ni-tion
her-oic	he-ro-ic
mic-ro-phone	mi-cro-phone
bedded	bed-ded
le-gen-da-r-y	leg-end-ar-y
hy-gien-ic	hy-gi-en-ic
pur-suer	pur-su-er
stur-d-y	stur-dy
based	based
der-iv-a-tive	de-riv-a-tive
prol-e-tar-i-an	pro-le-tar-i-an
con-vi-v-i-al	con-viv-i-al
mer-in-gue	me-ringue
gymk-ha-na	gym-kha-na
burn-ings	burn-ings
del-e-te-r-i-ous	del-e-te-ri-ous
vel-ve-teen	vel-vet-een
tran-s-lu-cen-cy	trans-lu-cen-cy
sho-g-un	sho-gun
pallid	pal-lid
cam-per	camp-er
preach-ing	preaching
dis-hon-est-y	dis-hon-es-ty
teen-a-ger	teen-ag-er
bo-t-a-ny	bot-a-ny
po-lym-er-ase	pol-y-mer-ase
tou-ris-tic	tour-is-tic
i-s-o-mor-phic	i-so-mor-phic
profil-ing	pro-fil-ing
flus-tered	flustered
dis-ylla-ble	di-syl-la-ble
joust-ing	jousting
ion-ic	i-on-ic
cho-re-ogra-ph-er	cho-re-og-ra-pher
no-bo-dy	no-bod-y
trum-pe-ter	trum-pet-er
freed-om	free-dom
con-ser-va-tive	con-serv-a-tive
pretreat-ment	pre-treat-ment
brand-y	bran-dy
de-vil	dev-il
per-mea-bil-i-ty	per-me-a-bil-i-ty
car-ri-age	car-riage
neu-ro-surg-er-y	neu-ro-sur-ger-y
de-sic-ca-tor	des-ic-ca-tor
so-phist	soph-ist
vehe-ment	ve-he-ment
mo-nau-ral	mon-au-ral
tar-ot	ta-rot
pro-b-le-mat-i-cal	prob-lem-at-i-cal
un-it	u-nit
mis-t-y	mist-y
hon-o-rif-ic	hon-or-if-ic
de-mo	dem-o
unk-nown	un-known
cur-vy	curv-y
cabi-net	cab-i-net
quad-ruped	quad-ru-ped
bono-bo	bo-no-bo
sham-an	sha-man
refer-ee-ing	refereeing
ir-re-tri-ev-a-bly	ir-re-triev-a-bly
phi-l-o-soph-i-cal	phil-o-soph-i-cal
seaweed	sea-weed
pe-t-er	pe-ter
pachy-derm	pach-y-derm
sep-ar-a-ble	sep-a-ra-ble
pe-r-u-sal	pe-rus-al
as-tro-nau-t-ics	as-tro-nau-tics
de-te-r-i-o-ra-tion	de-te-ri-o-ra-tion
white-washed	whitewashed
winn-ing-ly	win-ning-ly
mot-i-vate	mo-ti-vate
coas-t-al	coast-al
stan-dard	stand-ard
con-tem-p-tu-ous-ly	con-temp-tu-ous-ly
cor-re-spon-d-ence	cor-re-spond-ence
leer-ing	leering
clov-er	clo-ver
in-teg-ra-tive	in-te-gra-tive
un-it-ed	u-nit-ed
pej-or-a-tive	pe-jo-ra-tive
spirit-ed	spir-it-ed
mo-r-on	mo-ron
vaing-lo-ry	vain-glo-ry
skul-d-ug-ger-y	skul-dug-ger-y
smold-er	smol-der
riv-al	ri-val
dorm-er	dor-mer
dod-gem	dodg-em
tum-u-lus	tu-mu-lus
ra-v-en	ra-ven
prec-o-g-ni-tion	pre-cog-ni-tion
phy-loge-ny	phy-log-e-ny
neces-sar-i-ly	nec-es-sar-i-ly
mis-og-y-n-ist	mi-sog-y-nist
dis-cip-li-nar-i-an	dis-ci-pli-nar-i-an
saki	sa-ki
han-di-craft	hand-i-craft
ex-cel-sior	ex-cel-si-or
mag-ne-tite	mag-net-ite
pre-f-er	pre-fer
startling-ly	star-tling-ly
scrumhalf	scrum-half
plu-mage	plum-age
pa-tis-serie	pa-tis-se-rie
read-just	re-ad-just
pro-s-o-dy	pros-o-dy
el-e-men-ta-r-y	el-e-men-ta-ry
haph-a-zard-ly	hap-haz-ard-ly
li-mo	lim-o
briga-di-er	brig-a-dier
fin-ite	fi-nite
bu-oy-ant	buoy-ant
mel-liflu-ous	mel-lif-lu-ous
fron-tage	front-age
dis-con-tin-u-i-ty	dis-con-ti-nu-i-ty
hyper-ac-tive	hy-per-ac-tive
le-ghorn	leg-horn
prem-o-lar	pre-mo-lar
pro-tub-er-ance	pro-tu-ber-ance
re-s-em-ble	re-sem-ble
grape-fru-it	grape-fruit
cov-e-tous	cov-et-ous
quad-ruply	quad-ru-ply
trum-per-y	trump-er-y
de-bit	deb-it
pe-r-use	pe-ruse
mon-e-tar-ism	mon-e-ta-rism
cas-ta-way	cast-a-way
freest-yle	free-style
milk-shake	milkshake
sig-ner	sign-er
gar-age	ga-rage
for-tui-tous	for-tu-i-tous
cable-way	ca-ble-way
so-ci-o-e-c-o-nom-ic	so-ci-o-ec-o-nom-ic
cour-tier	cour-ti-er
re-ar-guard	rear-guard
eastern-most	east-ern-most
i-cos-a-he-dron	i-co-sa-he-dron
an-teat-er	ant-eat-er
fas-ti-d-i-ous	fas-tid-i-ous
pe-trel	pet-rel
mo-m-en-tar-y	mo-men-tar-y
a-p-o-lo-gi-a	ap-o-lo-gi-a
sun-tanned	suntanned
coin-cide	co-in-cide
fev-er	fe-ver
new-s-cast	news-cast
ditch-ing	ditching
vide-o-tape	vid-e-o-tape
scrip-twrit-er	script-writ-er
seques-tra-tion	se-ques-tra-tion
ca-v-ern	cav-ern
transverse	trans-verse
min-ute-ly	mi-nute-ly
une-mo-tion-al	un-e-mo-tion-al
dun-ghill	dung-hill
il-li-q-uid	il-liq-uid
o-pe-n-er	o-pen-er
dun-ga-r-ees	dun-ga-rees
un-sys-te-mat-ic	un-sys-tem-at-ic
at-ten-d-ance	at-tend-ance
re-cog-nize	rec-og-nize
clean-ser	cleans-er
unknow-ing	un-know-ing
bu-ri-al	bur-i-al
christ-en	chris-ten
theism	the-ism
mal-ig-nan-cy	ma-lig-nan-cy
e-nact	en-act
frustrat-ed	frus-trat-ed
splenet-ic	sple-net-ic
vehe-mence	ve-he-mence
guaca-mole	gua-ca-mo-le
lo-como-tive	lo-co-mo-tive
sal-mon	salm-on
res-pir-a-to-ry	res-pi-ra-to-ry
cou-p-let	cou-plet
post-modern	post-mod-ern
la-z-u-li	laz-u-li
em-o-tive	e-mo-tive
par-al-y-sis	pa-ral-y-sis
dis-hearten-ing	disheartening
neu-ro-n-al	neu-ron-al
free-l-ance	free-lance
cull-ing	culling
stin-gray	sting-ray
sup-ple-men-tar-y	sup-ple-men-ta-ry
sof-tie	soft-ie
ru-na-way	run-a-way
in-frastruc-tur-al	in-fra-struc-tur-al
cre-dit-wor-thi-ness	cred-it-wor-thi-ness
en-du-r-ance	en-dur-ance
var-ie-gat-ed	var-i-e-gat-ed
cam-paig-n-er	cam-paign-er
umpteen	ump-teen
de-vil-ment	dev-il-ment
cau-sa-tive	caus-a-tive
a-tav-ism	at-a-vism
coex-ten-sive	co-ex-ten-sive
dis-yl-lab-ic	di-syl-lab-ic
im-pro-b-a-ble	im-prob-a-ble
fe-r-o-cious-ly	fe-ro-cious-ly
torp-id	tor-pid
sur-rend-er	sur-ren-der
ap-par-a-tus	ap-pa-rat-us
ob-lig-ing-ly	o-blig-ing-ly
tur-nov-er	turn-o-ver
nin-e-teenth	nine-teenth
pleat-ed	pleated
cutler-y	cut-ler-y
im-pla-ca-ble	im-plac-a-ble
cask-et	cas-ket
par-s-ley	pars-ley
doork-nob	door-knob
de-li	del-i
mo-lasses	mo-las-ses
un-easi-ness	un-eas-i-ness
height-ened	heightened
thund-er	thun-der
tran-s-con-ti-nen-tal	trans-con-ti-nen-tal
gold-s-mith	gold-smith
res-o-n-ance	res-o-nance
glut-to-ny	glut-ton-y
com-pelling-ly	com-pel-ling-ly
gang-ly	gan-gly
e-nact-ment	en-act-ment
kin-et-ics	ki-net-ics
as-pid-is-tra	as-pi-dis-tra
de-prec-a-to-ry	dep-re-ca-to-ry
bi-o-m-ass	bi-o-mass
o-ver-seer	o-ver-se-er
running	run-ning
trous-er	trou-ser
coast-ing	coasting
te-le-o-log-i-cal	tel-e-o-log-i-cal
mis-o-g-y-nis-tic	mi-sog-y-nis-tic
pil-as-ter	pi-las-ter
herring	her-ring
de-spot-ic	des-pot-ic
ion	i-on
goa-t-ee	goat-ee
be-leaguered	beleaguered
ca-sh-ier	cash-ier
un-der-car-ri-age	un-der-car-riage
pro-bo-s-cis	pro-bos-cis
bi-er	bier
mouth-water-ing	mouth-wa-ter-ing
reg-e-late	re-ge-late
proph-e-s-y	proph-e-sy
a-w-ash	a-wash
bee-feat-er	beef-eat-er
ob-liging	o-blig-ing
eon	e-on
in-doc-trinate	in-doc-tri-nate
read-just-ment	re-ad-just-ment
highlight-er	high-light-er
ye-o-man	yeo-man
rede-fine	re-de-fine
a-pocry-phal	a-poc-ry-phal
sta-d-i-um	sta-di-um
py-ri-dine	pyr-i-dine
ra-con-teur	rac-on-teur
meth-y-lene	meth-yl-ene
ex-tre-mism	ex-trem-ism
di-alogue	di-a-logue
theist	the-ist
sub-ur-ban-i-sa-tion	suburbanisation
un-chartered	un-char-tered
ex-is-t-ence	ex-ist-ence
de-bo-nair	deb-o-nair
nav-y	na-vy
fing-er	fin-ger
fil-mic	film-ic
shoe-l-ace	shoe-lace
re-t-i-na	ret-i-na
host-age	hos-tage
doc-to-ral	doc-tor-al
cu-ra-ble	cur-a-ble
en-tour-age	en-tou-rage
im-mo-r-al	im-mor-al
righ-t-e-ous	right-eous
ple-bei-an	ple-be-ian
ar-bore-tum	ar-bo-re-tum
brigand	brig-and
ca-pri-ole	cap-ri-ole
groc-er	gro-cer
re-k-in-dle	re-kin-dle
cur-ly	curl-y
en-tre-pre-neu-ri-al	en-tre-pre-neur-i-al
por-traitist	por-trait-ist
mur-d-er	mur-der
car-ci-n-o-gen	car-cin-o-gen
dis-pen-ser	dis-pens-er
fu-gue	fugue
non-cha-l-ant	non-cha-lant
pin-kie	pink-ie
syca-more	syc-a-more
co-ri-an-d-er	co-ri-an-der
cas-ser-ole	cas-se-role
con-for-m-i-ty	con-form-i-ty
re-min-d-er	re-mind-er
science	sci-ence
body-build-ing	bod-y-build-ing
mar-sh-land	marsh-land
th-wart	thwart
nauseat-ing	nau-se-at-ing
in-val-id	in-va-lid
toke-nism	to-ken-ism
tub-u-lar	tu-bu-lar
sev-ered	severed
gal-leon	gal-le-on
stee-ly	steel-y
o-do-r-ous	o-dor-ous
fabled	fa-bled
reg-ist-ry	reg-is-try
as-so-n-ance	as-so-nance
con-vales-cence	con-va-les-cence
de-brief-ing	debriefing
sen-sual-i-ty	sen-su-al-i-ty
non-ethe-less	none-the-less
un-tran-s-lata-ble	un-trans-lat-a-ble
nuis-ance	nui-sance
orchid	or-chid
vex-ing	vexing
re-im-ple-ment-ed	reimplemented
ashamed	a-shamed
cafe	ca-fe
halfheart-ed-ly	half-heart-ed-ly
rew-rit-a-ble	re-writ-a-ble
triggered	trig-gered
hi-jack-ing	hijacking
fore-fath-er	fore-fa-ther
male-fac-tor	mal-e-fac-tor
ste-re-o	ster-e-o
tel-ep-a-thy	te-lep-a-thy
he-li-os-phere	he-li-o-sphere
re-tro-ac-tive	ret-ro-ac-tive
u-phill	up-hill
fin-al-i-ty	fi-nal-i-ty
con-ser-va-to-ry	con-serv-a-to-ry
se-v-ere	se-vere
ma-ta-dor	mat-a-dor
bulg-ing	bulging
un-pre-ju-diced	un-prej-u-diced
mil-lise-cond	mil-li-sec-ond
Words with errors: 1226
Words with incorrect number of syllables: 678
Total evluated: 6500
Perfect accuracy: 0.81
Number of syllables accuracy: 0.90
Average Levenshtein Distance(across incorrect words): 1.15
